'F. contable';'F. valor';'Concepto';'Importe';'Saldo';'Seq';'Import num';'Saldo anterior';'Tiene fecha';'Fecha Valor Concepto';'Clave_Concepto';'Categoria';'Subcategoria';'Fijo_Variable'
31/12/2005;31/12/2005;'AJUSTE INICIAL';1.978,70 €;1.978,70 €;-3478;1.978,70;6.502,79 €;'sin fechas';31/12/2005;'AJUSTE';'No computable';'Inicializacion';
02/01/2006;02/01/2006;'ONO';-71,06 €;1.907,64 €;-3477;-71,06;6.431,73 €;'sin fechas';02/01/2006;'ONO';'Gastos_Servicios tipicos';'Telecomunicaciones';'FIJO'
02/01/2006;02/01/2006;'REINT.CAJERO';-300,00 €;1.607,64 €;-3476;-300,00;6.131,73 €;'sin fechas';02/01/2006;'REINTCAJERO';'Gastos_Gastos varios';'Efectivo';'VARIABLES'
02/01/2006;02/01/2006;'REINT.CAJERO';-300,00 €;1.307,64 €;-3475;-300,00;5.831,73 €;'sin fechas';02/01/2006;'REINTCAJERO';'Gastos_Gastos varios';'Efectivo';'VARIABLES'
04/01/2006;04/01/2006;'AMENA RETEVISI';-28,72 €;1.278,92 €;-3474;-28,72;5.803,01 €;'sin fechas';04/01/2006;'AMENA';'Gastos_Servicios tipicos';'Telecomunicaciones';'FIJO'
05/01/2006;05/01/2006;'METRO';-6,65 €;1.272,27 €;-3473;-6,65;5.796,36 €;'sin fechas';05/01/2006;'METRO';'Gastos_Ocio y transporte';'Transporte';'VARIABLES'
06/01/2006;06/01/2006;'CONSUM';-5,73 €;1.266,54 €;-3472;-5,73;5.790,63 €;'sin fechas';06/01/2006;'CONSUM';'Gastos_Compras';'Supermercado';'VARIABLES'
06/01/2006;06/01/2006;'XARCUTERIA VIDAL';-18,90 €;1.247,64 €;-3471;-18,90;5.771,73 €;'sin fechas';06/01/2006;'XARCUTERIA';'Gastos_Compras';'Supermercado';'VARIABLES'
07/01/2006;07/01/2006;'RESTAURANTES';-38,70 €;1.208,94 €;-3470;-38,70;5.733,03 €;'sin fechas';07/01/2006;'RESTAURANTES';'Gastos_Ocio y transporte';'Restaurantes';'VARIABLES'
08/01/2006;08/01/2006;'RESTAURANTES';-58,58 €;1.150,36 €;-3469;-58,58;5.674,45 €;'sin fechas';08/01/2006;'RESTAURANTES';'Gastos_Ocio y transporte';'Restaurantes';'VARIABLES'
09/01/2006;09/01/2006;'CLSL BARCELONA ES';-22,00 €;1.128,36 €;-3468;-22,00;5.652,45 €;'sin fechas';09/01/2006;'CLSL';'Gastos_Compras';'Hogar';'VARIABLES'
09/01/2006;09/01/2006;'METRO';-6,65 €;1.121,71 €;-3467;-6,65;5.645,80 €;'sin fechas';09/01/2006;'METRO';'Gastos_Ocio y transporte';'Transporte';'VARIABLES'
09/01/2006;09/01/2006;'METRO';-6,40 €;1.115,31 €;-3466;-6,40;5.639,40 €;'sin fechas';09/01/2006;'METRO';'Gastos_Ocio y transporte';'Transporte';'VARIABLES'
10/01/2006;10/01/2006;'METRO';-6,65 €;1.108,66 €;-3465;-6,65;5.632,75 €;'sin fechas';10/01/2006;'METRO';'Gastos_Ocio y transporte';'Transporte';'VARIABLES'
11/01/2006;11/01/2006;'CINE';-9,80 €;1.098,86 €;-3464;-9,80;5.622,95 €;'sin fechas';11/01/2006;'CINE';'Gastos_Ocio y transporte';'Espectáculos';'VARIABLES'
12/01/2006;12/01/2006;'REINT.CAJERO';-20,00 €;1.078,86 €;-3463;-20,00;5.602,95 €;'sin fechas';12/01/2006;'REINTCAJERO';'Gastos_Gastos varios';'Efectivo';'VARIABLES'
13/01/2006;13/01/2006;'CAPRABO';-6,62 €;1.072,24 €;-3462;-6,62;5.596,33 €;'sin fechas';13/01/2006;'CAPRABO';'Gastos_Compras';'Supermercado';'VARIABLES'
16/01/2006;16/01/2006;'ENDESA DISTRIB';-19,45 €;1.052,79 €;-3461;-19,45;5.576,88 €;'sin fechas';16/01/2006;'ENDESA';'Gastos_Servicios tipicos';'Electricidad';'FIJO'
16/01/2006;16/01/2006;'METRO';-6,65 €;1.046,14 €;-3460;-6,65;5.570,23 €;'sin fechas';16/01/2006;'METRO';'Gastos_Ocio y transporte';'Transporte';'VARIABLES'
16/01/2006;16/01/2006;'METRO';-6,65 €;1.039,49 €;-3459;-6,65;5.563,58 €;'sin fechas';16/01/2006;'METRO';'Gastos_Ocio y transporte';'Transporte';'VARIABLES'
16/01/2006;16/01/2006;'SEG.AM.HIPITEC';-33,11 €;1.006,38 €;-3458;-33,11;5.530,47 €;'sin fechas';16/01/2006;'SEGAMHIPITEC';'Gastos_Seguros';'Seguro vida';'FIJO'
17/01/2006;17/01/2006;'METRO';-6,65 €;999,73 €;-3457;-6,65;5.523,82 €;'sin fechas';17/01/2006;'METRO';'Gastos_Ocio y transporte';'Transporte';'VARIABLES'
18/01/2006;18/01/2006;'ELECTRONICA WEB';-142,00 €;857,73 €;-3456;-142,00;5.381,82 €;'sin fechas';18/01/2006;'ELECTRONICA';'Gastos_Compras';'Hobbys';'VARIABLES'
18/01/2006;18/01/2006;'GROUPAMA PLUS';-42,60 €;815,13 €;-3455;-42,60;5.339,22 €;'sin fechas';18/01/2006;'GROUPAMA';'Gastos_Seguros';'Seguro salud';'FIJO'
19/01/2006;19/01/2006;'REINT.CAJERO';-20,00 €;795,13 €;-3454;-20,00;5.319,22 €;'sin fechas';19/01/2006;'REINTCAJERO';'Gastos_Gastos varios';'Efectivo';'VARIABLES'
20/01/2006;20/01/2006;'KUROKAI';-118,93 €;676,20 €;-3453;-118,93;5.200,29 €;'sin fechas';20/01/2006;'KUROKAI';'Gastos_Compras';'Ropa';'VARIABLES'
21/01/2006;21/01/2006;'CINE';-9,80 €;666,40 €;-3452;-9,80;5.190,49 €;'sin fechas';21/01/2006;'CINE';'Gastos_Ocio y transporte';'Espectáculos';'VARIABLES'
21/01/2006;21/01/2006;'GASOLINA';-48,00 €;618,40 €;-3451;-48,00;5.142,49 €;'sin fechas';21/01/2006;'GASOLINA';'Gastos_Ocio y transporte';'Gasolina';'VARIABLES'
21/01/2006;21/01/2006;'RESTAURANTES';-23,70 €;594,70 €;-3450;-23,70;5.118,79 €;'sin fechas';21/01/2006;'RESTAURANTES';'Gastos_Ocio y transporte';'Restaurantes';'VARIABLES'
24/01/2006;24/01/2006;'REINT.CAJERO';-20,00 €;574,70 €;-3449;-20,00;5.098,79 €;'sin fechas';24/01/2006;'REINTCAJERO';'Gastos_Gastos varios';'Efectivo';'VARIABLES'
24/01/2006;24/01/2006;'REINT.CAJERO';1.100,00 €;1.674,70 €;-3448;1.100,00;6.198,79 €;'sin fechas';24/01/2006;'REINTCAJERO';'Gastos_Gastos varios';'Efectivo';'VARIABLES'
24/01/2006;24/01/2006;'T. SHIRT STATTION BARCELONA ES';-16,00 €;1.658,70 €;-3447;-16,00;6.182,79 €;'sin fechas';24/01/2006;'SHIRT';'Gastos_Compras';'Ropa';'VARIABLES'
25/01/2006;25/01/2006;'AMENA RETEVISI';-56,31 €;1.602,39 €;-3446;-56,31;6.126,48 €;'sin fechas';25/01/2006;'AMENA';'Gastos_Servicios tipicos';'Telecomunicaciones';'FIJO'
26/01/2006;26/01/2006;'METRO';-6,65 €;1.595,74 €;-3445;-6,65;6.119,83 €;'sin fechas';26/01/2006;'METRO';'Gastos_Ocio y transporte';'Transporte';'VARIABLES'
26/01/2006;26/01/2006;'REINT.CAJERO';-40,00 €;1.555,74 €;-3444;-40,00;6.079,83 €;'sin fechas';26/01/2006;'REINTCAJERO';'Gastos_Gastos varios';'Efectivo';'VARIABLES'
27/01/2006;27/01/2006;'ONO';-73,18 €;1.482,56 €;-3443;-73,18;6.006,65 €;'sin fechas';27/01/2006;'ONO';'Gastos_Servicios tipicos';'Telecomunicaciones';'FIJO'
30/01/2006;30/01/2006;'METRO';-6,65 €;1.475,91 €;-3442;-6,65;6.000,00 €;'sin fechas';30/01/2006;'METRO';'Gastos_Ocio y transporte';'Transporte';'VARIABLES'
31/01/2006;31/01/2006;'RECIBO PTMOS. 3061-0960001518';-636,06 €;839,85 €;-3441;-636,06;5.363,94 €;'sin fechas';31/01/2006;'RECIBO';'Gastos_Banco y organismos';'Hipoteca';'FIJO'
31/01/2006;31/01/2006;'TASACIONES INMOBILIARIAS';692,77 €;1.532,62 €;-3440;692,77;6.056,71 €;'sin fechas';31/01/2006;'TASACIONES';'Ingresos';'Nomina';'FIJO'
03/02/2006;03/02/2006;'ADVENTURE TERRITO';-14,90 €;1.517,72 €;-3439;-14,90;6.041,81 €;'sin fechas';03/02/2006;'ADVENTURE';'Gastos_Compras';'Ropa';'VARIABLES'
03/02/2006;03/02/2006;'CINE';-9,80 €;1.507,92 €;-3438;-9,80;6.032,01 €;'sin fechas';03/02/2006;'CINE';'Gastos_Ocio y transporte';'Espectáculos';'VARIABLES'
03/02/2006;03/02/2006;'REINT.CAJERO';-20,00 €;1.487,92 €;-3437;-20,00;6.012,01 €;'sin fechas';03/02/2006;'REINTCAJERO';'Gastos_Gastos varios';'Efectivo';'VARIABLES'
04/02/2006;04/02/2006;'REINT.CAJERO';-20,00 €;1.467,92 €;-3436;-20,00;5.992,01 €;'sin fechas';04/02/2006;'REINTCAJERO';'Gastos_Gastos varios';'Efectivo';'VARIABLES'
06/02/2006;06/02/2006;'AMENA RETEVISI';-55,94 €;1.411,98 €;-3435;-55,94;5.936,07 €;'sin fechas';06/02/2006;'AMENA';'Gastos_Servicios tipicos';'Telecomunicaciones';'FIJO'
06/02/2006;06/02/2006;'DIVERS SANTS ESTACION';-19,90 €;1.392,08 €;-3434;-19,90;5.916,17 €;'sin fechas';06/02/2006;'DIVERS';'Gastos_Compras';'Supermercado';'VARIABLES'
06/02/2006;06/02/2006;'RENFE';-6,65 €;1.385,43 €;-3433;-6,65;5.909,52 €;'sin fechas';06/02/2006;'RENFE';'Gastos_Ocio y transporte';'Transporte';'VARIABLES'
06/02/2006;06/02/2006;'T. SHIRT STATTION BARCELONA ES';-20,00 €;1.365,43 €;-3432;-20,00;5.889,52 €;'sin fechas';06/02/2006;'SHIRT';'Gastos_Compras';'Ropa';'VARIABLES'
08/02/2006;08/02/2006;'GROUPAMA PLUS';-41,12 €;1.324,31 €;-3431;-41,12;5.848,40 €;'sin fechas';08/02/2006;'GROUPAMA';'Gastos_Seguros';'Seguro salud';'FIJO'
09/02/2006;09/02/2006;'METRO';-6,65 €;1.317,66 €;-3430;-6,65;5.841,75 €;'sin fechas';09/02/2006;'METRO';'Gastos_Ocio y transporte';'Transporte';'VARIABLES'
09/02/2006;09/02/2006;'REINT.CAJERO';-70,00 €;1.247,66 €;-3429;-70,00;5.771,75 €;'sin fechas';09/02/2006;'REINTCAJERO';'Gastos_Gastos varios';'Efectivo';'VARIABLES'
13/02/2006;13/02/2006;'PEAJE VILANOVA';-4,69 €;1.242,97 €;-3428;-4,69;5.767,06 €;'sin fechas';13/02/2006;'PEAJE';'Gastos_Ocio y transporte';'Parking y peaje';'VARIABLES'
13/02/2006;13/02/2006;'PEAJE VILANOVA';-4,69 €;1.238,28 €;-3427;-4,69;5.762,37 €;'sin fechas';13/02/2006;'PEAJE';'Gastos_Ocio y transporte';'Parking y peaje';'VARIABLES'
14/02/2006;14/02/2006;'CAPRABO';-8,32 €;1.229,96 €;-3426;-8,32;5.754,05 €;'sin fechas';14/02/2006;'CAPRABO';'Gastos_Compras';'Supermercado';'VARIABLES'
15/02/2006;15/02/2006;'METRO';-13,30 €;1.216,66 €;-3425;-13,30;5.740,75 €;'sin fechas';15/02/2006;'METRO';'Gastos_Ocio y transporte';'Transporte';'VARIABLES'
15/02/2006;15/02/2006;'SEG.AM.HIPITEC';-33,04 €;1.183,62 €;-3424;-33,04;5.707,71 €;'sin fechas';15/02/2006;'SEGAMHIPITEC';'Gastos_Seguros';'Seguro vida';'FIJO'
18/02/2006;18/02/2006;'REINT.CAJERO';-40,00 €;1.143,62 €;-3423;-40,00;5.667,71 €;'sin fechas';18/02/2006;'REINTCAJERO';'Gastos_Gastos varios';'Efectivo';'VARIABLES'
19/02/2006;19/02/2006;'RESTAURANTES';-33,97 €;1.109,65 €;-3422;-33,97;5.633,74 €;'sin fechas';19/02/2006;'RESTAURANTES';'Gastos_Ocio y transporte';'Restaurantes';'VARIABLES'
20/02/2006;20/02/2006;'METRO';-6,65 €;1.103,00 €;-3421;-6,65;5.627,09 €;'sin fechas';20/02/2006;'METRO';'Gastos_Ocio y transporte';'Transporte';'VARIABLES'
21/02/2006;21/02/2006;'GAS NATURAL';-30,23 €;1.072,77 €;-3420;-30,23;5.596,86 €;'sin fechas';21/02/2006;'GAS';'Gastos_Servicios tipicos';'Gas';'FIJO'
21/02/2006;21/02/2006;'ONO';-73,18 €;999,59 €;-3419;-73,18;5.523,68 €;'sin fechas';21/02/2006;'ONO';'Gastos_Servicios tipicos';'Telecomunicaciones';'FIJO'
23/02/2006;23/02/2006;'AMENA RETEVISI';-41,98 €;957,61 €;-3418;-41,98;5.481,70 €;'sin fechas';23/02/2006;'AMENA';'Gastos_Servicios tipicos';'Telecomunicaciones';'FIJO'
24/02/2006;24/02/2006;'GASOLINA';-45,00 €;912,61 €;-3417;-45,00;5.436,70 €;'sin fechas';24/02/2006;'GASOLINA';'Gastos_Ocio y transporte';'Gasolina';'VARIABLES'
25/02/2006;25/02/2006;'CINE';-12,40 €;900,21 €;-3416;-12,40;5.424,30 €;'sin fechas';25/02/2006;'CINE';'Gastos_Ocio y transporte';'Espectáculos';'VARIABLES'
25/02/2006;25/02/2006;'LA VIDA ES BELLA';-11,90 €;888,31 €;-3415;-11,90;5.412,40 €;'sin fechas';25/02/2006;'VIDA';'Gastos_Salud, saber y deporte';'Belleza';'VARIABLES'
27/02/2006;27/02/2006;'METRO';-18,30 €;870,01 €;-3414;-18,30;5.394,10 €;'sin fechas';27/02/2006;'METRO';'Gastos_Ocio y transporte';'Transporte';'VARIABLES'
28/02/2006;28/02/2006;'PEAJE XERTA';-2,45 €;867,56 €;-3413;-2,45;5.391,65 €;'sin fechas';28/02/2006;'PEAJE';'Gastos_Ocio y transporte';'Parking y peaje';'VARIABLES'
28/02/2006;28/02/2006;'PEAJE XERTA';-3,10 €;864,46 €;-3412;-3,10;5.388,55 €;'sin fechas';28/02/2006;'PEAJE';'Gastos_Ocio y transporte';'Parking y peaje';'VARIABLES'
28/02/2006;28/02/2006;'PEAJE XERTA';-4,25 €;860,21 €;-3411;-4,25;5.384,30 €;'sin fechas';28/02/2006;'PEAJE';'Gastos_Ocio y transporte';'Parking y peaje';'VARIABLES'
28/02/2006;28/02/2006;'PEAJE XERTA';-3,10 €;857,11 €;-3410;-3,10;5.381,20 €;'sin fechas';28/02/2006;'PEAJE';'Gastos_Ocio y transporte';'Parking y peaje';'VARIABLES'
28/02/2006;28/02/2006;'RECIBO PTMOS. 3061-0960001518';-636,06 €;221,05 €;-3409;-636,06;4.745,14 €;'sin fechas';28/02/2006;'RECIBO';'Gastos_Banco y organismos';'Hipoteca';'FIJO'
28/02/2006;28/02/2006;'REINT.CAJERO';-20,00 €;201,05 €;-3408;-20,00;4.725,14 €;'sin fechas';28/02/2006;'REINTCAJERO';'Gastos_Gastos varios';'Efectivo';'VARIABLES'
01/03/2006;01/03/2006;'METRO';-6,65 €;194,40 €;-3407;-6,65;4.718,49 €;'sin fechas';01/03/2006;'METRO';'Gastos_Ocio y transporte';'Transporte';'VARIABLES'
01/03/2006;28/02/2006;'TASACIONES INMOBILIARIAS';692,77 €;887,17 €;-3406;692,77;5.411,26 €;'sin fechas';28/02/2006;'TASACIONES';'Ingresos';'Nomina';'FIJO'
02/03/2006;02/03/2006;'METRO';-6,65 €;880,52 €;-3405;-6,65;5.404,61 €;'sin fechas';02/03/2006;'METRO';'Gastos_Ocio y transporte';'Transporte';'VARIABLES'
03/03/2006;03/03/2006;'REINT.CAJERO';-20,00 €;860,52 €;-3404;-20,00;5.384,61 €;'sin fechas';03/03/2006;'REINTCAJERO';'Gastos_Gastos varios';'Efectivo';'VARIABLES'
04/03/2006;04/03/2006;'HITCON RECAMBIOS';-17,98 €;842,54 €;-3403;-17,98;5.366,63 €;'sin fechas';04/03/2006;'HITCON';'Gastos_Vivienda y vehiculo';'Mnto. vehiculo';'VARIABLE'
04/03/2006;04/03/2006;'REINT.CAJERO';-50,00 €;792,54 €;-3402;-50,00;5.316,63 €;'sin fechas';04/03/2006;'REINTCAJERO';'Gastos_Gastos varios';'Efectivo';'VARIABLES'
04/03/2006;04/03/2006;'REINT.CAJERO';-40,00 €;752,54 €;-3401;-40,00;5.276,63 €;'sin fechas';04/03/2006;'REINTCAJERO';'Gastos_Gastos varios';'Efectivo';'VARIABLES'
06/03/2006;06/03/2006;'AMENA RETEVISI';-24,89 €;727,65 €;-3400;-24,89;5.251,74 €;'sin fechas';06/03/2006;'AMENA';'Gastos_Servicios tipicos';'Telecomunicaciones';'FIJO'
06/03/2006;06/03/2006;'METRO';-6,65 €;721,00 €;-3399;-6,65;5.245,09 €;'sin fechas';06/03/2006;'METRO';'Gastos_Ocio y transporte';'Transporte';'VARIABLES'
07/03/2006;07/03/2006;'METRO';-6,65 €;714,35 €;-3398;-6,65;5.238,44 €;'sin fechas';07/03/2006;'METRO';'Gastos_Ocio y transporte';'Transporte';'VARIABLES'
07/03/2006;07/03/2006;'REINT.CAJERO';600,00 €;1.314,35 €;-3397;600,00;5.838,44 €;'sin fechas';07/03/2006;'REINTCAJERO';'Gastos_Gastos varios';'Efectivo';'VARIABLES'
09/03/2006;09/03/2006;'GROUPAMA PLUS';-41,12 €;1.273,23 €;-3396;-41,12;5.797,32 €;'sin fechas';09/03/2006;'GROUPAMA';'Gastos_Seguros';'Seguro salud';'FIJO'
10/03/2006;10/03/2006;'GASOLINA';-50,00 €;1.223,23 €;-3395;-50,00;5.747,32 €;'sin fechas';10/03/2006;'GASOLINA';'Gastos_Ocio y transporte';'Gasolina';'VARIABLES'
10/03/2006;10/03/2006;'REINT.CAJERO';-90,00 €;1.133,23 €;-3394;-90,00;5.657,32 €;'sin fechas';10/03/2006;'REINTCAJERO';'Gastos_Gastos varios';'Efectivo';'VARIABLES'
10/03/2006;10/03/2006;'REINT.CAJERO';-20,00 €;1.113,23 €;-3393;-20,00;5.637,32 €;'sin fechas';10/03/2006;'REINTCAJERO';'Gastos_Gastos varios';'Efectivo';'VARIABLES'
11/03/2006;11/03/2006;'RESTAURANTES';-20,70 €;1.092,53 €;-3392;-20,70;5.616,62 €;'sin fechas';11/03/2006;'RESTAURANTES';'Gastos_Ocio y transporte';'Restaurantes';'VARIABLES'
13/03/2006;13/03/2006;'METRO';-6,65 €;1.085,88 €;-3391;-6,65;5.609,97 €;'sin fechas';13/03/2006;'METRO';'Gastos_Ocio y transporte';'Transporte';'VARIABLES'
13/03/2006;13/03/2006;'PEAJE XERTA';-5,20 €;1.080,68 €;-3390;-5,20;5.604,77 €;'sin fechas';13/03/2006;'PEAJE';'Gastos_Ocio y transporte';'Parking y peaje';'VARIABLES'
13/03/2006;13/03/2006;'PEAJE XERTA';-5,20 €;1.075,48 €;-3389;-5,20;5.599,57 €;'sin fechas';13/03/2006;'PEAJE';'Gastos_Ocio y transporte';'Parking y peaje';'VARIABLES'
14/03/2006;14/03/2006;'FARMACIA';-20,80 €;1.054,68 €;-3388;-20,80;5.578,77 €;'sin fechas';14/03/2006;'FARMACIA';'Gastos_Salud, saber y deporte';'Farmacia';'VARIABLES'
14/03/2006;14/03/2006;'METRO';-6,65 €;1.048,03 €;-3387;-6,65;5.572,12 €;'sin fechas';14/03/2006;'METRO';'Gastos_Ocio y transporte';'Transporte';'VARIABLES'
14/03/2006;14/03/2006;'MINA PUBLICA DE LA CIUTAT';-17,87 €;1.030,16 €;-3386;-17,87;5.554,25 €;'sin fechas';14/03/2006;'MINA';'Gastos_Servicios tipicos';'Agua';'FIJO'
14/03/2006;14/03/2006;'PEAJE XERTA';-2,30 €;1.027,86 €;-3385;-2,30;5.551,95 €;'sin fechas';14/03/2006;'PEAJE';'Gastos_Ocio y transporte';'Parking y peaje';'VARIABLES'
14/03/2006;14/03/2006;'PEAJE XERTA';-3,10 €;1.024,76 €;-3384;-3,10;5.548,85 €;'sin fechas';14/03/2006;'PEAJE';'Gastos_Ocio y transporte';'Parking y peaje';'VARIABLES'
14/03/2006;14/03/2006;'PEAJE XERTA';-2,45 €;1.022,31 €;-3383;-2,45;5.546,40 €;'sin fechas';14/03/2006;'PEAJE';'Gastos_Ocio y transporte';'Parking y peaje';'VARIABLES'
14/03/2006;14/03/2006;'PEAJE XERTA';-2,30 €;1.020,01 €;-3382;-2,30;5.544,10 €;'sin fechas';14/03/2006;'PEAJE';'Gastos_Ocio y transporte';'Parking y peaje';'VARIABLES'
14/03/2006;14/03/2006;'PEAJE XERTA';-3,10 €;1.016,91 €;-3381;-3,10;5.541,00 €;'sin fechas';14/03/2006;'PEAJE';'Gastos_Ocio y transporte';'Parking y peaje';'VARIABLES'
14/03/2006;14/03/2006;'PEAJE XERTA';-2,45 €;1.014,46 €;-3380;-2,45;5.538,55 €;'sin fechas';14/03/2006;'PEAJE';'Gastos_Ocio y transporte';'Parking y peaje';'VARIABLES'
16/03/2006;16/03/2006;'ENDESA DISTRIB';-14,81 €;999,65 €;-3379;-14,81;5.523,74 €;'sin fechas';16/03/2006;'ENDESA';'Gastos_Servicios tipicos';'Electricidad';'FIJO'
16/03/2006;16/03/2006;'SEG.AM.HIPITEC';-32,98 €;966,67 €;-3378;-32,98;5.490,76 €;'sin fechas';16/03/2006;'SEGAMHIPITEC';'Gastos_Seguros';'Seguro vida';'FIJO'
17/03/2006;17/03/2006;'YALTA CRIMEA \BARCELONA\ES';-10,20 €;956,47 €;-3377;-10,20;5.480,56 €;'sin fechas';17/03/2006;'YALTA';'Gastos_Compras';'Hogar';'VARIABLES'
18/03/2006;18/03/2006;'AKI TERRASSA';-24,65 €;931,82 €;-3376;-24,65;5.455,91 €;'sin fechas';18/03/2006;'AKI';'Gastos_Vivienda y vehiculo';'Mnto. hogar';'VARIABLES'
18/03/2006;18/03/2006;'MERCADONA';-41,72 €;890,10 €;-3375;-41,72;5.414,19 €;'sin fechas';18/03/2006;'MERCADONA';'Gastos_Compras';'Supermercado';'VARIABLES'
18/03/2006;18/03/2006;'RESTAURANTES';-20,70 €;869,40 €;-3374;-20,70;5.393,49 €;'sin fechas';18/03/2006;'RESTAURANTES';'Gastos_Ocio y transporte';'Restaurantes';'VARIABLES'
18/03/2006;18/03/2006;'TASACIONES INMOBILIARIAS';675,12 €;1.544,52 €;-3373;675,12;6.068,61 €;'sin fechas';18/03/2006;'TASACIONES';'Ingresos';'Nomina';'FIJO'
20/03/2006;20/03/2006;'PEAJE PREMIA';-0,64 €;1.543,88 €;-3372;-0,64;6.067,97 €;'sin fechas';20/03/2006;'PEAJE';'Gastos_Ocio y transporte';'Parking y peaje';'VARIABLES'
20/03/2006;20/03/2006;'PEAJE PREMIA';-0,64 €;1.543,24 €;-3371;-0,64;6.067,33 €;'sin fechas';20/03/2006;'PEAJE';'Gastos_Ocio y transporte';'Parking y peaje';'VARIABLES'
20/03/2006;20/03/2006;'REINT.CAJERO';-20,00 €;1.523,24 €;-3370;-20,00;6.047,33 €;'sin fechas';20/03/2006;'REINTCAJERO';'Gastos_Gastos varios';'Efectivo';'VARIABLES'
21/03/2006;21/03/2006;'CELIO TERRASSA';-6,99 €;1.516,25 €;-3369;-6,99;6.040,34 €;'sin fechas';21/03/2006;'CELIO';'Gastos_Compras';'Ropa';'VARIABLES'
21/03/2006;21/03/2006;'REINT.CAJERO';-20,00 €;1.496,25 €;-3368;-20,00;6.020,34 €;'sin fechas';21/03/2006;'REINTCAJERO';'Gastos_Gastos varios';'Efectivo';'VARIABLES'
21/03/2006;21/03/2006;'REINT.CAJERO';-150,00 €;1.346,25 €;-3367;-150,00;5.870,34 €;'sin fechas';21/03/2006;'REINTCAJERO';'Gastos_Gastos varios';'Efectivo';'VARIABLES'
21/03/2006;21/03/2006;'RESTAURANTES';-12,80 €;1.333,45 €;-3366;-12,80;5.857,54 €;'sin fechas';21/03/2006;'RESTAURANTES';'Gastos_Ocio y transporte';'Restaurantes';'VARIABLES'
22/03/2006;22/03/2006;'ONO';-73,18 €;1.260,27 €;-3365;-73,18;5.784,36 €;'sin fechas';22/03/2006;'ONO';'Gastos_Servicios tipicos';'Telecomunicaciones';'FIJO'
23/03/2006;23/03/2006;'AMENA RETEVISI';-34,39 €;1.225,88 €;-3364;-34,39;5.749,97 €;'sin fechas';23/03/2006;'AMENA';'Gastos_Servicios tipicos';'Telecomunicaciones';'FIJO'
25/03/2006;25/03/2006;'MERCADONA';-70,33 €;1.155,55 €;-3363;-70,33;5.679,64 €;'sin fechas';25/03/2006;'MERCADONA';'Gastos_Compras';'Supermercado';'VARIABLES'
25/03/2006;25/03/2006;'RESTAURANTES';-21,13 €;1.134,42 €;-3362;-21,13;5.658,51 €;'sin fechas';25/03/2006;'RESTAURANTES';'Gastos_Ocio y transporte';'Restaurantes';'VARIABLES'
26/03/2006;26/03/2006;'GASOLINA';-44,00 €;1.090,42 €;-3361;-44,00;5.614,51 €;'sin fechas';26/03/2006;'GASOLINA';'Gastos_Ocio y transporte';'Gasolina';'VARIABLES'
27/03/2006;27/03/2006;'METRO';-6,65 €;1.083,77 €;-3360;-6,65;5.607,86 €;'sin fechas';27/03/2006;'METRO';'Gastos_Ocio y transporte';'Transporte';'VARIABLES'
29/03/2006;29/03/2006;'METRO';-6,65 €;1.077,12 €;-3359;-6,65;5.601,21 €;'sin fechas';29/03/2006;'METRO';'Gastos_Ocio y transporte';'Transporte';'VARIABLES'
31/03/2006;31/03/2006;'RECIBO PTMOS. 3061-0960001518';-636,06 €;441,06 €;-3358;-636,06;4.965,15 €;'sin fechas';31/03/2006;'RECIBO';'Gastos_Banco y organismos';'Hipoteca';'FIJO'
31/03/2006;31/03/2006;'TASACIONES INMOBILIARIAS';666,10 €;1.107,16 €;-3357;666,10;5.631,25 €;'sin fechas';31/03/2006;'TASACIONES';'Ingresos';'Nomina';'FIJO'
01/04/2006;01/04/2006;'AKI TERRASSA';-25,00 €;1.082,16 €;-3356;-25,00;5.606,25 €;'sin fechas';01/04/2006;'AKI';'Gastos_Vivienda y vehiculo';'Mnto. hogar';'VARIABLES'
01/04/2006;01/04/2006;'BON AREA';-19,49 €;1.062,67 €;-3355;-19,49;5.586,76 €;'sin fechas';01/04/2006;'BON';'Gastos_Compras';'Supermercado';'VARIABLES'
01/04/2006;01/04/2006;'CARREFOUR-[comida]';-67,60 €;995,07 €;-3354;-67,60;5.519,16 €;'sin fechas';01/04/2006;'CARREFOURCOMIDA';'Gastos_Compras';'Supermercado';'VARIABLES'
01/04/2006;01/04/2006;'GUISHEOR SL';-15,85 €;979,22 €;-3353;-15,85;5.503,31 €;'sin fechas';01/04/2006;'GUISHEOR';'Gastos_Ocio y transporte';'Restaurantes';'VARIABLES'
01/04/2006;01/04/2006;'JUCLA';-70,00 €;909,22 €;-3352;-70,00;5.433,31 €;'sin fechas';01/04/2006;'JUCLA';'Gastos_Compras';'Ropa';'VARIABLES'
01/04/2006;01/04/2006;'REINT.CAJERO';-70,00 €;839,22 €;-3351;-70,00;5.363,31 €;'sin fechas';01/04/2006;'REINTCAJERO';'Gastos_Gastos varios';'Efectivo';'VARIABLES'
01/04/2006;01/04/2006;'REINT.CAJERO';-20,00 €;819,22 €;-3350;-20,00;5.343,31 €;'sin fechas';01/04/2006;'REINTCAJERO';'Gastos_Gastos varios';'Efectivo';'VARIABLES'
01/04/2006;01/04/2006;'RESTAURANTES';-20,70 €;798,52 €;-3349;-20,70;5.322,61 €;'sin fechas';01/04/2006;'RESTAURANTES';'Gastos_Ocio y transporte';'Restaurantes';'VARIABLES'
01/04/2006;01/04/2006;'SPLAFF';-23,40 €;775,12 €;-3348;-23,40;5.299,21 €;'sin fechas';01/04/2006;'SPLAFF';'Gastos_Compras';'Hogar';'VARIABLES'
04/04/2006;04/04/2006;'METRO';-6,65 €;768,47 €;-3347;-6,65;5.292,56 €;'sin fechas';04/04/2006;'METRO';'Gastos_Ocio y transporte';'Transporte';'VARIABLES'
04/04/2006;04/04/2006;'REINT.CAJERO';-80,00 €;688,47 €;-3346;-80,00;5.212,56 €;'sin fechas';04/04/2006;'REINTCAJERO';'Gastos_Gastos varios';'Efectivo';'VARIABLES'
05/04/2006;05/04/2006;'AMENA RETEVISI';-22,74 €;665,73 €;-3345;-22,74;5.189,82 €;'sin fechas';05/04/2006;'AMENA';'Gastos_Servicios tipicos';'Telecomunicaciones';'FIJO'
06/04/2006;06/04/2006;'CINE';-16,30 €;649,43 €;-3344;-16,30;5.173,52 €;'sin fechas';06/04/2006;'CINE';'Gastos_Ocio y transporte';'Espectáculos';'VARIABLES'
06/04/2006;06/04/2006;'H&M';-85,20 €;564,23 €;-3343;-85,20;5.088,32 €;'sin fechas';06/04/2006;'HM';'Gastos_Compras';'Ropa';'VARIABLES'
06/04/2006;06/04/2006;'JUCLA';-30,00 €;534,23 €;-3342;-30,00;5.058,32 €;'sin fechas';06/04/2006;'JUCLA';'Gastos_Compras';'Ropa';'VARIABLES'
07/04/2006;07/04/2006;'GAS NATURAL';-12,39 €;521,84 €;-3341;-12,39;5.045,93 €;'sin fechas';07/04/2006;'GAS';'Gastos_Servicios tipicos';'Gas';'FIJO'
08/04/2006;08/04/2006;'POTS PINTURAS ROQUETES';-53,44 €;468,40 €;-3340;-53,44;4.992,49 €;'sin fechas';08/04/2006;'POTS';'Gastos_Compras';'Hogar';'VARIABLES'
08/04/2006;08/04/2006;'SABECO TORTOSA';-271,47 €;196,93 €;-3339;-271,47;4.721,02 €;'sin fechas';08/04/2006;'SABECO';'Gastos_Compras';'Supermercado';'VARIABLES'
09/04/2006;09/04/2006;'REINT.CAJERO';-50,00 €;146,93 €;-3338;-50,00;4.671,02 €;'sin fechas';09/04/2006;'REINTCAJERO';'Gastos_Gastos varios';'Efectivo';'VARIABLES'
10/04/2006;10/04/2006;'SABECO TORTOSA';-55,30 €;91,63 €;-3337;-55,30;4.615,72 €;'sin fechas';10/04/2006;'SABECO';'Gastos_Compras';'Supermercado';'VARIABLES'
11/04/2006;11/04/2006;'GROUPAMA PLUS';-41,12 €;50,51 €;-3336;-41,12;4.574,60 €;'sin fechas';11/04/2006;'GROUPAMA';'Gastos_Seguros';'Seguro salud';'FIJO'
11/04/2006;11/04/2006;'SEGS. CATALANA';-497,57 €;-447,06 €;-3335;-497,57;4.077,03 €;'sin fechas';11/04/2006;'SEGS';'Gastos_Seguros';'Seguro auto';'FIJO'
12/04/2006;12/04/2006;'PEAJE XERTA';-2,30 €;-449,36 €;-3334;-2,30;4.074,73 €;'sin fechas';12/04/2006;'PEAJE';'Gastos_Ocio y transporte';'Parking y peaje';'VARIABLES'
12/04/2006;12/04/2006;'PEAJE XERTA';-3,10 €;-452,46 €;-3333;-3,10;4.071,63 €;'sin fechas';12/04/2006;'PEAJE';'Gastos_Ocio y transporte';'Parking y peaje';'VARIABLES'
12/04/2006;12/04/2006;'PEAJE XERTA';-2,45 €;-454,91 €;-3332;-2,45;4.069,18 €;'sin fechas';12/04/2006;'PEAJE';'Gastos_Ocio y transporte';'Parking y peaje';'VARIABLES'
12/04/2006;12/04/2006;'REEMBOLSO FOND';2.000,00 €;1.545,09 €;-3331;2.000,00;6.069,18 €;'sin fechas';12/04/2006;'REEMBOLSO';'Ingresos';'Transferencias';'VARIABLES'
12/04/2006;12/04/2006;'REINT.CAJERO';-40,00 €;1.505,09 €;-3330;-40,00;6.029,18 €;'sin fechas';12/04/2006;'REINTCAJERO';'Gastos_Gastos varios';'Efectivo';'VARIABLES'
12/04/2006;12/04/2006;'SEG.AM.HIPITEC';-32,91 €;1.472,18 €;-3329;-32,91;5.996,27 €;'sin fechas';12/04/2006;'SEGAMHIPITEC';'Gastos_Seguros';'Seguro vida';'FIJO'
13/04/2006;13/04/2006;'LLUMS 10';-69,65 €;1.402,53 €;-3328;-69,65;5.926,62 €;'sin fechas';13/04/2006;'LLUMS';'Gastos_Compras';'Hogar';'VARIABLES'
13/04/2006;13/04/2006;'POTS PINTURAS ROQUETES';-17,00 €;1.385,53 €;-3327;-17,00;5.909,62 €;'sin fechas';13/04/2006;'POTS';'Gastos_Compras';'Hogar';'VARIABLES'
13/04/2006;13/04/2006;'SABECO TORTOSA';-33,74 €;1.351,79 €;-3326;-33,74;5.875,88 €;'sin fechas';13/04/2006;'SABECO';'Gastos_Compras';'Supermercado';'VARIABLES'
14/04/2006;14/04/2006;'REINT.CAJERO';-110,00 €;1.241,79 €;-3325;-110,00;5.765,88 €;'sin fechas';14/04/2006;'REINTCAJERO';'Gastos_Gastos varios';'Efectivo';'VARIABLES'
17/04/2006;17/04/2006;'PEAJE XERTA';-5,20 €;1.236,59 €;-3324;-5,20;5.760,68 €;'sin fechas';17/04/2006;'PEAJE';'Gastos_Ocio y transporte';'Parking y peaje';'VARIABLES'
19/04/2006;19/04/2006;'REINT.CAJERO';-20,00 €;1.216,59 €;-3323;-20,00;5.740,68 €;'sin fechas';19/04/2006;'REINTCAJERO';'Gastos_Gastos varios';'Efectivo';'VARIABLES'
20/04/2006;20/04/2006;'DIVERS SANTS ESTACION';-9,95 €;1.206,64 €;-3322;-9,95;5.730,73 €;'sin fechas';20/04/2006;'DIVERS';'Gastos_Compras';'Supermercado';'VARIABLES'
20/04/2006;20/04/2006;'FARMACIA';-8,67 €;1.197,97 €;-3321;-8,67;5.722,06 €;'sin fechas';20/04/2006;'FARMACIA';'Gastos_Salud, saber y deporte';'Farmacia';'VARIABLES'
21/04/2006;21/04/2006;'CAPRABO';-14,68 €;1.183,29 €;-3320;-14,68;5.707,38 €;'sin fechas';21/04/2006;'CAPRABO';'Gastos_Compras';'Supermercado';'VARIABLES'
23/04/2006;23/04/2006;'REINT.CAJERO';-40,00 €;1.143,29 €;-3319;-40,00;5.667,38 €;'sin fechas';23/04/2006;'REINTCAJERO';'Gastos_Gastos varios';'Efectivo';'VARIABLES'
24/04/2006;24/04/2006;'PEAJE XERTA';-3,10 €;1.140,19 €;-3318;-3,10;5.664,28 €;'sin fechas';24/04/2006;'PEAJE';'Gastos_Ocio y transporte';'Parking y peaje';'VARIABLES'
24/04/2006;24/04/2006;'PEAJE XERTA';-2,30 €;1.137,89 €;-3317;-2,30;5.661,98 €;'sin fechas';24/04/2006;'PEAJE';'Gastos_Ocio y transporte';'Parking y peaje';'VARIABLES'
24/04/2006;24/04/2006;'PEAJE XERTA';-2,45 €;1.135,44 €;-3316;-2,45;5.659,53 €;'sin fechas';24/04/2006;'PEAJE';'Gastos_Ocio y transporte';'Parking y peaje';'VARIABLES'
25/04/2006;25/04/2006;'AMENA RETEVISI';-18,70 €;1.116,74 €;-3315;-18,70;5.640,83 €;'sin fechas';25/04/2006;'AMENA';'Gastos_Servicios tipicos';'Telecomunicaciones';'FIJO'
25/04/2006;25/04/2006;'METRO';-6,65 €;1.110,09 €;-3314;-6,65;5.634,18 €;'sin fechas';25/04/2006;'METRO';'Gastos_Ocio y transporte';'Transporte';'VARIABLES'
25/04/2006;25/04/2006;'ONO';-73,18 €;1.036,91 €;-3313;-73,18;5.561,00 €;'sin fechas';25/04/2006;'ONO';'Gastos_Servicios tipicos';'Telecomunicaciones';'FIJO'
25/04/2006;25/04/2006;'PEAJE XERTA';-5,20 €;1.031,71 €;-3312;-5,20;5.555,80 €;'sin fechas';25/04/2006;'PEAJE';'Gastos_Ocio y transporte';'Parking y peaje';'VARIABLES'
26/04/2006;26/04/2006;'METRO';-6,65 €;1.025,06 €;-3311;-6,65;5.549,15 €;'sin fechas';26/04/2006;'METRO';'Gastos_Ocio y transporte';'Transporte';'VARIABLES'
27/04/2006;27/04/2006;'INFORMACIO I TECNOLOGIA DE CAT';1.122,74 €;2.147,80 €;-3310;1.122,74;6.671,89 €;'sin fechas';27/04/2006;'INFORMACIO';'Ingresos';'Nomina';'FIJO'
27/04/2006;27/04/2006;'VETESMO, S.L.';-39,00 €;2.108,80 €;-3309;-39,00;6.632,89 €;'sin fechas';27/04/2006;'VETESMO';'Gastos_Compras';'Hogar';'VARIABLES'
28/04/2006;28/04/2006;'CINE';-13,00 €;2.095,80 €;-3308;-13,00;6.619,89 €;'sin fechas';28/04/2006;'CINE';'Gastos_Ocio y transporte';'Espectáculos';'VARIABLES'
28/04/2006;28/04/2006;'MERCADONA';-25,73 €;2.070,07 €;-3307;-25,73;6.594,16 €;'sin fechas';28/04/2006;'MERCADONA';'Gastos_Compras';'Supermercado';'VARIABLES'
29/04/2006;29/04/2006;'REINT.CAJERO';-40,00 €;2.030,07 €;-3306;-40,00;6.554,16 €;'sin fechas';29/04/2006;'REINTCAJERO';'Gastos_Gastos varios';'Efectivo';'VARIABLES'
02/05/2006;27/04/2006;'RECIBO PTMOS. 3061-0960001518';-636,06 €;1.394,01 €;-3305;-636,06;5.918,10 €;'sin fechas';27/04/2006;'RECIBO';'Gastos_Banco y organismos';'Hipoteca';'FIJO'
02/05/2006;02/05/2006;'REINT.CAJERO';-50,00 €;1.344,01 €;-3304;-50,00;5.868,10 €;'sin fechas';02/05/2006;'REINTCAJERO';'Gastos_Gastos varios';'Efectivo';'VARIABLES'
03/05/2006;03/05/2006;'AMENA RETEVISI';-51,99 €;1.292,02 €;-3303;-51,99;5.816,11 €;'sin fechas';03/05/2006;'AMENA';'Gastos_Servicios tipicos';'Telecomunicaciones';'FIJO'
03/05/2006;03/05/2006;'METRO';-6,65 €;1.285,37 €;-3302;-6,65;5.809,46 €;'sin fechas';03/05/2006;'METRO';'Gastos_Ocio y transporte';'Transporte';'VARIABLES'
03/05/2006;03/05/2006;'METRO';-6,65 €;1.278,72 €;-3301;-6,65;5.802,81 €;'sin fechas';03/05/2006;'METRO';'Gastos_Ocio y transporte';'Transporte';'VARIABLES'
05/05/2006;05/05/2006;'DIVERS SANTS ESTACION';-17,00 €;1.261,72 €;-3300;-17,00;5.785,81 €;'sin fechas';05/05/2006;'DIVERS';'Gastos_Compras';'Supermercado';'VARIABLES'
06/05/2006;06/05/2006;'CINE';-11,40 €;1.250,32 €;-3299;-11,40;5.774,41 €;'sin fechas';06/05/2006;'CINE';'Gastos_Ocio y transporte';'Espectáculos';'VARIABLES'
06/05/2006;06/05/2006;'GASOLINA';-54,00 €;1.196,32 €;-3298;-54,00;5.720,41 €;'sin fechas';06/05/2006;'GASOLINA';'Gastos_Ocio y transporte';'Gasolina';'VARIABLES'
06/05/2006;06/05/2006;'IKEA';-35,00 €;1.161,32 €;-3297;-35,00;5.685,41 €;'sin fechas';06/05/2006;'IKEA';'Gastos_Vivienda y vehiculo';'Mnto. hogar';'VARIABLES'
06/05/2006;06/05/2006;'REINT.CAJERO';-20,00 €;1.141,32 €;-3296;-20,00;5.665,41 €;'sin fechas';06/05/2006;'REINTCAJERO';'Gastos_Gastos varios';'Efectivo';'VARIABLES'
06/05/2006;06/05/2006;'RESTAURANTES';-34,03 €;1.107,29 €;-3295;-34,03;5.631,38 €;'sin fechas';06/05/2006;'RESTAURANTES';'Gastos_Ocio y transporte';'Restaurantes';'VARIABLES'
07/05/2006;07/05/2006;'REINT.CAJERO';-50,00 €;1.057,29 €;-3294;-50,00;5.581,38 €;'sin fechas';07/05/2006;'REINTCAJERO';'Gastos_Gastos varios';'Efectivo';'VARIABLES'
10/05/2006;10/05/2006;'METRO';-6,65 €;1.050,64 €;-3293;-6,65;5.574,73 €;'sin fechas';10/05/2006;'METRO';'Gastos_Ocio y transporte';'Transporte';'VARIABLES'
12/05/2006;12/05/2006;'GROUPAMA PLUS';-41,12 €;1.009,52 €;-3292;-41,12;5.533,61 €;'sin fechas';12/05/2006;'GROUPAMA';'Gastos_Seguros';'Seguro salud';'FIJO'
12/05/2006;12/05/2006;'METRO';-18,30 €;991,22 €;-3291;-18,30;5.515,31 €;'sin fechas';12/05/2006;'METRO';'Gastos_Ocio y transporte';'Transporte';'VARIABLES'
13/05/2006;13/05/2006;'LEROY MERLIN';-295,85 €;695,37 €;-3290;-295,85;5.219,46 €;'sin fechas';13/05/2006;'LEROY';'Gastos_Vivienda y vehiculo';'Mnto. hogar';'VARIABLES'
14/05/2006;14/05/2006;'RESTAURANTES';-19,10 €;676,27 €;-3289;-19,10;5.200,36 €;'sin fechas';14/05/2006;'RESTAURANTES';'Gastos_Ocio y transporte';'Restaurantes';'VARIABLES'
15/05/2006;15/05/2006;'SEG.AM.HIPITEC';-32,86 €;643,41 €;-3288;-32,86;5.167,50 €;'sin fechas';15/05/2006;'SEGAMHIPITEC';'Gastos_Seguros';'Seguro vida';'FIJO'
16/05/2006;16/05/2006;'METRO';-6,65 €;636,76 €;-3287;-6,65;5.160,85 €;'sin fechas';16/05/2006;'METRO';'Gastos_Ocio y transporte';'Transporte';'VARIABLES'
16/05/2006;16/05/2006;'REINT.CAJERO';-20,00 €;616,76 €;-3286;-20,00;5.140,85 €;'sin fechas';16/05/2006;'REINTCAJERO';'Gastos_Gastos varios';'Efectivo';'VARIABLES'
17/05/2006;17/05/2006;'ENDESA DISTRIB';-15,02 €;601,74 €;-3285;-15,02;5.125,83 €;'sin fechas';17/05/2006;'ENDESA';'Gastos_Servicios tipicos';'Electricidad';'FIJO'
19/05/2006;19/05/2006;'CINE';-11,40 €;590,34 €;-3284;-11,40;5.114,43 €;'sin fechas';19/05/2006;'CINE';'Gastos_Ocio y transporte';'Espectáculos';'VARIABLES'
20/05/2006;20/05/2006;'239 MINIT SPAIN LLAVES';-12,72 €;577,62 €;-3283;-12,72;5.101,71 €;'sin fechas';20/05/2006;'MINIT';'Gastos_Compras';'Ropa';'VARIABLES'
20/05/2006;20/05/2006;'ECA ITV, S.A';-30,75€;546,87 €;-3282;-30,75;5.070,96 €;'sin fechas';20/05/2006;'ECA';'Gastos_Vivienda y vehiculo';'Mnto. vehiculo';'VARIABLE'
20/05/2006;20/05/2006;'H&M';-14,90€;531,97 €;-3281;-14,90;5.056,06 €;'sin fechas';20/05/2006;'HM';'Gastos_Compras';'Ropa';'VARIABLES'
20/05/2006;20/05/2006;'RESTAURANTES';-28,50€;503,47 €;-3280;-28,50;5.027,56 €;'sin fechas';20/05/2006;'RESTAURANTES';'Gastos_Ocio y transporte';'Restaurantes';'VARIABLES'
20/05/2006;20/05/2006;'SWATCH GLORIES';-74,00€;429,47 €;-3279;-74,00;4.953,56 €;'sin fechas';20/05/2006;'SWATCH';'Gastos_Compras';'Ropa';'VARIABLES'
22/05/2006;22/05/2006;'ONO';-62,30€;367,17 €;-3278;-62,30;4.891,26 €;'sin fechas';22/05/2006;'ONO';'Gastos_Servicios tipicos';'Telecomunicaciones';'FIJO'
22/05/2006;22/05/2006;'PEAJE XERTA';-1,02€;366,15 €;-3277;-1,02;4.890,24 €;'sin fechas';22/05/2006;'PEAJE';'Gastos_Ocio y transporte';'Parking y peaje';'VARIABLES'
22/05/2006;22/05/2006;'PEAJE XERTA';-1,70€;364,45 €;-3276;-1,70;4.888,54 €;'sin fechas';22/05/2006;'PEAJE';'Gastos_Ocio y transporte';'Parking y peaje';'VARIABLES'
23/05/2006;23/05/2006;'AMENA RETEVISI';-40,94€;323,51 €;-3275;-40,94;4.847,60 €;'sin fechas';23/05/2006;'AMENA';'Gastos_Servicios tipicos';'Telecomunicaciones';'FIJO'
23/05/2006;23/05/2006;'METRO';-6,65€;316,86 €;-3274;-6,65;4.840,95 €;'sin fechas';23/05/2006;'METRO';'Gastos_Ocio y transporte';'Transporte';'VARIABLES'
23/05/2006;23/05/2006;'REEMBOLSO FOND';1.085,15€;1.402,01 €;-3273;1.085,15;5.926,10 €;'sin fechas';23/05/2006;'REEMBOLSO';'Ingresos';'Transferencias';'VARIABLES'
27/05/2006;27/05/2006;'CAPRABO';-10,93€;1.391,08 €;-3272;-10,93;5.915,17 €;'sin fechas';27/05/2006;'CAPRABO';'Gastos_Compras';'Supermercado';'VARIABLES'
27/05/2006;27/05/2006;'FARMACIA';-5,67€;1.385,41 €;-3271;-5,67;5.909,50 €;'sin fechas';27/05/2006;'FARMACIA';'Gastos_Salud, saber y deporte';'Farmacia';'VARIABLES'
28/05/2006;28/05/2006;'RESTAURANTES';-50,13€;1.335,28 €;-3270;-50,13;5.859,37 €;'sin fechas';28/05/2006;'RESTAURANTES';'Gastos_Ocio y transporte';'Restaurantes';'VARIABLES'
29/05/2006;31/05/2006;'AGENCIA DE LA MICROEMPRESA';786,36€;2.121,64 €;-3269;786,36;6.645,73 €;'sin fechas';31/05/2006;'AGENCIA';'Ingresos';'Nomina';'FIJO'
29/05/2006;29/05/2006;'INFORMACIO I TECNOLOGIA DE CAT';1.122,74€;3.244,38 €;-3268;1.122,74;7.768,47 €;'sin fechas';29/05/2006;'INFORMACIO';'Ingresos';'Nomina';'FIJO'
29/05/2006;29/05/2006;'REINT.CAJERO';3.445,00€;6.689,38 €;-3267;3.445,00;11.213,47 €;'sin fechas';29/05/2006;'REINTCAJERO';'Gastos_Gastos varios';'Efectivo';'VARIABLES'
30/05/2006;30/05/2006;'METRO';-6,65€;6.682,73 €;-3266;-6,65;11.206,82 €;'sin fechas';30/05/2006;'METRO';'Gastos_Ocio y transporte';'Transporte';'VARIABLES'
31/05/2006;31/05/2006;'RECIBO PTMOS. 3061-0960001518';-636,06€;6.046,67 €;-3265;-636,06;10.570,76 €;'sin fechas';31/05/2006;'RECIBO';'Gastos_Banco y organismos';'Hipoteca';'FIJO'
03/06/2006;03/06/2006;'GASOLINA';-50,00€;5.996,67 €;-3264;-50,00;10.520,76 €;'sin fechas';03/06/2006;'GASOLINA';'Gastos_Ocio y transporte';'Gasolina';'VARIABLES'
03/06/2006;03/06/2006;'REINT.CAJERO';-20,00€;5.976,67 €;-3263;-20,00;10.500,76 €;'sin fechas';03/06/2006;'REINTCAJERO';'Gastos_Gastos varios';'Efectivo';'VARIABLES'
04/06/2006;04/06/2006;'REINT.CAJERO';-70,00€;5.906,67 €;-3262;-70,00;10.430,76 €;'sin fechas';04/06/2006;'REINTCAJERO';'Gastos_Gastos varios';'Efectivo';'VARIABLES'
05/06/2006;05/06/2006;'GROUPAMA PLUS';-41,12€;5.865,55 €;-3261;-41,12;10.389,64 €;'sin fechas';05/06/2006;'GROUPAMA';'Gastos_Seguros';'Seguro salud';'FIJO'
05/06/2006;05/06/2006;'RENFE';-18,30€;5.847,25 €;-3260;-18,30;10.371,34 €;'sin fechas';05/06/2006;'RENFE';'Gastos_Ocio y transporte';'Transporte';'VARIABLES'
06/06/2006;06/06/2006;'AMENA RETEVISI';-43,51€;5.803,74 €;-3259;-43,51;10.327,83 €;'sin fechas';06/06/2006;'AMENA';'Gastos_Servicios tipicos';'Telecomunicaciones';'FIJO'
06/06/2006;06/06/2006;'RENFE';-6,65€;5.797,09 €;-3258;-6,65;10.321,18 €;'sin fechas';06/06/2006;'RENFE';'Gastos_Ocio y transporte';'Transporte';'VARIABLES'
10/06/2006;10/06/2006;'REINT.CAJERO';-20,00€;5.777,09 €;-3257;-20,00;10.301,18 €;'sin fechas';10/06/2006;'REINTCAJERO';'Gastos_Gastos varios';'Efectivo';'VARIABLES'
10/06/2006;10/06/2006;'RESTAURANTES';-22,04€;5.755,05 €;-3256;-22,04;10.279,14 €;'sin fechas';10/06/2006;'RESTAURANTES';'Gastos_Ocio y transporte';'Restaurantes';'VARIABLES'
12/06/2006;12/06/2006;'METRO';-6,65€;5.748,40 €;-3255;-6,65;10.272,49 €;'sin fechas';12/06/2006;'METRO';'Gastos_Ocio y transporte';'Transporte';'VARIABLES'
13/06/2006;13/06/2006;'GAS NATURAL';-137,77€;5.610,63 €;-3254;-137,77;10.134,72 €;'sin fechas';13/06/2006;'GAS';'Gastos_Servicios tipicos';'Gas';'FIJO'
13/06/2006;13/06/2006;'REINT.CAJERO';-20,00€;5.590,63 €;-3253;-20,00;10.114,72 €;'sin fechas';13/06/2006;'REINTCAJERO';'Gastos_Gastos varios';'Efectivo';'VARIABLES'
15/06/2006;15/06/2006;'SEG.AM.HIPITEC';-32,79€;5.557,84 €;-3252;-32,79;10.081,93 €;'sin fechas';15/06/2006;'SEGAMHIPITEC';'Gastos_Seguros';'Seguro vida';'FIJO'
16/06/2006;16/06/2006;'METRO';-18,30€;5.539,54 €;-3251;-18,30;10.063,63 €;'sin fechas';16/06/2006;'METRO';'Gastos_Ocio y transporte';'Transporte';'VARIABLES'
16/06/2006;16/06/2006;'REINT.CAJERO';-20,00€;5.519,54 €;-3250;-20,00;10.043,63 €;'sin fechas';16/06/2006;'REINTCAJERO';'Gastos_Gastos varios';'Efectivo';'VARIABLES'
17/06/2006;17/06/2006;'REINT.CAJERO';-20,00€;5.499,54 €;-3249;-20,00;10.023,63 €;'sin fechas';17/06/2006;'REINTCAJERO';'Gastos_Gastos varios';'Efectivo';'VARIABLES'
19/06/2006;19/06/2006;'MERCADONA';-29,41€;5.470,13 €;-3248;-29,41;9.994,22 €;'sin fechas';19/06/2006;'MERCADONA';'Gastos_Compras';'Supermercado';'VARIABLES'
19/06/2006;19/06/2006;'METRO';-6,65€;5.463,48 €;-3247;-6,65;9.987,57 €;'sin fechas';19/06/2006;'METRO';'Gastos_Ocio y transporte';'Transporte';'VARIABLES'
22/06/2006;22/06/2006;'CASER HOGAR';-42,11€;5.421,37 €;-3246;-42,11;9.945,46 €;'sin fechas';22/06/2006;'CASER';'Ingresos';'Transferencias';'VARIABLES'
23/06/2006;23/06/2006;'AMENA RETEVISI';-54,47€;5.366,90 €;-3245;-54,47;9.890,99 €;'sin fechas';23/06/2006;'AMENA';'Gastos_Servicios tipicos';'Telecomunicaciones';'FIJO'
25/06/2006;25/06/2006;'REINT.CAJERO';-40,00€;5.326,90 €;-3244;-40,00;9.850,99 €;'sin fechas';25/06/2006;'REINTCAJERO';'Gastos_Gastos varios';'Efectivo';'VARIABLES'
26/06/2006;26/06/2006;'MERCADONA';-18,35€;5.308,55 €;-3243;-18,35;9.832,64 €;'sin fechas';26/06/2006;'MERCADONA';'Gastos_Compras';'Supermercado';'VARIABLES'
26/06/2006;26/06/2006;'ONO';-65,41€;5.243,14 €;-3242;-65,41;9.767,23 €;'sin fechas';26/06/2006;'ONO';'Gastos_Servicios tipicos';'Telecomunicaciones';'FIJO'
26/06/2006;26/06/2006;'RENFE';-6,65€;5.236,49 €;-3241;-6,65;9.760,58 €;'sin fechas';26/06/2006;'RENFE';'Gastos_Ocio y transporte';'Transporte';'VARIABLES'
27/06/2006;27/06/2006;'MINA PUBLICA DE LA CIUTAT';-19,82€;5.216,67 €;-3240;-19,82;9.740,76 €;'sin fechas';27/06/2006;'MINA';'Gastos_Servicios tipicos';'Agua';'FIJO'
28/06/2006;30/06/2006;'AGENCIA DE LA MICROEMPRESA';786,36€;6.003,03 €;-3239;786,36;10.527,12 €;'sin fechas';30/06/2006;'AGENCIA';'Ingresos';'Nomina';'FIJO'
28/06/2006;28/06/2006;'CAFET.C T PRAT';-2,65€;6.000,38 €;-3238;-2,65;10.524,47 €;'sin fechas';28/06/2006;'CAFETC';'Gastos_Ocio y transporte';'Restaurantes';'VARIABLES'
28/06/2006;28/06/2006;'INFORMACIO I TECNOLOGIA DE CAT';1.122,74€;7.123,12 €;-3237;1.122,74;11.647,21 €;'sin fechas';28/06/2006;'INFORMACIO';'Ingresos';'Nomina';'FIJO'
28/06/2006;28/06/2006;'REINT.CAJERO';-60,00€;7.063,12 €;-3236;-60,00;11.587,21 €;'sin fechas';28/06/2006;'REINTCAJERO';'Gastos_Gastos varios';'Efectivo';'VARIABLES'
30/06/2006;30/06/2006;'RECIBO PTMOS. 3061-0960001518';-636,06€;6.427,06 €;-3235;-636,06;10.951,15 €;'sin fechas';30/06/2006;'RECIBO';'Gastos_Banco y organismos';'Hipoteca';'FIJO'
01/07/2006;01/07/2006;'ALCAMPO';-20,93€;6.406,13 €;-3234;-20,93;10.930,22 €;'sin fechas';01/07/2006;'ALCAMPO';'Gastos_Compras';'Supermercado';'VARIABLES'
01/07/2006;01/07/2006;'LEROY MERLIN';-20,90€;6.385,23 €;-3233;-20,90;10.909,32 €;'sin fechas';01/07/2006;'LEROY';'Gastos_Vivienda y vehiculo';'Mnto. hogar';'VARIABLES'
01/07/2006;01/07/2006;'MERCADONA';-137,63€;6.247,60 €;-3232;-137,63;10.771,69 €;'sin fechas';01/07/2006;'MERCADONA';'Gastos_Compras';'Supermercado';'VARIABLES'
01/07/2006;01/07/2006;'MISAKO';-12,00€;6.235,60 €;-3231;-12,00;10.759,69 €;'sin fechas';01/07/2006;'MISAKO';'Gastos_Compras';'Ropa';'VARIABLES'
03/07/2006;03/07/2006;'FARMACIA';-119,07€;6.116,53 €;-3230;-119,07;10.640,62 €;'sin fechas';03/07/2006;'FARMACIA';'Gastos_Salud, saber y deporte';'Farmacia';'VARIABLES'
03/07/2006;03/07/2006;'GASOLINA';-46,00€;6.070,53 €;-3229;-46,00;10.594,62 €;'sin fechas';03/07/2006;'GASOLINA';'Gastos_Ocio y transporte';'Gasolina';'VARIABLES'
03/07/2006;03/07/2006;'MEDIA MARKT';-84,85€;5.985,68 €;-3228;-84,85;10.509,77 €;'sin fechas';03/07/2006;'MEDIA';'Gastos_Compras';'Hobbys';'VARIABLES'
03/07/2006;03/07/2006;'REINT.CAJERO';-20,00€;5.965,68 €;-3227;-20,00;10.489,77 €;'sin fechas';03/07/2006;'REINTCAJERO';'Gastos_Gastos varios';'Efectivo';'VARIABLES'
03/07/2006;03/07/2006;'RESTAURANTES';-15,00€;5.950,68 €;-3226;-15,00;10.474,77 €;'sin fechas';03/07/2006;'RESTAURANTES';'Gastos_Ocio y transporte';'Restaurantes';'VARIABLES'
04/07/2006;04/07/2006;'AMENA RETEVISI';-46,14€;5.904,54 €;-3225;-46,14;10.428,63 €;'sin fechas';04/07/2006;'AMENA';'Gastos_Servicios tipicos';'Telecomunicaciones';'FIJO'
04/07/2006;04/07/2006;'REINT.CAJERO';-20,00€;5.884,54 €;-3224;-20,00;10.408,63 €;'sin fechas';04/07/2006;'REINTCAJERO';'Gastos_Gastos varios';'Efectivo';'VARIABLES'
05/07/2006;05/07/2006;'FERRETERIA JOSCA';-20,80€;5.863,74 €;-3223;-20,80;10.387,83 €;'sin fechas';05/07/2006;'FERRETERIA';'Gastos_Compras';'Hogar';'VARIABLES'
05/07/2006;05/07/2006;'PEAJE RUBI';-1,04€;5.862,70 €;-3222;-1,04;10.386,79 €;'sin fechas';05/07/2006;'PEAJE';'Gastos_Ocio y transporte';'Parking y peaje';'VARIABLES'
05/07/2006;05/07/2006;'PEAJE RUBI';-1,04€;5.861,66 €;-3221;-1,04;10.385,75 €;'sin fechas';05/07/2006;'PEAJE';'Gastos_Ocio y transporte';'Parking y peaje';'VARIABLES'
05/07/2006;05/07/2006;'PEAJE RUBI';-1,04€;5.860,62 €;-3220;-1,04;10.384,71 €;'sin fechas';05/07/2006;'PEAJE';'Gastos_Ocio y transporte';'Parking y peaje';'VARIABLES'
05/07/2006;05/07/2006;'PEAJE RUBI';-1,04€;5.859,58 €;-3219;-1,04;10.383,67 €;'sin fechas';05/07/2006;'PEAJE';'Gastos_Ocio y transporte';'Parking y peaje';'VARIABLES'
05/07/2006;05/07/2006;'PEAJE RUBI';-1,04€;5.858,54 €;-3218;-1,04;10.382,63 €;'sin fechas';05/07/2006;'PEAJE';'Gastos_Ocio y transporte';'Parking y peaje';'VARIABLES'
07/07/2006;07/07/2006;'GUIRAO TERRASSA';-26,00€;5.832,54 €;-3217;-26,00;10.356,63 €;'sin fechas';07/07/2006;'GUIRAO';'Gastos_Ocio y transporte';'Restaurantes';'VARIABLES'
10/07/2006;10/07/2006;'GASOLINA';-40,00€;5.792,54 €;-3216;-40,00;10.316,63 €;'sin fechas';10/07/2006;'GASOLINA';'Gastos_Ocio y transporte';'Gasolina';'VARIABLES'
10/07/2006;10/07/2006;'GROUPAMA PLUS';-41,12€;5.751,42 €;-3215;-41,12;10.275,51 €;'sin fechas';10/07/2006;'GROUPAMA';'Gastos_Seguros';'Seguro salud';'FIJO'
10/07/2006;10/07/2006;'PEAJE RUBI';-1,04€;5.750,38 €;-3214;-1,04;10.274,47 €;'sin fechas';10/07/2006;'PEAJE';'Gastos_Ocio y transporte';'Parking y peaje';'VARIABLES'
11/07/2006;11/07/2006;'MERCADONA';-11,63€;5.738,75 €;-3213;-11,63;10.262,84 €;'sin fechas';11/07/2006;'MERCADONA';'Gastos_Compras';'Supermercado';'VARIABLES'
11/07/2006;11/07/2006;'PEAJE RUBI';-1,04€;5.737,71 €;-3212;-1,04;10.261,80 €;'sin fechas';11/07/2006;'PEAJE';'Gastos_Ocio y transporte';'Parking y peaje';'VARIABLES'
11/07/2006;11/07/2006;'PEAJE RUBI';-1,04€;5.736,67 €;-3211;-1,04;10.260,76 €;'sin fechas';11/07/2006;'PEAJE';'Gastos_Ocio y transporte';'Parking y peaje';'VARIABLES'
11/07/2006;11/07/2006;'PEAJE RUBI';-1,04€;5.735,63 €;-3210;-1,04;10.259,72 €;'sin fechas';11/07/2006;'PEAJE';'Gastos_Ocio y transporte';'Parking y peaje';'VARIABLES'
11/07/2006;11/07/2006;'PEAJE RUBI';-1,04€;5.734,59 €;-3209;-1,04;10.258,68 €;'sin fechas';11/07/2006;'PEAJE';'Gastos_Ocio y transporte';'Parking y peaje';'VARIABLES'
11/07/2006;11/07/2006;'PEAJE RUBI';-1,04€;5.733,55 €;-3208;-1,04;10.257,64 €;'sin fechas';11/07/2006;'PEAJE';'Gastos_Ocio y transporte';'Parking y peaje';'VARIABLES'
14/07/2006;14/07/2006;'PEAJE RUBI';-0,99€;5.732,56 €;-3207;-0,99;10.256,65 €;'sin fechas';14/07/2006;'PEAJE';'Gastos_Ocio y transporte';'Parking y peaje';'VARIABLES'
14/07/2006;14/07/2006;'PEAJE RUBI';-0,99€;5.731,57 €;-3206;-0,99;10.255,66 €;'sin fechas';14/07/2006;'PEAJE';'Gastos_Ocio y transporte';'Parking y peaje';'VARIABLES'
15/07/2006;15/07/2006;'KUROKAI';-71,95€;5.659,62 €;-3205;-71,95;10.183,71 €;'sin fechas';15/07/2006;'KUROKAI';'Gastos_Compras';'Ropa';'VARIABLES'
16/07/2006;16/07/2006;'GASOLINA';-40,00€;5.619,62 €;-3204;-40,00;10.143,71 €;'sin fechas';16/07/2006;'GASOLINA';'Gastos_Ocio y transporte';'Gasolina';'VARIABLES'
16/07/2006;16/07/2006;'RESTAURANTES';-15,65€;5.603,97 €;-3203;-15,65;10.128,06 €;'sin fechas';16/07/2006;'RESTAURANTES';'Gastos_Ocio y transporte';'Restaurantes';'VARIABLES'
17/07/2006;17/07/2006;'AJUNTAMENT DE TERRASSA';-33,43€;5.570,54 €;-3202;-33,43;10.094,63 €;'sin fechas';17/07/2006;'AJUNTAMENT';'Gastos_Banco y organismos';'Ayuntamiento';'FIJO'
17/07/2006;17/07/2006;'ENDESA DISTRIB';-23,50€;5.547,04 €;-3201;-23,50;10.071,13 €;'sin fechas';17/07/2006;'ENDESA';'Gastos_Servicios tipicos';'Electricidad';'FIJO'
17/07/2006;17/07/2006;'SEG.AM.HIPITEC';-32,93€;5.514,11 €;-3200;-32,93;10.038,20 €;'sin fechas';17/07/2006;'SEGAMHIPITEC';'Gastos_Seguros';'Seguro vida';'FIJO'
18/07/2006;18/07/2006;'INFORMACIO I TECNOLOGIA DE CAT';1.228,57€;6.742,68 €;-3199;1.228,57;11.266,77 €;'sin fechas';18/07/2006;'INFORMACIO';'Ingresos';'Nomina';'FIJO'
18/07/2006;18/07/2006;'MERCADONA';-121,29€;6.621,39 €;-3198;-121,29;11.145,48 €;'sin fechas';18/07/2006;'MERCADONA';'Gastos_Compras';'Supermercado';'VARIABLES'
18/07/2006;18/07/2006;'PEAJE PREMIA';-0,64€;6.620,75 €;-3197;-0,64;11.144,84 €;'sin fechas';18/07/2006;'PEAJE';'Gastos_Ocio y transporte';'Parking y peaje';'VARIABLES'
18/07/2006;18/07/2006;'PEAJE PREMIA';-0,64€;6.620,11 €;-3196;-0,64;11.144,20 €;'sin fechas';18/07/2006;'PEAJE';'Gastos_Ocio y transporte';'Parking y peaje';'VARIABLES'
18/07/2006;18/07/2006;'PEAJE RUBI';-0,94€;6.619,17 €;-3195;-0,94;11.143,26 €;'sin fechas';18/07/2006;'PEAJE';'Gastos_Ocio y transporte';'Parking y peaje';'VARIABLES'
18/07/2006;18/07/2006;'PEAJE RUBI';-0,99€;6.618,18 €;-3194;-0,99;11.142,27 €;'sin fechas';18/07/2006;'PEAJE';'Gastos_Ocio y transporte';'Parking y peaje';'VARIABLES'
18/07/2006;18/07/2006;'PEAJE RUBI';-0,99€;6.617,19 €;-3193;-0,99;11.141,28 €;'sin fechas';18/07/2006;'PEAJE';'Gastos_Ocio y transporte';'Parking y peaje';'VARIABLES'
18/07/2006;18/07/2006;'PEAJE RUBI';-0,94€;6.616,25 €;-3192;-0,94;11.140,34 €;'sin fechas';18/07/2006;'PEAJE';'Gastos_Ocio y transporte';'Parking y peaje';'VARIABLES'
18/07/2006;18/07/2006;'PEAJE RUBI';-0,94€;6.615,31 €;-3191;-0,94;11.139,40 €;'sin fechas';18/07/2006;'PEAJE';'Gastos_Ocio y transporte';'Parking y peaje';'VARIABLES'
18/07/2006;18/07/2006;'PEAJE RUBI';-0,94€;6.614,37 €;-3190;-0,94;11.138,46 €;'sin fechas';18/07/2006;'PEAJE';'Gastos_Ocio y transporte';'Parking y peaje';'VARIABLES'
18/07/2006;18/07/2006;'PEAJE RUBI';-0,99€;6.613,38 €;-3189;-0,99;11.137,47 €;'sin fechas';18/07/2006;'PEAJE';'Gastos_Ocio y transporte';'Parking y peaje';'VARIABLES'
18/07/2006;18/07/2006;'PEAJE RUBI';-0,94€;6.612,44 €;-3188;-0,94;11.136,53 €;'sin fechas';18/07/2006;'PEAJE';'Gastos_Ocio y transporte';'Parking y peaje';'VARIABLES'
18/07/2006;18/07/2006;'RESTAURANTES';-14,38€;6.598,06 €;-3187;-14,38;11.122,15 €;'sin fechas';18/07/2006;'RESTAURANTES';'Gastos_Ocio y transporte';'Restaurantes';'VARIABLES'
18/07/2006;18/07/2006;'RESTAURANTES';-6,00€;6.592,06 €;-3186;-6,00;11.116,15 €;'sin fechas';18/07/2006;'RESTAURANTES';'Gastos_Ocio y transporte';'Restaurantes';'VARIABLES'
20/07/2006;20/07/2006;'MARCO ALDANY';-26,93€;6.565,13 €;-3185;-26,93;11.089,22 €;'sin fechas';20/07/2006;'MARCO';'Gastos_Salud, saber y deporte';'Belleza';'VARIABLES'
21/07/2006;21/07/2006;'GASOLINA';-40,00€;6.525,13 €;-3184;-40,00;11.049,22 €;'sin fechas';21/07/2006;'GASOLINA';'Gastos_Ocio y transporte';'Gasolina';'VARIABLES'
21/07/2006;21/07/2006;'PEAJE RUBI';-0,94€;6.524,19 €;-3183;-0,94;11.048,28 €;'sin fechas';21/07/2006;'PEAJE';'Gastos_Ocio y transporte';'Parking y peaje';'VARIABLES'
21/07/2006;21/07/2006;'PEAJE RUBI';-0,94€;6.523,25 €;-3182;-0,94;11.047,34 €;'sin fechas';21/07/2006;'PEAJE';'Gastos_Ocio y transporte';'Parking y peaje';'VARIABLES'
21/07/2006;21/07/2006;'PEAJE RUBI';-1,89€;6.521,36 €;-3181;-1,89;11.045,45 €;'sin fechas';21/07/2006;'PEAJE';'Gastos_Ocio y transporte';'Parking y peaje';'VARIABLES'
21/07/2006;21/07/2006;'PEAJE VILANOVA';-4,69€;6.516,67 €;-3180;-4,69;11.040,76 €;'sin fechas';21/07/2006;'PEAJE';'Gastos_Ocio y transporte';'Parking y peaje';'VARIABLES'
21/07/2006;21/07/2006;'PEAJE VILANOVA';-4,69€;6.511,98 €;-3179;-4,69;11.036,07 €;'sin fechas';21/07/2006;'PEAJE';'Gastos_Ocio y transporte';'Parking y peaje';'VARIABLES'
24/07/2006;24/07/2006;'CARREFOUR-[comida]';-52,05€;6.459,93 €;-3178;-52,05;10.984,02 €;'sin fechas';24/07/2006;'CARREFOURCOMIDA';'Gastos_Compras';'Supermercado';'VARIABLES'
24/07/2006;24/07/2006;'GASOLINA';-56,00€;6.403,93 €;-3177;-56,00;10.928,02 €;'sin fechas';24/07/2006;'GASOLINA';'Gastos_Ocio y transporte';'Gasolina';'VARIABLES'
24/07/2006;24/07/2006;'H&M';-11,80€;6.392,13 €;-3176;-11,80;10.916,22 €;'sin fechas';24/07/2006;'HM';'Gastos_Compras';'Ropa';'VARIABLES'
24/07/2006;24/07/2006;'MERCADONA';-11,21€;6.380,92 €;-3175;-11,21;10.905,01 €;'sin fechas';24/07/2006;'MERCADONA';'Gastos_Compras';'Supermercado';'VARIABLES'
24/07/2006;24/07/2006;'METRO';-6,65€;6.374,27 €;-3174;-6,65;10.898,36 €;'sin fechas';24/07/2006;'METRO';'Gastos_Ocio y transporte';'Transporte';'VARIABLES'
24/07/2006;24/07/2006;'RESTAURANTES';-36,49€;6.337,78 €;-3173;-36,49;10.861,87 €;'sin fechas';24/07/2006;'RESTAURANTES';'Gastos_Ocio y transporte';'Restaurantes';'VARIABLES'
25/07/2006;25/07/2006;'AMENA RETEVISI';-46,97€;6.290,81 €;-3172;-46,97;10.814,90 €;'sin fechas';25/07/2006;'AMENA';'Gastos_Servicios tipicos';'Telecomunicaciones';'FIJO'
25/07/2006;25/07/2006;'PEAJE RUBI';-1,89€;6.288,92 €;-3171;-1,89;10.813,01 €;'sin fechas';25/07/2006;'PEAJE';'Gastos_Ocio y transporte';'Parking y peaje';'VARIABLES'
26/07/2006;26/07/2006;'GIFI';-13,95€;6.274,97 €;-3170;-13,95;10.799,06 €;'sin fechas';26/07/2006;'GIFI';'Gastos_Compras';'Hogar';'VARIABLES'
26/07/2006;26/07/2006;'PEAJE RUBI';-0,94€;6.274,03 €;-3169;-0,94;10.798,12 €;'sin fechas';26/07/2006;'PEAJE';'Gastos_Ocio y transporte';'Parking y peaje';'VARIABLES'
26/07/2006;26/07/2006;'PEAJE RUBI';-0,94€;6.273,09 €;-3168;-0,94;10.797,18 €;'sin fechas';26/07/2006;'PEAJE';'Gastos_Ocio y transporte';'Parking y peaje';'VARIABLES'
26/07/2006;26/07/2006;'PEAJE RUBI';-0,94€;6.272,15 €;-3167;-0,94;10.796,24 €;'sin fechas';26/07/2006;'PEAJE';'Gastos_Ocio y transporte';'Parking y peaje';'VARIABLES'
26/07/2006;26/07/2006;'PEAJE RUBI';-0,83€;6.271,32 €;-3166;-0,83;10.795,41 €;'sin fechas';26/07/2006;'PEAJE';'Gastos_Ocio y transporte';'Parking y peaje';'VARIABLES'
26/07/2006;26/07/2006;'PEAJE RUBI';-0,83€;6.270,49 €;-3165;-0,83;10.794,58 €;'sin fechas';26/07/2006;'PEAJE';'Gastos_Ocio y transporte';'Parking y peaje';'VARIABLES'
26/07/2006;26/07/2006;'PEAJE RUBI';-0,83€;6.269,66 €;-3164;-0,83;10.793,75 €;'sin fechas';26/07/2006;'PEAJE';'Gastos_Ocio y transporte';'Parking y peaje';'VARIABLES'
26/07/2006;26/07/2006;'PEAJE RUBI';-0,83€;6.268,83 €;-3163;-0,83;10.792,92 €;'sin fechas';26/07/2006;'PEAJE';'Gastos_Ocio y transporte';'Parking y peaje';'VARIABLES'
26/07/2006;26/07/2006;'PEAJE RUBI';-0,83€;6.268,00 €;-3162;-0,83;10.792,09 €;'sin fechas';26/07/2006;'PEAJE';'Gastos_Ocio y transporte';'Parking y peaje';'VARIABLES'
26/07/2006;26/07/2006;'PEAJE XERTA';-3,10€;6.264,90 €;-3161;-3,10;10.788,99 €;'sin fechas';26/07/2006;'PEAJE';'Gastos_Ocio y transporte';'Parking y peaje';'VARIABLES'
26/07/2006;26/07/2006;'PEAJE XERTA';-2,45€;6.262,45 €;-3160;-2,45;10.786,54 €;'sin fechas';26/07/2006;'PEAJE';'Gastos_Ocio y transporte';'Parking y peaje';'VARIABLES'
26/07/2006;26/07/2006;'RESTAURANTES';-34,15€;6.228,30 €;-3159;-34,15;10.752,39 €;'sin fechas';26/07/2006;'RESTAURANTES';'Gastos_Ocio y transporte';'Restaurantes';'VARIABLES'
27/07/2006;27/07/2006;'ONO';-61,58€;6.166,72 €;-3158;-61,58;10.690,81 €;'sin fechas';27/07/2006;'ONO';'Gastos_Servicios tipicos';'Telecomunicaciones';'FIJO'
27/07/2006;27/07/2006;'RESTAURANTES';-21,00€;6.145,72 €;-3157;-21,00;10.669,81 €;'sin fechas';27/07/2006;'RESTAURANTES';'Gastos_Ocio y transporte';'Restaurantes';'VARIABLES'
28/07/2006;28/07/2006;'AGENCIA DE LA MICROEMPRESA';786,36€;6.932,08 €;-3156;786,36;11.456,17 €;'sin fechas';28/07/2006;'AGENCIA';'Ingresos';'Nomina';'FIJO'
28/07/2006;28/07/2006;'INFORMACIO I TECNOLOGIA DE CAT';1.542,75€;8.474,83 €;-3155;1.542,75;12.998,92 €;'sin fechas';28/07/2006;'INFORMACIO';'Ingresos';'Nomina';'FIJO'
28/07/2006;28/07/2006;'PEAJE RUBI';-1,04€;8.473,79 €;-3154;-1,04;12.997,88 €;'sin fechas';28/07/2006;'PEAJE';'Gastos_Ocio y transporte';'Parking y peaje';'VARIABLES'
28/07/2006;28/07/2006;'PEAJE RUBI';-0,83€;8.472,96 €;-3153;-0,83;12.997,05 €;'sin fechas';28/07/2006;'PEAJE';'Gastos_Ocio y transporte';'Parking y peaje';'VARIABLES'
31/07/2006;31/07/2006;'PEAJE RUBI';-1,89€;8.471,07 €;-3152;-1,89;12.995,16 €;'sin fechas';31/07/2006;'PEAJE';'Gastos_Ocio y transporte';'Parking y peaje';'VARIABLES'
31/07/2006;31/07/2006;'PEAJE XERTA';-2,30€;8.468,77 €;-3151;-2,30;12.992,86 €;'sin fechas';31/07/2006;'PEAJE';'Gastos_Ocio y transporte';'Parking y peaje';'VARIABLES'
31/07/2006;31/07/2006;'PEAJE XERTA';-2,45€;8.466,32 €;-3150;-2,45;12.990,41 €;'sin fechas';31/07/2006;'PEAJE';'Gastos_Ocio y transporte';'Parking y peaje';'VARIABLES'
31/07/2006;31/07/2006;'PEAJE XERTA';-3,10€;8.463,22 €;-3149;-3,10;12.987,31 €;'sin fechas';31/07/2006;'PEAJE';'Gastos_Ocio y transporte';'Parking y peaje';'VARIABLES'
31/07/2006;31/07/2006;'PEAJE XERTA';-2,30€;8.460,92 €;-3148;-2,30;12.985,01 €;'sin fechas';31/07/2006;'PEAJE';'Gastos_Ocio y transporte';'Parking y peaje';'VARIABLES'
31/07/2006;31/07/2006;'RECIBO PTMOS. 3061-0960001518';-636,06€;7.824,86 €;-3147;-636,06;12.348,95 €;'sin fechas';31/07/2006;'RECIBO';'Gastos_Banco y organismos';'Hipoteca';'FIJO'
31/07/2006;31/07/2006;'SABECO TORTOSA';-172,62€;7.652,24 €;-3146;-172,62;12.176,33 €;'sin fechas';31/07/2006;'SABECO';'Gastos_Compras';'Supermercado';'VARIABLES'
01/08/2006;01/08/2006;'PELUQUERIAS';-19,90€;7.632,34 €;-3145;-19,90;12.156,43 €;'sin fechas';01/08/2006;'PELUQUERIAS';'Gastos_Salud, saber y deporte';'Belleza';'VARIABLES'
02/08/2006;02/08/2006;'GASOLINA';-44,00€;7.588,34 €;-3144;-44,00;12.112,43 €;'sin fechas';02/08/2006;'GASOLINA';'Gastos_Ocio y transporte';'Gasolina';'VARIABLES'
02/08/2006;02/08/2006;'PEAJE XERTA';-5,20€;7.583,14 €;-3143;-5,20;12.107,23 €;'sin fechas';02/08/2006;'PEAJE';'Gastos_Ocio y transporte';'Parking y peaje';'VARIABLES'
02/08/2006;02/08/2006;'PEAJE XERTA';-5,20€;7.577,94 €;-3142;-5,20;12.102,03 €;'sin fechas';02/08/2006;'PEAJE';'Gastos_Ocio y transporte';'Parking y peaje';'VARIABLES'
03/08/2006;03/08/2006;'BIJOU BRIGITTE S';-9,40€;7.568,54 €;-3141;-9,40;12.092,63 €;'sin fechas';03/08/2006;'BIJOU';'Gastos_Compras';'Ropa';'VARIABLES'
03/08/2006;03/08/2006;'GROUPAMA PLUS';-41,12€;7.527,42 €;-3140;-41,12;12.051,51 €;'sin fechas';03/08/2006;'GROUPAMA';'Gastos_Seguros';'Seguro salud';'FIJO'
03/08/2006;03/08/2006;'PEAJE XERTA';-2,30€;7.525,12 €;-3139;-2,30;12.049,21 €;'sin fechas';03/08/2006;'PEAJE';'Gastos_Ocio y transporte';'Parking y peaje';'VARIABLES'
03/08/2006;03/08/2006;'PEAJE XERTA';-3,10€;7.522,02 €;-3138;-3,10;12.046,11 €;'sin fechas';03/08/2006;'PEAJE';'Gastos_Ocio y transporte';'Parking y peaje';'VARIABLES'
03/08/2006;03/08/2006;'PEAJE XERTA';-2,45€;7.519,57 €;-3137;-2,45;12.043,66 €;'sin fechas';03/08/2006;'PEAJE';'Gastos_Ocio y transporte';'Parking y peaje';'VARIABLES'
03/08/2006;03/08/2006;'SABECO TORTOSA';123,99€;7.643,56 €;-3136;123,99;12.167,65 €;'sin fechas';03/08/2006;'SABECO';'Gastos_Compras';'Supermercado';'VARIABLES'
03/08/2006;03/08/2006;'SABECO TORTOSA';-39,73€;7.603,83 €;-3135;-39,73;12.127,92 €;'sin fechas';03/08/2006;'SABECO';'Gastos_Compras';'Supermercado';'VARIABLES'
04/08/2006;04/08/2006;'AMENA RETEVISI';-16,23€;7.587,60 €;-3134;-16,23;12.111,69 €;'sin fechas';04/08/2006;'AMENA';'Gastos_Servicios tipicos';'Telecomunicaciones';'FIJO'
04/08/2006;04/08/2006;'PEAJE RUBI';-1,04€;7.586,56 €;-3133;-1,04;12.110,65 €;'sin fechas';04/08/2006;'PEAJE';'Gastos_Ocio y transporte';'Parking y peaje';'VARIABLES'
05/08/2006;05/08/2006;'SABECO TORTOSA';-49,54€;7.537,02 €;-3132;-49,54;12.061,11 €;'sin fechas';05/08/2006;'SABECO';'Gastos_Compras';'Supermercado';'VARIABLES'
07/08/2006;07/08/2006;'AGBAR INSTALAC';-52,20€;7.484,82 €;-3131;-52,20;12.008,91 €;'sin fechas';07/08/2006;'AGBAR';'Gastos_Servicios tipicos';'Agua';'FIJO'
08/08/2006;08/08/2006;'GAS NATURAL';-137,77€;7.347,05 €;-3130;-137,77;11.871,14 €;'sin fechas';08/08/2006;'GAS';'Gastos_Servicios tipicos';'Gas';'FIJO'
08/08/2006;08/08/2006;'PEAJE XERTA';-5,20€;7.341,85 €;-3129;-5,20;11.865,94 €;'sin fechas';08/08/2006;'PEAJE';'Gastos_Ocio y transporte';'Parking y peaje';'VARIABLES'
09/08/2006;09/08/2006;'ANUL COMPRA';1,88€;7.343,73 €;-3128;1,88;11.867,82 €;'sin fechas';09/08/2006;'ANUL';'Gastos_Gastos varios';'Efectivo';'VARIABLES'
09/08/2006;09/08/2006;'RESTAURANTES';-42,95€;7.300,78 €;-3127;-42,95;11.824,87 €;'sin fechas';09/08/2006;'RESTAURANTES';'Gastos_Ocio y transporte';'Restaurantes';'VARIABLES'
12/08/2006;12/08/2006;'SABECO TORTOSA';-38,64€;7.262,14 €;-3126;-38,64;11.786,23 €;'sin fechas';12/08/2006;'SABECO';'Gastos_Compras';'Supermercado';'VARIABLES'
16/08/2006;16/08/2006;'COMIDA XERTA';-21,03€;7.241,11 €;-3125;-21,03;11.765,20 €;'sin fechas';16/08/2006;'COMIDA';'Gastos_Compras';'Supermercado';'VARIABLES'
16/08/2006;16/08/2006;'SABECO TORTOSA';-44,96€;7.196,15 €;-3124;-44,96;11.720,24 €;'sin fechas';16/08/2006;'SABECO';'Gastos_Compras';'Supermercado';'VARIABLES'
16/08/2006;16/08/2006;'SEG.AM.HIPITEC';-32,86€;7.163,29 €;-3123;-32,86;11.687,38 €;'sin fechas';16/08/2006;'SEGAMHIPITEC';'Gastos_Seguros';'Seguro vida';'FIJO'
18/08/2006;18/08/2006;'ONO';-73,13€;7.090,16 €;-3122;-73,13;11.614,25 €;'sin fechas';18/08/2006;'ONO';'Gastos_Servicios tipicos';'Telecomunicaciones';'FIJO'
18/08/2006;18/08/2006;'REINT.CAJERO';-70,00€;7.020,16 €;-3121;-70,00;11.544,25 €;'sin fechas';18/08/2006;'REINTCAJERO';'Gastos_Gastos varios';'Efectivo';'VARIABLES'
19/08/2006;19/08/2006;'GASOLINA';-42,60€;6.977,56 €;-3120;-42,60;11.501,65 €;'sin fechas';19/08/2006;'GASOLINA';'Gastos_Ocio y transporte';'Gasolina';'VARIABLES'
19/08/2006;19/08/2006;'REINT.CAJERO';-70,00€;6.907,56 €;-3119;-70,00;11.431,65 €;'sin fechas';19/08/2006;'REINTCAJERO';'Gastos_Gastos varios';'Efectivo';'VARIABLES'
21/08/2006;21/08/2006;'MERCADONA';-149,91€;6.757,65 €;-3118;-149,91;11.281,74 €;'sin fechas';21/08/2006;'MERCADONA';'Gastos_Compras';'Supermercado';'VARIABLES'
22/08/2006;22/08/2006;'FF.CC.GENERALITAT';-18,30€;6.739,35 €;-3117;-18,30;11.263,44 €;'sin fechas';22/08/2006;'FFCCGENERALITAT';'Gastos_Ocio y transporte';'Transporte';'VARIABLES'
22/08/2006;22/08/2006;'IKEA';-18,15€;6.721,20 €;-3116;-18,15;11.245,29 €;'sin fechas';22/08/2006;'IKEA';'Gastos_Vivienda y vehiculo';'Mnto. hogar';'VARIABLES'
23/08/2006;23/08/2006;'FRANCE TELECOM';-34,01€;6.687,19 €;-3115;-34,01;11.211,28 €;'sin fechas';23/08/2006;'FRANCE';'Gastos_Servicios tipicos';'Telecomunicaciones';'FIJO'
25/08/2006;25/08/2006;'CAFET.C T PRAT';-2,35€;6.684,84 €;-3114;-2,35;11.208,93 €;'sin fechas';25/08/2006;'CAFETC';'Gastos_Ocio y transporte';'Restaurantes';'VARIABLES'
25/08/2006;25/08/2006;'PEAJE XERTA';-5,20€;6.679,64 €;-3113;-5,20;11.203,73 €;'sin fechas';25/08/2006;'PEAJE';'Gastos_Ocio y transporte';'Parking y peaje';'VARIABLES'
26/08/2006;26/08/2006;'GASOLINA';-56,94€;6.622,70 €;-3112;-56,94;11.146,79 €;'sin fechas';26/08/2006;'GASOLINA';'Gastos_Ocio y transporte';'Gasolina';'VARIABLES'
26/08/2006;26/08/2006;'MUEBLES REY';-1.018,00€;5.604,70 €;-3111;-1.018,00;10.128,79 €;'sin fechas';26/08/2006;'MUEBLES';'Gastos_Compras';'Hogar';'VARIABLES'
28/08/2006;28/08/2006;'PEAJE XERTA';-2,45€;5.602,25 €;-3110;-2,45;10.126,34 €;'sin fechas';28/08/2006;'PEAJE';'Gastos_Ocio y transporte';'Parking y peaje';'VARIABLES'
28/08/2006;28/08/2006;'PEAJE XERTA';-3,10€;5.599,15 €;-3109;-3,10;10.123,24 €;'sin fechas';28/08/2006;'PEAJE';'Gastos_Ocio y transporte';'Parking y peaje';'VARIABLES'
28/08/2006;28/08/2006;'PEAJE XERTA';-2,30€;5.596,85 €;-3108;-2,30;10.120,94 €;'sin fechas';28/08/2006;'PEAJE';'Gastos_Ocio y transporte';'Parking y peaje';'VARIABLES'
29/08/2006;31/08/2006;'AGENCIA DE LA MICROEMPRESA';786,36€;6.383,21 €;-3107;786,36;10.907,30 €;'sin fechas';31/08/2006;'AGENCIA';'Ingresos';'Nomina';'FIJO'
29/08/2006;29/08/2006;'CAFET.C T PRAT';-2,65€;6.380,56 €;-3106;-2,65;10.904,65 €;'sin fechas';29/08/2006;'CAFETC';'Gastos_Ocio y transporte';'Restaurantes';'VARIABLES'
29/08/2006;29/08/2006;'INFORMACIO I TECNOLOGIA DE CAT';1.118,65€;7.499,21 €;-3105;1.118,65;12.023,30 €;'sin fechas';29/08/2006;'INFORMACIO';'Ingresos';'Nomina';'FIJO'
29/08/2006;29/08/2006;'PEAJE RUBI';-1,04€;7.498,17 €;-3104;-1,04;12.022,26 €;'sin fechas';29/08/2006;'PEAJE';'Gastos_Ocio y transporte';'Parking y peaje';'VARIABLES'
29/08/2006;29/08/2006;'PEAJE RUBI';-1,04€;7.497,13 €;-3103;-1,04;12.021,22 €;'sin fechas';29/08/2006;'PEAJE';'Gastos_Ocio y transporte';'Parking y peaje';'VARIABLES'
29/08/2006;29/08/2006;'PEAJE RUBI';-1,04€;7.496,09 €;-3102;-1,04;12.020,18 €;'sin fechas';29/08/2006;'PEAJE';'Gastos_Ocio y transporte';'Parking y peaje';'VARIABLES'
29/08/2006;29/08/2006;'PEAJE RUBI';-1,04€;7.495,05 €;-3101;-1,04;12.019,14 €;'sin fechas';29/08/2006;'PEAJE';'Gastos_Ocio y transporte';'Parking y peaje';'VARIABLES'
29/08/2006;29/08/2006;'PEAJE RUBI';-1,04€;7.494,01 €;-3100;-1,04;12.018,10 €;'sin fechas';29/08/2006;'PEAJE';'Gastos_Ocio y transporte';'Parking y peaje';'VARIABLES'
29/08/2006;29/08/2006;'PEAJE RUBI';-1,04€;7.492,97 €;-3099;-1,04;12.017,06 €;'sin fechas';29/08/2006;'PEAJE';'Gastos_Ocio y transporte';'Parking y peaje';'VARIABLES'
29/08/2006;29/08/2006;'PEAJE RUBI';-1,04€;7.491,93 €;-3098;-1,04;12.016,02 €;'sin fechas';29/08/2006;'PEAJE';'Gastos_Ocio y transporte';'Parking y peaje';'VARIABLES'
30/08/2006;30/08/2006;'CAFET.C T PRAT';-2,40€;7.489,53 €;-3097;-2,40;12.013,62 €;'sin fechas';30/08/2006;'CAFETC';'Gastos_Ocio y transporte';'Restaurantes';'VARIABLES'
31/08/2006;31/08/2006;'CAFET.C T PRAT';-1,70€;7.487,83 €;-3096;-1,70;12.011,92 €;'sin fechas';31/08/2006;'CAFETC';'Gastos_Ocio y transporte';'Restaurantes';'VARIABLES'
31/08/2006;31/08/2006;'RECIBO PTMOS. 3061-0960001518';-636,06€;6.851,77 €;-3095;-636,06;11.375,86 €;'sin fechas';31/08/2006;'RECIBO';'Gastos_Banco y organismos';'Hipoteca';'FIJO'
01/09/2006;01/09/2006;'CAFET.C T PRAT';-2,80€;6.848,97 €;-3094;-2,80;11.373,06 €;'sin fechas';01/09/2006;'CAFETC';'Gastos_Ocio y transporte';'Restaurantes';'VARIABLES'
01/09/2006;01/09/2006;'PEAJE RUBI';-1,04€;6.847,93 €;-3093;-1,04;11.372,02 €;'sin fechas';01/09/2006;'PEAJE';'Gastos_Ocio y transporte';'Parking y peaje';'VARIABLES'
01/09/2006;01/09/2006;'PEAJE RUBI';-0,99€;6.846,94 €;-3092;-0,99;11.371,03 €;'sin fechas';01/09/2006;'PEAJE';'Gastos_Ocio y transporte';'Parking y peaje';'VARIABLES'
03/09/2006;03/09/2006;'GIFI';-39,95€;6.806,99 €;-3091;-39,95;11.331,08 €;'sin fechas';03/09/2006;'GIFI';'Gastos_Compras';'Hogar';'VARIABLES'
03/09/2006;03/09/2006;'MERCADONA';-38,34€;6.768,65 €;-3090;-38,34;11.292,74 €;'sin fechas';03/09/2006;'MERCADONA';'Gastos_Compras';'Supermercado';'VARIABLES'
03/09/2006;03/09/2006;'REINT.CAJERO';-20,00€;6.748,65 €;-3089;-20,00;11.272,74 €;'sin fechas';03/09/2006;'REINTCAJERO';'Gastos_Gastos varios';'Efectivo';'VARIABLES'
03/09/2006;03/09/2006;'RESTAURANTES';-22,70€;6.725,95 €;-3088;-22,70;11.250,04 €;'sin fechas';03/09/2006;'RESTAURANTES';'Gastos_Ocio y transporte';'Restaurantes';'VARIABLES'
04/09/2006;04/09/2006;'CAFET.C T PRAT';-2,35€;6.723,60 €;-3087;-2,35;11.247,69 €;'sin fechas';04/09/2006;'CAFETC';'Gastos_Ocio y transporte';'Restaurantes';'VARIABLES'
05/09/2006;05/09/2006;'CAFET.C T PRAT';-2,35€;6.721,25 €;-3086;-2,35;11.245,34 €;'sin fechas';05/09/2006;'CAFETC';'Gastos_Ocio y transporte';'Restaurantes';'VARIABLES'
05/09/2006;05/09/2006;'FARMACIA';-99,42€;6.621,83 €;-3085;-99,42;11.145,92 €;'sin fechas';05/09/2006;'FARMACIA';'Gastos_Salud, saber y deporte';'Farmacia';'VARIABLES'
05/09/2006;05/09/2006;'FRANCE TELECOM';-17,00€;6.604,83 €;-3084;-17,00;11.128,92 €;'sin fechas';05/09/2006;'FRANCE';'Gastos_Servicios tipicos';'Telecomunicaciones';'FIJO'
05/09/2006;05/09/2006;'GASOLINA';-30,00€;6.574,83 €;-3083;-30,00;11.098,92 €;'sin fechas';05/09/2006;'GASOLINA';'Gastos_Ocio y transporte';'Gasolina';'VARIABLES'
05/09/2006;05/09/2006;'LEROY MERLIN';-6,71€;6.568,12 €;-3082;-6,71;11.092,21 €;'sin fechas';05/09/2006;'LEROY';'Gastos_Vivienda y vehiculo';'Mnto. hogar';'VARIABLES'
05/09/2006;05/09/2006;'PEAJE RUBI';-0,99€;6.567,13 €;-3081;-0,99;11.091,22 €;'sin fechas';05/09/2006;'PEAJE';'Gastos_Ocio y transporte';'Parking y peaje';'VARIABLES'
05/09/2006;05/09/2006;'PEAJE RUBI';-1,04€;6.566,09 €;-3080;-1,04;11.090,18 €;'sin fechas';05/09/2006;'PEAJE';'Gastos_Ocio y transporte';'Parking y peaje';'VARIABLES'
05/09/2006;05/09/2006;'PEAJE RUBI';-1,04€;6.565,05 €;-3079;-1,04;11.089,14 €;'sin fechas';05/09/2006;'PEAJE';'Gastos_Ocio y transporte';'Parking y peaje';'VARIABLES'
05/09/2006;05/09/2006;'PEAJE RUBI';-1,04€;6.564,01 €;-3078;-1,04;11.088,10 €;'sin fechas';05/09/2006;'PEAJE';'Gastos_Ocio y transporte';'Parking y peaje';'VARIABLES'
05/09/2006;05/09/2006;'PEAJE RUBI';-0,99€;6.563,02 €;-3077;-0,99;11.087,11 €;'sin fechas';05/09/2006;'PEAJE';'Gastos_Ocio y transporte';'Parking y peaje';'VARIABLES'
05/09/2006;05/09/2006;'PEAJE RUBI';-0,99€;6.562,03 €;-3076;-0,99;11.086,12 €;'sin fechas';05/09/2006;'PEAJE';'Gastos_Ocio y transporte';'Parking y peaje';'VARIABLES'
05/09/2006;05/09/2006;'PEAJE RUBI';-0,99€;6.561,04 €;-3075;-0,99;11.085,13 €;'sin fechas';05/09/2006;'PEAJE';'Gastos_Ocio y transporte';'Parking y peaje';'VARIABLES'
05/09/2006;05/09/2006;'PEAJE RUBI';-0,94€;6.560,10 €;-3074;-0,94;11.084,19 €;'sin fechas';05/09/2006;'PEAJE';'Gastos_Ocio y transporte';'Parking y peaje';'VARIABLES'
06/09/2006;06/09/2006;'CAFET.C T PRAT';-2,35€;6.557,75 €;-3073;-2,35;11.081,84 €;'sin fechas';06/09/2006;'CAFETC';'Gastos_Ocio y transporte';'Restaurantes';'VARIABLES'
06/09/2006;06/09/2006;'MERCADONA';-5,59€;6.552,16 €;-3072;-5,59;11.076,25 €;'sin fechas';06/09/2006;'MERCADONA';'Gastos_Compras';'Supermercado';'VARIABLES'
07/09/2006;07/09/2006;'CAFET.C T PRAT';-3,05€;6.549,11 €;-3071;-3,05;11.073,20 €;'sin fechas';07/09/2006;'CAFETC';'Gastos_Ocio y transporte';'Restaurantes';'VARIABLES'
07/09/2006;07/09/2006;'GROUPAMA PLUS';-41,12€;6.507,99 €;-3070;-41,12;11.032,08 €;'sin fechas';07/09/2006;'GROUPAMA';'Gastos_Seguros';'Seguro salud';'FIJO'
08/09/2006;08/09/2006;'CAFET.C T PRAT';-2,65€;6.505,34 €;-3069;-2,65;11.029,43 €;'sin fechas';08/09/2006;'CAFETC';'Gastos_Ocio y transporte';'Restaurantes';'VARIABLES'
08/09/2006;08/09/2006;'GASOLINA';-46,13€;6.459,21 €;-3068;-46,13;10.983,30 €;'sin fechas';08/09/2006;'GASOLINA';'Gastos_Ocio y transporte';'Gasolina';'VARIABLES'
08/09/2006;08/09/2006;'PEAJE RUBI';-1,04€;6.458,17 €;-3067;-1,04;10.982,26 €;'sin fechas';08/09/2006;'PEAJE';'Gastos_Ocio y transporte';'Parking y peaje';'VARIABLES'
08/09/2006;08/09/2006;'PEAJE RUBI';-1,04€;6.457,13 €;-3066;-1,04;10.981,22 €;'sin fechas';08/09/2006;'PEAJE';'Gastos_Ocio y transporte';'Parking y peaje';'VARIABLES'
10/09/2006;10/09/2006;'REINT.CAJERO';-70,00€;6.387,13 €;-3065;-70,00;10.911,22 €;'sin fechas';10/09/2006;'REINTCAJERO';'Gastos_Gastos varios';'Efectivo';'VARIABLES'
12/09/2006;12/09/2006;'CAFET.C T PRAT';-2,35€;6.384,78 €;-3064;-2,35;10.908,87 €;'sin fechas';12/09/2006;'CAFETC';'Gastos_Ocio y transporte';'Restaurantes';'VARIABLES'
12/09/2006;12/09/2006;'GUIRAO TERRASSA';-25,00€;6.359,78 €;-3063;-25,00;10.883,87 €;'sin fechas';12/09/2006;'GUIRAO';'Gastos_Ocio y transporte';'Restaurantes';'VARIABLES'
12/09/2006;12/09/2006;'M&S';-9,90€;6.349,88 €;-3062;-9,90;10.873,97 €;'sin fechas';12/09/2006;'MS';'Gastos_Compras';'Ropa';'VARIABLES'
12/09/2006;12/09/2006;'PEAJE PREMIA';-0,64€;6.349,24 €;-3061;-0,64;10.873,33 €;'sin fechas';12/09/2006;'PEAJE';'Gastos_Ocio y transporte';'Parking y peaje';'VARIABLES'
12/09/2006;12/09/2006;'PEAJE RUBI';-1,04€;6.348,20 €;-3060;-1,04;10.872,29 €;'sin fechas';12/09/2006;'PEAJE';'Gastos_Ocio y transporte';'Parking y peaje';'VARIABLES'
12/09/2006;12/09/2006;'PEAJE RUBI';-1,04€;6.347,16 €;-3059;-1,04;10.871,25 €;'sin fechas';12/09/2006;'PEAJE';'Gastos_Ocio y transporte';'Parking y peaje';'VARIABLES'
12/09/2006;12/09/2006;'PEAJE RUBI';-1,04€;6.346,12 €;-3058;-1,04;10.870,21 €;'sin fechas';12/09/2006;'PEAJE';'Gastos_Ocio y transporte';'Parking y peaje';'VARIABLES'
12/09/2006;12/09/2006;'PEAJE RUBI';-1,04€;6.345,08 €;-3057;-1,04;10.869,17 €;'sin fechas';12/09/2006;'PEAJE';'Gastos_Ocio y transporte';'Parking y peaje';'VARIABLES'
12/09/2006;12/09/2006;'PEAJE RUBI';-1,04€;6.344,04 €;-3056;-1,04;10.868,13 €;'sin fechas';12/09/2006;'PEAJE';'Gastos_Ocio y transporte';'Parking y peaje';'VARIABLES'
12/09/2006;12/09/2006;'PEAJE RUBI';-1,04€;6.343,00 €;-3055;-1,04;10.867,09 €;'sin fechas';12/09/2006;'PEAJE';'Gastos_Ocio y transporte';'Parking y peaje';'VARIABLES'
12/09/2006;12/09/2006;'PEAJE RUBI';-1,04€;6.341,96 €;-3054;-1,04;10.866,05 €;'sin fechas';12/09/2006;'PEAJE';'Gastos_Ocio y transporte';'Parking y peaje';'VARIABLES'
12/09/2006;12/09/2006;'PEAJE XERTA';-3,10€;6.338,86 €;-3053;-3,10;10.862,95 €;'sin fechas';12/09/2006;'PEAJE';'Gastos_Ocio y transporte';'Parking y peaje';'VARIABLES'
12/09/2006;12/09/2006;'PEAJE XERTA';-2,30€;6.336,56 €;-3052;-2,30;10.860,65 €;'sin fechas';12/09/2006;'PEAJE';'Gastos_Ocio y transporte';'Parking y peaje';'VARIABLES'
12/09/2006;12/09/2006;'PEAJE XERTA';-2,45€;6.334,11 €;-3051;-2,45;10.858,20 €;'sin fechas';12/09/2006;'PEAJE';'Gastos_Ocio y transporte';'Parking y peaje';'VARIABLES'
13/09/2006;13/09/2006;'CAFET.C T PRAT';-2,35€;6.331,76 €;-3050;-2,35;10.855,85 €;'sin fechas';13/09/2006;'CAFETC';'Gastos_Ocio y transporte';'Restaurantes';'VARIABLES'
13/09/2006;13/09/2006;'GASOLINA';-50,00€;6.281,76 €;-3049;-50,00;10.805,85 €;'sin fechas';13/09/2006;'GASOLINA';'Gastos_Ocio y transporte';'Gasolina';'VARIABLES'
14/09/2006;14/09/2006;'CAFET.C T PRAT';-4,90€;6.276,86 €;-3048;-4,90;10.800,95 €;'sin fechas';14/09/2006;'CAFETC';'Gastos_Ocio y transporte';'Restaurantes';'VARIABLES'
14/09/2006;14/09/2006;'MERCADONA';-117,15€;6.159,71 €;-3047;-117,15;10.683,80 €;'sin fechas';14/09/2006;'MERCADONA';'Gastos_Compras';'Supermercado';'VARIABLES'
15/09/2006;15/09/2006;'M&S';-49,85€;6.109,86 €;-3046;-49,85;10.633,95 €;'sin fechas';15/09/2006;'MS';'Gastos_Compras';'Ropa';'VARIABLES'
15/09/2006;15/09/2006;'PEAJE XERTA';-2,30€;6.107,56 €;-3045;-2,30;10.631,65 €;'sin fechas';15/09/2006;'PEAJE';'Gastos_Ocio y transporte';'Parking y peaje';'VARIABLES'
15/09/2006;15/09/2006;'PEAJE XERTA';-3,10€;6.104,46 €;-3044;-3,10;10.628,55 €;'sin fechas';15/09/2006;'PEAJE';'Gastos_Ocio y transporte';'Parking y peaje';'VARIABLES'
15/09/2006;15/09/2006;'PEAJE XERTA';-2,45€;6.102,01 €;-3043;-2,45;10.626,10 €;'sin fechas';15/09/2006;'PEAJE';'Gastos_Ocio y transporte';'Parking y peaje';'VARIABLES'
15/09/2006;15/09/2006;'PEAJE XERTA';-5,20€;6.096,81 €;-3042;-5,20;10.620,90 €;'sin fechas';15/09/2006;'PEAJE';'Gastos_Ocio y transporte';'Parking y peaje';'VARIABLES'
15/09/2006;15/09/2006;'REINT.CAJERO';-40,00€;6.056,81 €;-3041;-40,00;10.580,90 €;'sin fechas';15/09/2006;'REINTCAJERO';'Gastos_Gastos varios';'Efectivo';'VARIABLES'
16/09/2006;16/09/2006;'IKEA';-18,15€;6.038,66 €;-3040;-18,15;10.562,75 €;'sin fechas';16/09/2006;'IKEA';'Gastos_Vivienda y vehiculo';'Mnto. hogar';'VARIABLES'
17/09/2006;17/09/2006;'RESTAURANTES';-22,70€;6.015,96 €;-3039;-22,70;10.540,05 €;'sin fechas';17/09/2006;'RESTAURANTES';'Gastos_Ocio y transporte';'Restaurantes';'VARIABLES'
18/09/2006;18/09/2006;'CAFET.C T PRAT';-1,35€;6.014,61 €;-3038;-1,35;10.538,70 €;'sin fechas';18/09/2006;'CAFETC';'Gastos_Ocio y transporte';'Restaurantes';'VARIABLES'
18/09/2006;18/09/2006;'ENDESA DISTRIB';-45,72€;5.968,89 €;-3037;-45,72;10.492,98 €;'sin fechas';18/09/2006;'ENDESA';'Gastos_Servicios tipicos';'Electricidad';'FIJO'
18/09/2006;18/09/2006;'SEG.AM.HIPITEC';-32,79€;5.936,10 €;-3036;-32,79;10.460,19 €;'sin fechas';18/09/2006;'SEGAMHIPITEC';'Gastos_Seguros';'Seguro vida';'FIJO'
19/09/2006;19/09/2006;'CAFET.C T PRAT';-1,35€;5.934,75 €;-3035;-1,35;10.458,84 €;'sin fechas';19/09/2006;'CAFETC';'Gastos_Ocio y transporte';'Restaurantes';'VARIABLES'
19/09/2006;19/09/2006;'PEAJE RUBI';-1,04€;5.933,71 €;-3034;-1,04;10.457,80 €;'sin fechas';19/09/2006;'PEAJE';'Gastos_Ocio y transporte';'Parking y peaje';'VARIABLES'
19/09/2006;19/09/2006;'PEAJE RUBI';-1,04€;5.932,67 €;-3033;-1,04;10.456,76 €;'sin fechas';19/09/2006;'PEAJE';'Gastos_Ocio y transporte';'Parking y peaje';'VARIABLES'
19/09/2006;19/09/2006;'PEAJE RUBI';-1,04€;5.931,63 €;-3032;-1,04;10.455,72 €;'sin fechas';19/09/2006;'PEAJE';'Gastos_Ocio y transporte';'Parking y peaje';'VARIABLES'
20/09/2006;20/09/2006;'CAFET.C T PRAT';-2,35€;5.929,28 €;-3031;-2,35;10.453,37 €;'sin fechas';20/09/2006;'CAFETC';'Gastos_Ocio y transporte';'Restaurantes';'VARIABLES'
20/09/2006;20/09/2006;'CAFET.C T PRAT';-1,35€;5.927,93 €;-3030;-1,35;10.452,02 €;'sin fechas';20/09/2006;'CAFETC';'Gastos_Ocio y transporte';'Restaurantes';'VARIABLES'
20/09/2006;20/09/2006;'GASOLINA';-30,00€;5.897,93 €;-3029;-30,00;10.422,02 €;'sin fechas';20/09/2006;'GASOLINA';'Gastos_Ocio y transporte';'Gasolina';'VARIABLES'
20/09/2006;20/09/2006;'PEAJE RUBI';-0,99€;5.896,94 €;-3028;-0,99;10.421,03 €;'sin fechas';20/09/2006;'PEAJE';'Gastos_Ocio y transporte';'Parking y peaje';'VARIABLES'
20/09/2006;20/09/2006;'PEAJE RUBI';-1,04€;5.895,90 €;-3027;-1,04;10.419,99 €;'sin fechas';20/09/2006;'PEAJE';'Gastos_Ocio y transporte';'Parking y peaje';'VARIABLES'
20/09/2006;20/09/2006;'PEAJE RUBI';-1,04€;5.894,86 €;-3026;-1,04;10.418,95 €;'sin fechas';20/09/2006;'PEAJE';'Gastos_Ocio y transporte';'Parking y peaje';'VARIABLES'
20/09/2006;20/09/2006;'PEAJE RUBI';-0,99€;5.893,87 €;-3025;-0,99;10.417,96 €;'sin fechas';20/09/2006;'PEAJE';'Gastos_Ocio y transporte';'Parking y peaje';'VARIABLES'
20/09/2006;20/09/2006;'PEAJE RUBI';-0,99€;5.892,88 €;-3024;-0,99;10.416,97 €;'sin fechas';20/09/2006;'PEAJE';'Gastos_Ocio y transporte';'Parking y peaje';'VARIABLES'
20/09/2006;20/09/2006;'PEAJE RUBI';-1,89€;5.890,99 €;-3023;-1,89;10.415,08 €;'sin fechas';20/09/2006;'PEAJE';'Gastos_Ocio y transporte';'Parking y peaje';'VARIABLES'
20/09/2006;20/09/2006;'PEAJE XERTA';-5,20€;5.885,79 €;-3022;-5,20;10.409,88 €;'sin fechas';20/09/2006;'PEAJE';'Gastos_Ocio y transporte';'Parking y peaje';'VARIABLES'
21/09/2006;21/09/2006;'CAFET.C T PRAT';-1,35€;5.884,44 €;-3021;-1,35;10.408,53 €;'sin fechas';21/09/2006;'CAFETC';'Gastos_Ocio y transporte';'Restaurantes';'VARIABLES'
21/09/2006;21/09/2006;'ONO';-72,82€;5.811,62 €;-3020;-72,82;10.335,71 €;'sin fechas';21/09/2006;'ONO';'Gastos_Servicios tipicos';'Telecomunicaciones';'FIJO'
22/09/2006;22/09/2006;'CAFET.C T PRAT';-1,80€;5.809,82 €;-3019;-1,80;10.333,91 €;'sin fechas';22/09/2006;'CAFETC';'Gastos_Ocio y transporte';'Restaurantes';'VARIABLES'
22/09/2006;22/09/2006;'CINE';-10,60€;5.799,22 €;-3018;-10,60;10.323,31 €;'sin fechas';22/09/2006;'CINE';'Gastos_Ocio y transporte';'Espectáculos';'VARIABLES'
23/09/2006;23/09/2006;'KUROKAI';-99,00€;5.700,22 €;-3017;-99,00;10.224,31 €;'sin fechas';23/09/2006;'KUROKAI';'Gastos_Compras';'Ropa';'VARIABLES'
23/09/2006;23/09/2006;'MEDIA MARKT';-129,70€;5.570,52 €;-3016;-129,70;10.094,61 €;'sin fechas';23/09/2006;'MEDIA';'Gastos_Compras';'Hobbys';'VARIABLES'
23/09/2006;23/09/2006;'RESTAURANTES';-41,30€;5.529,22 €;-3015;-41,30;10.053,31 €;'sin fechas';23/09/2006;'RESTAURANTES';'Gastos_Ocio y transporte';'Restaurantes';'VARIABLES'
23/09/2006;23/09/2006;'ULANKA';-35,00€;5.494,22 €;-3014;-35,00;10.018,31 €;'sin fechas';23/09/2006;'ULANKA';'Gastos_Compras';'Ropa';'VARIABLES'
25/09/2006;25/09/2006;'DEV.TRIBUTARIA';611,37€;6.105,59 €;-3013;611,37;10.629,68 €;'sin fechas';25/09/2006;'DEVTRIBUTARIA';'Ingresos';'Devoluciones';'VARIABLES'
25/09/2006;25/09/2006;'FRANCE TELECOM';-17,18€;6.088,41 €;-3012;-17,18;10.612,50 €;'sin fechas';25/09/2006;'FRANCE';'Gastos_Servicios tipicos';'Telecomunicaciones';'FIJO'
26/09/2006;26/09/2006;'GASOLINA';-60,01€;6.028,40 €;-3011;-60,01;10.552,49 €;'sin fechas';26/09/2006;'GASOLINA';'Gastos_Ocio y transporte';'Gasolina';'VARIABLES'
26/09/2006;26/09/2006;'PEAJE RUBI';-0,99€;6.027,41 €;-3010;-0,99;10.551,50 €;'sin fechas';26/09/2006;'PEAJE';'Gastos_Ocio y transporte';'Parking y peaje';'VARIABLES'
26/09/2006;26/09/2006;'PEAJE RUBI';-0,99€;6.026,42 €;-3009;-0,99;10.550,51 €;'sin fechas';26/09/2006;'PEAJE';'Gastos_Ocio y transporte';'Parking y peaje';'VARIABLES'
26/09/2006;26/09/2006;'PEAJE RUBI';-0,94€;6.025,48 €;-3008;-0,94;10.549,57 €;'sin fechas';26/09/2006;'PEAJE';'Gastos_Ocio y transporte';'Parking y peaje';'VARIABLES'
26/09/2006;26/09/2006;'PEAJE RUBI';-1,04€;6.024,44 €;-3007;-1,04;10.548,53 €;'sin fechas';26/09/2006;'PEAJE';'Gastos_Ocio y transporte';'Parking y peaje';'VARIABLES'
26/09/2006;26/09/2006;'PEAJE RUBI';-1,04€;6.023,40 €;-3006;-1,04;10.547,49 €;'sin fechas';26/09/2006;'PEAJE';'Gastos_Ocio y transporte';'Parking y peaje';'VARIABLES'
26/09/2006;26/09/2006;'PEAJE RUBI';-0,94€;6.022,46 €;-3005;-0,94;10.546,55 €;'sin fechas';26/09/2006;'PEAJE';'Gastos_Ocio y transporte';'Parking y peaje';'VARIABLES'
26/09/2006;26/09/2006;'PEAJE RUBI';-1,04€;6.021,42 €;-3004;-1,04;10.545,51 €;'sin fechas';26/09/2006;'PEAJE';'Gastos_Ocio y transporte';'Parking y peaje';'VARIABLES'
26/09/2006;26/09/2006;'PEAJE RUBI';-1,04€;6.020,38 €;-3003;-1,04;10.544,47 €;'sin fechas';26/09/2006;'PEAJE';'Gastos_Ocio y transporte';'Parking y peaje';'VARIABLES'
26/09/2006;26/09/2006;'PEAJE RUBI';-0,94€;6.019,44 €;-3002;-0,94;10.543,53 €;'sin fechas';26/09/2006;'PEAJE';'Gastos_Ocio y transporte';'Parking y peaje';'VARIABLES'
26/09/2006;26/09/2006;'PEAJE RUBI';-1,04€;6.018,40 €;-3001;-1,04;10.542,49 €;'sin fechas';26/09/2006;'PEAJE';'Gastos_Ocio y transporte';'Parking y peaje';'VARIABLES'
27/09/2006;27/09/2006;'CAFET.C T PRAT';-1,35€;6.017,05 €;-3000;-1,35;10.541,14 €;'sin fechas';27/09/2006;'CAFETC';'Gastos_Ocio y transporte';'Restaurantes';'VARIABLES'
27/09/2006;27/09/2006;'MINA PUBLICA DE LA CIUTAT';-20,38€;5.996,67 €;-2999;-20,38;10.520,76 €;'sin fechas';27/09/2006;'MINA';'Gastos_Servicios tipicos';'Agua';'FIJO'
28/09/2006;28/09/2006;'INFORMACIO I TECNOLOGIA DE CAT';1.274,31€;7.270,98 €;-2998;1.274,31;11.795,07 €;'sin fechas';28/09/2006;'INFORMACIO';'Ingresos';'Nomina';'FIJO'
29/09/2006;29/09/2006;'M&S';-29,90€;7.241,08 €;-2997;-29,90;11.765,17 €;'sin fechas';29/09/2006;'MS';'Gastos_Compras';'Ropa';'VARIABLES'
30/09/2006;30/09/2006;'AGENCIA DE LA MICROEMPRESA';786,36€;8.027,44 €;-2996;786,36;12.551,53 €;'sin fechas';30/09/2006;'AGENCIA';'Ingresos';'Nomina';'FIJO'
01/10/2006;01/10/2006;'EMBUT.REGIONALES';-14,60€;8.012,84 €;-2995;-14,60;12.536,93 €;'sin fechas';01/10/2006;'EMBUTREGIONALES';'Gastos_Compras';'Supermercado';'VARIABLES'
02/10/2006;02/10/2006;'CAFET.C T PRAT';-1,35€;8.011,49 €;-2994;-1,35;12.535,58 €;'sin fechas';02/10/2006;'CAFETC';'Gastos_Ocio y transporte';'Restaurantes';'VARIABLES'
02/10/2006;02/10/2006;'FF.CC.GENERALITAT';-6,65€;8.004,84 €;-2993;-6,65;12.528,93 €;'sin fechas';02/10/2006;'FFCCGENERALITAT';'Gastos_Ocio y transporte';'Transporte';'VARIABLES'
02/10/2006;30/09/2006;'RECIBO PTMOS. 3061-0960001518';-636,06€;7.368,78 €;-2992;-636,06;11.892,87 €;'sin fechas';30/09/2006;'RECIBO';'Gastos_Banco y organismos';'Hipoteca';'FIJO'
03/10/2006;03/10/2006;'CAFET.C T PRAT';-1,35€;7.367,43 €;-2991;-1,35;11.891,52 €;'sin fechas';03/10/2006;'CAFETC';'Gastos_Ocio y transporte';'Restaurantes';'VARIABLES'
03/10/2006;03/10/2006;'PEAJE RUBI';-0,94€;7.366,49 €;-2990;-0,94;11.890,58 €;'sin fechas';03/10/2006;'PEAJE';'Gastos_Ocio y transporte';'Parking y peaje';'VARIABLES'
03/10/2006;03/10/2006;'PEAJE RUBI';-0,94€;7.365,55 €;-2989;-0,94;11.889,64 €;'sin fechas';03/10/2006;'PEAJE';'Gastos_Ocio y transporte';'Parking y peaje';'VARIABLES'
03/10/2006;03/10/2006;'PEAJE RUBI';-0,94€;7.364,61 €;-2988;-0,94;11.888,70 €;'sin fechas';03/10/2006;'PEAJE';'Gastos_Ocio y transporte';'Parking y peaje';'VARIABLES'
03/10/2006;03/10/2006;'PEAJE RUBI';-1,04€;7.363,57 €;-2987;-1,04;11.887,66 €;'sin fechas';03/10/2006;'PEAJE';'Gastos_Ocio y transporte';'Parking y peaje';'VARIABLES'
03/10/2006;03/10/2006;'PEAJE RUBI';-0,94€;7.362,63 €;-2986;-0,94;11.886,72 €;'sin fechas';03/10/2006;'PEAJE';'Gastos_Ocio y transporte';'Parking y peaje';'VARIABLES'
03/10/2006;03/10/2006;'PEAJE RUBI';-1,04€;7.361,59 €;-2985;-1,04;11.885,68 €;'sin fechas';03/10/2006;'PEAJE';'Gastos_Ocio y transporte';'Parking y peaje';'VARIABLES'
03/10/2006;03/10/2006;'PEAJE RUBI';-1,04€;7.360,55 €;-2984;-1,04;11.884,64 €;'sin fechas';03/10/2006;'PEAJE';'Gastos_Ocio y transporte';'Parking y peaje';'VARIABLES'
03/10/2006;03/10/2006;'PEAJE RUBI';-1,04€;7.359,51 €;-2983;-1,04;11.883,60 €;'sin fechas';03/10/2006;'PEAJE';'Gastos_Ocio y transporte';'Parking y peaje';'VARIABLES'
04/10/2006;04/10/2006;'CAFET.C T PRAT';-1,35€;7.358,16 €;-2982;-1,35;11.882,25 €;'sin fechas';04/10/2006;'CAFETC';'Gastos_Ocio y transporte';'Restaurantes';'VARIABLES'
04/10/2006;04/10/2006;'FRANCE TELECOM';-15,01€;7.343,15 €;-2981;-15,01;11.867,24 €;'sin fechas';04/10/2006;'FRANCE';'Gastos_Servicios tipicos';'Telecomunicaciones';'FIJO'
05/10/2006;05/10/2006;'CAFET.C T PRAT';-1,35€;7.341,80 €;-2980;-1,35;11.865,89 €;'sin fechas';05/10/2006;'CAFETC';'Gastos_Ocio y transporte';'Restaurantes';'VARIABLES'
05/10/2006;05/10/2006;'COMISIONES';-12,00€;7.329,80 €;-2979;-12,00;11.853,89 €;'sin fechas';05/10/2006;'COMISIONES';'Gastos_Banco y organismos';'Cargos banco';'FIJO'
05/10/2006;05/10/2006;'GASOLINA';-57,00€;7.272,80 €;-2978;-57,00;11.796,89 €;'sin fechas';05/10/2006;'GASOLINA';'Gastos_Ocio y transporte';'Gasolina';'VARIABLES'
05/10/2006;05/10/2006;'INTERESES';0,33€;7.273,13 €;-2977;0,33;11.797,22 €;'sin fechas';05/10/2006;'INTERESES';'Ingresos';'Rendimientos';
05/10/2006;05/10/2006;'INTERESES';-0,19€;7.272,94 €;-2976;-0,19;11.797,03 €;'sin fechas';05/10/2006;'INTERESES';'Ingresos';'Rendimientos';
05/10/2006;05/10/2006;'R.R.C';-0,05€;7.272,89 €;-2975;-0,05;11.796,98 €;'sin fechas';05/10/2006;'RRC';'Gastos_Compras';'Hogar';'VARIABLES'
09/10/2006;09/10/2006;'BON AREA';-27,81€;7.245,08 €;-2974;-27,81;11.769,17 €;'sin fechas';09/10/2006;'BON';'Gastos_Compras';'Supermercado';'VARIABLES'
09/10/2006;09/10/2006;'CARREFOUR-[comida]';-17,80€;7.227,28 €;-2973;-17,80;11.751,37 €;'sin fechas';09/10/2006;'CARREFOURCOMIDA';'Gastos_Compras';'Supermercado';'VARIABLES'
09/10/2006;09/10/2006;'CINE';-13,00€;7.214,28 €;-2972;-13,00;11.738,37 €;'sin fechas';09/10/2006;'CINE';'Gastos_Ocio y transporte';'Espectáculos';'VARIABLES'
09/10/2006;09/10/2006;'FARMACIA';-12,00€;7.202,28 €;-2971;-12,00;11.726,37 €;'sin fechas';09/10/2006;'FARMACIA';'Gastos_Salud, saber y deporte';'Farmacia';'VARIABLES'
09/10/2006;09/10/2006;'GROUPAMA PLUS';-41,12€;7.161,16 €;-2970;-41,12;11.685,25 €;'sin fechas';09/10/2006;'GROUPAMA';'Gastos_Seguros';'Seguro salud';'FIJO'
09/10/2006;09/10/2006;'H&M';-100,50€;7.060,66 €;-2969;-100,50;11.584,75 €;'sin fechas';09/10/2006;'HM';'Gastos_Compras';'Ropa';'VARIABLES'
09/10/2006;09/10/2006;'MAIL CENTER';-19,95€;7.040,71 €;-2968;-19,95;11.564,80 €;'sin fechas';09/10/2006;'MAIL';'Gastos_Compras';'Hogar';'VARIABLES'
09/10/2006;09/10/2006;'PEAJE RUBI';-0,94€;7.039,77 €;-2967;-0,94;11.563,86 €;'sin fechas';09/10/2006;'PEAJE';'Gastos_Ocio y transporte';'Parking y peaje';'VARIABLES'
09/10/2006;09/10/2006;'REINT.CAJERO';-90,00€;6.949,77 €;-2966;-90,00;11.473,86 €;'sin fechas';09/10/2006;'REINTCAJERO';'Gastos_Gastos varios';'Efectivo';'VARIABLES'
09/10/2006;09/10/2006;'RESTAURANTES';-39,91€;6.909,86 €;-2965;-39,91;11.433,95 €;'sin fechas';09/10/2006;'RESTAURANTES';'Gastos_Ocio y transporte';'Restaurantes';'VARIABLES'
10/10/2006;10/10/2006;'PEAJE RUBI';-1,04€;6.908,82 €;-2964;-1,04;11.432,91 €;'sin fechas';10/10/2006;'PEAJE';'Gastos_Ocio y transporte';'Parking y peaje';'VARIABLES'
10/10/2006;10/10/2006;'PEAJE RUBI';-1,04€;6.907,78 €;-2963;-1,04;11.431,87 €;'sin fechas';10/10/2006;'PEAJE';'Gastos_Ocio y transporte';'Parking y peaje';'VARIABLES'
11/10/2006;11/10/2006;'PEAJE RUBI';-1,04€;6.906,74 €;-2962;-1,04;11.430,83 €;'sin fechas';11/10/2006;'PEAJE';'Gastos_Ocio y transporte';'Parking y peaje';'VARIABLES'
11/10/2006;11/10/2006;'PEAJE RUBI';-1,04€;6.905,70 €;-2961;-1,04;11.429,79 €;'sin fechas';11/10/2006;'PEAJE';'Gastos_Ocio y transporte';'Parking y peaje';'VARIABLES'
11/10/2006;11/10/2006;'PEAJE RUBI';-1,04€;6.904,66 €;-2960;-1,04;11.428,75 €;'sin fechas';11/10/2006;'PEAJE';'Gastos_Ocio y transporte';'Parking y peaje';'VARIABLES'
11/10/2006;11/10/2006;'PEAJE RUBI';-1,04€;6.903,62 €;-2959;-1,04;11.427,71 €;'sin fechas';11/10/2006;'PEAJE';'Gastos_Ocio y transporte';'Parking y peaje';'VARIABLES'
11/10/2006;11/10/2006;'PEAJE RUBI';-1,04€;6.902,58 €;-2958;-1,04;11.426,67 €;'sin fechas';11/10/2006;'PEAJE';'Gastos_Ocio y transporte';'Parking y peaje';'VARIABLES'
11/10/2006;11/10/2006;'PEAJE RUBI';-1,04€;6.901,54 €;-2957;-1,04;11.425,63 €;'sin fechas';11/10/2006;'PEAJE';'Gastos_Ocio y transporte';'Parking y peaje';'VARIABLES'
14/10/2006;14/10/2006;'MERCADONA';-165,11€;6.736,43 €;-2956;-165,11;11.260,52 €;'sin fechas';14/10/2006;'MERCADONA';'Gastos_Compras';'Supermercado';'VARIABLES'
16/10/2006;16/10/2006;'CAFET.C T PRAT';-2,65€;6.733,78 €;-2955;-2,65;11.257,87 €;'sin fechas';16/10/2006;'CAFETC';'Gastos_Ocio y transporte';'Restaurantes';'VARIABLES'
16/10/2006;16/10/2006;'GAS NATURAL';-137,77€;6.596,01 €;-2954;-137,77;11.120,10 €;'sin fechas';16/10/2006;'GAS';'Gastos_Servicios tipicos';'Gas';'FIJO'
16/10/2006;16/10/2006;'SEG.AM.HIPITEC';-32,73€;6.563,28 €;-2953;-32,73;11.087,37 €;'sin fechas';16/10/2006;'SEGAMHIPITEC';'Gastos_Seguros';'Seguro vida';'FIJO'
17/10/2006;17/10/2006;'CAFET.C T PRAT';-2,65€;6.560,63 €;-2952;-2,65;11.084,72 €;'sin fechas';17/10/2006;'CAFETC';'Gastos_Ocio y transporte';'Restaurantes';'VARIABLES'
17/10/2006;17/10/2006;'EL SENOR DE LOS HI\TERRASSA\ES';-24,96€;6.535,67 €;-2951;-24,96;11.059,76 €;'sin fechas';17/10/2006;'SENOR';'Gastos_Ocio y transporte';'Restaurantes';'VARIABLES'
17/10/2006;17/10/2006;'GASOLINA';-60,00€;6.475,67 €;-2950;-60,00;10.999,76 €;'sin fechas';17/10/2006;'GASOLINA';'Gastos_Ocio y transporte';'Gasolina';'VARIABLES'
17/10/2006;17/10/2006;'PEAJE RUBI';-1,04€;6.474,63 €;-2949;-1,04;10.998,72 €;'sin fechas';17/10/2006;'PEAJE';'Gastos_Ocio y transporte';'Parking y peaje';'VARIABLES'
17/10/2006;17/10/2006;'PEAJE RUBI';-1,04€;6.473,59 €;-2948;-1,04;10.997,68 €;'sin fechas';17/10/2006;'PEAJE';'Gastos_Ocio y transporte';'Parking y peaje';'VARIABLES'
17/10/2006;17/10/2006;'PEAJE RUBI';-1,04€;6.472,55 €;-2947;-1,04;10.996,64 €;'sin fechas';17/10/2006;'PEAJE';'Gastos_Ocio y transporte';'Parking y peaje';'VARIABLES'
17/10/2006;17/10/2006;'PEAJE RUBI';-0,99€;6.471,56 €;-2946;-0,99;10.995,65 €;'sin fechas';17/10/2006;'PEAJE';'Gastos_Ocio y transporte';'Parking y peaje';'VARIABLES'
17/10/2006;17/10/2006;'PEAJE RUBI';-1,04€;6.470,52 €;-2945;-1,04;10.994,61 €;'sin fechas';17/10/2006;'PEAJE';'Gastos_Ocio y transporte';'Parking y peaje';'VARIABLES'
17/10/2006;17/10/2006;'PEAJE RUBI';-1,04€;6.469,48 €;-2944;-1,04;10.993,57 €;'sin fechas';17/10/2006;'PEAJE';'Gastos_Ocio y transporte';'Parking y peaje';'VARIABLES'
17/10/2006;17/10/2006;'PEAJE RUBI';-1,04€;6.468,44 €;-2943;-1,04;10.992,53 €;'sin fechas';17/10/2006;'PEAJE';'Gastos_Ocio y transporte';'Parking y peaje';'VARIABLES'
17/10/2006;17/10/2006;'PEAJE RUBI';-1,04€;6.467,40 €;-2942;-1,04;10.991,49 €;'sin fechas';17/10/2006;'PEAJE';'Gastos_Ocio y transporte';'Parking y peaje';'VARIABLES'
18/10/2006;18/10/2006;'CAFET.C T PRAT';-1,35€;6.466,05 €;-2941;-1,35;10.990,14 €;'sin fechas';18/10/2006;'CAFETC';'Gastos_Ocio y transporte';'Restaurantes';'VARIABLES'
19/10/2006;19/10/2006;'CAFET.C T PRAT';-2,15€;6.463,90 €;-2940;-2,15;10.987,99 €;'sin fechas';19/10/2006;'CAFETC';'Gastos_Ocio y transporte';'Restaurantes';'VARIABLES'
19/10/2006;19/10/2006;'CAFET.C T PRAT';-1,35€;6.462,55 €;-2939;-1,35;10.986,64 €;'sin fechas';19/10/2006;'CAFETC';'Gastos_Ocio y transporte';'Restaurantes';'VARIABLES'
20/10/2006;20/10/2006;'CAFET.C T PRAT';-2,35€;6.460,20 €;-2938;-2,35;10.984,29 €;'sin fechas';20/10/2006;'CAFETC';'Gastos_Ocio y transporte';'Restaurantes';'VARIABLES'
20/10/2006;20/10/2006;'CLSL BARCELONA ES';-16,95€;6.443,25 €;-2937;-16,95;10.967,34 €;'sin fechas';20/10/2006;'CLSL';'Gastos_Compras';'Hogar';'VARIABLES'
20/10/2006;20/10/2006;'ONO';-87,78€;6.355,47 €;-2936;-87,78;10.879,56 €;'sin fechas';20/10/2006;'ONO';'Gastos_Servicios tipicos';'Telecomunicaciones';'FIJO'
23/10/2006;23/10/2006;'CAFET.C T PRAT';-2,65€;6.352,82 €;-2935;-2,65;10.876,91 €;'sin fechas';23/10/2006;'CAFETC';'Gastos_Ocio y transporte';'Restaurantes';'VARIABLES'
23/10/2006;23/10/2006;'CAFET.C T PRAT';-1,35€;6.351,47 €;-2934;-1,35;10.875,56 €;'sin fechas';23/10/2006;'CAFETC';'Gastos_Ocio y transporte';'Restaurantes';'VARIABLES'
23/10/2006;23/10/2006;'CAPRABO';-8,86€;6.342,61 €;-2933;-8,86;10.866,70 €;'sin fechas';23/10/2006;'CAPRABO';'Gastos_Compras';'Supermercado';'VARIABLES'
23/10/2006;23/10/2006;'GIFI';-12,80€;6.329,81 €;-2932;-12,80;10.853,90 €;'sin fechas';23/10/2006;'GIFI';'Gastos_Compras';'Hogar';'VARIABLES'
24/10/2006;24/10/2006;'CAFET.C T PRAT';-1,65€;6.328,16 €;-2931;-1,65;10.852,25 €;'sin fechas';24/10/2006;'CAFETC';'Gastos_Ocio y transporte';'Restaurantes';'VARIABLES'
24/10/2006;24/10/2006;'CAFET.C T PRAT';-1,35€;6.326,81 €;-2930;-1,35;10.850,90 €;'sin fechas';24/10/2006;'CAFETC';'Gastos_Ocio y transporte';'Restaurantes';'VARIABLES'
24/10/2006;24/10/2006;'FARMACIA';-3,84€;6.322,97 €;-2929;-3,84;10.847,06 €;'sin fechas';24/10/2006;'FARMACIA';'Gastos_Salud, saber y deporte';'Farmacia';'VARIABLES'
24/10/2006;24/10/2006;'FRANCE TELECOM';-15,18€;6.307,79 €;-2928;-15,18;10.831,88 €;'sin fechas';24/10/2006;'FRANCE';'Gastos_Servicios tipicos';'Telecomunicaciones';'FIJO'
24/10/2006;24/10/2006;'PEAJE RUBI';-0,99€;6.306,80 €;-2927;-0,99;10.830,89 €;'sin fechas';24/10/2006;'PEAJE';'Gastos_Ocio y transporte';'Parking y peaje';'VARIABLES'
24/10/2006;24/10/2006;'PEAJE RUBI';-0,99€;6.305,81 €;-2926;-0,99;10.829,90 €;'sin fechas';24/10/2006;'PEAJE';'Gastos_Ocio y transporte';'Parking y peaje';'VARIABLES'
24/10/2006;24/10/2006;'PEAJE RUBI';-1,04€;6.304,77 €;-2925;-1,04;10.828,86 €;'sin fechas';24/10/2006;'PEAJE';'Gastos_Ocio y transporte';'Parking y peaje';'VARIABLES'
24/10/2006;24/10/2006;'PEAJE RUBI';-0,99€;6.303,78 €;-2924;-0,99;10.827,87 €;'sin fechas';24/10/2006;'PEAJE';'Gastos_Ocio y transporte';'Parking y peaje';'VARIABLES'
25/10/2006;25/10/2006;'CAFET.C T PRAT';-1,95€;6.301,83 €;-2923;-1,95;10.825,92 €;'sin fechas';25/10/2006;'CAFETC';'Gastos_Ocio y transporte';'Restaurantes';'VARIABLES'
25/10/2006;25/10/2006;'CAFET.C T PRAT';-1,35€;6.300,48 €;-2922;-1,35;10.824,57 €;'sin fechas';25/10/2006;'CAFETC';'Gastos_Ocio y transporte';'Restaurantes';'VARIABLES'
25/10/2006;25/10/2006;'PEAJE RUBI';-0,99€;6.299,49 €;-2921;-0,99;10.823,58 €;'sin fechas';25/10/2006;'PEAJE';'Gastos_Ocio y transporte';'Parking y peaje';'VARIABLES'
25/10/2006;25/10/2006;'PEAJE RUBI';-1,04€;6.298,45 €;-2920;-1,04;10.822,54 €;'sin fechas';25/10/2006;'PEAJE';'Gastos_Ocio y transporte';'Parking y peaje';'VARIABLES'
26/10/2006;26/10/2006;'CAFET.C T PRAT';-2,80€;6.295,65 €;-2919;-2,80;10.819,74 €;'sin fechas';26/10/2006;'CAFETC';'Gastos_Ocio y transporte';'Restaurantes';'VARIABLES'
26/10/2006;26/10/2006;'M&S';-23,90€;6.271,75 €;-2918;-23,90;10.795,84 €;'sin fechas';26/10/2006;'MS';'Gastos_Compras';'Ropa';'VARIABLES'
30/10/2006;31/10/2006;'AGENCIA DE LA MICROEMPRESA';541,56€;6.813,31 €;-2917;541,56;11.337,40 €;'sin fechas';31/10/2006;'AGENCIA';'Ingresos';'Nomina';'FIJO'
30/10/2006;30/10/2006;'CARREFOUR-[comida]';-86,97€;6.726,34 €;-2916;-86,97;11.250,43 €;'sin fechas';30/10/2006;'CARREFOURCOMIDA';'Gastos_Compras';'Supermercado';'VARIABLES'
30/10/2006;30/10/2006;'CARREFOUR-[comida]';-86,97€;6.639,37 €;-2915;-86,97;11.163,46 €;'sin fechas';30/10/2006;'CARREFOURCOMIDA';'Gastos_Compras';'Supermercado';'VARIABLES'
30/10/2006;31/10/2006;'FUNDACIO PRIVADA';319,27€;6.958,64 €;-2914;319,27;11.482,73 €;'sin fechas';31/10/2006;'FUNDACIO';'Ingresos';'Nomina';'FIJO'
30/10/2006;30/10/2006;'GASOLINA';-55,01€;6.903,63 €;-2913;-55,01;11.427,72 €;'sin fechas';30/10/2006;'GASOLINA';'Gastos_Ocio y transporte';'Gasolina';'VARIABLES'
30/10/2006;30/10/2006;'GASOLINA';-55,01€;6.848,62 €;-2912;-55,01;11.372,71 €;'sin fechas';30/10/2006;'GASOLINA';'Gastos_Ocio y transporte';'Gasolina';'VARIABLES'
30/10/2006;30/10/2006;'INFORMACIO I TECNOLOGIA DE CAT';1.274,31€;8.122,93 €;-2911;1.274,31;12.647,02 €;'sin fechas';30/10/2006;'INFORMACIO';'Ingresos';'Nomina';'FIJO'
30/10/2006;30/10/2006;'MERCADONA';-37,81€;8.085,12 €;-2910;-37,81;12.609,21 €;'sin fechas';30/10/2006;'MERCADONA';'Gastos_Compras';'Supermercado';'VARIABLES'
30/10/2006;30/10/2006;'PEAJE RUBI';-1,04€;8.084,08 €;-2909;-1,04;12.608,17 €;'sin fechas';30/10/2006;'PEAJE';'Gastos_Ocio y transporte';'Parking y peaje';'VARIABLES'
30/10/2006;30/10/2006;'PEAJE RUBI';-1,04€;8.083,04 €;-2908;-1,04;12.607,13 €;'sin fechas';30/10/2006;'PEAJE';'Gastos_Ocio y transporte';'Parking y peaje';'VARIABLES'
30/10/2006;30/10/2006;'PEAJE RUBI';-0,94€;8.082,10 €;-2907;-0,94;12.606,19 €;'sin fechas';30/10/2006;'PEAJE';'Gastos_Ocio y transporte';'Parking y peaje';'VARIABLES'
30/10/2006;30/10/2006;'PEAJE RUBI';-0,94€;8.081,16 €;-2906;-0,94;12.605,25 €;'sin fechas';30/10/2006;'PEAJE';'Gastos_Ocio y transporte';'Parking y peaje';'VARIABLES'
30/10/2006;30/10/2006;'PEAJE RUBI';-1,04€;8.080,12 €;-2905;-1,04;12.604,21 €;'sin fechas';30/10/2006;'PEAJE';'Gastos_Ocio y transporte';'Parking y peaje';'VARIABLES'
30/10/2006;30/10/2006;'REINT.CAJERO';-30,00€;8.050,12 €;-2904;-30,00;12.574,21 €;'sin fechas';30/10/2006;'REINTCAJERO';'Gastos_Gastos varios';'Efectivo';'VARIABLES'
30/10/2006;30/10/2006;'REINT.CAJERO';-30,00€;8.020,12 €;-2903;-30,00;12.544,21 €;'sin fechas';30/10/2006;'REINTCAJERO';'Gastos_Gastos varios';'Efectivo';'VARIABLES'
30/10/2006;30/10/2006;'REINT.CAJERO';-40,00€;7.980,12 €;-2902;-40,00;12.504,21 €;'sin fechas';30/10/2006;'REINTCAJERO';'Gastos_Gastos varios';'Efectivo';'VARIABLES'
30/10/2006;30/10/2006;'RESTAURANTES';-27,07€;7.953,05 €;-2901;-27,07;12.477,14 €;'sin fechas';30/10/2006;'RESTAURANTES';'Gastos_Ocio y transporte';'Restaurantes';'VARIABLES'
30/10/2006;30/10/2006;'RESTAURANTES';-27,07€;7.925,98 €;-2900;-27,07;12.450,07 €;'sin fechas';30/10/2006;'RESTAURANTES';'Gastos_Ocio y transporte';'Restaurantes';'VARIABLES'
31/10/2006;31/10/2006;'ANUL COMPRA';30,00€;7.955,98 €;-2899;30,00;12.480,07 €;'sin fechas';31/10/2006;'ANUL';'Gastos_Gastos varios';'Efectivo';'VARIABLES'
31/10/2006;31/10/2006;'ANUL COMPRA';27,07€;7.983,05 €;-2898;27,07;12.507,14 €;'sin fechas';31/10/2006;'ANUL';'Gastos_Gastos varios';'Efectivo';'VARIABLES'
31/10/2006;31/10/2006;'ANUL COMPRA';55,01€;8.038,06 €;-2897;55,01;12.562,15 €;'sin fechas';31/10/2006;'ANUL';'Gastos_Gastos varios';'Efectivo';'VARIABLES'
31/10/2006;31/10/2006;'ANUL COMPRA';86,97€;8.125,03 €;-2896;86,97;12.649,12 €;'sin fechas';31/10/2006;'ANUL';'Gastos_Gastos varios';'Efectivo';'VARIABLES'
31/10/2006;31/10/2006;'PEAJE RUBI';-0,94€;8.124,09 €;-2895;-0,94;12.648,18 €;'sin fechas';31/10/2006;'PEAJE';'Gastos_Ocio y transporte';'Parking y peaje';'VARIABLES'
31/10/2006;31/10/2006;'PEAJE RUBI';-1,04€;8.123,05 €;-2894;-1,04;12.647,14 €;'sin fechas';31/10/2006;'PEAJE';'Gastos_Ocio y transporte';'Parking y peaje';'VARIABLES'
31/10/2006;31/10/2006;'RECIBO PTMOS. 3061-0960001518';-636,06€;7.486,99 €;-2893;-636,06;12.011,08 €;'sin fechas';31/10/2006;'RECIBO';'Gastos_Banco y organismos';'Hipoteca';'FIJO'
01/11/2006;01/11/2006;'REINT.CAJERO';-40,00€;7.446,99 €;-2892;-40,00;11.971,08 €;'sin fechas';01/11/2006;'REINTCAJERO';'Gastos_Gastos varios';'Efectivo';'VARIABLES'
02/11/2006;02/11/2006;'CAFET.C T PRAT';-6,35€;7.440,64 €;-2891;-6,35;11.964,73 €;'sin fechas';02/11/2006;'CAFETC';'Gastos_Ocio y transporte';'Restaurantes';'VARIABLES'
02/11/2006;02/11/2006;'PEAJE RUBI';-1,04€;7.439,60 €;-2890;-1,04;11.963,69 €;'sin fechas';02/11/2006;'PEAJE';'Gastos_Ocio y transporte';'Parking y peaje';'VARIABLES'
02/11/2006;02/11/2006;'PEAJE RUBI';-1,04€;7.438,56 €;-2889;-1,04;11.962,65 €;'sin fechas';02/11/2006;'PEAJE';'Gastos_Ocio y transporte';'Parking y peaje';'VARIABLES'
02/11/2006;02/11/2006;'PEAJE RUBI';-1,04€;7.437,52 €;-2888;-1,04;11.961,61 €;'sin fechas';02/11/2006;'PEAJE';'Gastos_Ocio y transporte';'Parking y peaje';'VARIABLES'
02/11/2006;02/11/2006;'PEAJE RUBI';-1,04€;7.436,48 €;-2887;-1,04;11.960,57 €;'sin fechas';02/11/2006;'PEAJE';'Gastos_Ocio y transporte';'Parking y peaje';'VARIABLES'
02/11/2006;02/11/2006;'PEAJE RUBI';-0,94€;7.435,54 €;-2886;-0,94;11.959,63 €;'sin fechas';02/11/2006;'PEAJE';'Gastos_Ocio y transporte';'Parking y peaje';'VARIABLES'
03/11/2006;03/11/2006;'PEAJE VILANOVA';-4,69€;7.430,85 €;-2885;-4,69;11.954,94 €;'sin fechas';03/11/2006;'PEAJE';'Gastos_Ocio y transporte';'Parking y peaje';'VARIABLES'
04/11/2006;04/11/2006;'IKEA';-552,55€;6.878,30 €;-2884;-552,55;11.402,39 €;'sin fechas';04/11/2006;'IKEA';'Gastos_Vivienda y vehiculo';'Mnto. hogar';'VARIABLES'
04/11/2006;04/11/2006;'IKEA';-59,00€;6.819,30 €;-2883;-59,00;11.343,39 €;'sin fechas';04/11/2006;'IKEA';'Gastos_Vivienda y vehiculo';'Mnto. hogar';'VARIABLES'
04/11/2006;04/11/2006;'IKEA';-17,25€;6.802,05 €;-2882;-17,25;11.326,14 €;'sin fechas';04/11/2006;'IKEA';'Gastos_Vivienda y vehiculo';'Mnto. hogar';'VARIABLES'
05/11/2006;05/11/2006;'GASOLINA';-49,50€;6.752,55 €;-2881;-49,50;11.276,64 €;'sin fechas';05/11/2006;'GASOLINA';'Gastos_Ocio y transporte';'Gasolina';'VARIABLES'
06/11/2006;06/11/2006;'CAFET.C T PRAT';-1,35€;6.751,20 €;-2880;-1,35;11.275,29 €;'sin fechas';06/11/2006;'CAFETC';'Gastos_Ocio y transporte';'Restaurantes';'VARIABLES'
06/11/2006;06/11/2006;'FRANCE TELECOM';-16,82€;6.734,38 €;-2879;-16,82;11.258,47 €;'sin fechas';06/11/2006;'FRANCE';'Gastos_Servicios tipicos';'Telecomunicaciones';'FIJO'
07/11/2006;07/11/2006;'CAFET.C T PRAT';-1,50€;6.732,88 €;-2878;-1,50;11.256,97 €;'sin fechas';07/11/2006;'CAFETC';'Gastos_Ocio y transporte';'Restaurantes';'VARIABLES'
07/11/2006;07/11/2006;'GROUPAMA PLUS';-41,12€;6.691,76 €;-2877;-41,12;11.215,85 €;'sin fechas';07/11/2006;'GROUPAMA';'Gastos_Seguros';'Seguro salud';'FIJO'
07/11/2006;07/11/2006;'PEAJE RUBI';-0,94€;6.690,82 €;-2876;-0,94;11.214,91 €;'sin fechas';07/11/2006;'PEAJE';'Gastos_Ocio y transporte';'Parking y peaje';'VARIABLES'
07/11/2006;07/11/2006;'PEAJE RUBI';-0,94€;6.689,88 €;-2875;-0,94;11.213,97 €;'sin fechas';07/11/2006;'PEAJE';'Gastos_Ocio y transporte';'Parking y peaje';'VARIABLES'
08/11/2006;08/11/2006;'CAFET.C T PRAT';-1,65€;6.688,23 €;-2874;-1,65;11.212,32 €;'sin fechas';08/11/2006;'CAFETC';'Gastos_Ocio y transporte';'Restaurantes';'VARIABLES'
08/11/2006;08/11/2006;'CAFET.C T PRAT';-1,35€;6.686,88 €;-2873;-1,35;11.210,97 €;'sin fechas';08/11/2006;'CAFETC';'Gastos_Ocio y transporte';'Restaurantes';'VARIABLES'
08/11/2006;08/11/2006;'PEAJE RUBI';-1,04€;6.685,84 €;-2872;-1,04;11.209,93 €;'sin fechas';08/11/2006;'PEAJE';'Gastos_Ocio y transporte';'Parking y peaje';'VARIABLES'
08/11/2006;08/11/2006;'PEAJE RUBI';-1,04€;6.684,80 €;-2871;-1,04;11.208,89 €;'sin fechas';08/11/2006;'PEAJE';'Gastos_Ocio y transporte';'Parking y peaje';'VARIABLES'
10/11/2006;10/11/2006;'CAFET.C T PRAT';-2,15€;6.682,65 €;-2870;-2,15;11.206,74 €;'sin fechas';10/11/2006;'CAFETC';'Gastos_Ocio y transporte';'Restaurantes';'VARIABLES'
10/11/2006;10/11/2006;'GASOLINA';-20,00€;6.662,65 €;-2869;-20,00;11.186,74 €;'sin fechas';10/11/2006;'GASOLINA';'Gastos_Ocio y transporte';'Gasolina';'VARIABLES'
11/11/2006;11/11/2006;'PELUQUERIAS';-57,50€;6.605,15 €;-2868;-57,50;11.129,24 €;'sin fechas';11/11/2006;'PELUQUERIAS';'Gastos_Salud, saber y deporte';'Belleza';'VARIABLES'
11/11/2006;11/11/2006;'SABECO TORTOSA';-37,69€;6.567,46 €;-2867;-37,69;11.091,55 €;'sin fechas';11/11/2006;'SABECO';'Gastos_Compras';'Supermercado';'VARIABLES'
13/11/2006;13/11/2006;'CAFET.C T PRAT';-2,35€;6.565,11 €;-2866;-2,35;11.089,20 €;'sin fechas';13/11/2006;'CAFETC';'Gastos_Ocio y transporte';'Restaurantes';'VARIABLES'
13/11/2006;13/11/2006;'CAFET.C T PRAT';-1,35€;6.563,76 €;-2865;-1,35;11.087,85 €;'sin fechas';13/11/2006;'CAFETC';'Gastos_Ocio y transporte';'Restaurantes';'VARIABLES'
13/11/2006;13/11/2006;'GASOLINA';-50,00€;6.513,76 €;-2864;-50,00;11.037,85 €;'sin fechas';13/11/2006;'GASOLINA';'Gastos_Ocio y transporte';'Gasolina';'VARIABLES'
13/11/2006;13/11/2006;'PEAJE RUBI';-1,04€;6.512,72 €;-2863;-1,04;11.036,81 €;'sin fechas';13/11/2006;'PEAJE';'Gastos_Ocio y transporte';'Parking y peaje';'VARIABLES'
13/11/2006;13/11/2006;'PEAJE RUBI';-1,04€;6.511,68 €;-2862;-1,04;11.035,77 €;'sin fechas';13/11/2006;'PEAJE';'Gastos_Ocio y transporte';'Parking y peaje';'VARIABLES'
14/11/2006;14/11/2006;'CAFET.C T PRAT';-3,40€;6.508,28 €;-2861;-3,40;11.032,37 €;'sin fechas';14/11/2006;'CAFETC';'Gastos_Ocio y transporte';'Restaurantes';'VARIABLES'
14/11/2006;14/11/2006;'CAFET.C T PRAT';-1,35€;6.506,93 €;-2860;-1,35;11.031,02 €;'sin fechas';14/11/2006;'CAFETC';'Gastos_Ocio y transporte';'Restaurantes';'VARIABLES'
14/11/2006;14/11/2006;'PEAJE RUBI';-1,04€;6.505,89 €;-2859;-1,04;11.029,98 €;'sin fechas';14/11/2006;'PEAJE';'Gastos_Ocio y transporte';'Parking y peaje';'VARIABLES'
14/11/2006;14/11/2006;'PEAJE RUBI';-1,04€;6.504,85 €;-2858;-1,04;11.028,94 €;'sin fechas';14/11/2006;'PEAJE';'Gastos_Ocio y transporte';'Parking y peaje';'VARIABLES'
14/11/2006;14/11/2006;'PEAJE RUBI';-1,04€;6.503,81 €;-2857;-1,04;11.027,90 €;'sin fechas';14/11/2006;'PEAJE';'Gastos_Ocio y transporte';'Parking y peaje';'VARIABLES'
14/11/2006;14/11/2006;'PEAJE RUBI';-1,04€;6.502,77 €;-2856;-1,04;11.026,86 €;'sin fechas';14/11/2006;'PEAJE';'Gastos_Ocio y transporte';'Parking y peaje';'VARIABLES'
14/11/2006;14/11/2006;'PEAJE RUBI';-1,04€;6.501,73 €;-2855;-1,04;11.025,82 €;'sin fechas';14/11/2006;'PEAJE';'Gastos_Ocio y transporte';'Parking y peaje';'VARIABLES'
14/11/2006;14/11/2006;'PEAJE RUBI';-1,04€;6.500,69 €;-2854;-1,04;11.024,78 €;'sin fechas';14/11/2006;'PEAJE';'Gastos_Ocio y transporte';'Parking y peaje';'VARIABLES'
14/11/2006;14/11/2006;'PEAJE RUBI';-1,04€;6.499,65 €;-2853;-1,04;11.023,74 €;'sin fechas';14/11/2006;'PEAJE';'Gastos_Ocio y transporte';'Parking y peaje';'VARIABLES'
14/11/2006;14/11/2006;'PEAJE XERTA';-3,10€;6.496,55 €;-2852;-3,10;11.020,64 €;'sin fechas';14/11/2006;'PEAJE';'Gastos_Ocio y transporte';'Parking y peaje';'VARIABLES'
14/11/2006;14/11/2006;'PEAJE XERTA';-2,45€;6.494,10 €;-2851;-2,45;11.018,19 €;'sin fechas';14/11/2006;'PEAJE';'Gastos_Ocio y transporte';'Parking y peaje';'VARIABLES'
15/11/2006;15/11/2006;'CAFET.C T PRAT';-4,30€;6.489,80 €;-2850;-4,30;11.013,89 €;'sin fechas';15/11/2006;'CAFETC';'Gastos_Ocio y transporte';'Restaurantes';'VARIABLES'
15/11/2006;15/11/2006;'SEG.AM.HIPITEC';-32,66€;6.457,14 €;-2849;-32,66;10.981,23 €;'sin fechas';15/11/2006;'SEGAMHIPITEC';'Gastos_Seguros';'Seguro vida';'FIJO'
16/11/2006;16/11/2006;'CAFET.C T PRAT';-1,35€;6.455,79 €;-2848;-1,35;10.979,88 €;'sin fechas';16/11/2006;'CAFETC';'Gastos_Ocio y transporte';'Restaurantes';'VARIABLES'
16/11/2006;16/11/2006;'ENDESA DISTRIB';-52,01€;6.403,78 €;-2847;-52,01;10.927,87 €;'sin fechas';16/11/2006;'ENDESA';'Gastos_Servicios tipicos';'Electricidad';'FIJO'
18/11/2006;18/11/2006;'MERCADONA';-131,54€;6.272,24 €;-2846;-131,54;10.796,33 €;'sin fechas';18/11/2006;'MERCADONA';'Gastos_Compras';'Supermercado';'VARIABLES'
18/11/2006;18/11/2006;'REINT.CAJERO';-70,00€;6.202,24 €;-2845;-70,00;10.726,33 €;'sin fechas';18/11/2006;'REINTCAJERO';'Gastos_Gastos varios';'Efectivo';'VARIABLES'
20/11/2006;20/11/2006;'FARMACIA';-2,00€;6.200,24 €;-2844;-2,00;10.724,33 €;'sin fechas';20/11/2006;'FARMACIA';'Gastos_Salud, saber y deporte';'Farmacia';'VARIABLES'
20/11/2006;20/11/2006;'NOSTRUM';-5,45€;6.194,79 €;-2843;-5,45;10.718,88 €;'sin fechas';20/11/2006;'NOSTRUM';'Gastos_Ocio y transporte';'Restaurantes';'VARIABLES'
20/11/2006;20/11/2006;'PEAJE RUBI';-1,04€;6.193,75 €;-2842;-1,04;10.717,84 €;'sin fechas';20/11/2006;'PEAJE';'Gastos_Ocio y transporte';'Parking y peaje';'VARIABLES'
20/11/2006;20/11/2006;'PEAJE RUBI';-1,04€;6.192,71 €;-2841;-1,04;10.716,80 €;'sin fechas';20/11/2006;'PEAJE';'Gastos_Ocio y transporte';'Parking y peaje';'VARIABLES'
20/11/2006;20/11/2006;'PEAJE XERTA';-5,20€;6.187,51 €;-2840;-5,20;10.711,60 €;'sin fechas';20/11/2006;'PEAJE';'Gastos_Ocio y transporte';'Parking y peaje';'VARIABLES'
20/11/2006;20/11/2006;'PEAJE XERTA';-5,20€;6.182,31 €;-2839;-5,20;10.706,40 €;'sin fechas';20/11/2006;'PEAJE';'Gastos_Ocio y transporte';'Parking y peaje';'VARIABLES'
20/11/2006;20/11/2006;'REINT.CAJERO';-300,00€;5.882,31 €;-2838;-300,00;10.406,40 €;'sin fechas';20/11/2006;'REINTCAJERO';'Gastos_Gastos varios';'Efectivo';'VARIABLES'
20/11/2006;20/11/2006;'REINT.CAJERO';-300,00€;5.582,31 €;-2837;-300,00;10.106,40 €;'sin fechas';20/11/2006;'REINTCAJERO';'Gastos_Gastos varios';'Efectivo';'VARIABLES'
20/11/2006;20/11/2006;'REINT.CAJERO';-300,00€;5.282,31 €;-2836;-300,00;9.806,40 €;'sin fechas';20/11/2006;'REINTCAJERO';'Gastos_Gastos varios';'Efectivo';'VARIABLES'
20/11/2006;20/11/2006;'REINT.CAJERO';-100,00€;5.182,31 €;-2835;-100,00;9.706,40 €;'sin fechas';20/11/2006;'REINTCAJERO';'Gastos_Gastos varios';'Efectivo';'VARIABLES'
21/11/2006;21/11/2006;'PEAJE RUBI';-1,04€;5.181,27 €;-2834;-1,04;9.705,36 €;'sin fechas';21/11/2006;'PEAJE';'Gastos_Ocio y transporte';'Parking y peaje';'VARIABLES'
21/11/2006;21/11/2006;'PEAJE RUBI';-1,04€;5.180,23 €;-2833;-1,04;9.704,32 €;'sin fechas';21/11/2006;'PEAJE';'Gastos_Ocio y transporte';'Parking y peaje';'VARIABLES'
21/11/2006;21/11/2006;'PEAJE RUBI';-1,89€;5.178,34 €;-2832;-1,89;9.702,43 €;'sin fechas';21/11/2006;'PEAJE';'Gastos_Ocio y transporte';'Parking y peaje';'VARIABLES'
21/11/2006;21/11/2006;'PEAJE XERTA';-2,30€;5.176,04 €;-2831;-2,30;9.700,13 €;'sin fechas';21/11/2006;'PEAJE';'Gastos_Ocio y transporte';'Parking y peaje';'VARIABLES'
21/11/2006;21/11/2006;'PEAJE XERTA';-2,45€;5.173,59 €;-2830;-2,45;9.697,68 €;'sin fechas';21/11/2006;'PEAJE';'Gastos_Ocio y transporte';'Parking y peaje';'VARIABLES'
21/11/2006;21/11/2006;'PEAJE XERTA';-2,30€;5.171,29 €;-2829;-2,30;9.695,38 €;'sin fechas';21/11/2006;'PEAJE';'Gastos_Ocio y transporte';'Parking y peaje';'VARIABLES'
21/11/2006;21/11/2006;'PEAJE XERTA';-3,10€;5.168,19 €;-2828;-3,10;9.692,28 €;'sin fechas';21/11/2006;'PEAJE';'Gastos_Ocio y transporte';'Parking y peaje';'VARIABLES'
21/11/2006;21/11/2006;'REINT.CAJERO';-300,00€;4.868,19 €;-2827;-300,00;9.392,28 €;'sin fechas';21/11/2006;'REINTCAJERO';'Gastos_Gastos varios';'Efectivo';'VARIABLES'
21/11/2006;21/11/2006;'REINT.CAJERO';-100,00€;4.768,19 €;-2826;-100,00;9.292,28 €;'sin fechas';21/11/2006;'REINTCAJERO';'Gastos_Gastos varios';'Efectivo';'VARIABLES'
21/11/2006;21/11/2006;'REINT.CAJERO';-100,00€;4.668,19 €;-2825;-100,00;9.192,28 €;'sin fechas';21/11/2006;'REINTCAJERO';'Gastos_Gastos varios';'Efectivo';'VARIABLES'
22/11/2006;22/11/2006;'GASOLINA';-48,22€;4.619,97 €;-2824;-48,22;9.144,06 €;'sin fechas';22/11/2006;'GASOLINA';'Gastos_Ocio y transporte';'Gasolina';'VARIABLES'
22/11/2006;22/11/2006;'PEAJE RUBI';-1,04€;4.618,93 €;-2823;-1,04;9.143,02 €;'sin fechas';22/11/2006;'PEAJE';'Gastos_Ocio y transporte';'Parking y peaje';'VARIABLES'
22/11/2006;22/11/2006;'PEAJE RUBI';-1,04€;4.617,89 €;-2822;-1,04;9.141,98 €;'sin fechas';22/11/2006;'PEAJE';'Gastos_Ocio y transporte';'Parking y peaje';'VARIABLES'
22/11/2006;22/11/2006;'PEAJE RUBI';-1,04€;4.616,85 €;-2821;-1,04;9.140,94 €;'sin fechas';22/11/2006;'PEAJE';'Gastos_Ocio y transporte';'Parking y peaje';'VARIABLES'
22/11/2006;22/11/2006;'PEAJE RUBI';-1,04€;4.615,81 €;-2820;-1,04;9.139,90 €;'sin fechas';22/11/2006;'PEAJE';'Gastos_Ocio y transporte';'Parking y peaje';'VARIABLES'
22/11/2006;22/11/2006;'PEAJE RUBI';-1,04€;4.614,77 €;-2819;-1,04;9.138,86 €;'sin fechas';22/11/2006;'PEAJE';'Gastos_Ocio y transporte';'Parking y peaje';'VARIABLES'
22/11/2006;22/11/2006;'PEAJE RUBI';-1,04€;4.613,73 €;-2818;-1,04;9.137,82 €;'sin fechas';22/11/2006;'PEAJE';'Gastos_Ocio y transporte';'Parking y peaje';'VARIABLES'
23/11/2006;23/11/2006;'CAFET.C T PRAT';-1,35€;4.612,38 €;-2817;-1,35;9.136,47 €;'sin fechas';23/11/2006;'CAFETC';'Gastos_Ocio y transporte';'Restaurantes';'VARIABLES'
23/11/2006;23/11/2006;'FRANCE TELECOM';-10,44€;4.601,94 €;-2816;-10,44;9.126,03 €;'sin fechas';23/11/2006;'FRANCE';'Gastos_Servicios tipicos';'Telecomunicaciones';'FIJO'
23/11/2006;23/11/2006;'FRUITES I VERDURES';-9,11€;4.592,83 €;-2815;-9,11;9.116,92 €;'sin fechas';23/11/2006;'FRUITES';'Gastos_Compras';'Supermercado';'VARIABLES'
23/11/2006;23/11/2006;'ONO';-80,22€;4.512,61 €;-2814;-80,22;9.036,70 €;'sin fechas';23/11/2006;'ONO';'Gastos_Servicios tipicos';'Telecomunicaciones';'FIJO'
24/11/2006;24/11/2006;'PEAJE RUBI';-1,04€;4.511,57 €;-2813;-1,04;9.035,66 €;'sin fechas';24/11/2006;'PEAJE';'Gastos_Ocio y transporte';'Parking y peaje';'VARIABLES'
24/11/2006;24/11/2006;'PEAJE RUBI';-1,04€;4.510,53 €;-2812;-1,04;9.034,62 €;'sin fechas';24/11/2006;'PEAJE';'Gastos_Ocio y transporte';'Parking y peaje';'VARIABLES'
27/11/2006;27/11/2006;'FARMACIA';-20,75€;4.489,78 €;-2811;-20,75;9.013,87 €;'sin fechas';27/11/2006;'FARMACIA';'Gastos_Salud, saber y deporte';'Farmacia';'VARIABLES'
27/11/2006;27/11/2006;'IKEA';-7,85€;4.481,93 €;-2810;-7,85;9.006,02 €;'sin fechas';27/11/2006;'IKEA';'Gastos_Vivienda y vehiculo';'Mnto. hogar';'VARIABLES'
27/11/2006;27/11/2006;'IKEA';-43,01€;4.438,92 €;-2809;-43,01;8.963,01 €;'sin fechas';27/11/2006;'IKEA';'Gastos_Vivienda y vehiculo';'Mnto. hogar';'VARIABLES'
27/11/2006;27/11/2006;'IKEA';-9,60€;4.429,32 €;-2808;-9,60;8.953,41 €;'sin fechas';27/11/2006;'IKEA';'Gastos_Vivienda y vehiculo';'Mnto. hogar';'VARIABLES'
27/11/2006;27/11/2006;'REINT.CAJERO';-20,00€;4.409,32 €;-2807;-20,00;8.933,41 €;'sin fechas';27/11/2006;'REINTCAJERO';'Gastos_Gastos varios';'Efectivo';'VARIABLES'
28/11/2006;28/11/2006;'GASOLINA';-39,65€;4.369,67 €;-2806;-39,65;8.893,76 €;'sin fechas';28/11/2006;'GASOLINA';'Gastos_Ocio y transporte';'Gasolina';'VARIABLES'
28/11/2006;28/11/2006;'PEAJE RUBI';-0,99€;4.368,68 €;-2805;-0,99;8.892,77 €;'sin fechas';28/11/2006;'PEAJE';'Gastos_Ocio y transporte';'Parking y peaje';'VARIABLES'
28/11/2006;28/11/2006;'PEAJE RUBI';-1,04€;4.367,64 €;-2804;-1,04;8.891,73 €;'sin fechas';28/11/2006;'PEAJE';'Gastos_Ocio y transporte';'Parking y peaje';'VARIABLES'
29/11/2006;30/11/2006;'AGENCIA DE LA MICROEMPRESA';573,10€;4.940,74 €;-2803;573,10;9.464,83 €;'sin fechas';30/11/2006;'AGENCIA';'Ingresos';'Nomina';'FIJO'
29/11/2006;29/11/2006;'CAFET.C T PRAT';-2,00€;4.938,74 €;-2802;-2,00;9.462,83 €;'sin fechas';29/11/2006;'CAFETC';'Gastos_Ocio y transporte';'Restaurantes';'VARIABLES'
29/11/2006;29/11/2006;'CAFET.C T PRAT';-6,35€;4.932,39 €;-2801;-6,35;9.456,48 €;'sin fechas';29/11/2006;'CAFETC';'Gastos_Ocio y transporte';'Restaurantes';'VARIABLES'
29/11/2006;30/11/2006;'FUNDACIO PRIVADA';319,27€;5.251,66 €;-2800;319,27;9.775,75 €;'sin fechas';30/11/2006;'FUNDACIO';'Ingresos';'Nomina';'FIJO'
29/11/2006;29/11/2006;'INFORMACIO I TECNOLOGIA DE CAT';1.238,06€;6.489,72 €;-2799;1.238,06;11.013,81 €;'sin fechas';29/11/2006;'INFORMACIO';'Ingresos';'Nomina';'FIJO'
29/11/2006;29/11/2006;'PEAJE RUBI';-1,04€;6.488,68 €;-2798;-1,04;11.012,77 €;'sin fechas';29/11/2006;'PEAJE';'Gastos_Ocio y transporte';'Parking y peaje';'VARIABLES'
29/11/2006;29/11/2006;'PEAJE RUBI';-1,04€;6.487,64 €;-2797;-1,04;11.011,73 €;'sin fechas';29/11/2006;'PEAJE';'Gastos_Ocio y transporte';'Parking y peaje';'VARIABLES'
29/11/2006;29/11/2006;'PEAJE RUBI';-1,04€;6.486,60 €;-2796;-1,04;11.010,69 €;'sin fechas';29/11/2006;'PEAJE';'Gastos_Ocio y transporte';'Parking y peaje';'VARIABLES'
29/11/2006;29/11/2006;'PEAJE RUBI';-1,04€;6.485,56 €;-2795;-1,04;11.009,65 €;'sin fechas';29/11/2006;'PEAJE';'Gastos_Ocio y transporte';'Parking y peaje';'VARIABLES'
29/11/2006;29/11/2006;'REINT.CAJERO';-300,00€;6.185,56 €;-2794;-300,00;10.709,65 €;'sin fechas';29/11/2006;'REINTCAJERO';'Gastos_Gastos varios';'Efectivo';'VARIABLES'
30/11/2006;30/11/2006;'RECIBO PTMOS. 3061-0960001518';-636,06€;5.549,50 €;-2793;-636,06;10.073,59 €;'sin fechas';30/11/2006;'RECIBO';'Gastos_Banco y organismos';'Hipoteca';'FIJO'
04/12/2006;04/12/2006;'CAFET.C T PRAT';-1,70€;5.547,80 €;-2792;-1,70;10.071,89 €;'sin fechas';04/12/2006;'CAFETC';'Gastos_Ocio y transporte';'Restaurantes';'VARIABLES'
04/12/2006;04/12/2006;'CAFET.C T PRAT';-1,35€;5.546,45 €;-2791;-1,35;10.070,54 €;'sin fechas';04/12/2006;'CAFETC';'Gastos_Ocio y transporte';'Restaurantes';'VARIABLES'
04/12/2006;04/12/2006;'CARREFOUR-[comida]';-78,15€;5.468,30 €;-2790;-78,15;9.992,39 €;'sin fechas';04/12/2006;'CARREFOURCOMIDA';'Gastos_Compras';'Supermercado';'VARIABLES'
04/12/2006;04/12/2006;'FARMACIA';-11,63€;5.456,67 €;-2789;-11,63;9.980,76 €;'sin fechas';04/12/2006;'FARMACIA';'Gastos_Salud, saber y deporte';'Farmacia';'VARIABLES'
04/12/2006;04/12/2006;'PEAJE RUBI';-0,99€;5.455,68 €;-2788;-0,99;9.979,77 €;'sin fechas';04/12/2006;'PEAJE';'Gastos_Ocio y transporte';'Parking y peaje';'VARIABLES'
04/12/2006;04/12/2006;'PEAJE RUBI';-1,89€;5.453,79 €;-2787;-1,89;9.977,88 €;'sin fechas';04/12/2006;'PEAJE';'Gastos_Ocio y transporte';'Parking y peaje';'VARIABLES'
04/12/2006;04/12/2006;'PEAJE RUBI';-1,04€;5.452,75 €;-2786;-1,04;9.976,84 €;'sin fechas';04/12/2006;'PEAJE';'Gastos_Ocio y transporte';'Parking y peaje';'VARIABLES'
04/12/2006;04/12/2006;'PEAJE RUBI';-1,04€;5.451,71 €;-2785;-1,04;9.975,80 €;'sin fechas';04/12/2006;'PEAJE';'Gastos_Ocio y transporte';'Parking y peaje';'VARIABLES'
04/12/2006;04/12/2006;'PEAJE VILANOVA';-4,69€;5.447,02 €;-2784;-4,69;9.971,11 €;'sin fechas';04/12/2006;'PEAJE';'Gastos_Ocio y transporte';'Parking y peaje';'VARIABLES'
04/12/2006;04/12/2006;'PEAJE VILANOVA';-4,69€;5.442,33 €;-2783;-4,69;9.966,42 €;'sin fechas';04/12/2006;'PEAJE';'Gastos_Ocio y transporte';'Parking y peaje';'VARIABLES'
04/12/2006;04/12/2006;'RESTAURANTES';-32,90€;5.409,43 €;-2782;-32,90;9.933,52 €;'sin fechas';04/12/2006;'RESTAURANTES';'Gastos_Ocio y transporte';'Restaurantes';'VARIABLES'
05/12/2006;05/12/2006;'CAFET.C T PRAT';-3,70€;5.405,73 €;-2781;-3,70;9.929,82 €;'sin fechas';05/12/2006;'CAFETC';'Gastos_Ocio y transporte';'Restaurantes';'VARIABLES'
05/12/2006;05/12/2006;'CINE';-10,90€;5.394,83 €;-2780;-10,90;9.918,92 €;'sin fechas';05/12/2006;'CINE';'Gastos_Ocio y transporte';'Espectáculos';'VARIABLES'
05/12/2006;05/12/2006;'FRANCE TELECOM';-32,51€;5.362,32 €;-2779;-32,51;9.886,41 €;'sin fechas';05/12/2006;'FRANCE';'Gastos_Servicios tipicos';'Telecomunicaciones';'FIJO'
05/12/2006;05/12/2006;'GASOLINA';-38,59€;5.323,73 €;-2778;-38,59;9.847,82 €;'sin fechas';05/12/2006;'GASOLINA';'Gastos_Ocio y transporte';'Gasolina';'VARIABLES'
05/12/2006;05/12/2006;'PEAJE RUBI';-1,04€;5.322,69 €;-2777;-1,04;9.846,78 €;'sin fechas';05/12/2006;'PEAJE';'Gastos_Ocio y transporte';'Parking y peaje';'VARIABLES'
05/12/2006;05/12/2006;'PEAJE RUBI';-1,04€;5.321,65 €;-2776;-1,04;9.845,74 €;'sin fechas';05/12/2006;'PEAJE';'Gastos_Ocio y transporte';'Parking y peaje';'VARIABLES'
05/12/2006;05/12/2006;'PEAJE RUBI';-0,99€;5.320,66 €;-2775;-0,99;9.844,75 €;'sin fechas';05/12/2006;'PEAJE';'Gastos_Ocio y transporte';'Parking y peaje';'VARIABLES'
05/12/2006;05/12/2006;'PEAJE RUBI';-1,04€;5.319,62 €;-2774;-1,04;9.843,71 €;'sin fechas';05/12/2006;'PEAJE';'Gastos_Ocio y transporte';'Parking y peaje';'VARIABLES'
05/12/2006;05/12/2006;'PEAJE RUBI';-1,04€;5.318,58 €;-2773;-1,04;9.842,67 €;'sin fechas';05/12/2006;'PEAJE';'Gastos_Ocio y transporte';'Parking y peaje';'VARIABLES'
05/12/2006;05/12/2006;'PEAJE RUBI';-1,04€;5.317,54 €;-2772;-1,04;9.841,63 €;'sin fechas';05/12/2006;'PEAJE';'Gastos_Ocio y transporte';'Parking y peaje';'VARIABLES'
05/12/2006;05/12/2006;'REINT.CAJERO';-40,00€;5.277,54 €;-2771;-40,00;9.801,63 €;'sin fechas';05/12/2006;'REINTCAJERO';'Gastos_Gastos varios';'Efectivo';'VARIABLES'
07/12/2006;07/12/2006;'LEROY MERLIN';-7,75€;5.269,79 €;-2770;-7,75;9.793,88 €;'sin fechas';07/12/2006;'LEROY';'Gastos_Vivienda y vehiculo';'Mnto. hogar';'VARIABLES'
07/12/2006;07/12/2006;'REINT.CAJERO';-300,00€;4.969,79 €;-2769;-300,00;9.493,88 €;'sin fechas';07/12/2006;'REINTCAJERO';'Gastos_Gastos varios';'Efectivo';'VARIABLES'
07/12/2006;07/12/2006;'REINT.CAJERO';-300,00€;4.669,79 €;-2768;-300,00;9.193,88 €;'sin fechas';07/12/2006;'REINTCAJERO';'Gastos_Gastos varios';'Efectivo';'VARIABLES'
07/12/2006;07/12/2006;'REINT.CAJERO';-300,00€;4.369,79 €;-2767;-300,00;8.893,88 €;'sin fechas';07/12/2006;'REINTCAJERO';'Gastos_Gastos varios';'Efectivo';'VARIABLES'
07/12/2006;07/12/2006;'REINT.CAJERO';-300,00€;4.069,79 €;-2766;-300,00;8.593,88 €;'sin fechas';07/12/2006;'REINTCAJERO';'Gastos_Gastos varios';'Efectivo';'VARIABLES'
07/12/2006;07/12/2006;'REINT.CAJERO';-300,00€;3.769,79 €;-2765;-300,00;8.293,88 €;'sin fechas';07/12/2006;'REINTCAJERO';'Gastos_Gastos varios';'Efectivo';'VARIABLES'
07/12/2006;07/12/2006;'REINT.CAJERO';-100,00€;3.669,79 €;-2764;-100,00;8.193,88 €;'sin fechas';07/12/2006;'REINTCAJERO';'Gastos_Gastos varios';'Efectivo';'VARIABLES'
11/12/2006;11/12/2006;'BIJOU BRIGITTE S';-7,50€;3.662,29 €;-2763;-7,50;8.186,38 €;'sin fechas';11/12/2006;'BIJOU';'Gastos_Compras';'Ropa';'VARIABLES'
11/12/2006;11/12/2006;'BON PREU BARCELONA';-31,78€;3.630,51 €;-2762;-31,78;8.154,60 €;'sin fechas';11/12/2006;'BON';'Gastos_Compras';'Supermercado';'VARIABLES'
11/12/2006;11/12/2006;'BRICOKING TERRASSA';-12,15€;3.618,36 €;-2761;-12,15;8.142,45 €;'sin fechas';11/12/2006;'BRICOKING';'Gastos_Vivienda y vehiculo';'Mnto. hogar';'VARIABLES'
11/12/2006;11/12/2006;'CAFET.C T PRAT';-3,50€;3.614,86 €;-2760;-3,50;8.138,95 €;'sin fechas';11/12/2006;'CAFETC';'Gastos_Ocio y transporte';'Restaurantes';'VARIABLES'
11/12/2006;11/12/2006;'CAFET.C T PRAT';-1,35€;3.613,51 €;-2759;-1,35;8.137,60 €;'sin fechas';11/12/2006;'CAFETC';'Gastos_Ocio y transporte';'Restaurantes';'VARIABLES'
11/12/2006;11/12/2006;'CARREFOUR-[comida]';-48,04€;3.565,47 €;-2758;-48,04;8.089,56 €;'sin fechas';11/12/2006;'CARREFOURCOMIDA';'Gastos_Compras';'Supermercado';'VARIABLES'
11/12/2006;11/12/2006;'CINE';-13,60€;3.551,87 €;-2757;-13,60;8.075,96 €;'sin fechas';11/12/2006;'CINE';'Gastos_Ocio y transporte';'Espectáculos';'VARIABLES'
11/12/2006;11/12/2006;'GIFI';-64,50€;3.487,37 €;-2756;-64,50;8.011,46 €;'sin fechas';11/12/2006;'GIFI';'Gastos_Compras';'Hogar';'VARIABLES'
11/12/2006;11/12/2006;'M&S';-14,95€;3.472,42 €;-2755;-14,95;7.996,51 €;'sin fechas';11/12/2006;'MS';'Gastos_Compras';'Ropa';'VARIABLES'
11/12/2006;11/12/2006;'NOSTRUM';-5,45€;3.466,97 €;-2754;-5,45;7.991,06 €;'sin fechas';11/12/2006;'NOSTRUM';'Gastos_Ocio y transporte';'Restaurantes';'VARIABLES'
11/12/2006;11/12/2006;'PEAJE RUBI';-1,04€;3.465,93 €;-2753;-1,04;7.990,02 €;'sin fechas';11/12/2006;'PEAJE';'Gastos_Ocio y transporte';'Parking y peaje';'VARIABLES'
11/12/2006;11/12/2006;'PEAJE RUBI';-1,04€;3.464,89 €;-2752;-1,04;7.988,98 €;'sin fechas';11/12/2006;'PEAJE';'Gastos_Ocio y transporte';'Parking y peaje';'VARIABLES'
11/12/2006;11/12/2006;'PEAJE RUBI';-1,04€;3.463,85 €;-2751;-1,04;7.987,94 €;'sin fechas';11/12/2006;'PEAJE';'Gastos_Ocio y transporte';'Parking y peaje';'VARIABLES'
11/12/2006;11/12/2006;'PEAJE RUBI';-1,04€;3.462,81 €;-2750;-1,04;7.986,90 €;'sin fechas';11/12/2006;'PEAJE';'Gastos_Ocio y transporte';'Parking y peaje';'VARIABLES'
11/12/2006;11/12/2006;'REINT.CAJERO';-90,00€;3.372,81 €;-2749;-90,00;7.896,90 €;'sin fechas';11/12/2006;'REINTCAJERO';'Gastos_Gastos varios';'Efectivo';'VARIABLES'
11/12/2006;11/12/2006;'REINT.CAJERO';-50,00€;3.322,81 €;-2748;-50,00;7.846,90 €;'sin fechas';11/12/2006;'REINTCAJERO';'Gastos_Gastos varios';'Efectivo';'VARIABLES'
11/12/2006;11/12/2006;'RESTAURANTES';-8,55€;3.314,26 €;-2747;-8,55;7.838,35 €;'sin fechas';11/12/2006;'RESTAURANTES';'Gastos_Ocio y transporte';'Restaurantes';'VARIABLES'
11/12/2006;11/12/2006;'SUPER DE CARN TOT';-58,40€;3.255,86 €;-2746;-58,40;7.779,95 €;'sin fechas';11/12/2006;'SUPER';'Gastos_Compras';'Supermercado';'VARIABLES'
12/12/2006;12/12/2006;'CAFET.C T PRAT';-1,35€;3.254,51 €;-2745;-1,35;7.778,60 €;'sin fechas';12/12/2006;'CAFETC';'Gastos_Ocio y transporte';'Restaurantes';'VARIABLES'
12/12/2006;12/12/2006;'GASOLINA';-50,00€;3.204,51 €;-2744;-50,00;7.728,60 €;'sin fechas';12/12/2006;'GASOLINA';'Gastos_Ocio y transporte';'Gasolina';'VARIABLES'
12/12/2006;12/12/2006;'GROUPAMA PLUS';-41,12€;3.163,39 €;-2743;-41,12;7.687,48 €;'sin fechas';12/12/2006;'GROUPAMA';'Gastos_Seguros';'Seguro salud';'FIJO'
12/12/2006;12/12/2006;'PEAJE RUBI';-1,04€;3.162,35 €;-2742;-1,04;7.686,44 €;'sin fechas';12/12/2006;'PEAJE';'Gastos_Ocio y transporte';'Parking y peaje';'VARIABLES'
12/12/2006;12/12/2006;'PEAJE RUBI';-1,04€;3.161,31 €;-2741;-1,04;7.685,40 €;'sin fechas';12/12/2006;'PEAJE';'Gastos_Ocio y transporte';'Parking y peaje';'VARIABLES'
12/12/2006;12/12/2006;'REINT.CAJERO';-60,00€;3.101,31 €;-2740;-60,00;7.625,40 €;'sin fechas';12/12/2006;'REINTCAJERO';'Gastos_Gastos varios';'Efectivo';'VARIABLES'
12/12/2006;12/12/2006;'TRASF.CIT';85,00€;3.186,31 €;-2739;85,00;7.710,40 €;'sin fechas';12/12/2006;'TRASFCIT';'Ingresos';'Nomina';'FIJO'
13/12/2006;13/12/2006;'QUICUINA';-14,50€;3.171,81 €;-2738;-14,50;7.695,90 €;'sin fechas';13/12/2006;'QUICUINA';'Gastos_Compras';'Supermercado';'VARIABLES'
14/12/2006;14/12/2006;'FF.CC.GENERALITAT';-13,30€;3.158,51 €;-2737;-13,30;7.682,60 €;'sin fechas';14/12/2006;'FFCCGENERALITAT';'Gastos_Ocio y transporte';'Transporte';'VARIABLES'
14/12/2006;14/12/2006;'MERCADONA';-147,36€;3.011,15 €;-2736;-147,36;7.535,24 €;'sin fechas';14/12/2006;'MERCADONA';'Gastos_Compras';'Supermercado';'VARIABLES'
14/12/2006;14/12/2006;'NUBOL DOLC';-2,40€;3.008,75 €;-2735;-2,40;7.532,84 €;'sin fechas';14/12/2006;'NUBOL';'Gastos_Ocio y transporte';'Restaurantes';'VARIABLES'
14/12/2006;14/12/2006;'REINT.CAJERO';-60,00€;2.948,75 €;-2734;-60,00;7.472,84 €;'sin fechas';14/12/2006;'REINTCAJERO';'Gastos_Gastos varios';'Efectivo';'VARIABLES'
14/12/2006;14/12/2006;'SUSCRIP. FONDO';-1.000,00€;1.948,75 €;-2733;-1.000,00;6.472,84 €;'sin fechas';14/12/2006;'SUSCRIP';'Gastos_Gastos varios';'Transferencias';'VARIABLES'
15/12/2006;15/12/2006;'CAFET.C T PRAT';-1,95€;1.946,80 €;-2732;-1,95;6.470,89 €;'sin fechas';15/12/2006;'CAFETC';'Gastos_Ocio y transporte';'Restaurantes';'VARIABLES'
15/12/2006;15/12/2006;'SEG.AM.HIPITEC';-32,61€;1.914,19 €;-2731;-32,61;6.438,28 €;'sin fechas';15/12/2006;'SEGAMHIPITEC';'Gastos_Seguros';'Seguro vida';'FIJO'
18/12/2006;18/12/2006;'CARREFOUR-[comida]';-51,35€;1.862,84 €;-2730;-51,35;6.386,93 €;'sin fechas';18/12/2006;'CARREFOURCOMIDA';'Gastos_Compras';'Supermercado';'VARIABLES'
18/12/2006;18/12/2006;'GASOLINA';-36,80€;1.826,04 €;-2729;-36,80;6.350,13 €;'sin fechas';18/12/2006;'GASOLINA';'Gastos_Ocio y transporte';'Gasolina';'VARIABLES'
18/12/2006;18/12/2006;'INFORMACIO I TECNOLOGIA DE CAT';1.394,43€;3.220,47 €;-2728;1.394,43;7.744,56 €;'sin fechas';18/12/2006;'INFORMACIO';'Ingresos';'Nomina';'FIJO'
18/12/2006;18/12/2006;'JUCLA';-212,00€;3.008,47 €;-2727;-212,00;7.532,56 €;'sin fechas';18/12/2006;'JUCLA';'Gastos_Compras';'Ropa';'VARIABLES'
18/12/2006;18/12/2006;'JUCLA';-212,00€;2.796,47 €;-2726;-212,00;7.320,56 €;'sin fechas';18/12/2006;'JUCLA';'Gastos_Compras';'Ropa';'VARIABLES'
18/12/2006;18/12/2006;'KUROKAI';-60,97€;2.735,50 €;-2725;-60,97;7.259,59 €;'sin fechas';18/12/2006;'KUROKAI';'Gastos_Compras';'Ropa';'VARIABLES'
18/12/2006;18/12/2006;'PASTIS.ROURA';-14,88€;2.720,62 €;-2724;-14,88;7.244,71 €;'sin fechas';18/12/2006;'PASTISROURA';'Gastos_Compras';'Supermercado';'VARIABLES'
18/12/2006;18/12/2006;'PEAJE RUBI';-1,04€;2.719,58 €;-2723;-1,04;7.243,67 €;'sin fechas';18/12/2006;'PEAJE';'Gastos_Ocio y transporte';'Parking y peaje';'VARIABLES'
18/12/2006;18/12/2006;'PEAJE RUBI';-1,04€;2.718,54 €;-2722;-1,04;7.242,63 €;'sin fechas';18/12/2006;'PEAJE';'Gastos_Ocio y transporte';'Parking y peaje';'VARIABLES'
18/12/2006;18/12/2006;'REINT.CAJERO';212,00€;2.930,54 €;-2721;212,00;7.454,63 €;'sin fechas';18/12/2006;'REINTCAJERO';'Gastos_Gastos varios';'Efectivo';'VARIABLES'
18/12/2006;18/12/2006;'SUPER DE CARN TOT';-11,88€;2.918,66 €;-2720;-11,88;7.442,75 €;'sin fechas';18/12/2006;'SUPER';'Gastos_Compras';'Supermercado';'VARIABLES'
19/12/2006;19/12/2006;'NOSTRUM';-5,95€;2.912,71 €;-2719;-5,95;7.436,80 €;'sin fechas';19/12/2006;'NOSTRUM';'Gastos_Ocio y transporte';'Restaurantes';'VARIABLES'
19/12/2006;19/12/2006;'PEAJE RUBI';-1,04€;2.911,67 €;-2718;-1,04;7.435,76 €;'sin fechas';19/12/2006;'PEAJE';'Gastos_Ocio y transporte';'Parking y peaje';'VARIABLES'
19/12/2006;19/12/2006;'PEAJE RUBI';-1,04€;2.910,63 €;-2717;-1,04;7.434,72 €;'sin fechas';19/12/2006;'PEAJE';'Gastos_Ocio y transporte';'Parking y peaje';'VARIABLES'
19/12/2006;19/12/2006;'PEAJE RUBI';-1,04€;2.909,59 €;-2716;-1,04;7.433,68 €;'sin fechas';19/12/2006;'PEAJE';'Gastos_Ocio y transporte';'Parking y peaje';'VARIABLES'
19/12/2006;19/12/2006;'PEAJE RUBI';-1,04€;2.908,55 €;-2715;-1,04;7.432,64 €;'sin fechas';19/12/2006;'PEAJE';'Gastos_Ocio y transporte';'Parking y peaje';'VARIABLES'
19/12/2006;19/12/2006;'PEAJE RUBI';-1,04€;2.907,51 €;-2714;-1,04;7.431,60 €;'sin fechas';19/12/2006;'PEAJE';'Gastos_Ocio y transporte';'Parking y peaje';'VARIABLES'
19/12/2006;19/12/2006;'PEAJE RUBI';-1,04€;2.906,47 €;-2713;-1,04;7.430,56 €;'sin fechas';19/12/2006;'PEAJE';'Gastos_Ocio y transporte';'Parking y peaje';'VARIABLES'
20/12/2006;20/12/2006;'GAS NATURAL';-206,85€;2.699,62 €;-2712;-206,85;7.223,71 €;'sin fechas';20/12/2006;'GAS';'Gastos_Servicios tipicos';'Gas';'FIJO'
20/12/2006;20/12/2006;'REINT.CAJERO';-40,00€;2.659,62 €;-2711;-40,00;7.183,71 €;'sin fechas';20/12/2006;'REINTCAJERO';'Gastos_Gastos varios';'Efectivo';'VARIABLES'
21/12/2006;21/12/2006;'CAFET.C T PRAT';-2,50€;2.657,12 €;-2710;-2,50;7.181,21 €;'sin fechas';21/12/2006;'CAFETC';'Gastos_Ocio y transporte';'Restaurantes';'VARIABLES'
22/12/2006;22/12/2006;'ONO';-67,52€;2.589,60 €;-2709;-67,52;7.113,69 €;'sin fechas';22/12/2006;'ONO';'Gastos_Servicios tipicos';'Telecomunicaciones';'FIJO'
22/12/2006;22/12/2006;'PEAJE RUBI';-1,04€;2.588,56 €;-2708;-1,04;7.112,65 €;'sin fechas';22/12/2006;'PEAJE';'Gastos_Ocio y transporte';'Parking y peaje';'VARIABLES'
22/12/2006;22/12/2006;'PEAJE RUBI';-1,04€;2.587,52 €;-2707;-1,04;7.111,61 €;'sin fechas';22/12/2006;'PEAJE';'Gastos_Ocio y transporte';'Parking y peaje';'VARIABLES'
22/12/2006;22/12/2006;'PEAJE RUBI';-1,89€;2.585,63 €;-2706;-1,89;7.109,72 €;'sin fechas';22/12/2006;'PEAJE';'Gastos_Ocio y transporte';'Parking y peaje';'VARIABLES'
26/12/2006;26/12/2006;'AGENCIA DE LA MICROEMPRESA';585,53€;3.171,16 €;-2705;585,53;7.695,25 €;'sin fechas';26/12/2006;'AGENCIA';'Ingresos';'Nomina';'FIJO'
26/12/2006;26/12/2006;'FRANCE TELECOM';-14,09€;3.157,07 €;-2704;-14,09;7.681,16 €;'sin fechas';26/12/2006;'FRANCE';'Gastos_Servicios tipicos';'Telecomunicaciones';'FIJO'
26/12/2006;26/12/2006;'GASOLINA';-40,00€;3.117,07 €;-2703;-40,00;7.641,16 €;'sin fechas';26/12/2006;'GASOLINA';'Gastos_Ocio y transporte';'Gasolina';'VARIABLES'
26/12/2006;26/12/2006;'MINA PUBLICA DE LA CIUTAT';-19,67€;3.097,40 €;-2702;-19,67;7.621,49 €;'sin fechas';26/12/2006;'MINA';'Gastos_Servicios tipicos';'Agua';'FIJO'
26/12/2006;26/12/2006;'PEAJE RUBI';-1,04€;3.096,36 €;-2701;-1,04;7.620,45 €;'sin fechas';26/12/2006;'PEAJE';'Gastos_Ocio y transporte';'Parking y peaje';'VARIABLES'
26/12/2006;26/12/2006;'PEAJE RUBI';-1,04€;3.095,32 €;-2700;-1,04;7.619,41 €;'sin fechas';26/12/2006;'PEAJE';'Gastos_Ocio y transporte';'Parking y peaje';'VARIABLES'
26/12/2006;26/12/2006;'PEAJE RUBI';-1,89€;3.093,43 €;-2699;-1,89;7.617,52 €;'sin fechas';26/12/2006;'PEAJE';'Gastos_Ocio y transporte';'Parking y peaje';'VARIABLES'
26/12/2006;26/12/2006;'REINT.CAJERO';-40,00€;3.053,43 €;-2698;-40,00;7.577,52 €;'sin fechas';26/12/2006;'REINTCAJERO';'Gastos_Gastos varios';'Efectivo';'VARIABLES'
26/12/2006;26/12/2006;'REINT.CAJERO';-70,00€;2.983,43 €;-2697;-70,00;7.507,52 €;'sin fechas';26/12/2006;'REINTCAJERO';'Gastos_Gastos varios';'Efectivo';'VARIABLES'
26/12/2006;26/12/2006;'SUPER DE CARN TOT';-50,74€;2.932,69 €;-2696;-50,74;7.456,78 €;'sin fechas';26/12/2006;'SUPER';'Gastos_Compras';'Supermercado';'VARIABLES'
27/12/2006;27/12/2006;'BRICOKING TERRASSA';-35,85€;2.896,84 €;-2695;-35,85;7.420,93 €;'sin fechas';27/12/2006;'BRICOKING';'Gastos_Vivienda y vehiculo';'Mnto. hogar';'VARIABLES'
27/12/2006;27/12/2006;'CARREFOUR-[comida]';-13,40€;2.883,44 €;-2694;-13,40;7.407,53 €;'sin fechas';27/12/2006;'CARREFOURCOMIDA';'Gastos_Compras';'Supermercado';'VARIABLES'
27/12/2006;27/12/2006;'CINE';-9,60€;2.873,84 €;-2693;-9,60;7.397,93 €;'sin fechas';27/12/2006;'CINE';'Gastos_Ocio y transporte';'Espectáculos';'VARIABLES'
27/12/2006;27/12/2006;'CORONEL TAPIOCA';-29,50€;2.844,34 €;-2692;-29,50;7.368,43 €;'sin fechas';27/12/2006;'CORONEL';'Gastos_Compras';'Ropa';'VARIABLES'
27/12/2006;27/12/2006;'MEDIA MARKT';-169,70€;2.674,64 €;-2691;-169,70;7.198,73 €;'sin fechas';27/12/2006;'MEDIA';'Gastos_Compras';'Hobbys';'VARIABLES'
27/12/2006;27/12/2006;'PEAJE RUBI';-1,04€;2.673,60 €;-2690;-1,04;7.197,69 €;'sin fechas';27/12/2006;'PEAJE';'Gastos_Ocio y transporte';'Parking y peaje';'VARIABLES'
27/12/2006;27/12/2006;'PEAJE RUBI';-1,04€;2.672,56 €;-2689;-1,04;7.196,65 €;'sin fechas';27/12/2006;'PEAJE';'Gastos_Ocio y transporte';'Parking y peaje';'VARIABLES'
27/12/2006;27/12/2006;'PEAJE RUBI';-1,04€;2.671,52 €;-2688;-1,04;7.195,61 €;'sin fechas';27/12/2006;'PEAJE';'Gastos_Ocio y transporte';'Parking y peaje';'VARIABLES'
27/12/2006;27/12/2006;'PEAJE RUBI';-1,04€;2.670,48 €;-2687;-1,04;7.194,57 €;'sin fechas';27/12/2006;'PEAJE';'Gastos_Ocio y transporte';'Parking y peaje';'VARIABLES'
27/12/2006;27/12/2006;'PEAJE RUBI';-1,04€;2.669,44 €;-2686;-1,04;7.193,53 €;'sin fechas';27/12/2006;'PEAJE';'Gastos_Ocio y transporte';'Parking y peaje';'VARIABLES'
27/12/2006;27/12/2006;'PEAJE RUBI';-1,04€;2.668,40 €;-2685;-1,04;7.192,49 €;'sin fechas';27/12/2006;'PEAJE';'Gastos_Ocio y transporte';'Parking y peaje';'VARIABLES'
27/12/2006;27/12/2006;'RESTAURANTES';-13,60€;2.654,80 €;-2684;-13,60;7.178,89 €;'sin fechas';27/12/2006;'RESTAURANTES';'Gastos_Ocio y transporte';'Restaurantes';'VARIABLES'
28/12/2006;28/12/2006;'AJUNTAMENT DE TERRASSA';-33,43€;2.621,37 €;-2683;-33,43;7.145,46 €;'sin fechas';28/12/2006;'AJUNTAMENT';'Gastos_Banco y organismos';'Ayuntamiento';'FIJO'
28/12/2006;28/12/2006;'IKEA';-176,19€;2.445,18 €;-2682;-176,19;6.969,27 €;'sin fechas';28/12/2006;'IKEA';'Gastos_Vivienda y vehiculo';'Mnto. hogar';'VARIABLES'
28/12/2006;28/12/2006;'INFORMACIO I TECNOLOGIA DE CAT';1.274,31€;3.719,49 €;-2681;1.274,31;8.243,58 €;'sin fechas';28/12/2006;'INFORMACIO';'Ingresos';'Nomina';'FIJO'
29/12/2006;29/12/2006;'CASER HOGAR';-227,12€;3.492,37 €;-2680;-227,12;8.016,46 €;'sin fechas';29/12/2006;'CASER';'Ingresos';'Transferencias';'VARIABLES'
29/12/2006;29/12/2006;'GASOLINA';-30,00€;3.462,37 €;-2679;-30,00;7.986,46 €;'sin fechas';29/12/2006;'GASOLINA';'Gastos_Ocio y transporte';'Gasolina';'VARIABLES'
29/12/2006;29/12/2006;'PORTAVENTURA';-9,45€;3.452,92 €;-2678;-9,45;7.977,01 €;'sin fechas';29/12/2006;'PORTAVENTURA';'Gastos_Ocio y transporte';'Vacaciones';'VARIABLES'
02/01/2007;02/01/2007;'CAFET.C T PRAT';-2,45€;3.450,47 €;-2677;-2,45;7.974,56 €;'sin fechas';02/01/2007;'CAFETC';'Gastos_Ocio y transporte';'Restaurantes';'VARIABLES'
02/01/2007;02/01/2007;'GASOLINA';-29,27€;3.421,20 €;-2676;-29,27;7.945,29 €;'sin fechas';02/01/2007;'GASOLINA';'Gastos_Ocio y transporte';'Gasolina';'VARIABLES'
02/01/2007;30/12/2006;'GIFI';-19,00€;3.402,20 €;-2675;-19,00;7.926,29 €;'sin fechas';30/12/2006;'GIFI';'Gastos_Compras';'Hogar';'VARIABLES'
02/01/2007;02/01/2007;'PEAJE RUBI';-1,04€;3.401,16 €;-2674;-1,04;7.925,25 €;'sin fechas';02/01/2007;'PEAJE';'Gastos_Ocio y transporte';'Parking y peaje';'VARIABLES'
02/01/2007;02/01/2007;'PEAJE RUBI';-1,04€;3.400,12 €;-2673;-1,04;7.924,21 €;'sin fechas';02/01/2007;'PEAJE';'Gastos_Ocio y transporte';'Parking y peaje';'VARIABLES'
02/01/2007;02/01/2007;'PEAJE RUBI';-1,04€;3.399,08 €;-2672;-1,04;7.923,17 €;'sin fechas';02/01/2007;'PEAJE';'Gastos_Ocio y transporte';'Parking y peaje';'VARIABLES'
02/01/2007;02/01/2007;'PEAJE RUBI';-1,04€;3.398,04 €;-2671;-1,04;7.922,13 €;'sin fechas';02/01/2007;'PEAJE';'Gastos_Ocio y transporte';'Parking y peaje';'VARIABLES'
02/01/2007;31/12/2006;'RECIBO PTMOS. 3061-0960001518';-636,06€;2.761,98 €;-2670;-636,06;7.286,07 €;'sin fechas';31/12/2006;'RECIBO';'Gastos_Banco y organismos';'Hipoteca';'FIJO'
02/01/2007;30/12/2006;'RESTAURANTES';-17,20€;2.744,78 €;-2669;-17,20;7.268,87 €;'sin fechas';30/12/2006;'RESTAURANTES';'Gastos_Ocio y transporte';'Restaurantes';'VARIABLES'
03/01/2007;03/01/2007;'CAFET.C T PRAT';-2,45€;2.742,33 €;-2668;-2,45;7.266,42 €;'sin fechas';03/01/2007;'CAFETC';'Gastos_Ocio y transporte';'Restaurantes';'VARIABLES'
03/01/2007;31/12/2006;'FUNDACIO PRIVADA';319,27€;3.061,60 €;-2667;319,27;7.585,69 €;'sin fechas';31/12/2006;'FUNDACIO';'Ingresos';'Nomina';'FIJO'
03/01/2007;03/01/2007;'PEAJE XERTA';-2,45€;3.059,15 €;-2666;-2,45;7.583,24 €;'sin fechas';03/01/2007;'PEAJE';'Gastos_Ocio y transporte';'Parking y peaje';'VARIABLES'
03/01/2007;03/01/2007;'PEAJE XERTA';-3,10€;3.056,05 €;-2665;-3,10;7.580,14 €;'sin fechas';03/01/2007;'PEAJE';'Gastos_Ocio y transporte';'Parking y peaje';'VARIABLES'
03/01/2007;03/01/2007;'PEAJE XERTA';-2,30€;3.053,75 €;-2664;-2,30;7.577,84 €;'sin fechas';03/01/2007;'PEAJE';'Gastos_Ocio y transporte';'Parking y peaje';'VARIABLES'
03/01/2007;02/01/2007;'SUSCRIP. FONDO';-150,00€;2.903,75 €;-2663;-150,00;7.427,84 €;'sin fechas';02/01/2007;'SUSCRIP';'Gastos_Gastos varios';'Transferencias';'VARIABLES'
04/01/2007;04/01/2007;'FRANCE TELECOM';-17,41€;2.886,34 €;-2662;-17,41;7.410,43 €;'sin fechas';04/01/2007;'FRANCE';'Gastos_Servicios tipicos';'Telecomunicaciones';'FIJO'
07/01/2007;07/01/2007;'RESTAURANTES';-22,70€;2.863,64 €;-2661;-22,70;7.387,73 €;'sin fechas';07/01/2007;'RESTAURANTES';'Gastos_Ocio y transporte';'Restaurantes';'VARIABLES'
08/01/2007;08/01/2007;'FF.CC.GENERALITAT';-19,00€;2.844,64 €;-2660;-19,00;7.368,73 €;'sin fechas';08/01/2007;'FFCCGENERALITAT';'Gastos_Ocio y transporte';'Transporte';'VARIABLES'
08/01/2007;08/01/2007;'PEAJE RUBI';-1,04€;2.843,60 €;-2659;-1,04;7.367,69 €;'sin fechas';08/01/2007;'PEAJE';'Gastos_Ocio y transporte';'Parking y peaje';'VARIABLES'
08/01/2007;08/01/2007;'PEAJE RUBI';-1,04€;2.842,56 €;-2658;-1,04;7.366,65 €;'sin fechas';08/01/2007;'PEAJE';'Gastos_Ocio y transporte';'Parking y peaje';'VARIABLES'
09/01/2007;09/01/2007;'MERCADONA';-87,05€;2.755,51 €;-2657;-87,05;7.279,60 €;'sin fechas';09/01/2007;'MERCADONA';'Gastos_Compras';'Supermercado';'VARIABLES'
09/01/2007;09/01/2007;'PEAJE RUBI';-1,08€;2.754,43 €;-2656;-1,08;7.278,52 €;'sin fechas';09/01/2007;'PEAJE';'Gastos_Ocio y transporte';'Parking y peaje';'VARIABLES'
09/01/2007;09/01/2007;'PEAJE RUBI';-1,08€;2.753,35 €;-2655;-1,08;7.277,44 €;'sin fechas';09/01/2007;'PEAJE';'Gastos_Ocio y transporte';'Parking y peaje';'VARIABLES'
12/01/2007;12/01/2007;'REINT.CAJERO';-40,00€;2.713,35 €;-2654;-40,00;7.237,44 €;'sin fechas';12/01/2007;'REINTCAJERO';'Gastos_Gastos varios';'Efectivo';'VARIABLES'
13/01/2007;13/01/2007;'M&S';-56,70€;2.656,65 €;-2653;-56,70;7.180,74 €;'sin fechas';13/01/2007;'MS';'Gastos_Compras';'Ropa';'VARIABLES'
13/01/2007;13/01/2007;'SUPER DE CARN TOT';-56,05€;2.600,60 €;-2652;-56,05;7.124,69 €;'sin fechas';13/01/2007;'SUPER';'Gastos_Compras';'Supermercado';'VARIABLES'
14/01/2007;14/01/2007;'CARREFOUR-[comida]';-39,80€;2.560,80 €;-2651;-39,80;7.084,89 €;'sin fechas';14/01/2007;'CARREFOURCOMIDA';'Gastos_Compras';'Supermercado';'VARIABLES'
14/01/2007;14/01/2007;'DECATHLON';-208,45€;2.352,35 €;-2650;-208,45;6.876,44 €;'sin fechas';14/01/2007;'DECATHLON';'Gastos_Compras';'Deportivo';'VARIABLES'
14/01/2007;14/01/2007;'EL CORTE INGLES';-80,00€;2.272,35 €;-2649;-80,00;6.796,44 €;'sin fechas';14/01/2007;'CORTE';'Gastos_Compras';'Supermercado';'VARIABLES'
14/01/2007;14/01/2007;'EL CORTE INGLES';-80,00€;2.192,35 €;-2648;-80,00;6.716,44 €;'sin fechas';14/01/2007;'CORTE';'Gastos_Compras';'Supermercado';'VARIABLES'
14/01/2007;14/01/2007;'KUROKAI';-151,91€;2.040,44 €;-2647;-151,91;6.564,53 €;'sin fechas';14/01/2007;'KUROKAI';'Gastos_Compras';'Ropa';'VARIABLES'
14/01/2007;14/01/2007;'OPER. S.E.P. EL CORTE INGLES';80,00€;2.120,44 €;-2646;80,00;6.644,53 €;'sin fechas';14/01/2007;'OPER';'Gastos_Compras';'Ropa';'VARIABLES'
15/01/2007;15/01/2007;'ENDESA DISTRIB';-59,45€;2.060,99 €;-2645;-59,45;6.585,08 €;'sin fechas';15/01/2007;'ENDESA';'Gastos_Servicios tipicos';'Electricidad';'FIJO'
15/01/2007;15/01/2007;'REINT.CAJERO';-40,00€;2.020,99 €;-2644;-40,00;6.545,08 €;'sin fechas';15/01/2007;'REINTCAJERO';'Gastos_Gastos varios';'Efectivo';'VARIABLES'
16/01/2007;16/01/2007;'GASOLINA';-38,62€;1.982,37 €;-2643;-38,62;6.506,46 €;'sin fechas';16/01/2007;'GASOLINA';'Gastos_Ocio y transporte';'Gasolina';'VARIABLES'
17/01/2007;17/01/2007;'CINE';-9,60€;1.972,77 €;-2642;-9,60;6.496,86 €;'sin fechas';17/01/2007;'CINE';'Gastos_Ocio y transporte';'Espectáculos';'VARIABLES'
17/01/2007;17/01/2007;'SEG.AM.HIPITEC';-32,54€;1.940,23 €;-2641;-32,54;6.464,32 €;'sin fechas';17/01/2007;'SEGAMHIPITEC';'Gastos_Seguros';'Seguro vida';'FIJO'
18/01/2007;18/01/2007;'QUICUINA';-7,40€;1.932,83 €;-2640;-7,40;6.456,92 €;'sin fechas';18/01/2007;'QUICUINA';'Gastos_Compras';'Supermercado';'VARIABLES'
18/01/2007;18/01/2007;'REINT.CAJERO';-60,00€;1.872,83 €;-2639;-60,00;6.396,92 €;'sin fechas';18/01/2007;'REINTCAJERO';'Gastos_Gastos varios';'Efectivo';'VARIABLES'
18/01/2007;17/01/2007;'RESTAURANTES';-11,75€;1.861,08 €;-2638;-11,75;6.385,17 €;'sin fechas';17/01/2007;'RESTAURANTES';'Gastos_Ocio y transporte';'Restaurantes';'VARIABLES'
19/01/2007;19/01/2007;'ONO';-67,00€;1.794,08 €;-2637;-67,00;6.318,17 €;'sin fechas';19/01/2007;'ONO';'Gastos_Servicios tipicos';'Telecomunicaciones';'FIJO'
22/01/2007;22/01/2007;'FF.CC.GENERALITAT';-13,80€;1.780,28 €;-2636;-13,80;6.304,37 €;'sin fechas';22/01/2007;'FFCCGENERALITAT';'Gastos_Ocio y transporte';'Transporte';'VARIABLES'
22/01/2007;15/01/2007;'PEAJE RUBI';-1,08€;1.779,20 €;-2635;-1,08;6.303,29 €;'sin fechas';15/01/2007;'PEAJE';'Gastos_Ocio y transporte';'Parking y peaje';'VARIABLES'
22/01/2007;15/01/2007;'PEAJE RUBI';-1,08€;1.778,12 €;-2634;-1,08;6.302,21 €;'sin fechas';15/01/2007;'PEAJE';'Gastos_Ocio y transporte';'Parking y peaje';'VARIABLES'
23/01/2007;23/01/2007;'CAFET.C T PRAT';-1,55€;1.776,57 €;-2633;-1,55;6.300,66 €;'sin fechas';23/01/2007;'CAFETC';'Gastos_Ocio y transporte';'Restaurantes';'VARIABLES'
23/01/2007;23/01/2007;'GASOLINA';-38,59€;1.737,98 €;-2632;-38,59;6.262,07 €;'sin fechas';23/01/2007;'GASOLINA';'Gastos_Ocio y transporte';'Gasolina';'VARIABLES'
23/01/2007;17/01/2007;'PEAJE RUBI';-1,08€;1.736,90 €;-2631;-1,08;6.260,99 €;'sin fechas';17/01/2007;'PEAJE';'Gastos_Ocio y transporte';'Parking y peaje';'VARIABLES'
23/01/2007;17/01/2007;'PEAJE RUBI';-1,08€;1.735,82 €;-2630;-1,08;6.259,91 €;'sin fechas';17/01/2007;'PEAJE';'Gastos_Ocio y transporte';'Parking y peaje';'VARIABLES'
23/01/2007;18/01/2007;'PEAJE RUBI';-1,08€;1.734,74 €;-2629;-1,08;6.258,83 €;'sin fechas';18/01/2007;'PEAJE';'Gastos_Ocio y transporte';'Parking y peaje';'VARIABLES'
23/01/2007;18/01/2007;'REINT.CAJERO';-2,50€;1.732,24 €;-2628;-2,50;6.256,33 €;'sin fechas';18/01/2007;'REINTCAJERO';'Gastos_Gastos varios';'Efectivo';'VARIABLES'
24/01/2007;24/01/2007;'FRANCE TELECOM';-20,03€;1.712,21 €;-2627;-20,03;6.236,30 €;'sin fechas';24/01/2007;'FRANCE';'Gastos_Servicios tipicos';'Telecomunicaciones';'FIJO'
24/01/2007;24/01/2007;'QUICUINA';-6,15€;1.706,06 €;-2626;-6,15;6.230,15 €;'sin fechas';24/01/2007;'QUICUINA';'Gastos_Compras';'Supermercado';'VARIABLES'
25/01/2007;25/01/2007;'REINT.CAJERO';-40,00€;1.666,06 €;-2625;-40,00;6.190,15 €;'sin fechas';25/01/2007;'REINTCAJERO';'Gastos_Gastos varios';'Efectivo';'VARIABLES'
26/01/2007;26/01/2007;'MERCADONA';-127,17€;1.538,89 €;-2624;-127,17;6.062,98 €;'sin fechas';26/01/2007;'MERCADONA';'Gastos_Compras';'Supermercado';'VARIABLES'
26/01/2007;26/01/2007;'METRO';-6,90€;1.531,99 €;-2623;-6,90;6.056,08 €;'sin fechas';26/01/2007;'METRO';'Gastos_Ocio y transporte';'Transporte';'VARIABLES'
26/01/2007;19/01/2007;'PEAJE RUBI';-1,08€;1.530,91 €;-2622;-1,08;6.055,00 €;'sin fechas';19/01/2007;'PEAJE';'Gastos_Ocio y transporte';'Parking y peaje';'VARIABLES'
26/01/2007;19/01/2007;'PEAJE RUBI';-1,08€;1.529,83 €;-2621;-1,08;6.053,92 €;'sin fechas';19/01/2007;'PEAJE';'Gastos_Ocio y transporte';'Parking y peaje';'VARIABLES'
26/01/2007;26/01/2007;'REINT.CAJERO';-20,00€;1.509,83 €;-2620;-20,00;6.033,92 €;'sin fechas';26/01/2007;'REINTCAJERO';'Gastos_Gastos varios';'Efectivo';'VARIABLES'
29/01/2007;29/01/2007;'CAFET.C T PRAT';-2,00€;1.507,83 €;-2619;-2,00;6.031,92 €;'sin fechas';29/01/2007;'CAFETC';'Gastos_Ocio y transporte';'Restaurantes';'VARIABLES'
29/01/2007;29/01/2007;'CAFET.C T PRAT';-1,55€;1.506,28 €;-2618;-1,55;6.030,37 €;'sin fechas';29/01/2007;'CAFETC';'Gastos_Ocio y transporte';'Restaurantes';'VARIABLES'
29/01/2007;22/01/2007;'PEAJE RUBI';-1,08€;1.505,20 €;-2617;-1,08;6.029,29 €;'sin fechas';22/01/2007;'PEAJE';'Gastos_Ocio y transporte';'Parking y peaje';'VARIABLES'
29/01/2007;22/01/2007;'PEAJE RUBI';-1,08€;1.504,12 €;-2616;-1,08;6.028,21 €;'sin fechas';22/01/2007;'PEAJE';'Gastos_Ocio y transporte';'Parking y peaje';'VARIABLES'
30/01/2007;30/01/2007;'DECATHLON';-31,15€;1.472,97 €;-2615;-31,15;5.997,06 €;'sin fechas';30/01/2007;'DECATHLON';'Gastos_Compras';'Deportivo';'VARIABLES'
30/01/2007;30/01/2007;'GASOLINA';-38,59€;1.434,38 €;-2614;-38,59;5.958,47 €;'sin fechas';30/01/2007;'GASOLINA';'Gastos_Ocio y transporte';'Gasolina';'VARIABLES'
30/01/2007;31/01/2007;'INFORMACIO I TECNOLOGIA DE CAT';1.743,36€;3.177,74 €;-2613;1.743,36;7.701,83 €;'sin fechas';31/01/2007;'INFORMACIO';'Ingresos';'Nomina';'FIJO'
30/01/2007;23/01/2007;'PEAJE RUBI';-1,08€;3.176,66 €;-2612;-1,08;7.700,75 €;'sin fechas';23/01/2007;'PEAJE';'Gastos_Ocio y transporte';'Parking y peaje';'VARIABLES'
30/01/2007;16/01/2007;'PEAJE RUBI';-1,08€;3.175,58 €;-2611;-1,08;7.699,67 €;'sin fechas';16/01/2007;'PEAJE';'Gastos_Ocio y transporte';'Parking y peaje';'VARIABLES'
30/01/2007;16/01/2007;'PEAJE RUBI';-1,08€;3.174,50 €;-2610;-1,08;7.698,59 €;'sin fechas';16/01/2007;'PEAJE';'Gastos_Ocio y transporte';'Parking y peaje';'VARIABLES'
30/01/2007;24/01/2007;'PEAJE RUBI';-1,08€;3.173,42 €;-2609;-1,08;7.697,51 €;'sin fechas';24/01/2007;'PEAJE';'Gastos_Ocio y transporte';'Parking y peaje';'VARIABLES'
30/01/2007;24/01/2007;'PEAJE RUBI';-1,08€;3.172,34 €;-2608;-1,08;7.696,43 €;'sin fechas';24/01/2007;'PEAJE';'Gastos_Ocio y transporte';'Parking y peaje';'VARIABLES'
30/01/2007;25/01/2007;'PEAJE RUBI';-1,08€;3.171,26 €;-2607;-1,08;7.695,35 €;'sin fechas';25/01/2007;'PEAJE';'Gastos_Ocio y transporte';'Parking y peaje';'VARIABLES'
30/01/2007;23/01/2007;'PEAJE RUBI';-1,08€;3.170,18 €;-2606;-1,08;7.694,27 €;'sin fechas';23/01/2007;'PEAJE';'Gastos_Ocio y transporte';'Parking y peaje';'VARIABLES'
30/01/2007;25/01/2007;'PEAJE RUBI';-1,08€;3.169,10 €;-2605;-1,08;7.693,19 €;'sin fechas';25/01/2007;'PEAJE';'Gastos_Ocio y transporte';'Parking y peaje';'VARIABLES'
30/01/2007;30/01/2007;'REINT.CAJERO';-50,00€;3.119,10 €;-2604;-50,00;7.643,19 €;'sin fechas';30/01/2007;'REINTCAJERO';'Gastos_Gastos varios';'Efectivo';'VARIABLES'
31/01/2007;31/01/2007;'CAFET.C T PRAT';-2,00€;3.117,10 €;-2603;-2,00;7.641,19 €;'sin fechas';31/01/2007;'CAFETC';'Gastos_Ocio y transporte';'Restaurantes';'VARIABLES'
31/01/2007;31/01/2007;'RECIBO PTMOS. 3061-0960001518';-759,27€;2.357,83 €;-2602;-759,27;6.881,92 €;'sin fechas';31/01/2007;'RECIBO';'Gastos_Banco y organismos';'Hipoteca';'FIJO'
01/02/2007;31/01/2007;'AGENCIA DE LA MICROEMPRESA';592,04€;2.949,87 €;-2601;592,04;7.473,96 €;'sin fechas';31/01/2007;'AGENCIA';'Ingresos';'Nomina';'FIJO'
01/02/2007;01/02/2007;'CAFET.C T PRAT';-2,75€;2.947,12 €;-2600;-2,75;7.471,21 €;'sin fechas';01/02/2007;'CAFETC';'Gastos_Ocio y transporte';'Restaurantes';'VARIABLES'
01/02/2007;01/02/2007;'FARMACIA';-9,00€;2.938,12 €;-2599;-9,00;7.462,21 €;'sin fechas';01/02/2007;'FARMACIA';'Gastos_Salud, saber y deporte';'Farmacia';'VARIABLES'
01/02/2007;31/01/2007;'FUNDACIO PRIVADA';313,94€;3.252,06 €;-2598;313,94;7.776,15 €;'sin fechas';31/01/2007;'FUNDACIO';'Ingresos';'Nomina';'FIJO'
01/02/2007;01/02/2007;'REINT.CAJERO';-30,00€;3.222,06 €;-2597;-30,00;7.746,15 €;'sin fechas';01/02/2007;'REINTCAJERO';'Gastos_Gastos varios';'Efectivo';'VARIABLES'
01/02/2007;01/02/2007;'VIRGIN ACTIVE';-15,50€;3.206,56 €;-2596;-15,50;7.730,65 €;'sin fechas';01/02/2007;'VIRGIN';'Gastos_Salud, saber y deporte';'Deportes';'VARIABLES'
02/02/2007;02/02/2007;'NOSTRUM';-5,70€;3.200,86 €;-2595;-5,70;7.724,95 €;'sin fechas';02/02/2007;'NOSTRUM';'Gastos_Ocio y transporte';'Restaurantes';'VARIABLES'
02/02/2007;26/01/2007;'PEAJES OTROS';-3,22€;3.197,64 €;-2594;-3,22;7.721,73 €;'sin fechas';26/01/2007;'PEAJES';'Gastos_Ocio y transporte';'Parking y peaje';'VARIABLES'
03/02/2007;03/02/2007;'CINE';-12,60€;3.185,04 €;-2593;-12,60;7.709,13 €;'sin fechas';03/02/2007;'CINE';'Gastos_Ocio y transporte';'Espectáculos';'VARIABLES'
03/02/2007;03/02/2007;'GIFI';-29,70€;3.155,34 €;-2592;-29,70;7.679,43 €;'sin fechas';03/02/2007;'GIFI';'Gastos_Compras';'Hogar';'VARIABLES'
03/02/2007;03/02/2007;'REINT.CAJERO';-50,00€;3.105,34 €;-2591;-50,00;7.629,43 €;'sin fechas';03/02/2007;'REINTCAJERO';'Gastos_Gastos varios';'Efectivo';'VARIABLES'
03/02/2007;03/02/2007;'SIMPLY MARKET';-27,13€;3.078,21 €;-2590;-27,13;7.602,30 €;'sin fechas';03/02/2007;'SIMPLY';'Gastos_Compras';'Supermercado';'VARIABLES'
03/02/2007;03/02/2007;'SUPER DE CARN TOT';-52,76€;3.025,45 €;-2589;-52,76;7.549,54 €;'sin fechas';03/02/2007;'SUPER';'Gastos_Compras';'Supermercado';'VARIABLES'
03/02/2007;02/02/2007;'VIRGIN ACTIVE';-54,00€;2.971,45 €;-2588;-54,00;7.495,54 €;'sin fechas';02/02/2007;'VIRGIN';'Gastos_Salud, saber y deporte';'Deportes';'VARIABLES'
03/02/2007;02/02/2007;'VIRGIN ACTIVE';-54,00€;2.917,45 €;-2587;-54,00;7.441,54 €;'sin fechas';02/02/2007;'VIRGIN';'Gastos_Salud, saber y deporte';'Deportes';'VARIABLES'
05/02/2007;26/01/2007;'PEAJE RUBI';-1,08€;2.916,37 €;-2586;-1,08;7.440,46 €;'sin fechas';26/01/2007;'PEAJE';'Gastos_Ocio y transporte';'Parking y peaje';'VARIABLES'
05/02/2007;26/01/2007;'PEAJE RUBI';-1,08€;2.915,29 €;-2585;-1,08;7.439,38 €;'sin fechas';26/01/2007;'PEAJE';'Gastos_Ocio y transporte';'Parking y peaje';'VARIABLES'
05/02/2007;26/01/2007;'PEAJE RUBI';-1,08€;2.914,21 €;-2584;-1,08;7.438,30 €;'sin fechas';26/01/2007;'PEAJE';'Gastos_Ocio y transporte';'Parking y peaje';'VARIABLES'
05/02/2007;29/01/2007;'PEAJE RUBI';-1,08€;2.913,13 €;-2583;-1,08;7.437,22 €;'sin fechas';29/01/2007;'PEAJE';'Gastos_Ocio y transporte';'Parking y peaje';'VARIABLES'
05/02/2007;29/01/2007;'PEAJE RUBI';-1,08€;2.912,05 €;-2582;-1,08;7.436,14 €;'sin fechas';29/01/2007;'PEAJE';'Gastos_Ocio y transporte';'Parking y peaje';'VARIABLES'
06/02/2007;06/02/2007;'FRANCE TELECOM';-25,34€;2.886,71 €;-2581;-25,34;7.410,80 €;'sin fechas';06/02/2007;'FRANCE';'Gastos_Servicios tipicos';'Telecomunicaciones';'FIJO'
06/02/2007;06/02/2007;'GASOLINA';-38,76€;2.847,95 €;-2580;-38,76;7.372,04 €;'sin fechas';06/02/2007;'GASOLINA';'Gastos_Ocio y transporte';'Gasolina';'VARIABLES'
06/02/2007;31/01/2007;'PEAJE RUBI';-1,08€;2.846,87 €;-2579;-1,08;7.370,96 €;'sin fechas';31/01/2007;'PEAJE';'Gastos_Ocio y transporte';'Parking y peaje';'VARIABLES'
06/02/2007;30/01/2007;'PEAJE RUBI';-1,08€;2.845,79 €;-2578;-1,08;7.369,88 €;'sin fechas';30/01/2007;'PEAJE';'Gastos_Ocio y transporte';'Parking y peaje';'VARIABLES'
06/02/2007;30/01/2007;'PEAJE RUBI';-1,08€;2.844,71 €;-2577;-1,08;7.368,80 €;'sin fechas';30/01/2007;'PEAJE';'Gastos_Ocio y transporte';'Parking y peaje';'VARIABLES'
06/02/2007;31/01/2007;'PEAJE RUBI';-1,08€;2.843,63 €;-2576;-1,08;7.367,72 €;'sin fechas';31/01/2007;'PEAJE';'Gastos_Ocio y transporte';'Parking y peaje';'VARIABLES'
06/02/2007;05/02/2007;'SUSCRIP. FONDO';-150,00€;2.693,63 €;-2575;-150,00;7.217,72 €;'sin fechas';05/02/2007;'SUSCRIP';'Gastos_Gastos varios';'Transferencias';'VARIABLES'
06/02/2007;05/02/2007;'SUSCRIP. FONDO';-150,00€;2.543,63 €;-2574;-150,00;7.067,72 €;'sin fechas';05/02/2007;'SUSCRIP';'Gastos_Gastos varios';'Transferencias';'VARIABLES'
07/02/2007;07/02/2007;'ANUL COMPRA';70,00€;2.613,63 €;-2573;70,00;7.137,72 €;'sin fechas';07/02/2007;'ANUL';'Gastos_Gastos varios';'Efectivo';'VARIABLES'
07/02/2007;07/02/2007;'ANUL COMPRA';70,00€;2.683,63 €;-2572;70,00;7.207,72 €;'sin fechas';07/02/2007;'ANUL';'Gastos_Gastos varios';'Efectivo';'VARIABLES'
07/02/2007;07/02/2007;'CINE';-9,60€;2.674,03 €;-2571;-9,60;7.198,12 €;'sin fechas';07/02/2007;'CINE';'Gastos_Ocio y transporte';'Espectáculos';'VARIABLES'
07/02/2007;07/02/2007;'REINT.CAJERO';-20,00€;2.654,03 €;-2570;-20,00;7.178,12 €;'sin fechas';07/02/2007;'REINTCAJERO';'Gastos_Gastos varios';'Efectivo';'VARIABLES'
07/02/2007;07/02/2007;'REINT.CAJERO';-40,00€;2.614,03 €;-2569;-40,00;7.138,12 €;'sin fechas';07/02/2007;'REINTCAJERO';'Gastos_Gastos varios';'Efectivo';'VARIABLES'
07/02/2007;07/02/2007;'REINT.CAJERO';-70,00€;2.544,03 €;-2568;-70,00;7.068,12 €;'sin fechas';07/02/2007;'REINTCAJERO';'Gastos_Gastos varios';'Efectivo';'VARIABLES'
07/02/2007;07/02/2007;'REINT.CAJERO';-70,00€;2.474,03 €;-2567;-70,00;6.998,12 €;'sin fechas';07/02/2007;'REINTCAJERO';'Gastos_Gastos varios';'Efectivo';'VARIABLES'
09/02/2007;09/02/2007;'FF.CC.GENERALITAT';-19,00€;2.455,03 €;-2566;-19,00;6.979,12 €;'sin fechas';09/02/2007;'FFCCGENERALITAT';'Gastos_Ocio y transporte';'Transporte';'VARIABLES'
09/02/2007;02/02/2007;'PEAJE RUBI';-1,08€;2.453,95 €;-2565;-1,08;6.978,04 €;'sin fechas';02/02/2007;'PEAJE';'Gastos_Ocio y transporte';'Parking y peaje';'VARIABLES'
09/02/2007;02/02/2007;'PEAJE RUBI';-1,08€;2.452,87 €;-2564;-1,08;6.976,96 €;'sin fechas';02/02/2007;'PEAJE';'Gastos_Ocio y transporte';'Parking y peaje';'VARIABLES'
09/02/2007;01/02/2007;'PEAJE RUBI';-1,08€;2.451,79 €;-2563;-1,08;6.975,88 €;'sin fechas';01/02/2007;'PEAJE';'Gastos_Ocio y transporte';'Parking y peaje';'VARIABLES'
09/02/2007;01/02/2007;'PEAJE RUBI';-1,08€;2.450,71 €;-2562;-1,08;6.974,80 €;'sin fechas';01/02/2007;'PEAJE';'Gastos_Ocio y transporte';'Parking y peaje';'VARIABLES'
09/02/2007;09/02/2007;'REINT.CAJERO';-40,00€;2.410,71 €;-2561;-40,00;6.934,80 €;'sin fechas';09/02/2007;'REINTCAJERO';'Gastos_Gastos varios';'Efectivo';'VARIABLES'
10/02/2007;10/02/2007;'RESTAURANTES';-57,89€;2.352,82 €;-2560;-57,89;6.876,91 €;'sin fechas';10/02/2007;'RESTAURANTES';'Gastos_Ocio y transporte';'Restaurantes';'VARIABLES'
10/02/2007;10/02/2007;'SABECO TORTOSA';-49,79€;2.303,03 €;-2559;-49,79;6.827,12 €;'sin fechas';10/02/2007;'SABECO';'Gastos_Compras';'Supermercado';'VARIABLES'
12/02/2007;12/02/2007;'GAS NATURAL';-141,72€;2.161,31 €;-2558;-141,72;6.685,40 €;'sin fechas';12/02/2007;'GAS';'Gastos_Servicios tipicos';'Gas';'FIJO'
12/02/2007;05/02/2007;'PEAJE RUBI';-1,08€;2.160,23 €;-2557;-1,08;6.684,32 €;'sin fechas';05/02/2007;'PEAJE';'Gastos_Ocio y transporte';'Parking y peaje';'VARIABLES'
12/02/2007;05/02/2007;'PEAJE RUBI';-1,08€;2.159,15 €;-2556;-1,08;6.683,24 €;'sin fechas';05/02/2007;'PEAJE';'Gastos_Ocio y transporte';'Parking y peaje';'VARIABLES'
13/02/2007;08/02/2007;'PEAJE RUBI';-1,08€;2.158,07 €;-2555;-1,08;6.682,16 €;'sin fechas';08/02/2007;'PEAJE';'Gastos_Ocio y transporte';'Parking y peaje';'VARIABLES'
13/02/2007;07/02/2007;'PEAJE RUBI';-1,08€;2.156,99 €;-2554;-1,08;6.681,08 €;'sin fechas';07/02/2007;'PEAJE';'Gastos_Ocio y transporte';'Parking y peaje';'VARIABLES'
13/02/2007;08/02/2007;'PEAJE RUBI';-1,08€;2.155,91 €;-2553;-1,08;6.680,00 €;'sin fechas';08/02/2007;'PEAJE';'Gastos_Ocio y transporte';'Parking y peaje';'VARIABLES'
13/02/2007;07/02/2007;'PEAJE RUBI';-1,08€;2.154,83 €;-2552;-1,08;6.678,92 €;'sin fechas';07/02/2007;'PEAJE';'Gastos_Ocio y transporte';'Parking y peaje';'VARIABLES'
13/02/2007;06/02/2007;'PEAJE RUBI';-1,08€;2.153,75 €;-2551;-1,08;6.677,84 €;'sin fechas';06/02/2007;'PEAJE';'Gastos_Ocio y transporte';'Parking y peaje';'VARIABLES'
13/02/2007;06/02/2007;'PEAJE RUBI';-1,08€;2.152,67 €;-2550;-1,08;6.676,76 €;'sin fechas';06/02/2007;'PEAJE';'Gastos_Ocio y transporte';'Parking y peaje';'VARIABLES'
13/02/2007;13/02/2007;'REINT.CAJERO';-50,00€;2.102,67 €;-2549;-50,00;6.626,76 €;'sin fechas';13/02/2007;'REINTCAJERO';'Gastos_Gastos varios';'Efectivo';'VARIABLES'
14/02/2007;14/02/2007;'CAPRABO';-20,38€;2.082,29 €;-2548;-20,38;6.606,38 €;'sin fechas';14/02/2007;'CAPRABO';'Gastos_Compras';'Supermercado';'VARIABLES'
14/02/2007;14/02/2007;'GASOLINA';-38,62€;2.043,67 €;-2547;-38,62;6.567,76 €;'sin fechas';14/02/2007;'GASOLINA';'Gastos_Ocio y transporte';'Gasolina';'VARIABLES'
15/02/2007;15/02/2007;'SEG.AM.HIPITEC';-32,53€;2.011,14 €;-2546;-32,53;6.535,23 €;'sin fechas';15/02/2007;'SEGAMHIPITEC';'Gastos_Seguros';'Seguro vida';'FIJO'
16/02/2007;16/02/2007;'CAFET.C T PRAT';-4,75€;2.006,39 €;-2545;-4,75;6.530,48 €;'sin fechas';16/02/2007;'CAFETC';'Gastos_Ocio y transporte';'Restaurantes';'VARIABLES'
16/02/2007;16/02/2007;'CINE';-12,20€;1.994,19 €;-2544;-12,20;6.518,28 €;'sin fechas';16/02/2007;'CINE';'Gastos_Ocio y transporte';'Espectáculos';'VARIABLES'
16/02/2007;09/02/2007;'PEAJE RUBI';-1,08€;1.993,11 €;-2543;-1,08;6.517,20 €;'sin fechas';09/02/2007;'PEAJE';'Gastos_Ocio y transporte';'Parking y peaje';'VARIABLES'
16/02/2007;09/02/2007;'PEAJES OTROS';-2,86€;1.990,25 €;-2542;-2,86;6.514,34 €;'sin fechas';09/02/2007;'PEAJES';'Gastos_Ocio y transporte';'Parking y peaje';'VARIABLES'
16/02/2007;16/02/2007;'REINT.CAJERO';-40,00€;1.950,25 €;-2541;-40,00;6.474,34 €;'sin fechas';16/02/2007;'REINTCAJERO';'Gastos_Gastos varios';'Efectivo';'VARIABLES'
17/02/2007;17/02/2007;'BON AREA';-24,75€;1.925,50 €;-2540;-24,75;6.449,59 €;'sin fechas';17/02/2007;'BON';'Gastos_Compras';'Supermercado';'VARIABLES'
17/02/2007;17/02/2007;'CINE';-12,60€;1.912,90 €;-2539;-12,60;6.436,99 €;'sin fechas';17/02/2007;'CINE';'Gastos_Ocio y transporte';'Espectáculos';'VARIABLES'
19/02/2007;19/02/2007;'GASOLINA';-28,99€;1.883,91 €;-2538;-28,99;6.408,00 €;'sin fechas';19/02/2007;'GASOLINA';'Gastos_Ocio y transporte';'Gasolina';'VARIABLES'
19/02/2007;19/02/2007;'NOSTRUM';-7,00€;1.876,91 €;-2537;-7,00;6.401,00 €;'sin fechas';19/02/2007;'NOSTRUM';'Gastos_Ocio y transporte';'Restaurantes';'VARIABLES'
19/02/2007;12/02/2007;'PEAJE RUBI';-1,08€;1.875,83 €;-2536;-1,08;6.399,92 €;'sin fechas';12/02/2007;'PEAJE';'Gastos_Ocio y transporte';'Parking y peaje';'VARIABLES'
19/02/2007;12/02/2007;'PEAJE RUBI';-1,08€;1.874,75 €;-2535;-1,08;6.398,84 €;'sin fechas';12/02/2007;'PEAJE';'Gastos_Ocio y transporte';'Parking y peaje';'VARIABLES'
20/02/2007;20/02/2007;'BON AREA';-6,47€;1.868,28 €;-2534;-6,47;6.392,37 €;'sin fechas';20/02/2007;'BON';'Gastos_Compras';'Supermercado';'VARIABLES'
20/02/2007;15/02/2007;'PEAJE RUBI';-1,08€;1.867,20 €;-2533;-1,08;6.391,29 €;'sin fechas';15/02/2007;'PEAJE';'Gastos_Ocio y transporte';'Parking y peaje';'VARIABLES'
20/02/2007;14/02/2007;'PEAJE RUBI';-1,08€;1.866,12 €;-2532;-1,08;6.390,21 €;'sin fechas';14/02/2007;'PEAJE';'Gastos_Ocio y transporte';'Parking y peaje';'VARIABLES'
20/02/2007;13/02/2007;'PEAJE RUBI';-1,03€;1.865,09 €;-2531;-1,03;6.389,18 €;'sin fechas';13/02/2007;'PEAJE';'Gastos_Ocio y transporte';'Parking y peaje';'VARIABLES'
20/02/2007;13/02/2007;'PEAJE RUBI';-1,08€;1.864,01 €;-2530;-1,08;6.388,10 €;'sin fechas';13/02/2007;'PEAJE';'Gastos_Ocio y transporte';'Parking y peaje';'VARIABLES'
20/02/2007;14/02/2007;'PEAJE RUBI';-1,03€;1.862,98 €;-2529;-1,03;6.387,07 €;'sin fechas';14/02/2007;'PEAJE';'Gastos_Ocio y transporte';'Parking y peaje';'VARIABLES'
20/02/2007;15/02/2007;'PEAJE RUBI';-1,03€;1.861,95 €;-2528;-1,03;6.386,04 €;'sin fechas';15/02/2007;'PEAJE';'Gastos_Ocio y transporte';'Parking y peaje';'VARIABLES'
21/02/2007;21/02/2007;'ONO';-84,70€;1.777,25 €;-2527;-84,70;6.301,34 €;'sin fechas';21/02/2007;'ONO';'Gastos_Servicios tipicos';'Telecomunicaciones';'FIJO'
22/02/2007;22/02/2007;'CAFET.C T PRAT';-2,25€;1.775,00 €;-2526;-2,25;6.299,09 €;'sin fechas';22/02/2007;'CAFETC';'Gastos_Ocio y transporte';'Restaurantes';'VARIABLES'
22/02/2007;22/02/2007;'GROUPAMA PLUS';-86,67€;1.688,33 €;-2525;-86,67;6.212,42 €;'sin fechas';22/02/2007;'GROUPAMA';'Gastos_Seguros';'Seguro salud';'FIJO'
22/02/2007;22/02/2007;'PELUQUERIAS';-9,99€;1.678,34 €;-2524;-9,99;6.202,43 €;'sin fechas';22/02/2007;'PELUQUERIAS';'Gastos_Salud, saber y deporte';'Belleza';'VARIABLES'
23/02/2007;23/02/2007;'CAFET.C T PRAT';-4,60€;1.673,74 €;-2523;-4,60;6.197,83 €;'sin fechas';23/02/2007;'CAFETC';'Gastos_Ocio y transporte';'Restaurantes';'VARIABLES'
23/02/2007;23/02/2007;'CINE';-12,20€;1.661,54 €;-2522;-12,20;6.185,63 €;'sin fechas';23/02/2007;'CINE';'Gastos_Ocio y transporte';'Espectáculos';'VARIABLES'
23/02/2007;23/02/2007;'FRANCE TELECOM';-24,69€;1.636,85 €;-2521;-24,69;6.160,94 €;'sin fechas';23/02/2007;'FRANCE';'Gastos_Servicios tipicos';'Telecomunicaciones';'FIJO'
23/02/2007;23/02/2007;'GASOLINA';-38,65€;1.598,20 €;-2520;-38,65;6.122,29 €;'sin fechas';23/02/2007;'GASOLINA';'Gastos_Ocio y transporte';'Gasolina';'VARIABLES'
23/02/2007;16/02/2007;'PEAJE RUBI';-1,08€;1.597,12 €;-2519;-1,08;6.121,21 €;'sin fechas';16/02/2007;'PEAJE';'Gastos_Ocio y transporte';'Parking y peaje';'VARIABLES'
23/02/2007;16/02/2007;'PEAJE RUBI';-1,08€;1.596,04 €;-2518;-1,08;6.120,13 €;'sin fechas';16/02/2007;'PEAJE';'Gastos_Ocio y transporte';'Parking y peaje';'VARIABLES'
23/02/2007;23/02/2007;'REINT.CAJERO';-40,00€;1.556,04 €;-2517;-40,00;6.080,13 €;'sin fechas';23/02/2007;'REINTCAJERO';'Gastos_Gastos varios';'Efectivo';'VARIABLES'
24/02/2007;24/02/2007;'REINT.CAJERO';-40,00€;1.516,04 €;-2516;-40,00;6.040,13 €;'sin fechas';24/02/2007;'REINTCAJERO';'Gastos_Gastos varios';'Efectivo';'VARIABLES'
24/02/2007;24/02/2007;'RESTAURANTES';-33,22€;1.482,82 €;-2515;-33,22;6.006,91 €;'sin fechas';24/02/2007;'RESTAURANTES';'Gastos_Ocio y transporte';'Restaurantes';'VARIABLES'
26/02/2007;26/02/2007;'BON AREA';-16,32€;1.466,50 €;-2514;-16,32;5.990,59 €;'sin fechas';26/02/2007;'BON';'Gastos_Compras';'Supermercado';'VARIABLES'
26/02/2007;19/02/2007;'PEAJE RUBI';-1,03€;1.465,47 €;-2513;-1,03;5.989,56 €;'sin fechas';19/02/2007;'PEAJE';'Gastos_Ocio y transporte';'Parking y peaje';'VARIABLES'
26/02/2007;19/02/2007;'PEAJE RUBI';-1,08€;1.464,39 €;-2512;-1,08;5.988,48 €;'sin fechas';19/02/2007;'PEAJE';'Gastos_Ocio y transporte';'Parking y peaje';'VARIABLES'
27/02/2007;28/02/2007;'INFORMACIO I TECNOLOGIA DE CAT';1.258,10€;2.722,49 €;-2511;1.258,10;7.246,58 €;'sin fechas';28/02/2007;'INFORMACIO';'Ingresos';'Nomina';'FIJO'
27/02/2007;20/02/2007;'PEAJE RUBI';-1,03€;2.721,46 €;-2510;-1,03;7.245,55 €;'sin fechas';20/02/2007;'PEAJE';'Gastos_Ocio y transporte';'Parking y peaje';'VARIABLES'
27/02/2007;21/02/2007;'PEAJE RUBI';-0,97€;2.720,49 €;-2509;-0,97;7.244,58 €;'sin fechas';21/02/2007;'PEAJE';'Gastos_Ocio y transporte';'Parking y peaje';'VARIABLES'
27/02/2007;22/02/2007;'PEAJE RUBI';-0,97€;2.719,52 €;-2508;-0,97;7.243,61 €;'sin fechas';22/02/2007;'PEAJE';'Gastos_Ocio y transporte';'Parking y peaje';'VARIABLES'
27/02/2007;21/02/2007;'PEAJE RUBI';-1,08€;2.718,44 €;-2507;-1,08;7.242,53 €;'sin fechas';21/02/2007;'PEAJE';'Gastos_Ocio y transporte';'Parking y peaje';'VARIABLES'
27/02/2007;22/02/2007;'PEAJE RUBI';-1,08€;2.717,36 €;-2506;-1,08;7.241,45 €;'sin fechas';22/02/2007;'PEAJE';'Gastos_Ocio y transporte';'Parking y peaje';'VARIABLES'
27/02/2007;20/02/2007;'PEAJE RUBI';-1,08€;2.716,28 €;-2505;-1,08;7.240,37 €;'sin fechas';20/02/2007;'PEAJE';'Gastos_Ocio y transporte';'Parking y peaje';'VARIABLES'
28/02/2007;28/02/2007;'RECIBO PTMOS. 3061-0960001518';-759,27€;1.957,01 €;-2504;-759,27;6.481,10 €;'sin fechas';28/02/2007;'RECIBO';'Gastos_Banco y organismos';'Hipoteca';'FIJO'
01/03/2007;01/03/2007;'MERCADONA';-14,45€;1.942,56 €;-2503;-14,45;6.466,65 €;'sin fechas';01/03/2007;'MERCADONA';'Gastos_Compras';'Supermercado';'VARIABLES'
02/03/2007;28/02/2007;'AGENCIA DE LA MICROEMPRESA';592,04€;2.534,60 €;-2502;592,04;7.058,69 €;'sin fechas';28/02/2007;'AGENCIA';'Ingresos';'Nomina';'FIJO'
02/03/2007;01/03/2007;'AJUNTAMENT DE TERRASSA';-51,36€;2.483,24 €;-2501;-51,36;7.007,33 €;'sin fechas';01/03/2007;'AJUNTAMENT';'Gastos_Banco y organismos';'Ayuntamiento';'FIJO'
02/03/2007;28/02/2007;'FUNDACIO PRIVADA';313,94€;2.797,18 €;-2500;313,94;7.321,27 €;'sin fechas';28/02/2007;'FUNDACIO';'Ingresos';'Nomina';'FIJO'
02/03/2007;02/03/2007;'MERCADONA';-121,73€;2.675,45 €;-2499;-121,73;7.199,54 €;'sin fechas';02/03/2007;'MERCADONA';'Gastos_Compras';'Supermercado';'VARIABLES'
02/03/2007;23/02/2007;'PEAJE RUBI';-1,08€;2.674,37 €;-2498;-1,08;7.198,46 €;'sin fechas';23/02/2007;'PEAJE';'Gastos_Ocio y transporte';'Parking y peaje';'VARIABLES'
02/03/2007;23/02/2007;'PEAJE RUBI';-0,97€;2.673,40 €;-2497;-0,97;7.197,49 €;'sin fechas';23/02/2007;'PEAJE';'Gastos_Ocio y transporte';'Parking y peaje';'VARIABLES'
02/03/2007;02/03/2007;'VIRGIN ACTIVE';-54,00€;2.619,40 €;-2496;-54,00;7.143,49 €;'sin fechas';02/03/2007;'VIRGIN';'Gastos_Salud, saber y deporte';'Deportes';'VARIABLES'
02/03/2007;02/03/2007;'VIRGIN ACTIVE';-54,00€;2.565,40 €;-2495;-54,00;7.089,49 €;'sin fechas';02/03/2007;'VIRGIN';'Gastos_Salud, saber y deporte';'Deportes';'VARIABLES'
03/03/2007;03/03/2007;'FARMACIA';-16,48€;2.548,92 €;-2494;-16,48;7.073,01 €;'sin fechas';03/03/2007;'FARMACIA';'Gastos_Salud, saber y deporte';'Farmacia';'VARIABLES'
03/03/2007;03/03/2007;'GASOLINA';-40,00€;2.508,92 €;-2493;-40,00;7.033,01 €;'sin fechas';03/03/2007;'GASOLINA';'Gastos_Ocio y transporte';'Gasolina';'VARIABLES'
03/03/2007;03/03/2007;'REINT.CAJERO';-40,00€;2.468,92 €;-2492;-40,00;6.993,01 €;'sin fechas';03/03/2007;'REINTCAJERO';'Gastos_Gastos varios';'Efectivo';'VARIABLES'
03/03/2007;03/03/2007;'SUPER DE CARN TOT';-68,15€;2.400,77 €;-2491;-68,15;6.924,86 €;'sin fechas';03/03/2007;'SUPER';'Gastos_Compras';'Supermercado';'VARIABLES'
05/03/2007;05/03/2007;'CAFET.C T PRAT';-1,60€;2.399,17 €;-2490;-1,60;6.923,26 €;'sin fechas';05/03/2007;'CAFETC';'Gastos_Ocio y transporte';'Restaurantes';'VARIABLES'
05/03/2007;26/02/2007;'PEAJE RUBI';-0,97€;2.398,20 €;-2489;-0,97;6.922,29 €;'sin fechas';26/02/2007;'PEAJE';'Gastos_Ocio y transporte';'Parking y peaje';'VARIABLES'
05/03/2007;26/02/2007;'PEAJE RUBI';-1,08€;2.397,12 €;-2488;-1,08;6.921,21 €;'sin fechas';26/02/2007;'PEAJE';'Gastos_Ocio y transporte';'Parking y peaje';'VARIABLES'
06/03/2007;06/03/2007;'FF.CC.GENERALITAT';-13,80€;2.383,32 €;-2487;-13,80;6.907,41 €;'sin fechas';06/03/2007;'FFCCGENERALITAT';'Gastos_Ocio y transporte';'Transporte';'VARIABLES'
06/03/2007;06/03/2007;'FRANCE TELECOM';-10,44€;2.372,88 €;-2486;-10,44;6.896,97 €;'sin fechas';06/03/2007;'FRANCE';'Gastos_Servicios tipicos';'Telecomunicaciones';'FIJO'
06/03/2007;28/02/2007;'PEAJE RUBI';-1,08€;2.371,80 €;-2485;-1,08;6.895,89 €;'sin fechas';28/02/2007;'PEAJE';'Gastos_Ocio y transporte';'Parking y peaje';'VARIABLES'
06/03/2007;27/02/2007;'PEAJE RUBI';-0,97€;2.370,83 €;-2484;-0,97;6.894,92 €;'sin fechas';27/02/2007;'PEAJE';'Gastos_Ocio y transporte';'Parking y peaje';'VARIABLES'
06/03/2007;28/02/2007;'PEAJE RUBI';-0,97€;2.369,86 €;-2483;-0,97;6.893,95 €;'sin fechas';28/02/2007;'PEAJE';'Gastos_Ocio y transporte';'Parking y peaje';'VARIABLES'
06/03/2007;01/03/2007;'PEAJE RUBI';-1,08€;2.368,78 €;-2482;-1,08;6.892,87 €;'sin fechas';01/03/2007;'PEAJE';'Gastos_Ocio y transporte';'Parking y peaje';'VARIABLES'
06/03/2007;27/02/2007;'PEAJE RUBI';-1,08€;2.367,70 €;-2481;-1,08;6.891,79 €;'sin fechas';27/02/2007;'PEAJE';'Gastos_Ocio y transporte';'Parking y peaje';'VARIABLES'
06/03/2007;01/03/2007;'PEAJE RUBI';-1,08€;2.366,62 €;-2480;-1,08;6.890,71 €;'sin fechas';01/03/2007;'PEAJE';'Gastos_Ocio y transporte';'Parking y peaje';'VARIABLES'
06/03/2007;06/03/2007;'RECIBO PTMOS. 3061-0960001518';-300,00€;2.066,62 €;-2479;-300,00;6.590,71 €;'sin fechas';06/03/2007;'RECIBO';'Gastos_Banco y organismos';'Hipoteca';'FIJO'
07/03/2007;07/03/2007;'GASOLINA';-40,00€;2.026,62 €;-2478;-40,00;6.550,71 €;'sin fechas';07/03/2007;'GASOLINA';'Gastos_Ocio y transporte';'Gasolina';'VARIABLES'
09/03/2007;09/03/2007;'CINE';-12,60€;2.014,02 €;-2477;-12,60;6.538,11 €;'sin fechas';09/03/2007;'CINE';'Gastos_Ocio y transporte';'Espectáculos';'VARIABLES'
09/03/2007;02/03/2007;'PEAJE RUBI';-1,08€;2.012,94 €;-2476;-1,08;6.537,03 €;'sin fechas';02/03/2007;'PEAJE';'Gastos_Ocio y transporte';'Parking y peaje';'VARIABLES'
09/03/2007;09/03/2007;'RESTAURANTES';-11,20€;2.001,74 €;-2475;-11,20;6.525,83 €;'sin fechas';09/03/2007;'RESTAURANTES';'Gastos_Ocio y transporte';'Restaurantes';'VARIABLES'
10/03/2007;10/03/2007;'CARREFOUR-[comida]';-18,79€;1.982,95 €;-2474;-18,79;6.507,04 €;'sin fechas';10/03/2007;'CARREFOURCOMIDA';'Gastos_Compras';'Supermercado';'VARIABLES'
12/03/2007;12/03/2007;'GROUPAMA PLUS';-42,57€;1.940,38 €;-2473;-42,57;6.464,47 €;'sin fechas';12/03/2007;'GROUPAMA';'Gastos_Seguros';'Seguro salud';'FIJO'
12/03/2007;05/03/2007;'PEAJE RUBI';-1,08€;1.939,30 €;-2472;-1,08;6.463,39 €;'sin fechas';05/03/2007;'PEAJE';'Gastos_Ocio y transporte';'Parking y peaje';'VARIABLES'
12/03/2007;05/03/2007;'PEAJE RUBI';-1,08€;1.938,22 €;-2471;-1,08;6.462,31 €;'sin fechas';05/03/2007;'PEAJE';'Gastos_Ocio y transporte';'Parking y peaje';'VARIABLES'
13/03/2007;13/03/2007;'GASOLINA';-40,00€;1.898,22 €;-2470;-40,00;6.422,31 €;'sin fechas';13/03/2007;'GASOLINA';'Gastos_Ocio y transporte';'Gasolina';'VARIABLES'
13/03/2007;06/03/2007;'PEAJE RUBI';-1,08€;1.897,14 €;-2469;-1,08;6.421,23 €;'sin fechas';06/03/2007;'PEAJE';'Gastos_Ocio y transporte';'Parking y peaje';'VARIABLES'
13/03/2007;07/03/2007;'PEAJE RUBI';-1,08€;1.896,06 €;-2468;-1,08;6.420,15 €;'sin fechas';07/03/2007;'PEAJE';'Gastos_Ocio y transporte';'Parking y peaje';'VARIABLES'
13/03/2007;06/03/2007;'PEAJE RUBI';-1,08€;1.894,98 €;-2467;-1,08;6.419,07 €;'sin fechas';06/03/2007;'PEAJE';'Gastos_Ocio y transporte';'Parking y peaje';'VARIABLES'
13/03/2007;06/03/2007;'PEAJE RUBI';-1,08€;1.893,90 €;-2466;-1,08;6.417,99 €;'sin fechas';06/03/2007;'PEAJE';'Gastos_Ocio y transporte';'Parking y peaje';'VARIABLES'
13/03/2007;07/03/2007;'PEAJE RUBI';-1,08€;1.892,82 €;-2465;-1,08;6.416,91 €;'sin fechas';07/03/2007;'PEAJE';'Gastos_Ocio y transporte';'Parking y peaje';'VARIABLES'
13/03/2007;06/03/2007;'PEAJE RUBI';-1,08€;1.891,74 €;-2464;-1,08;6.415,83 €;'sin fechas';06/03/2007;'PEAJE';'Gastos_Ocio y transporte';'Parking y peaje';'VARIABLES'
13/03/2007;08/03/2007;'PEAJE RUBI';-1,08€;1.890,66 €;-2463;-1,08;6.414,75 €;'sin fechas';08/03/2007;'PEAJE';'Gastos_Ocio y transporte';'Parking y peaje';'VARIABLES'
13/03/2007;08/03/2007;'PEAJE RUBI';-1,08€;1.889,58 €;-2462;-1,08;6.413,67 €;'sin fechas';08/03/2007;'PEAJE';'Gastos_Ocio y transporte';'Parking y peaje';'VARIABLES'
13/03/2007;13/03/2007;'REINT.CAJERO';-40,00€;1.849,58 €;-2461;-40,00;6.373,67 €;'sin fechas';13/03/2007;'REINTCAJERO';'Gastos_Gastos varios';'Efectivo';'VARIABLES'
14/03/2007;14/03/2007;'REINT.CAJERO';-20,00€;1.829,58 €;-2460;-20,00;6.353,67 €;'sin fechas';14/03/2007;'REINTCAJERO';'Gastos_Gastos varios';'Efectivo';'VARIABLES'
14/03/2007;14/03/2007;'RESTAURANTES';-13,19€;1.816,39 €;-2459;-13,19;6.340,48 €;'sin fechas';14/03/2007;'RESTAURANTES';'Gastos_Ocio y transporte';'Restaurantes';'VARIABLES'
15/03/2007;15/03/2007;'SEG.AM.HIPITEC';-32,49€;1.783,90 €;-2458;-32,49;6.307,99 €;'sin fechas';15/03/2007;'SEGAMHIPITEC';'Gastos_Seguros';'Seguro vida';'FIJO'
16/03/2007;16/03/2007;'Cena Mario';-40,00€;1.743,90 €;-2457;-40,00;6.267,99 €;'sin fechas';16/03/2007;'CENA';'Gastos_Ocio y transporte';'Restaurantes';'VARIABLES'
16/03/2007;16/03/2007;'ENDESA DISTRIB';-65,73€;1.678,17 €;-2456;-65,73;6.202,26 €;'sin fechas';16/03/2007;'ENDESA';'Gastos_Servicios tipicos';'Electricidad';'FIJO'
16/03/2007;16/03/2007;'METRO';-6,90€;1.671,27 €;-2455;-6,90;6.195,36 €;'sin fechas';16/03/2007;'METRO';'Gastos_Ocio y transporte';'Transporte';'VARIABLES'
16/03/2007;09/03/2007;'PEAJE RUBI';-1,08€;1.670,19 €;-2454;-1,08;6.194,28 €;'sin fechas';09/03/2007;'PEAJE';'Gastos_Ocio y transporte';'Parking y peaje';'VARIABLES'
16/03/2007;09/03/2007;'PEAJE RUBI';-1,08€;1.669,11 €;-2453;-1,08;6.193,20 €;'sin fechas';09/03/2007;'PEAJE';'Gastos_Ocio y transporte';'Parking y peaje';'VARIABLES'
17/03/2007;17/03/2007;'H&M';-59,80€;1.609,31 €;-2452;-59,80;6.133,40 €;'sin fechas';17/03/2007;'HM';'Gastos_Compras';'Ropa';'VARIABLES'
17/03/2007;17/03/2007;'parking';-170,00€;1.439,31 €;-2451;-170,00;5.963,40 €;'sin fechas';17/03/2007;'PARKING';'Gastos_Ocio y transporte';'Parking y peaje';'VARIABLES'
17/03/2007;17/03/2007;'RESTAURANTES';-65,40€;1.373,91 €;-2450;-65,40;5.898,00 €;'sin fechas';17/03/2007;'RESTAURANTES';'Gastos_Ocio y transporte';'Restaurantes';'VARIABLES'
19/03/2007;12/03/2007;'PEAJE RUBI';-1,08€;1.372,83 €;-2449;-1,08;5.896,92 €;'sin fechas';12/03/2007;'PEAJE';'Gastos_Ocio y transporte';'Parking y peaje';'VARIABLES'
19/03/2007;12/03/2007;'PEAJE RUBI';-1,08€;1.371,75 €;-2448;-1,08;5.895,84 €;'sin fechas';12/03/2007;'PEAJE';'Gastos_Ocio y transporte';'Parking y peaje';'VARIABLES'
20/03/2007;20/03/2007;'GASOLINA';-29,27€;1.342,48 €;-2447;-29,27;5.866,57 €;'sin fechas';20/03/2007;'GASOLINA';'Gastos_Ocio y transporte';'Gasolina';'VARIABLES'
20/03/2007;15/03/2007;'PEAJE RUBI';-1,08€;1.341,40 €;-2446;-1,08;5.865,49 €;'sin fechas';15/03/2007;'PEAJE';'Gastos_Ocio y transporte';'Parking y peaje';'VARIABLES'
20/03/2007;14/03/2007;'PEAJE RUBI';-1,03€;1.340,37 €;-2445;-1,03;5.864,46 €;'sin fechas';14/03/2007;'PEAJE';'Gastos_Ocio y transporte';'Parking y peaje';'VARIABLES'
20/03/2007;14/03/2007;'PEAJE RUBI';-1,08€;1.339,29 €;-2444;-1,08;5.863,38 €;'sin fechas';14/03/2007;'PEAJE';'Gastos_Ocio y transporte';'Parking y peaje';'VARIABLES'
20/03/2007;13/03/2007;'PEAJE RUBI';-1,03€;1.338,26 €;-2443;-1,03;5.862,35 €;'sin fechas';13/03/2007;'PEAJE';'Gastos_Ocio y transporte';'Parking y peaje';'VARIABLES'
20/03/2007;15/03/2007;'PEAJE RUBI';-1,08€;1.337,18 €;-2442;-1,08;5.861,27 €;'sin fechas';15/03/2007;'PEAJE';'Gastos_Ocio y transporte';'Parking y peaje';'VARIABLES'
20/03/2007;13/03/2007;'PEAJE RUBI';-1,08€;1.336,10 €;-2441;-1,08;5.860,19 €;'sin fechas';13/03/2007;'PEAJE';'Gastos_Ocio y transporte';'Parking y peaje';'VARIABLES'
20/03/2007;19/03/2007;'REEMBOLSO FOND';1.000,00€;2.336,10 €;-2440;1.000,00;6.860,19 €;'sin fechas';19/03/2007;'REEMBOLSO';'Ingresos';'Transferencias';'VARIABLES'
21/03/2007;21/03/2007;'CAFET.C T PRAT';-2,00€;2.334,10 €;-2439;-2,00;6.858,19 €;'sin fechas';21/03/2007;'CAFETC';'Gastos_Ocio y transporte';'Restaurantes';'VARIABLES'
21/03/2007;21/03/2007;'CAFET.C T PRAT';-1,55€;2.332,55 €;-2438;-1,55;6.856,64 €;'sin fechas';21/03/2007;'CAFETC';'Gastos_Ocio y transporte';'Restaurantes';'VARIABLES'
21/03/2007;21/03/2007;'ONO';-74,50€;2.258,05 €;-2437;-74,50;6.782,14 €;'sin fechas';21/03/2007;'ONO';'Gastos_Servicios tipicos';'Telecomunicaciones';'FIJO'
22/03/2007;22/03/2007;'an/verf.finca';10,50€;2.268,55 €;-2436;10,50;6.792,64 €;'sin fechas';22/03/2007;'ANVERFFINCA';'Gastos_Banco y organismos';'Cargos banco';'FIJO'
22/03/2007;22/03/2007;'REINT.CAJERO';-20,00€;2.248,55 €;-2435;-20,00;6.772,64 €;'sin fechas';22/03/2007;'REINTCAJERO';'Gastos_Gastos varios';'Efectivo';'VARIABLES'
22/03/2007;22/03/2007;'REINT.CAJERO';-30,00€;2.218,55 €;-2434;-30,00;6.742,64 €;'sin fechas';22/03/2007;'REINTCAJERO';'Gastos_Gastos varios';'Efectivo';'VARIABLES'
22/03/2007;22/03/2007;'REINT.CAJERO';20,00€;2.238,55 €;-2433;20,00;6.762,64 €;'sin fechas';22/03/2007;'REINTCAJERO';'Gastos_Gastos varios';'Efectivo';'VARIABLES'
22/03/2007;22/03/2007;'verf.finca';-10,50€;2.228,05 €;-2432;-10,50;6.752,14 €;'sin fechas';22/03/2007;'VERFFINCA';'Gastos_Banco y organismos';'Cargos banco';'FIJO'
22/03/2007;22/03/2007;'verf.finca';-10,50€;2.217,55 €;-2431;-10,50;6.741,64 €;'sin fechas';22/03/2007;'VERFFINCA';'Gastos_Banco y organismos';'Cargos banco';'FIJO'
23/03/2007;23/03/2007;'FRANCE TELECOM';-12,25€;2.205,30 €;-2430;-12,25;6.729,39 €;'sin fechas';23/03/2007;'FRANCE';'Gastos_Servicios tipicos';'Telecomunicaciones';'FIJO'
23/03/2007;16/03/2007;'PEAJE RUBI';-1,03€;2.204,27 €;-2429;-1,03;6.728,36 €;'sin fechas';16/03/2007;'PEAJE';'Gastos_Ocio y transporte';'Parking y peaje';'VARIABLES'
23/03/2007;16/03/2007;'PEAJE RUBI';-1,08€;2.203,19 €;-2428;-1,08;6.727,28 €;'sin fechas';16/03/2007;'PEAJE';'Gastos_Ocio y transporte';'Parking y peaje';'VARIABLES'
23/03/2007;16/03/2007;'PEAJE RUBI';-1,03€;2.202,16 €;-2427;-1,03;6.726,25 €;'sin fechas';16/03/2007;'PEAJE';'Gastos_Ocio y transporte';'Parking y peaje';'VARIABLES'
23/03/2007;17/03/2007;'PEAJE RUBI';-1,96€;2.200,20 €;-2426;-1,96;6.724,29 €;'sin fechas';17/03/2007;'PEAJE';'Gastos_Ocio y transporte';'Parking y peaje';'VARIABLES'
24/03/2007;24/03/2007;'BON AREA';-14,10€;2.186,10 €;-2425;-14,10;6.710,19 €;'sin fechas';24/03/2007;'BON';'Gastos_Compras';'Supermercado';'VARIABLES'
26/03/2007;26/03/2007;'CAFET.C T PRAT';-2,45€;2.183,65 €;-2424;-2,45;6.707,74 €;'sin fechas';26/03/2007;'CAFETC';'Gastos_Ocio y transporte';'Restaurantes';'VARIABLES'
26/03/2007;26/03/2007;'GASOLINA';-12,05€;2.171,60 €;-2423;-12,05;6.695,69 €;'sin fechas';26/03/2007;'GASOLINA';'Gastos_Ocio y transporte';'Gasolina';'VARIABLES'
26/03/2007;18/03/2007;'PEAJE RUBI';-1,96€;2.169,64 €;-2422;-1,96;6.693,73 €;'sin fechas';18/03/2007;'PEAJE';'Gastos_Ocio y transporte';'Parking y peaje';'VARIABLES'
26/03/2007;18/03/2007;'PEAJE RUBI';-1,96€;2.167,68 €;-2421;-1,96;6.691,77 €;'sin fechas';18/03/2007;'PEAJE';'Gastos_Ocio y transporte';'Parking y peaje';'VARIABLES'
26/03/2007;19/03/2007;'PEAJE RUBI';-1,08€;2.166,60 €;-2420;-1,08;6.690,69 €;'sin fechas';19/03/2007;'PEAJE';'Gastos_Ocio y transporte';'Parking y peaje';'VARIABLES'
26/03/2007;19/03/2007;'PEAJE RUBI';-1,08€;2.165,52 €;-2419;-1,08;6.689,61 €;'sin fechas';19/03/2007;'PEAJE';'Gastos_Ocio y transporte';'Parking y peaje';'VARIABLES'
27/03/2007;27/03/2007;'METRO';-6,90€;2.158,62 €;-2418;-6,90;6.682,71 €;'sin fechas';27/03/2007;'METRO';'Gastos_Ocio y transporte';'Transporte';'VARIABLES'
27/03/2007;20/03/2007;'PEAJE RUBI';-1,08€;2.157,54 €;-2417;-1,08;6.681,63 €;'sin fechas';20/03/2007;'PEAJE';'Gastos_Ocio y transporte';'Parking y peaje';'VARIABLES'
27/03/2007;21/03/2007;'PEAJE RUBI';-1,08€;2.156,46 €;-2416;-1,08;6.680,55 €;'sin fechas';21/03/2007;'PEAJE';'Gastos_Ocio y transporte';'Parking y peaje';'VARIABLES'
27/03/2007;20/03/2007;'PEAJE RUBI';-1,08€;2.155,38 €;-2415;-1,08;6.679,47 €;'sin fechas';20/03/2007;'PEAJE';'Gastos_Ocio y transporte';'Parking y peaje';'VARIABLES'
27/03/2007;22/03/2007;'PEAJE RUBI';-1,08€;2.154,30 €;-2414;-1,08;6.678,39 €;'sin fechas';22/03/2007;'PEAJE';'Gastos_Ocio y transporte';'Parking y peaje';'VARIABLES'
27/03/2007;22/03/2007;'PEAJE RUBI';-1,03€;2.153,27 €;-2413;-1,03;6.677,36 €;'sin fechas';22/03/2007;'PEAJE';'Gastos_Ocio y transporte';'Parking y peaje';'VARIABLES'
27/03/2007;21/03/2007;'PEAJE RUBI';-1,08€;2.152,19 €;-2412;-1,08;6.676,28 €;'sin fechas';21/03/2007;'PEAJE';'Gastos_Ocio y transporte';'Parking y peaje';'VARIABLES'
27/03/2007;27/03/2007;'RECIBO PTMOS. 3061-0960001518';13.000,00€;15.152,19 €;-2411;13.000,00;19.676,28 €;'sin fechas';27/03/2007;'RECIBO';'Gastos_Banco y organismos';'Hipoteca';'FIJO'
27/03/2007;27/03/2007;'RECIBO PTMOS. 3061-0960001518';-234,00€;14.918,19 €;-2410;-234,00;19.442,28 €;'sin fechas';27/03/2007;'RECIBO';'Gastos_Banco y organismos';'Hipoteca';'FIJO'
27/03/2007;27/03/2007;'RECIBO PTMOS. 3061-0960001518';39,00€;14.957,19 €;-2409;39,00;19.481,28 €;'sin fechas';27/03/2007;'RECIBO';'Gastos_Banco y organismos';'Hipoteca';'FIJO'
27/03/2007;27/03/2007;'RECIBO PTMOS. 3061-0960001518';-13.619,19€;1.338,00 €;-2408;-13.619,19;5.862,09 €;'sin fechas';27/03/2007;'RECIBO';'Gastos_Banco y organismos';'Hipoteca';'FIJO'
28/03/2007;28/03/2007;'BON AREA';-7,14€;1.330,86 €;-2407;-7,14;5.854,95 €;'sin fechas';28/03/2007;'BON';'Gastos_Compras';'Supermercado';'VARIABLES'
28/03/2007;28/03/2007;'MINA PUBLICA DE LA CIUTAT';-20,88€;1.309,98 €;-2406;-20,88;5.834,07 €;'sin fechas';28/03/2007;'MINA';'Gastos_Servicios tipicos';'Agua';'FIJO'
29/03/2007;30/03/2007;'INFORMACIO I TECNOLOGIA DE CAT';1.258,10€;2.568,08 €;-2405;1.258,10;7.092,17 €;'sin fechas';30/03/2007;'INFORMACIO';'Ingresos';'Nomina';'FIJO'
30/03/2007;30/03/2007;'CAFET.C T PRAT';-2,95€;2.565,13 €;-2404;-2,95;7.089,22 €;'sin fechas';30/03/2007;'CAFETC';'Gastos_Ocio y transporte';'Restaurantes';'VARIABLES'
30/03/2007;30/03/2007;'GASOLINA';-30,00€;2.535,13 €;-2403;-30,00;7.059,22 €;'sin fechas';30/03/2007;'GASOLINA';'Gastos_Ocio y transporte';'Gasolina';'VARIABLES'
30/03/2007;23/03/2007;'PEAJE RUBI';-0,97€;2.534,16 €;-2402;-0,97;7.058,25 €;'sin fechas';23/03/2007;'PEAJE';'Gastos_Ocio y transporte';'Parking y peaje';'VARIABLES'
30/03/2007;23/03/2007;'PEAJE RUBI';-1,08€;2.533,08 €;-2401;-1,08;7.057,17 €;'sin fechas';23/03/2007;'PEAJE';'Gastos_Ocio y transporte';'Parking y peaje';'VARIABLES'
30/03/2007;30/03/2007;'RESTAURANTES';-11,10€;2.521,98 €;-2400;-11,10;7.046,07 €;'sin fechas';30/03/2007;'RESTAURANTES';'Gastos_Ocio y transporte';'Restaurantes';'VARIABLES'
30/03/2007;30/03/2007;'TOYOTA ORIENT CARS';-68,15€;2.453,83 €;-2399;-68,15;6.977,92 €;'sin fechas';30/03/2007;'TOYOTA';'Gastos_Vivienda y vehiculo';'Mnto. vehiculo';'VARIABLE'
31/03/2007;31/03/2007;'BON AREA';-23,94€;2.429,89 €;-2398;-23,94;6.953,98 €;'sin fechas';31/03/2007;'BON';'Gastos_Compras';'Supermercado';'VARIABLES'
01/04/2007;30/03/2007;'AGENCIA DE LA MICROEMPRESA';592,04€;3.021,93 €;-2397;592,04;7.546,02 €;'sin fechas';30/03/2007;'AGENCIA';'Ingresos';'Nomina';'FIJO'
01/04/2007;30/03/2007;'FUNDACIO PRIVADA';313,94€;3.335,87 €;-2396;313,94;7.859,96 €;'sin fechas';30/03/2007;'FUNDACIO';'Ingresos';'Nomina';'FIJO'
01/04/2007;01/04/2007;'RESTAURANTES';-17,33€;3.318,54 €;-2395;-17,33;7.842,63 €;'sin fechas';01/04/2007;'RESTAURANTES';'Gastos_Ocio y transporte';'Restaurantes';'VARIABLES'
02/04/2007;02/04/2007;'BON AREA';-21,57€;3.296,97 €;-2394;-21,57;7.821,06 €;'sin fechas';02/04/2007;'BON';'Gastos_Compras';'Supermercado';'VARIABLES'
02/04/2007;26/03/2007;'PEAJE RUBI';-1,08€;3.295,89 €;-2393;-1,08;7.819,98 €;'sin fechas';26/03/2007;'PEAJE';'Gastos_Ocio y transporte';'Parking y peaje';'VARIABLES'
02/04/2007;26/03/2007;'PEAJE RUBI';-1,08€;3.294,81 €;-2392;-1,08;7.818,90 €;'sin fechas';26/03/2007;'PEAJE';'Gastos_Ocio y transporte';'Parking y peaje';'VARIABLES'
02/04/2007;31/03/2007;'RECIBO PTMOS. 3061-0960001518';-759,27€;2.535,54 €;-2391;-759,27;7.059,63 €;'sin fechas';31/03/2007;'RECIBO';'Gastos_Banco y organismos';'Hipoteca';'FIJO'
04/04/2007;04/04/2007;'FRANCE TELECOM';-10,44€;2.525,10 €;-2390;-10,44;7.049,19 €;'sin fechas';04/04/2007;'FRANCE';'Gastos_Servicios tipicos';'Telecomunicaciones';'FIJO'
05/04/2007;05/04/2007;'GAS NATURAL';-142,45€;2.382,65 €;-2389;-142,45;6.906,74 €;'sin fechas';05/04/2007;'GAS';'Gastos_Servicios tipicos';'Gas';'FIJO'
05/04/2007;05/04/2007;'REINT.CAJERO';-70,00€;2.312,65 €;-2388;-70,00;6.836,74 €;'sin fechas';05/04/2007;'REINTCAJERO';'Gastos_Gastos varios';'Efectivo';'VARIABLES'
05/04/2007;05/04/2007;'SABECO TORTOSA';-70,36€;2.242,29 €;-2387;-70,36;6.766,38 €;'sin fechas';05/04/2007;'SABECO';'Gastos_Compras';'Supermercado';'VARIABLES'
05/04/2007;05/04/2007;'SEGS. CATALANA';-778,05€;1.464,24 €;-2386;-778,05;5.988,33 €;'sin fechas';05/04/2007;'SEGS';'Gastos_Seguros';'Seguro auto';'FIJO'
10/04/2007;04/04/2007;'PEAJE XERTA';-5,40€;1.458,84 €;-2385;-5,40;5.982,93 €;'sin fechas';04/04/2007;'PEAJE';'Gastos_Ocio y transporte';'Parking y peaje';'VARIABLES'
10/04/2007;04/04/2007;'PEAJE XERTA';-1,08€;1.457,76 €;-2384;-1,08;5.981,85 €;'sin fechas';04/04/2007;'PEAJE';'Gastos_Ocio y transporte';'Parking y peaje';'VARIABLES'
10/04/2007;04/04/2007;'PEAJE XERTA';-3,20€;1.454,56 €;-2383;-3,20;5.978,65 €;'sin fechas';04/04/2007;'PEAJE';'Gastos_Ocio y transporte';'Parking y peaje';'VARIABLES'
10/04/2007;04/04/2007;'PEAJE XERTA';-2,35€;1.452,21 €;-2382;-2,35;5.976,30 €;'sin fechas';04/04/2007;'PEAJE';'Gastos_Ocio y transporte';'Parking y peaje';'VARIABLES'
10/04/2007;04/04/2007;'PEAJE XERTA';-2,50€;1.449,71 €;-2381;-2,50;5.973,80 €;'sin fechas';04/04/2007;'PEAJE';'Gastos_Ocio y transporte';'Parking y peaje';'VARIABLES'
11/04/2007;11/04/2007;'QUICUINA';-14,80€;1.434,91 €;-2380;-14,80;5.959,00 €;'sin fechas';11/04/2007;'QUICUINA';'Gastos_Compras';'Supermercado';'VARIABLES'
12/04/2007;11/04/2007;'GROUPAMA PLUS';-42,57€;1.392,34 €;-2379;-42,57;5.916,43 €;'sin fechas';11/04/2007;'GROUPAMA';'Gastos_Seguros';'Seguro salud';'FIJO'
14/04/2007;14/04/2007;'BON AREA';-20,68€;1.371,66 €;-2378;-20,68;5.895,75 €;'sin fechas';14/04/2007;'BON';'Gastos_Compras';'Supermercado';'VARIABLES'
16/04/2007;16/04/2007;'FF.CC.GENERALITAT';-2,60€;1.369,06 €;-2377;-2,60;5.893,15 €;'sin fechas';16/04/2007;'FFCCGENERALITAT';'Gastos_Ocio y transporte';'Transporte';'VARIABLES'
16/04/2007;16/04/2007;'FF.CC.GENERALITAT';-2,60€;1.366,46 €;-2376;-2,60;5.890,55 €;'sin fechas';16/04/2007;'FFCCGENERALITAT';'Gastos_Ocio y transporte';'Transporte';'VARIABLES'
16/04/2007;16/04/2007;'FNAC';-42,40€;1.324,06 €;-2375;-42,40;5.848,15 €;'sin fechas';16/04/2007;'FNAC';'Gastos_Compras';'Supermercado';'VARIABLES'
16/04/2007;09/04/2007;'PEAJE XERTA';-2,50€;1.321,56 €;-2374;-2,50;5.845,65 €;'sin fechas';09/04/2007;'PEAJE';'Gastos_Ocio y transporte';'Parking y peaje';'VARIABLES'
16/04/2007;09/04/2007;'PEAJE XERTA';-2,35€;1.319,21 €;-2373;-2,35;5.843,30 €;'sin fechas';09/04/2007;'PEAJE';'Gastos_Ocio y transporte';'Parking y peaje';'VARIABLES'
16/04/2007;09/04/2007;'PEAJE XERTA';-3,20€;1.316,01 €;-2372;-3,20;5.840,10 €;'sin fechas';09/04/2007;'PEAJE';'Gastos_Ocio y transporte';'Parking y peaje';'VARIABLES'
16/04/2007;09/04/2007;'PEAJE XERTA';-5,40€;1.310,61 €;-2371;-5,40;5.834,70 €;'sin fechas';09/04/2007;'PEAJE';'Gastos_Ocio y transporte';'Parking y peaje';'VARIABLES'
16/04/2007;16/04/2007;'REINT.CAJERO';-50,00€;1.260,61 €;-2370;-50,00;5.784,70 €;'sin fechas';16/04/2007;'REINTCAJERO';'Gastos_Gastos varios';'Efectivo';'VARIABLES'
16/04/2007;16/04/2007;'SEG.AM.HIPITEC';-32,44€;1.228,17 €;-2369;-32,44;5.752,26 €;'sin fechas';16/04/2007;'SEGAMHIPITEC';'Gastos_Seguros';'Seguro vida';'FIJO'
17/04/2007;17/04/2007;'FF.CC.GENERALITAT';-2,60€;1.225,57 €;-2368;-2,60;5.749,66 €;'sin fechas';17/04/2007;'FFCCGENERALITAT';'Gastos_Ocio y transporte';'Transporte';'VARIABLES'
17/04/2007;10/04/2007;'PEAJE RUBI';-1,08€;1.224,49 €;-2367;-1,08;5.748,58 €;'sin fechas';10/04/2007;'PEAJE';'Gastos_Ocio y transporte';'Parking y peaje';'VARIABLES'
17/04/2007;12/04/2007;'PEAJE RUBI';-1,08€;1.223,41 €;-2366;-1,08;5.747,50 €;'sin fechas';12/04/2007;'PEAJE';'Gastos_Ocio y transporte';'Parking y peaje';'VARIABLES'
17/04/2007;11/04/2007;'PEAJE RUBI';-1,08€;1.222,33 €;-2365;-1,08;5.746,42 €;'sin fechas';11/04/2007;'PEAJE';'Gastos_Ocio y transporte';'Parking y peaje';'VARIABLES'
17/04/2007;11/04/2007;'PEAJE RUBI';-1,08€;1.221,25 €;-2364;-1,08;5.745,34 €;'sin fechas';11/04/2007;'PEAJE';'Gastos_Ocio y transporte';'Parking y peaje';'VARIABLES'
17/04/2007;12/04/2007;'PEAJE RUBI';-1,08€;1.220,17 €;-2363;-1,08;5.744,26 €;'sin fechas';12/04/2007;'PEAJE';'Gastos_Ocio y transporte';'Parking y peaje';'VARIABLES'
17/04/2007;10/04/2007;'PEAJE RUBI';-1,08€;1.219,09 €;-2362;-1,08;5.743,18 €;'sin fechas';10/04/2007;'PEAJE';'Gastos_Ocio y transporte';'Parking y peaje';'VARIABLES'
18/04/2007;18/04/2007;'CAFET.C T PRAT';-2,00€;1.217,09 €;-2361;-2,00;5.741,18 €;'sin fechas';18/04/2007;'CAFETC';'Gastos_Ocio y transporte';'Restaurantes';'VARIABLES'
18/04/2007;18/04/2007;'CAFET.C T PRAT';-1,55€;1.215,54 €;-2360;-1,55;5.739,63 €;'sin fechas';18/04/2007;'CAFETC';'Gastos_Ocio y transporte';'Restaurantes';'VARIABLES'
18/04/2007;18/04/2007;'GASOLINA';-20,00€;1.195,54 €;-2359;-20,00;5.719,63 €;'sin fechas';18/04/2007;'GASOLINA';'Gastos_Ocio y transporte';'Gasolina';'VARIABLES'
19/04/2007;19/04/2007;'FARMACIA';-11,88€;1.183,66 €;-2358;-11,88;5.707,75 €;'sin fechas';19/04/2007;'FARMACIA';'Gastos_Salud, saber y deporte';'Farmacia';'VARIABLES'
19/04/2007;19/04/2007;'ONO';-71,53€;1.112,13 €;-2357;-71,53;5.636,22 €;'sin fechas';19/04/2007;'ONO';'Gastos_Servicios tipicos';'Telecomunicaciones';'FIJO'
20/04/2007;20/04/2007;'CAFET.C T PRAT';-1,70€;1.110,43 €;-2356;-1,70;5.634,52 €;'sin fechas';20/04/2007;'CAFETC';'Gastos_Ocio y transporte';'Restaurantes';'VARIABLES'
20/04/2007;20/04/2007;'REINT.CAJERO';-20,00€;1.090,43 €;-2355;-20,00;5.614,52 €;'sin fechas';20/04/2007;'REINTCAJERO';'Gastos_Gastos varios';'Efectivo';'VARIABLES'
21/04/2007;21/04/2007;'BON AREA';-17,43€;1.073,00 €;-2354;-17,43;5.597,09 €;'sin fechas';21/04/2007;'BON';'Gastos_Compras';'Supermercado';'VARIABLES'
21/04/2007;21/04/2007;'MEDIA MARKT';-17,90€;1.055,10 €;-2353;-17,90;5.579,19 €;'sin fechas';21/04/2007;'MEDIA';'Gastos_Compras';'Hobbys';'VARIABLES'
21/04/2007;21/04/2007;'RESTAURANTES';-28,09€;1.027,01 €;-2352;-28,09;5.551,10 €;'sin fechas';21/04/2007;'RESTAURANTES';'Gastos_Ocio y transporte';'Restaurantes';'VARIABLES'
23/04/2007;23/04/2007;'CAFET.C T PRAT';-1,55€;1.025,46 €;-2351;-1,55;5.549,55 €;'sin fechas';23/04/2007;'CAFETC';'Gastos_Ocio y transporte';'Restaurantes';'VARIABLES'
24/04/2007;24/04/2007;'FRANCE TELECOM';-24,91€;1.000,55 €;-2350;-24,91;5.524,64 €;'sin fechas';24/04/2007;'FRANCE';'Gastos_Servicios tipicos';'Telecomunicaciones';'FIJO'
24/04/2007;18/04/2007;'PEAJE RUBI';-1,08€;999,47 €;-2349;-1,08;5.523,56 €;'sin fechas';18/04/2007;'PEAJE';'Gastos_Ocio y transporte';'Parking y peaje';'VARIABLES'
24/04/2007;19/04/2007;'PEAJE RUBI';-1,08€;998,39 €;-2348;-1,08;5.522,48 €;'sin fechas';19/04/2007;'PEAJE';'Gastos_Ocio y transporte';'Parking y peaje';'VARIABLES'
24/04/2007;18/04/2007;'PEAJE RUBI';-1,08€;997,31 €;-2347;-1,08;5.521,40 €;'sin fechas';18/04/2007;'PEAJE';'Gastos_Ocio y transporte';'Parking y peaje';'VARIABLES'
24/04/2007;19/04/2007;'PEAJE RUBI';-2,10€;995,21 €;-2346;-2,10;5.519,30 €;'sin fechas';19/04/2007;'PEAJE';'Gastos_Ocio y transporte';'Parking y peaje';'VARIABLES'
24/04/2007;24/04/2007;'PLATAFORMA CARNICA TERRASSA ES';-39,97€;955,24 €;-2345;-39,97;5.479,33 €;'sin fechas';24/04/2007;'PLATAFORMA';'Gastos_Compras';'Supermercado';'VARIABLES'
25/04/2007;25/04/2007;'CAFET.C T PRAT';-2,10€;953,14 €;-2344;-2,10;5.477,23 €;'sin fechas';25/04/2007;'CAFETC';'Gastos_Ocio y transporte';'Restaurantes';'VARIABLES'
25/04/2007;25/04/2007;'GASOLINA';-29,29€;923,85 €;-2343;-29,29;5.447,94 €;'sin fechas';25/04/2007;'GASOLINA';'Gastos_Ocio y transporte';'Gasolina';'VARIABLES'
26/04/2007;26/04/2007;'MERCADONA';-112,71€;811,14 €;-2342;-112,71;5.335,23 €;'sin fechas';26/04/2007;'MERCADONA';'Gastos_Compras';'Supermercado';'VARIABLES'
27/04/2007;27/04/2007;'BRICOKING TERRASSA';-13,60€;797,54 €;-2341;-13,60;5.321,63 €;'sin fechas';27/04/2007;'BRICOKING';'Gastos_Vivienda y vehiculo';'Mnto. hogar';'VARIABLES'
27/04/2007;21/04/2007;'OTROS';-4,10€;793,44 €;-2340;-4,10;5.317,53 €;'sin fechas';21/04/2007;'OTROS';'Gastos_Gastos varios';'Otros gastos';'VARIABLES'
27/04/2007;20/04/2007;'PEAJE RUBI';-1,08€;792,36 €;-2339;-1,08;5.316,45 €;'sin fechas';20/04/2007;'PEAJE';'Gastos_Ocio y transporte';'Parking y peaje';'VARIABLES'
27/04/2007;20/04/2007;'PEAJE RUBI';-1,08€;791,28 €;-2338;-1,08;5.315,37 €;'sin fechas';20/04/2007;'PEAJE';'Gastos_Ocio y transporte';'Parking y peaje';'VARIABLES'
27/04/2007;27/04/2007;'REINT.CAJERO';-20,00€;771,28 €;-2337;-20,00;5.295,37 €;'sin fechas';27/04/2007;'REINTCAJERO';'Gastos_Gastos varios';'Efectivo';'VARIABLES'
27/04/2007;27/04/2007;'RESTAURANTES';-19,05€;752,23 €;-2336;-19,05;5.276,32 €;'sin fechas';27/04/2007;'RESTAURANTES';'Gastos_Ocio y transporte';'Restaurantes';'VARIABLES'
28/04/2007;30/04/2007;'AGENCIA DE LA MICROEMPRESA';885,30€;1.637,53 €;-2335;885,30;6.161,62 €;'sin fechas';30/04/2007;'AGENCIA';'Ingresos';'Nomina';'FIJO'
28/04/2007;30/04/2007;'INFORMACIO I TECNOLOGIA DE CAT';1.743,62€;3.381,15 €;-2334;1.743,62;7.905,24 €;'sin fechas';30/04/2007;'INFORMACIO';'Ingresos';'Nomina';'FIJO'
30/04/2007;30/04/2007;'RECIBO PTMOS. 3061-0960001518';-184,82€;3.196,33 €;-2333;-184,82;7.720,42 €;'sin fechas';30/04/2007;'RECIBO';'Gastos_Banco y organismos';'Hipoteca';'FIJO'
30/04/2007;30/04/2007;'RECIBO PTMOS. 3061-0960001518';-759,27€;2.437,06 €;-2332;-759,27;6.961,15 €;'sin fechas';30/04/2007;'RECIBO';'Gastos_Banco y organismos';'Hipoteca';'FIJO'
02/05/2007;02/05/2007;'AJUNTAMENT DE TERRASSA';-51,36€;2.385,70 €;-2331;-51,36;6.909,79 €;'sin fechas';02/05/2007;'AJUNTAMENT';'Gastos_Banco y organismos';'Ayuntamiento';'FIJO'
02/05/2007;02/05/2007;'CAFET.C T PRAT';-2,10€;2.383,60 €;-2330;-2,10;6.907,69 €;'sin fechas';02/05/2007;'CAFETC';'Gastos_Ocio y transporte';'Restaurantes';'VARIABLES'
02/05/2007;26/04/2007;'OTROS';-16,10€;2.367,50 €;-2329;-16,10;6.891,59 €;'sin fechas';26/04/2007;'OTROS';'Gastos_Gastos varios';'Otros gastos';'VARIABLES'
02/05/2007;24/04/2007;'PEAJE RUBI';-1,08€;2.366,42 €;-2328;-1,08;6.890,51 €;'sin fechas';24/04/2007;'PEAJE';'Gastos_Ocio y transporte';'Parking y peaje';'VARIABLES'
02/05/2007;24/04/2007;'PEAJE RUBI';-1,08€;2.365,34 €;-2327;-1,08;6.889,43 €;'sin fechas';24/04/2007;'PEAJE';'Gastos_Ocio y transporte';'Parking y peaje';'VARIABLES'
02/05/2007;23/04/2007;'PEAJE RUBI';-1,08€;2.364,26 €;-2326;-1,08;6.888,35 €;'sin fechas';23/04/2007;'PEAJE';'Gastos_Ocio y transporte';'Parking y peaje';'VARIABLES'
02/05/2007;23/04/2007;'PEAJE RUBI';-1,08€;2.363,18 €;-2325;-1,08;6.887,27 €;'sin fechas';23/04/2007;'PEAJE';'Gastos_Ocio y transporte';'Parking y peaje';'VARIABLES'
02/05/2007;25/04/2007;'PEAJE RUBI';-1,08€;2.362,10 €;-2324;-1,08;6.886,19 €;'sin fechas';25/04/2007;'PEAJE';'Gastos_Ocio y transporte';'Parking y peaje';'VARIABLES'
02/05/2007;25/04/2007;'PEAJE RUBI';-1,08€;2.361,02 €;-2323;-1,08;6.885,11 €;'sin fechas';25/04/2007;'PEAJE';'Gastos_Ocio y transporte';'Parking y peaje';'VARIABLES'
02/05/2007;02/05/2007;'REINT.CAJERO';-200,00€;2.161,02 €;-2322;-200,00;6.685,11 €;'sin fechas';02/05/2007;'REINTCAJERO';'Gastos_Gastos varios';'Efectivo';'VARIABLES'
04/05/2007;04/05/2007;'BON AREA';-21,99€;2.139,03 €;-2321;-21,99;6.663,12 €;'sin fechas';04/05/2007;'BON';'Gastos_Compras';'Supermercado';'VARIABLES'
04/05/2007;04/05/2007;'FRANCE TELECOM';-12,01€;2.127,02 €;-2320;-12,01;6.651,11 €;'sin fechas';04/05/2007;'FRANCE';'Gastos_Servicios tipicos';'Telecomunicaciones';'FIJO'
07/05/2007;07/05/2007;'DECATHLON';-18,00€;2.109,02 €;-2319;-18,00;6.633,11 €;'sin fechas';07/05/2007;'DECATHLON';'Gastos_Compras';'Deportivo';'VARIABLES'
08/05/2007;03/05/2007;'PEAJE RUBI';-1,08€;2.107,94 €;-2318;-1,08;6.632,03 €;'sin fechas';03/05/2007;'PEAJE';'Gastos_Ocio y transporte';'Parking y peaje';'VARIABLES'
08/05/2007;02/05/2007;'PEAJE RUBI';-1,08€;2.106,86 €;-2317;-1,08;6.630,95 €;'sin fechas';02/05/2007;'PEAJE';'Gastos_Ocio y transporte';'Parking y peaje';'VARIABLES'
08/05/2007;02/05/2007;'PEAJE RUBI';-1,08€;2.105,78 €;-2316;-1,08;6.629,87 €;'sin fechas';02/05/2007;'PEAJE';'Gastos_Ocio y transporte';'Parking y peaje';'VARIABLES'
08/05/2007;03/05/2007;'PEAJE RUBI';-1,08€;2.104,70 €;-2315;-1,08;6.628,79 €;'sin fechas';03/05/2007;'PEAJE';'Gastos_Ocio y transporte';'Parking y peaje';'VARIABLES'
08/05/2007;08/05/2007;'REINT.CAJERO';-20,00€;2.084,70 €;-2314;-20,00;6.608,79 €;'sin fechas';08/05/2007;'REINTCAJERO';'Gastos_Gastos varios';'Efectivo';'VARIABLES'
08/05/2007;08/05/2007;'REINT.CAJERO';-2,40€;2.082,30 €;-2313;-2,40;6.606,39 €;'sin fechas';08/05/2007;'REINTCAJERO';'Gastos_Gastos varios';'Efectivo';'VARIABLES'
08/05/2007;08/05/2007;'REINT.CAJERO';20,00€;2.102,30 €;-2312;20,00;6.626,39 €;'sin fechas';08/05/2007;'REINTCAJERO';'Gastos_Gastos varios';'Efectivo';'VARIABLES'
08/05/2007;08/05/2007;'REINT.CAJERO';2,40€;2.104,70 €;-2311;2,40;6.628,79 €;'sin fechas';08/05/2007;'REINTCAJERO';'Gastos_Gastos varios';'Efectivo';'VARIABLES'
08/05/2007;08/05/2007;'REINT.CAJERO';-20,00€;2.084,70 €;-2310;-20,00;6.608,79 €;'sin fechas';08/05/2007;'REINTCAJERO';'Gastos_Gastos varios';'Efectivo';'VARIABLES'
09/05/2007;09/05/2007;'GASOLINA';-42,77€;2.041,93 €;-2309;-42,77;6.566,02 €;'sin fechas';09/05/2007;'GASOLINA';'Gastos_Ocio y transporte';'Gasolina';'VARIABLES'
10/05/2007;10/05/2007;'CINE';-9,60€;2.032,33 €;-2308;-9,60;6.556,42 €;'sin fechas';10/05/2007;'CINE';'Gastos_Ocio y transporte';'Espectáculos';'VARIABLES'
11/05/2007;11/05/2007;'GROUPAMA PLUS';-42,57€;1.989,76 €;-2307;-42,57;6.513,85 €;'sin fechas';11/05/2007;'GROUPAMA';'Gastos_Seguros';'Seguro salud';'FIJO'
11/05/2007;04/05/2007;'PEAJE RUBI';-1,08€;1.988,68 €;-2306;-1,08;6.512,77 €;'sin fechas';04/05/2007;'PEAJE';'Gastos_Ocio y transporte';'Parking y peaje';'VARIABLES'
11/05/2007;04/05/2007;'PEAJE RUBI';-1,08€;1.987,60 €;-2305;-1,08;6.511,69 €;'sin fechas';04/05/2007;'PEAJE';'Gastos_Ocio y transporte';'Parking y peaje';'VARIABLES'
12/05/2007;12/05/2007;'LOLA VIDAL CABELL';-45,00€;1.942,60 €;-2304;-45,00;6.466,69 €;'sin fechas';12/05/2007;'LOLA';'Gastos_Ocio y transporte';'Restaurantes';'VARIABLES'
12/05/2007;12/05/2007;'M&S';-10,00€;1.932,60 €;-2303;-10,00;6.456,69 €;'sin fechas';12/05/2007;'MS';'Gastos_Compras';'Ropa';'VARIABLES'
14/05/2007;14/05/2007;'CAFET.C T PRAT';-2,45€;1.930,15 €;-2302;-2,45;6.454,24 €;'sin fechas';14/05/2007;'CAFETC';'Gastos_Ocio y transporte';'Restaurantes';'VARIABLES'
15/05/2007;07/05/2007;'PEAJE RUBI';-1,08€;1.929,07 €;-2301;-1,08;6.453,16 €;'sin fechas';07/05/2007;'PEAJE';'Gastos_Ocio y transporte';'Parking y peaje';'VARIABLES'
15/05/2007;08/05/2007;'PEAJE RUBI';-1,08€;1.927,99 €;-2300;-1,08;6.452,08 €;'sin fechas';08/05/2007;'PEAJE';'Gastos_Ocio y transporte';'Parking y peaje';'VARIABLES'
15/05/2007;08/05/2007;'PEAJE RUBI';-1,08€;1.926,91 €;-2299;-1,08;6.451,00 €;'sin fechas';08/05/2007;'PEAJE';'Gastos_Ocio y transporte';'Parking y peaje';'VARIABLES'
15/05/2007;07/05/2007;'PEAJE RUBI';-1,08€;1.925,83 €;-2298;-1,08;6.449,92 €;'sin fechas';07/05/2007;'PEAJE';'Gastos_Ocio y transporte';'Parking y peaje';'VARIABLES'
15/05/2007;10/05/2007;'PEAJE RUBI';-1,08€;1.924,75 €;-2297;-1,08;6.448,84 €;'sin fechas';10/05/2007;'PEAJE';'Gastos_Ocio y transporte';'Parking y peaje';'VARIABLES'
15/05/2007;10/05/2007;'PEAJE RUBI';-1,08€;1.923,67 €;-2296;-1,08;6.447,76 €;'sin fechas';10/05/2007;'PEAJE';'Gastos_Ocio y transporte';'Parking y peaje';'VARIABLES'
15/05/2007;09/05/2007;'PEAJE RUBI';-1,08€;1.922,59 €;-2295;-1,08;6.446,68 €;'sin fechas';09/05/2007;'PEAJE';'Gastos_Ocio y transporte';'Parking y peaje';'VARIABLES'
15/05/2007;09/05/2007;'PEAJE RUBI';-1,08€;1.921,51 €;-2294;-1,08;6.445,60 €;'sin fechas';09/05/2007;'PEAJE';'Gastos_Ocio y transporte';'Parking y peaje';'VARIABLES'
15/05/2007;15/05/2007;'RENFE';-2,50€;1.919,01 €;-2293;-2,50;6.443,10 €;'sin fechas';15/05/2007;'RENFE';'Gastos_Ocio y transporte';'Transporte';'VARIABLES'
15/05/2007;15/05/2007;'SEG.AM.HIPITEC';-32,38€;1.886,63 €;-2292;-32,38;6.410,72 €;'sin fechas';15/05/2007;'SEGAMHIPITEC';'Gastos_Seguros';'Seguro vida';'FIJO'
16/05/2007;16/05/2007;'BON AREA';-30,86€;1.855,77 €;-2291;-30,86;6.379,86 €;'sin fechas';16/05/2007;'BON';'Gastos_Compras';'Supermercado';'VARIABLES'
16/05/2007;16/05/2007;'CAFET.C T PRAT';-5,25€;1.850,52 €;-2290;-5,25;6.374,61 €;'sin fechas';16/05/2007;'CAFETC';'Gastos_Ocio y transporte';'Restaurantes';'VARIABLES'
16/05/2007;16/05/2007;'javier martinez monche COMPRA NUEVO COCHE';-46,22€;1.804,30 €;-2289;-46,22;6.328,39 €;'sin fechas';16/05/2007;'JAVIER';'Gastos_Vivienda y vehiculo';'Mnto. vehiculo';'VARIABLE'
17/05/2007;17/05/2007;'ENDESA DISTRIB';-79,40€;1.724,90 €;-2288;-79,40;6.248,99 €;'sin fechas';17/05/2007;'ENDESA';'Gastos_Servicios tipicos';'Electricidad';'FIJO'
17/05/2007;17/05/2007;'FF.CC.GENERALITAT';-1,85€;1.723,05 €;-2287;-1,85;6.247,14 €;'sin fechas';17/05/2007;'FFCCGENERALITAT';'Gastos_Ocio y transporte';'Transporte';'VARIABLES'
17/05/2007;17/05/2007;'REINT.CAJERO';-20,00€;1.703,05 €;-2286;-20,00;6.227,14 €;'sin fechas';17/05/2007;'REINTCAJERO';'Gastos_Gastos varios';'Efectivo';'VARIABLES'
18/05/2007;11/05/2007;'PEAJE RUBI';-1,08€;1.701,97 €;-2285;-1,08;6.226,06 €;'sin fechas';11/05/2007;'PEAJE';'Gastos_Ocio y transporte';'Parking y peaje';'VARIABLES'
18/05/2007;11/05/2007;'PEAJE RUBI';-1,08€;1.700,89 €;-2284;-1,08;6.224,98 €;'sin fechas';11/05/2007;'PEAJE';'Gastos_Ocio y transporte';'Parking y peaje';'VARIABLES'
19/05/2007;19/05/2007;'CARREFOUR-[comida]';-12,37€;1.688,52 €;-2283;-12,37;6.212,61 €;'sin fechas';19/05/2007;'CARREFOURCOMIDA';'Gastos_Compras';'Supermercado';'VARIABLES'
19/05/2007;19/05/2007;'GASOLINA';-30,00€;1.658,52 €;-2282;-30,00;6.182,61 €;'sin fechas';19/05/2007;'GASOLINA';'Gastos_Ocio y transporte';'Gasolina';'VARIABLES'
19/05/2007;19/05/2007;'pepoptic s.l. barcelona es';-106,13€;1.552,39 €;-2281;-106,13;6.076,48 €;'sin fechas';19/05/2007;'PEPOPTIC';'Gastos_Compras';'Ropa';'VARIABLES'
19/05/2007;19/05/2007;'SUPER DE CARN TOT';-31,48€;1.520,91 €;-2280;-31,48;6.045,00 €;'sin fechas';19/05/2007;'SUPER';'Gastos_Compras';'Supermercado';'VARIABLES'
21/05/2007;21/05/2007;'CAFET.C T PRAT';-2,45€;1.518,46 €;-2279;-2,45;6.042,55 €;'sin fechas';21/05/2007;'CAFETC';'Gastos_Ocio y transporte';'Restaurantes';'VARIABLES'
22/05/2007;17/05/2007;'PEAJE RUBI';-1,08€;1.517,38 €;-2278;-1,08;6.041,47 €;'sin fechas';17/05/2007;'PEAJE';'Gastos_Ocio y transporte';'Parking y peaje';'VARIABLES'
22/05/2007;15/05/2007;'PEAJE RUBI';-1,08€;1.516,30 €;-2277;-1,08;6.040,39 €;'sin fechas';15/05/2007;'PEAJE';'Gastos_Ocio y transporte';'Parking y peaje';'VARIABLES'
22/05/2007;15/05/2007;'PEAJE RUBI';-1,08€;1.515,22 €;-2276;-1,08;6.039,31 €;'sin fechas';15/05/2007;'PEAJE';'Gastos_Ocio y transporte';'Parking y peaje';'VARIABLES'
22/05/2007;14/05/2007;'PEAJE RUBI';-1,08€;1.514,14 €;-2275;-1,08;6.038,23 €;'sin fechas';14/05/2007;'PEAJE';'Gastos_Ocio y transporte';'Parking y peaje';'VARIABLES'
22/05/2007;16/05/2007;'PEAJE RUBI';-1,08€;1.513,06 €;-2274;-1,08;6.037,15 €;'sin fechas';16/05/2007;'PEAJE';'Gastos_Ocio y transporte';'Parking y peaje';'VARIABLES'
22/05/2007;17/05/2007;'PEAJE RUBI';-1,08€;1.511,98 €;-2273;-1,08;6.036,07 €;'sin fechas';17/05/2007;'PEAJE';'Gastos_Ocio y transporte';'Parking y peaje';'VARIABLES'
22/05/2007;14/05/2007;'PEAJE RUBI';-1,08€;1.510,90 €;-2272;-1,08;6.034,99 €;'sin fechas';14/05/2007;'PEAJE';'Gastos_Ocio y transporte';'Parking y peaje';'VARIABLES'
22/05/2007;16/05/2007;'PEAJE RUBI';-1,08€;1.509,82 €;-2271;-1,08;6.033,91 €;'sin fechas';16/05/2007;'PEAJE';'Gastos_Ocio y transporte';'Parking y peaje';'VARIABLES'
22/05/2007;22/05/2007;'RENFE';-2,50€;1.507,32 €;-2270;-2,50;6.031,41 €;'sin fechas';22/05/2007;'RENFE';'Gastos_Ocio y transporte';'Transporte';'VARIABLES'
22/05/2007;22/05/2007;'RENFE';-2,50€;1.504,82 €;-2269;-2,50;6.028,91 €;'sin fechas';22/05/2007;'RENFE';'Gastos_Ocio y transporte';'Transporte';'VARIABLES'
22/05/2007;22/05/2007;'RENFE';2,50€;1.507,32 €;-2268;2,50;6.031,41 €;'sin fechas';22/05/2007;'RENFE';'Gastos_Ocio y transporte';'Transporte';'VARIABLES'
23/05/2007;23/05/2007;'FF.CC.GENERALITAT';-1,85€;1.505,47 €;-2267;-1,85;6.029,56 €;'sin fechas';23/05/2007;'FFCCGENERALITAT';'Gastos_Ocio y transporte';'Transporte';'VARIABLES'
23/05/2007;23/05/2007;'FF.CC.GENERALITAT';-1,85€;1.503,62 €;-2266;-1,85;6.027,71 €;'sin fechas';23/05/2007;'FFCCGENERALITAT';'Gastos_Ocio y transporte';'Transporte';'VARIABLES'
23/05/2007;23/05/2007;'FRANCE TELECOM';-15,36€;1.488,26 €;-2265;-15,36;6.012,35 €;'sin fechas';23/05/2007;'FRANCE';'Gastos_Servicios tipicos';'Telecomunicaciones';'FIJO'
23/05/2007;23/05/2007;'REINT.CAJERO';-20,00€;1.468,26 €;-2264;-20,00;5.992,35 €;'sin fechas';23/05/2007;'REINTCAJERO';'Gastos_Gastos varios';'Efectivo';'VARIABLES'
24/05/2007;24/05/2007;'CAFET.C T PRAT';-2,50€;1.465,76 €;-2263;-2,50;5.989,85 €;'sin fechas';24/05/2007;'CAFETC';'Gastos_Ocio y transporte';'Restaurantes';'VARIABLES'
24/05/2007;24/05/2007;'REINT.CAJERO';-20,00€;1.445,76 €;-2262;-20,00;5.969,85 €;'sin fechas';24/05/2007;'REINTCAJERO';'Gastos_Gastos varios';'Efectivo';'VARIABLES'
25/05/2007;25/05/2007;'BON AREA';-22,50€;1.423,26 €;-2261;-22,50;5.947,35 €;'sin fechas';25/05/2007;'BON';'Gastos_Compras';'Supermercado';'VARIABLES'
25/05/2007;25/05/2007;'CAFET.C T PRAT';-2,45€;1.420,81 €;-2260;-2,45;5.944,90 €;'sin fechas';25/05/2007;'CAFETC';'Gastos_Ocio y transporte';'Restaurantes';'VARIABLES'
25/05/2007;18/05/2007;'PEAJE RUBI';-1,08€;1.419,73 €;-2259;-1,08;5.943,82 €;'sin fechas';18/05/2007;'PEAJE';'Gastos_Ocio y transporte';'Parking y peaje';'VARIABLES'
25/05/2007;18/05/2007;'PEAJE RUBI';-1,08€;1.418,65 €;-2258;-1,08;5.942,74 €;'sin fechas';18/05/2007;'PEAJE';'Gastos_Ocio y transporte';'Parking y peaje';'VARIABLES'
26/05/2007;26/05/2007;'pepoptic s.l. barcelona es';-200,00€;1.218,65 €;-2257;-200,00;5.742,74 €;'sin fechas';26/05/2007;'PEPOPTIC';'Gastos_Compras';'Ropa';'VARIABLES'
26/05/2007;26/05/2007;'REINT.CAJERO';-20,00€;1.198,65 €;-2256;-20,00;5.722,74 €;'sin fechas';26/05/2007;'REINTCAJERO';'Gastos_Gastos varios';'Efectivo';'VARIABLES'
28/05/2007;28/05/2007;'CINE';-9,60€;1.189,05 €;-2255;-9,60;5.713,14 €;'sin fechas';28/05/2007;'CINE';'Gastos_Ocio y transporte';'Espectáculos';'VARIABLES'
29/05/2007;29/05/2007;'GASOLINA';-32,05€;1.157,00 €;-2254;-32,05;5.681,09 €;'sin fechas';29/05/2007;'GASOLINA';'Gastos_Ocio y transporte';'Gasolina';'VARIABLES'
29/05/2007;22/05/2007;'PEAJE RUBI';-1,08€;1.155,92 €;-2253;-1,08;5.680,01 €;'sin fechas';22/05/2007;'PEAJE';'Gastos_Ocio y transporte';'Parking y peaje';'VARIABLES'
29/05/2007;22/05/2007;'PEAJE RUBI';-1,08€;1.154,84 €;-2252;-1,08;5.678,93 €;'sin fechas';22/05/2007;'PEAJE';'Gastos_Ocio y transporte';'Parking y peaje';'VARIABLES'
29/05/2007;24/05/2007;'PEAJE RUBI';-1,08€;1.153,76 €;-2251;-1,08;5.677,85 €;'sin fechas';24/05/2007;'PEAJE';'Gastos_Ocio y transporte';'Parking y peaje';'VARIABLES'
29/05/2007;21/05/2007;'PEAJE RUBI';-1,08€;1.152,68 €;-2250;-1,08;5.676,77 €;'sin fechas';21/05/2007;'PEAJE';'Gastos_Ocio y transporte';'Parking y peaje';'VARIABLES'
29/05/2007;23/05/2007;'PEAJE RUBI';-1,08€;1.151,60 €;-2249;-1,08;5.675,69 €;'sin fechas';23/05/2007;'PEAJE';'Gastos_Ocio y transporte';'Parking y peaje';'VARIABLES'
29/05/2007;21/05/2007;'PEAJE RUBI';-1,08€;1.150,52 €;-2248;-1,08;5.674,61 €;'sin fechas';21/05/2007;'PEAJE';'Gastos_Ocio y transporte';'Parking y peaje';'VARIABLES'
29/05/2007;23/05/2007;'PEAJE RUBI';-1,08€;1.149,44 €;-2247;-1,08;5.673,53 €;'sin fechas';23/05/2007;'PEAJE';'Gastos_Ocio y transporte';'Parking y peaje';'VARIABLES'
29/05/2007;24/05/2007;'PEAJE RUBI';-1,08€;1.148,36 €;-2246;-1,08;5.672,45 €;'sin fechas';24/05/2007;'PEAJE';'Gastos_Ocio y transporte';'Parking y peaje';'VARIABLES'
29/05/2007;29/05/2007;'REINT.CAJERO';-200,00€;948,36 €;-2245;-200,00;5.472,45 €;'sin fechas';29/05/2007;'REINTCAJERO';'Gastos_Gastos varios';'Efectivo';'VARIABLES'
29/05/2007;29/05/2007;'RENFE';-2,50€;945,86 €;-2244;-2,50;5.469,95 €;'sin fechas';29/05/2007;'RENFE';'Gastos_Ocio y transporte';'Transporte';'VARIABLES'
29/05/2007;29/05/2007;'RENFE';-2,50€;943,36 €;-2243;-2,50;5.467,45 €;'sin fechas';29/05/2007;'RENFE';'Gastos_Ocio y transporte';'Transporte';'VARIABLES'
30/05/2007;30/05/2007;'CAFET.C T PRAT';-2,75€;940,61 €;-2242;-2,75;5.464,70 €;'sin fechas';30/05/2007;'CAFETC';'Gastos_Ocio y transporte';'Restaurantes';'VARIABLES'
30/05/2007;31/05/2007;'INFORMACIO I TECNOLOGIA DE CAT';1.258,10€;2.198,71 €;-2241;1.258,10;6.722,80 €;'sin fechas';31/05/2007;'INFORMACIO';'Ingresos';'Nomina';'FIJO'
31/05/2007;31/05/2007;'RECIBO PTMOS. 3061-0960004140';-177,24€;2.021,47 €;-2240;-177,24;6.545,56 €;'sin fechas';31/05/2007;'RECIBO';'Gastos_Banco y organismos';'Hipoteca';'FIJO'
31/05/2007;31/05/2007;'RECIBO PTMOS. 3061-0960001518';-759,27€;1.262,20 €;-2239;-759,27;5.786,29 €;'sin fechas';31/05/2007;'RECIBO';'Gastos_Banco y organismos';'Hipoteca';'FIJO'
31/05/2007;31/05/2007;'RENFE';-2,50€;1.259,70 €;-2238;-2,50;5.783,79 €;'sin fechas';31/05/2007;'RENFE';'Gastos_Ocio y transporte';'Transporte';'VARIABLES'
01/06/2007;01/06/2007;'FARMACIA';-3,00€;1.256,70 €;-2237;-3,00;5.780,79 €;'sin fechas';01/06/2007;'FARMACIA';'Gastos_Salud, saber y deporte';'Farmacia';'VARIABLES'
01/06/2007;01/06/2007;'MERCADONA';-10,33€;1.246,37 €;-2236;-10,33;5.770,46 €;'sin fechas';01/06/2007;'MERCADONA';'Gastos_Compras';'Supermercado';'VARIABLES'
01/06/2007;25/05/2007;'PEAJE RUBI';-1,03€;1.245,34 €;-2235;-1,03;5.769,43 €;'sin fechas';25/05/2007;'PEAJE';'Gastos_Ocio y transporte';'Parking y peaje';'VARIABLES'
01/06/2007;25/05/2007;'PEAJE RUBI';-1,03€;1.244,31 €;-2234;-1,03;5.768,40 €;'sin fechas';25/05/2007;'PEAJE';'Gastos_Ocio y transporte';'Parking y peaje';'VARIABLES'
02/06/2007;31/05/2007;'AGENCIA DE LA MICROEMPRESA';885,30€;2.129,61 €;-2233;885,30;6.653,70 €;'sin fechas';31/05/2007;'AGENCIA';'Ingresos';'Nomina';'FIJO'
03/06/2007;03/06/2007;'RESTAURANTES';-12,50€;2.117,11 €;-2232;-12,50;6.641,20 €;'sin fechas';03/06/2007;'RESTAURANTES';'Gastos_Ocio y transporte';'Restaurantes';'VARIABLES'
05/06/2007;05/06/2007;'FRANCE TELECOM';-13,83€;2.103,28 €;-2231;-13,83;6.627,37 €;'sin fechas';05/06/2007;'FRANCE';'Gastos_Servicios tipicos';'Telecomunicaciones';'FIJO'
05/06/2007;05/06/2007;'GAS NATURAL';-142,45€;1.960,83 €;-2230;-142,45;6.484,92 €;'sin fechas';05/06/2007;'GAS';'Gastos_Servicios tipicos';'Gas';'FIJO'
05/06/2007;01/05/2007;'ONO';-66,74€;1.894,09 €;-2229;-66,74;6.418,18 €;'sin fechas';01/05/2007;'ONO';'Gastos_Servicios tipicos';'Telecomunicaciones';'FIJO'
05/06/2007;28/05/2007;'PEAJE RUBI';-1,08€;1.893,01 €;-2228;-1,08;6.417,10 €;'sin fechas';28/05/2007;'PEAJE';'Gastos_Ocio y transporte';'Parking y peaje';'VARIABLES'
05/06/2007;30/05/2007;'PEAJE RUBI';-1,08€;1.891,93 €;-2227;-1,08;6.416,02 €;'sin fechas';30/05/2007;'PEAJE';'Gastos_Ocio y transporte';'Parking y peaje';'VARIABLES'
05/06/2007;29/05/2007;'PEAJE RUBI';-1,08€;1.890,85 €;-2226;-1,08;6.414,94 €;'sin fechas';29/05/2007;'PEAJE';'Gastos_Ocio y transporte';'Parking y peaje';'VARIABLES'
05/06/2007;31/05/2007;'PEAJE RUBI';-1,08€;1.889,77 €;-2225;-1,08;6.413,86 €;'sin fechas';31/05/2007;'PEAJE';'Gastos_Ocio y transporte';'Parking y peaje';'VARIABLES'
05/06/2007;29/05/2007;'PEAJE RUBI';-1,08€;1.888,69 €;-2224;-1,08;6.412,78 €;'sin fechas';29/05/2007;'PEAJE';'Gastos_Ocio y transporte';'Parking y peaje';'VARIABLES'
05/06/2007;31/05/2007;'PEAJE RUBI';-1,03€;1.887,66 €;-2223;-1,03;6.411,75 €;'sin fechas';31/05/2007;'PEAJE';'Gastos_Ocio y transporte';'Parking y peaje';'VARIABLES'
05/06/2007;28/05/2007;'PEAJE RUBI';-1,08€;1.886,58 €;-2222;-1,08;6.410,67 €;'sin fechas';28/05/2007;'PEAJE';'Gastos_Ocio y transporte';'Parking y peaje';'VARIABLES'
05/06/2007;30/05/2007;'PEAJE RUBI';-1,08€;1.885,50 €;-2221;-1,08;6.409,59 €;'sin fechas';30/05/2007;'PEAJE';'Gastos_Ocio y transporte';'Parking y peaje';'VARIABLES'
05/06/2007;05/06/2007;'REINT.CAJERO';-20,00€;1.865,50 €;-2220;-20,00;6.389,59 €;'sin fechas';05/06/2007;'REINTCAJERO';'Gastos_Gastos varios';'Efectivo';'VARIABLES'
05/06/2007;05/06/2007;'RENFE';-2,50€;1.863,00 €;-2219;-2,50;6.387,09 €;'sin fechas';05/06/2007;'RENFE';'Gastos_Ocio y transporte';'Transporte';'VARIABLES'
06/06/2007;06/06/2007;'CAFET.C T PRAT';-2,45€;1.860,55 €;-2218;-2,45;6.384,64 €;'sin fechas';06/06/2007;'CAFETC';'Gastos_Ocio y transporte';'Restaurantes';'VARIABLES'
07/06/2007;07/06/2007;'BON AREA';-14,24€;1.846,31 €;-2217;-14,24;6.370,40 €;'sin fechas';07/06/2007;'BON';'Gastos_Compras';'Supermercado';'VARIABLES'
07/06/2007;07/06/2007;'CAFET.C T PRAT';-2,00€;1.844,31 €;-2216;-2,00;6.368,40 €;'sin fechas';07/06/2007;'CAFETC';'Gastos_Ocio y transporte';'Restaurantes';'VARIABLES'
07/06/2007;07/06/2007;'GASOLINA';-29,27€;1.815,04 €;-2215;-29,27;6.339,13 €;'sin fechas';07/06/2007;'GASOLINA';'Gastos_Ocio y transporte';'Gasolina';'VARIABLES'
08/06/2007;08/06/2007;'CAFET.C T PRAT';-2,50€;1.812,54 €;-2214;-2,50;6.336,63 €;'sin fechas';08/06/2007;'CAFETC';'Gastos_Ocio y transporte';'Restaurantes';'VARIABLES'
08/06/2007;08/06/2007;'GROUPAMA PLUS';-42,57€;1.769,97 €;-2213;-42,57;6.294,06 €;'sin fechas';08/06/2007;'GROUPAMA';'Gastos_Seguros';'Seguro salud';'FIJO'
08/06/2007;08/06/2007;'MERCADONA';-128,33€;1.641,64 €;-2212;-128,33;6.165,73 €;'sin fechas';08/06/2007;'MERCADONA';'Gastos_Compras';'Supermercado';'VARIABLES'
09/06/2007;09/06/2007;'CAPRABO';-25,43€;1.616,21 €;-2211;-25,43;6.140,30 €;'sin fechas';09/06/2007;'CAPRABO';'Gastos_Compras';'Supermercado';'VARIABLES'
09/06/2007;09/06/2007;'CINE';-12,60€;1.603,61 €;-2210;-12,60;6.127,70 €;'sin fechas';09/06/2007;'CINE';'Gastos_Ocio y transporte';'Espectáculos';'VARIABLES'
09/06/2007;09/06/2007;'REINT.CAJERO';-20,00€;1.583,61 €;-2209;-20,00;6.107,70 €;'sin fechas';09/06/2007;'REINTCAJERO';'Gastos_Gastos varios';'Efectivo';'VARIABLES'
09/06/2007;09/06/2007;'REINT.CAJERO';-20,00€;1.563,61 €;-2208;-20,00;6.087,70 €;'sin fechas';09/06/2007;'REINTCAJERO';'Gastos_Gastos varios';'Efectivo';'VARIABLES'
09/06/2007;09/06/2007;'RESTAURANTES';-52,43€;1.511,18 €;-2207;-52,43;6.035,27 €;'sin fechas';09/06/2007;'RESTAURANTES';'Gastos_Ocio y transporte';'Restaurantes';'VARIABLES'
09/06/2007;09/06/2007;'SUPER DE CARN TOT';-33,15€;1.478,03 €;-2206;-33,15;6.002,12 €;'sin fechas';09/06/2007;'SUPER';'Gastos_Compras';'Supermercado';'VARIABLES'
11/06/2007;11/06/2007;'CAFET.C T PRAT';-2,10€;1.475,93 €;-2205;-2,10;6.000,02 €;'sin fechas';11/06/2007;'CAFETC';'Gastos_Ocio y transporte';'Restaurantes';'VARIABLES'
11/06/2007;11/06/2007;'FARMACIA';-13,52€;1.462,41 €;-2204;-13,52;5.986,50 €;'sin fechas';11/06/2007;'FARMACIA';'Gastos_Salud, saber y deporte';'Farmacia';'VARIABLES'
11/06/2007;01/06/2007;'PEAJE RUBI';-1,08€;1.461,33 €;-2203;-1,08;5.985,42 €;'sin fechas';01/06/2007;'PEAJE';'Gastos_Ocio y transporte';'Parking y peaje';'VARIABLES'
11/06/2007;01/06/2007;'PEAJE RUBI';-1,08€;1.460,25 €;-2202;-1,08;5.984,34 €;'sin fechas';01/06/2007;'PEAJE';'Gastos_Ocio y transporte';'Parking y peaje';'VARIABLES'
12/06/2007;06/06/2007;'PEAJE RUBI';-1,08€;1.459,17 €;-2201;-1,08;5.983,26 €;'sin fechas';06/06/2007;'PEAJE';'Gastos_Ocio y transporte';'Parking y peaje';'VARIABLES'
12/06/2007;07/06/2007;'PEAJE RUBI';-1,08€;1.458,09 €;-2200;-1,08;5.982,18 €;'sin fechas';07/06/2007;'PEAJE';'Gastos_Ocio y transporte';'Parking y peaje';'VARIABLES'
12/06/2007;06/06/2007;'PEAJE RUBI';-1,08€;1.457,01 €;-2199;-1,08;5.981,10 €;'sin fechas';06/06/2007;'PEAJE';'Gastos_Ocio y transporte';'Parking y peaje';'VARIABLES'
12/06/2007;05/06/2007;'PEAJE RUBI';-1,08€;1.455,93 €;-2198;-1,08;5.980,02 €;'sin fechas';05/06/2007;'PEAJE';'Gastos_Ocio y transporte';'Parking y peaje';'VARIABLES'
12/06/2007;07/06/2007;'PEAJE RUBI';-1,08€;1.454,85 €;-2197;-1,08;5.978,94 €;'sin fechas';07/06/2007;'PEAJE';'Gastos_Ocio y transporte';'Parking y peaje';'VARIABLES'
12/06/2007;05/06/2007;'PEAJE RUBI';-1,08€;1.453,77 €;-2196;-1,08;5.977,86 €;'sin fechas';05/06/2007;'PEAJE';'Gastos_Ocio y transporte';'Parking y peaje';'VARIABLES'
13/06/2007;13/06/2007;'CAFET.C T PRAT';-2,25€;1.451,52 €;-2195;-2,25;5.975,61 €;'sin fechas';13/06/2007;'CAFETC';'Gastos_Ocio y transporte';'Restaurantes';'VARIABLES'
15/06/2007;15/06/2007;'CAFET.C T PRAT';-1,80€;1.449,72 €;-2194;-1,80;5.973,81 €;'sin fechas';15/06/2007;'CAFETC';'Gastos_Ocio y transporte';'Restaurantes';'VARIABLES'
15/06/2007;08/06/2007;'PEAJE RUBI';-1,08€;1.448,64 €;-2193;-1,08;5.972,73 €;'sin fechas';08/06/2007;'PEAJE';'Gastos_Ocio y transporte';'Parking y peaje';'VARIABLES'
15/06/2007;08/06/2007;'PEAJE RUBI';-1,08€;1.447,56 €;-2192;-1,08;5.971,65 €;'sin fechas';08/06/2007;'PEAJE';'Gastos_Ocio y transporte';'Parking y peaje';'VARIABLES'
15/06/2007;15/06/2007;'SEG.AM.HIPITEC';-32,33€;1.415,23 €;-2191;-32,33;5.939,32 €;'sin fechas';15/06/2007;'SEGAMHIPITEC';'Gastos_Seguros';'Seguro vida';'FIJO'
18/06/2007;18/06/2007;'CAFET.C T PRAT';-2,45€;1.412,78 €;-2190;-2,45;5.936,87 €;'sin fechas';18/06/2007;'CAFETC';'Gastos_Ocio y transporte';'Restaurantes';'VARIABLES'
18/06/2007;18/06/2007;'GASOLINA';-38,67€;1.374,11 €;-2189;-38,67;5.898,20 €;'sin fechas';18/06/2007;'GASOLINA';'Gastos_Ocio y transporte';'Gasolina';'VARIABLES'
18/06/2007;18/06/2007;'ONO';-74,08€;1.300,03 €;-2188;-74,08;5.824,12 €;'sin fechas';18/06/2007;'ONO';'Gastos_Servicios tipicos';'Telecomunicaciones';'FIJO'
19/06/2007;19/05/2007;'COCHE&PARKING';-1,75€;1.298,28 €;-2187;-1,75;5.822,37 €;'sin fechas';19/05/2007;'COCHEPARKING';'Gastos_Ocio y transporte';'Parking y peaje';'VARIABLES'
19/06/2007;11/06/2007;'PEAJE RUBI';-1,08€;1.297,20 €;-2186;-1,08;5.821,29 €;'sin fechas';11/06/2007;'PEAJE';'Gastos_Ocio y transporte';'Parking y peaje';'VARIABLES'
19/06/2007;12/06/2007;'PEAJE RUBI';-1,08€;1.296,12 €;-2185;-1,08;5.820,21 €;'sin fechas';12/06/2007;'PEAJE';'Gastos_Ocio y transporte';'Parking y peaje';'VARIABLES'
19/06/2007;12/06/2007;'PEAJE RUBI';-1,08€;1.295,04 €;-2184;-1,08;5.819,13 €;'sin fechas';12/06/2007;'PEAJE';'Gastos_Ocio y transporte';'Parking y peaje';'VARIABLES'
19/06/2007;11/06/2007;'PEAJE RUBI';-1,08€;1.293,96 €;-2183;-1,08;5.818,05 €;'sin fechas';11/06/2007;'PEAJE';'Gastos_Ocio y transporte';'Parking y peaje';'VARIABLES'
20/06/2007;20/06/2007;'CAFET.C T PRAT';-1,80€;1.292,16 €;-2182;-1,80;5.816,25 €;'sin fechas';20/06/2007;'CAFETC';'Gastos_Ocio y transporte';'Restaurantes';'VARIABLES'
20/06/2007;20/06/2007;'CAFET.C T PRAT';-1,55€;1.290,61 €;-2181;-1,55;5.814,70 €;'sin fechas';20/06/2007;'CAFETC';'Gastos_Ocio y transporte';'Restaurantes';'VARIABLES'
21/06/2007;21/06/2007;'BON AREA';-15,40€;1.275,21 €;-2180;-15,40;5.799,30 €;'sin fechas';21/06/2007;'BON';'Gastos_Compras';'Supermercado';'VARIABLES'
21/06/2007;21/06/2007;'CAFET.C T PRAT';-1,80€;1.273,41 €;-2179;-1,80;5.797,50 €;'sin fechas';21/06/2007;'CAFETC';'Gastos_Ocio y transporte';'Restaurantes';'VARIABLES'
21/06/2007;21/06/2007;'FARMACIA';-9,00€;1.264,41 €;-2178;-9,00;5.788,50 €;'sin fechas';21/06/2007;'FARMACIA';'Gastos_Salud, saber y deporte';'Farmacia';'VARIABLES'
22/06/2007;22/06/2007;'CAFET.C T PRAT';-2,75€;1.261,66 €;-2177;-2,75;5.785,75 €;'sin fechas';22/06/2007;'CAFETC';'Gastos_Ocio y transporte';'Restaurantes';'VARIABLES'
22/06/2007;22/06/2007;'FARMACIA';-4,65€;1.257,01 €;-2176;-4,65;5.781,10 €;'sin fechas';22/06/2007;'FARMACIA';'Gastos_Salud, saber y deporte';'Farmacia';'VARIABLES'
22/06/2007;22/06/2007;'GASOLINA';-8,00€;1.249,01 €;-2175;-8,00;5.773,10 €;'sin fechas';22/06/2007;'GASOLINA';'Gastos_Ocio y transporte';'Gasolina';'VARIABLES'
22/06/2007;22/06/2007;'parking';-100,00€;1.149,01 €;-2174;-100,00;5.673,10 €;'sin fechas';22/06/2007;'PARKING';'Gastos_Ocio y transporte';'Parking y peaje';'VARIABLES'
23/06/2007;23/06/2007;'CAPRABO';-30,24€;1.118,77 €;-2173;-30,24;5.642,86 €;'sin fechas';23/06/2007;'CAPRABO';'Gastos_Compras';'Supermercado';'VARIABLES'
25/06/2007;25/06/2007;'CAFET.C T PRAT';-2,75€;1.116,02 €;-2172;-2,75;5.640,11 €;'sin fechas';25/06/2007;'CAFETC';'Gastos_Ocio y transporte';'Restaurantes';'VARIABLES'
25/06/2007;25/06/2007;'FRANCE TELECOM';-11,15€;1.104,87 €;-2171;-11,15;5.628,96 €;'sin fechas';25/06/2007;'FRANCE';'Gastos_Servicios tipicos';'Telecomunicaciones';'FIJO'
26/06/2007;26/06/2007;'CAFET.C T PRAT';-1,75€;1.103,12 €;-2170;-1,75;5.627,21 €;'sin fechas';26/06/2007;'CAFETC';'Gastos_Ocio y transporte';'Restaurantes';'VARIABLES'
28/06/2007;28/06/2007;'FARMACIA';-8,35€;1.094,77 €;-2169;-8,35;5.618,86 €;'sin fechas';28/06/2007;'FARMACIA';'Gastos_Salud, saber y deporte';'Farmacia';'VARIABLES'
28/06/2007;28/06/2007;'GASOLINA';-30,00€;1.064,77 €;-2168;-30,00;5.588,86 €;'sin fechas';28/06/2007;'GASOLINA';'Gastos_Ocio y transporte';'Gasolina';'VARIABLES'
28/06/2007;29/06/2007;'INFORMACIO I TECNOLOGIA DE CAT';1.258,10€;2.322,87 €;-2167;1.258,10;6.846,96 €;'sin fechas';29/06/2007;'INFORMACIO';'Ingresos';'Nomina';'FIJO'
28/06/2007;28/06/2007;'MINA PUBLICA DE LA CIUTAT';-18,63€;2.304,24 €;-2166;-18,63;6.828,33 €;'sin fechas';28/06/2007;'MINA';'Gastos_Servicios tipicos';'Agua';'FIJO'
29/06/2007;29/06/2007;'CAFET.C T PRAT';-2,85€;2.301,39 €;-2165;-2,85;6.825,48 €;'sin fechas';29/06/2007;'CAFETC';'Gastos_Ocio y transporte';'Restaurantes';'VARIABLES'
29/06/2007;29/06/2007;'CINE';-8,00€;2.293,39 €;-2164;-8,00;6.817,48 €;'sin fechas';29/06/2007;'CINE';'Gastos_Ocio y transporte';'Espectáculos';'VARIABLES'
29/06/2007;29/06/2007;'FARMACIA';-7,60€;2.285,79 €;-2163;-7,60;6.809,88 €;'sin fechas';29/06/2007;'FARMACIA';'Gastos_Salud, saber y deporte';'Farmacia';'VARIABLES'
29/06/2007;29/06/2007;'REINT.CAJERO';-10,00€;2.275,79 €;-2162;-10,00;6.799,88 €;'sin fechas';29/06/2007;'REINTCAJERO';'Gastos_Gastos varios';'Efectivo';'VARIABLES'
30/06/2007;29/06/2007;'AGENCIA DE LA MICROEMPRESA';885,30€;3.161,09 €;-2161;885,30;7.685,18 €;'sin fechas';29/06/2007;'AGENCIA';'Ingresos';'Nomina';'FIJO'
30/06/2007;30/06/2007;'MARCO ALDANY';-9,99€;3.151,10 €;-2160;-9,99;7.675,19 €;'sin fechas';30/06/2007;'MARCO';'Gastos_Salud, saber y deporte';'Belleza';'VARIABLES'
30/06/2007;30/06/2007;'REINT.CAJERO';-140,00€;3.011,10 €;-2159;-140,00;7.535,19 €;'sin fechas';30/06/2007;'REINTCAJERO';'Gastos_Gastos varios';'Efectivo';'VARIABLES'
30/06/2007;30/06/2007;'REINT.CAJERO';-40,00€;2.971,10 €;-2158;-40,00;7.495,19 €;'sin fechas';30/06/2007;'REINTCAJERO';'Gastos_Gastos varios';'Efectivo';'VARIABLES'
02/07/2007;02/07/2007;'AJUNTAMENT DE TERRASSA';-51,36€;2.919,74 €;-2157;-51,36;7.443,83 €;'sin fechas';02/07/2007;'AJUNTAMENT';'Gastos_Banco y organismos';'Ayuntamiento';'FIJO'
02/07/2007;30/06/2007;'RECIBO PTMOS. 3061-0960004140';-177,24€;2.742,50 €;-2156;-177,24;7.266,59 €;'sin fechas';30/06/2007;'RECIBO';'Gastos_Banco y organismos';'Hipoteca';'FIJO'
02/07/2007;30/06/2007;'RECIBO PTMOS. 3061-0960001518';-759,27€;1.983,23 €;-2155;-759,27;6.507,32 €;'sin fechas';30/06/2007;'RECIBO';'Gastos_Banco y organismos';'Hipoteca';'FIJO'
04/07/2007;04/07/2007;'CINE';-8,00€;1.975,23 €;-2154;-8,00;6.499,32 €;'sin fechas';04/07/2007;'CINE';'Gastos_Ocio y transporte';'Espectáculos';'VARIABLES'
04/07/2007;04/07/2007;'FRANCE TELECOM';-10,44€;1.964,79 €;-2153;-10,44;6.488,88 €;'sin fechas';04/07/2007;'FRANCE';'Gastos_Servicios tipicos';'Telecomunicaciones';'FIJO'
05/07/2007;05/07/2007;'CAFET.C T PRAT';-2,45€;1.962,34 €;-2152;-2,45;6.486,43 €;'sin fechas';05/07/2007;'CAFETC';'Gastos_Ocio y transporte';'Restaurantes';'VARIABLES'
05/07/2007;05/07/2007;'GASOLINA';-3,70€;1.958,64 €;-2151;-3,70;6.482,73 €;'sin fechas';05/07/2007;'GASOLINA';'Gastos_Ocio y transporte';'Gasolina';'VARIABLES'
05/07/2007;05/07/2007;'GASOLINA';-25,36€;1.933,28 €;-2150;-25,36;6.457,37 €;'sin fechas';05/07/2007;'GASOLINA';'Gastos_Ocio y transporte';'Gasolina';'VARIABLES'
05/07/2007;05/07/2007;'REINT.CAJERO';-180,00€;1.753,28 €;-2149;-180,00;6.277,37 €;'sin fechas';05/07/2007;'REINTCAJERO';'Gastos_Gastos varios';'Efectivo';'VARIABLES'
05/07/2007;05/07/2007;'RESTAURANTES';-6,70€;1.746,58 €;-2148;-6,70;6.270,67 €;'sin fechas';05/07/2007;'RESTAURANTES';'Gastos_Ocio y transporte';'Restaurantes';'VARIABLES'
05/07/2007;05/07/2007;'RESTAURANTES';-16,95€;1.729,63 €;-2147;-16,95;6.253,72 €;'sin fechas';05/07/2007;'RESTAURANTES';'Gastos_Ocio y transporte';'Restaurantes';'VARIABLES'
06/07/2007;06/07/2007;'CAFET.C T PRAT';-2,45€;1.727,18 €;-2146;-2,45;6.251,27 €;'sin fechas';06/07/2007;'CAFETC';'Gastos_Ocio y transporte';'Restaurantes';'VARIABLES'
06/07/2007;06/07/2007;'CARREFOUR-[comida]';-41,70€;1.685,48 €;-2145;-41,70;6.209,57 €;'sin fechas';06/07/2007;'CARREFOURCOMIDA';'Gastos_Compras';'Supermercado';'VARIABLES'
06/07/2007;06/07/2007;'RESTAURANTES';-14,30€;1.671,18 €;-2144;-14,30;6.195,27 €;'sin fechas';06/07/2007;'RESTAURANTES';'Gastos_Ocio y transporte';'Restaurantes';'VARIABLES'
07/07/2007;07/07/2007;'AKI TERRASSA';-23,50€;1.647,68 €;-2143;-23,50;6.171,77 €;'sin fechas';07/07/2007;'AKI';'Gastos_Vivienda y vehiculo';'Mnto. hogar';'VARIABLES'
07/07/2007;07/07/2007;'BON AREA';-34,46€;1.613,22 €;-2142;-34,46;6.137,31 €;'sin fechas';07/07/2007;'BON';'Gastos_Compras';'Supermercado';'VARIABLES'
07/07/2007;07/07/2007;'BON AREA';-13,00€;1.600,22 €;-2141;-13,00;6.124,31 €;'sin fechas';07/07/2007;'BON';'Gastos_Compras';'Supermercado';'VARIABLES'
07/07/2007;07/07/2007;'BON AREA';-4,41€;1.595,81 €;-2140;-4,41;6.119,90 €;'sin fechas';07/07/2007;'BON';'Gastos_Compras';'Supermercado';'VARIABLES'
07/07/2007;07/07/2007;'CARREFOUR-[comida]';-31,19€;1.564,62 €;-2139;-31,19;6.088,71 €;'sin fechas';07/07/2007;'CARREFOURCOMIDA';'Gastos_Compras';'Supermercado';'VARIABLES'
09/07/2007;09/07/2007;'CAFET.C T PRAT';-1,80€;1.562,82 €;-2138;-1,80;6.086,91 €;'sin fechas';09/07/2007;'CAFETC';'Gastos_Ocio y transporte';'Restaurantes';'VARIABLES'
09/07/2007;09/07/2007;'CAFET.C T PRAT';-6,55€;1.556,27 €;-2137;-6,55;6.080,36 €;'sin fechas';09/07/2007;'CAFETC';'Gastos_Ocio y transporte';'Restaurantes';'VARIABLES'
09/07/2007;09/07/2007;'FARMACIA';-6,95€;1.549,32 €;-2136;-6,95;6.073,41 €;'sin fechas';09/07/2007;'FARMACIA';'Gastos_Salud, saber y deporte';'Farmacia';'VARIABLES'
09/07/2007;09/07/2007;'GROUPAMA PLUS';-42,57€;1.506,75 €;-2135;-42,57;6.030,84 €;'sin fechas';09/07/2007;'GROUPAMA';'Gastos_Seguros';'Seguro salud';'FIJO'
10/07/2007;10/07/2007;'CAFET.C T PRAT';-3,00€;1.503,75 €;-2134;-3,00;6.027,84 €;'sin fechas';10/07/2007;'CAFETC';'Gastos_Ocio y transporte';'Restaurantes';'VARIABLES'
10/07/2007;10/07/2007;'REINT.CAJERO';-20,00€;1.483,75 €;-2133;-20,00;6.007,84 €;'sin fechas';10/07/2007;'REINTCAJERO';'Gastos_Gastos varios';'Efectivo';'VARIABLES'
10/07/2007;10/07/2007;'RENFE';-1,25€;1.482,50 €;-2132;-1,25;6.006,59 €;'sin fechas';10/07/2007;'RENFE';'Gastos_Ocio y transporte';'Transporte';'VARIABLES'
10/07/2007;10/07/2007;'RENFE';-2,50€;1.480,00 €;-2131;-2,50;6.004,09 €;'sin fechas';10/07/2007;'RENFE';'Gastos_Ocio y transporte';'Transporte';'VARIABLES'
11/07/2007;11/07/2007;'CAFET.C T PRAT';-1,80€;1.478,20 €;-2130;-1,80;6.002,29 €;'sin fechas';11/07/2007;'CAFETC';'Gastos_Ocio y transporte';'Restaurantes';'VARIABLES'
11/07/2007;11/07/2007;'CINE';-8,00€;1.470,20 €;-2129;-8,00;5.994,29 €;'sin fechas';11/07/2007;'CINE';'Gastos_Ocio y transporte';'Espectáculos';'VARIABLES'
11/07/2007;11/07/2007;'GASOLINA';-35,00€;1.435,20 €;-2128;-35,00;5.959,29 €;'sin fechas';11/07/2007;'GASOLINA';'Gastos_Ocio y transporte';'Gasolina';'VARIABLES'
12/07/2007;12/07/2007;'CAFET.C T PRAT';-1,80€;1.433,40 €;-2127;-1,80;5.957,49 €;'sin fechas';12/07/2007;'CAFETC';'Gastos_Ocio y transporte';'Restaurantes';'VARIABLES'
12/07/2007;12/07/2007;'MERCADONA';-107,21€;1.326,19 €;-2126;-107,21;5.850,28 €;'sin fechas';12/07/2007;'MERCADONA';'Gastos_Compras';'Supermercado';'VARIABLES'
13/07/2007;13/07/2007;'CAFET.C T PRAT';-2,50€;1.323,69 €;-2125;-2,50;5.847,78 €;'sin fechas';13/07/2007;'CAFETC';'Gastos_Ocio y transporte';'Restaurantes';'VARIABLES'
13/07/2007;13/07/2007;'MERCADONA';-28,63€;1.295,06 €;-2124;-28,63;5.819,15 €;'sin fechas';13/07/2007;'MERCADONA';'Gastos_Compras';'Supermercado';'VARIABLES'
14/07/2007;14/07/2007;'av.parc valles ii- terrassa (pan y tortel comida amigos y pizzas noche)';-40,00€;1.255,06 €;-2123;-40,00;5.779,15 €;'sin fechas';14/07/2007;'AVPARC';'Gastos_Ocio y transporte';'Restaurantes';'VARIABLES'
16/07/2007;16/07/2007;'AJUNTAMENT DE TERRASSA';-33,64€;1.221,42 €;-2122;-33,64;5.745,51 €;'sin fechas';16/07/2007;'AJUNTAMENT';'Gastos_Banco y organismos';'Ayuntamiento';'FIJO'
16/07/2007;16/07/2007;'CAFET.C T PRAT';-1,70€;1.219,72 €;-2121;-1,70;5.743,81 €;'sin fechas';16/07/2007;'CAFETC';'Gastos_Ocio y transporte';'Restaurantes';'VARIABLES'
16/07/2007;16/07/2007;'REINT.CAJERO';-20,00€;1.199,72 €;-2120;-20,00;5.723,81 €;'sin fechas';16/07/2007;'REINTCAJERO';'Gastos_Gastos varios';'Efectivo';'VARIABLES'
16/07/2007;16/07/2007;'SEG.AM.HIPITEC';-32,54€;1.167,18 €;-2119;-32,54;5.691,27 €;'sin fechas';16/07/2007;'SEGAMHIPITEC';'Gastos_Seguros';'Seguro vida';'FIJO'
17/07/2007;17/07/2007;'ENDESA DISTRIB';-81,05€;1.086,13 €;-2118;-81,05;5.610,22 €;'sin fechas';17/07/2007;'ENDESA';'Gastos_Servicios tipicos';'Electricidad';'FIJO'
17/07/2007;18/07/2007;'INFORMACIO I TECNOLOGIA DE CAT';1.378,22€;2.464,35 €;-2117;1.378,22;6.988,44 €;'sin fechas';18/07/2007;'INFORMACIO';'Ingresos';'Nomina';'FIJO'
17/07/2007;17/07/2007;'MEDIA MARKT';-327,99€;2.136,36 €;-2116;-327,99;6.660,45 €;'sin fechas';17/07/2007;'MEDIA';'Gastos_Compras';'Hobbys';'VARIABLES'
17/07/2007;17/07/2007;'ONO';-84,10€;2.052,26 €;-2115;-84,10;6.576,35 €;'sin fechas';17/07/2007;'ONO';'Gastos_Servicios tipicos';'Telecomunicaciones';'FIJO'
17/07/2007;12/07/2007;'PEAJE RUBI';-1,85€;2.050,41 €;-2114;-1,85;6.574,50 €;'sin fechas';12/07/2007;'PEAJE';'Gastos_Ocio y transporte';'Parking y peaje';'VARIABLES'
17/07/2007;17/07/2007;'RENFE';-1,25€;2.049,16 €;-2113;-1,25;6.573,25 €;'sin fechas';17/07/2007;'RENFE';'Gastos_Ocio y transporte';'Transporte';'VARIABLES'
17/07/2007;17/07/2007;'RESTAURANTES';-5,55€;2.043,61 €;-2112;-5,55;6.567,70 €;'sin fechas';17/07/2007;'RESTAURANTES';'Gastos_Ocio y transporte';'Restaurantes';'VARIABLES'
18/07/2007;18/07/2007;'CAFET.C T PRAT';-5,25€;2.038,36 €;-2111;-5,25;6.562,45 €;'sin fechas';18/07/2007;'CAFETC';'Gastos_Ocio y transporte';'Restaurantes';'VARIABLES'
20/07/2007;20/07/2007;'CINE';-8,00€;2.030,36 €;-2110;-8,00;6.554,45 €;'sin fechas';20/07/2007;'CINE';'Gastos_Ocio y transporte';'Espectáculos';'VARIABLES'
20/07/2007;20/07/2007;'GASOLINA';-30,00€;2.000,36 €;-2109;-30,00;6.524,45 €;'sin fechas';20/07/2007;'GASOLINA';'Gastos_Ocio y transporte';'Gasolina';'VARIABLES'
20/07/2007;20/07/2007;'REINT.CAJERO';-20,00€;1.980,36 €;-2108;-20,00;6.504,45 €;'sin fechas';20/07/2007;'REINTCAJERO';'Gastos_Gastos varios';'Efectivo';'VARIABLES'
22/07/2007;22/07/2007;'RESTAURANTES';-10,40€;1.969,96 €;-2107;-10,40;6.494,05 €;'sin fechas';22/07/2007;'RESTAURANTES';'Gastos_Ocio y transporte';'Restaurantes';'VARIABLES'
23/07/2007;23/07/2007;'REINT.CAJERO';-20,00€;1.949,96 €;-2106;-20,00;6.474,05 €;'sin fechas';23/07/2007;'REINTCAJERO';'Gastos_Gastos varios';'Efectivo';'VARIABLES'
24/07/2007;24/07/2007;'BON AREA';-28,58€;1.921,38 €;-2105;-28,58;6.445,47 €;'sin fechas';24/07/2007;'BON';'Gastos_Compras';'Supermercado';'VARIABLES'
24/07/2007;24/07/2007;'CAFET.C T PRAT';-3,35€;1.918,03 €;-2104;-3,35;6.442,12 €;'sin fechas';24/07/2007;'CAFETC';'Gastos_Ocio y transporte';'Restaurantes';'VARIABLES'
24/07/2007;24/07/2007;'FRANCE TELECOM';-11,81€;1.906,22 €;-2103;-11,81;6.430,31 €;'sin fechas';24/07/2007;'FRANCE';'Gastos_Servicios tipicos';'Telecomunicaciones';'FIJO'
24/07/2007;24/07/2007;'REINT.CAJERO';-20,00€;1.886,22 €;-2102;-20,00;6.410,31 €;'sin fechas';24/07/2007;'REINTCAJERO';'Gastos_Gastos varios';'Efectivo';'VARIABLES'
24/07/2007;24/07/2007;'RENFE';-1,25€;1.884,97 €;-2101;-1,25;6.409,06 €;'sin fechas';24/07/2007;'RENFE';'Gastos_Ocio y transporte';'Transporte';'VARIABLES'
25/07/2007;25/07/2007;'CAFET.C T PRAT';-2,75€;1.882,22 €;-2100;-2,75;6.406,31 €;'sin fechas';25/07/2007;'CAFETC';'Gastos_Ocio y transporte';'Restaurantes';'VARIABLES'
26/07/2007;26/07/2007;'CAFET.C T PRAT';-2,75€;1.879,47 €;-2099;-2,75;6.403,56 €;'sin fechas';26/07/2007;'CAFETC';'Gastos_Ocio y transporte';'Restaurantes';'VARIABLES'
26/07/2007;26/07/2007;'CINE';-8,00€;1.871,47 €;-2098;-8,00;6.395,56 €;'sin fechas';26/07/2007;'CINE';'Gastos_Ocio y transporte';'Espectáculos';'VARIABLES'
27/07/2007;27/07/2007;'M&S';-33,43€;1.838,04 €;-2097;-33,43;6.362,13 €;'sin fechas';27/07/2007;'MS';'Gastos_Compras';'Ropa';'VARIABLES'
28/07/2007;28/07/2007;'CARREFOUR-[comida]';-13,98€;1.824,06 €;-2096;-13,98;6.348,15 €;'sin fechas';28/07/2007;'CARREFOURCOMIDA';'Gastos_Compras';'Supermercado';'VARIABLES'
28/07/2007;28/07/2007;'CORONEL TAPIOCA';-38,97€;1.785,09 €;-2095;-38,97;6.309,18 €;'sin fechas';28/07/2007;'CORONEL';'Gastos_Compras';'Ropa';'VARIABLES'
28/07/2007;28/07/2007;'GASOLINA';-34,00€;1.751,09 €;-2094;-34,00;6.275,18 €;'sin fechas';28/07/2007;'GASOLINA';'Gastos_Ocio y transporte';'Gasolina';'VARIABLES'
28/07/2007;31/07/2007;'INFORMACIO I TECNOLOGIA DE CAT';1.258,10€;3.009,19 €;-2093;1.258,10;7.533,28 €;'sin fechas';31/07/2007;'INFORMACIO';'Ingresos';'Nomina';'FIJO'
28/07/2007;28/07/2007;'KANAK BARCELONA S';-40,80€;2.968,39 €;-2092;-40,80;7.492,48 €;'sin fechas';28/07/2007;'KANAK';'Gastos_Compras';'Ropa';'VARIABLES'
28/07/2007;28/07/2007;'macon s.a. barcelona';-29,90€;2.938,49 €;-2091;-29,90;7.462,58 €;'sin fechas';28/07/2007;'MACON';'Gastos_Compras';'Ropa';'VARIABLES'
28/07/2007;28/07/2007;'RESTAURANTES';-24,50€;2.913,99 €;-2090;-24,50;7.438,08 €;'sin fechas';28/07/2007;'RESTAURANTES';'Gastos_Ocio y transporte';'Restaurantes';'VARIABLES'
30/07/2007;30/07/2007;'REINT.CAJERO';-20,00€;2.893,99 €;-2089;-20,00;7.418,08 €;'sin fechas';30/07/2007;'REINTCAJERO';'Gastos_Gastos varios';'Efectivo';'VARIABLES'
31/07/2007;31/07/2007;'BON AREA';-16,93€;2.877,06 €;-2088;-16,93;7.401,15 €;'sin fechas';31/07/2007;'BON';'Gastos_Compras';'Supermercado';'VARIABLES'
31/07/2007;31/07/2007;'CAFET.C T PRAT';-2,75€;2.874,31 €;-2087;-2,75;7.398,40 €;'sin fechas';31/07/2007;'CAFETC';'Gastos_Ocio y transporte';'Restaurantes';'VARIABLES'
31/07/2007;31/07/2007;'RECIBO PTMOS. 3061-0960004140';-177,24€;2.697,07 €;-2086;-177,24;7.221,16 €;'sin fechas';31/07/2007;'RECIBO';'Gastos_Banco y organismos';'Hipoteca';'FIJO'
31/07/2007;31/07/2007;'RECIBO PTMOS. 3061-0960001518';-798,05€;1.899,02 €;-2085;-798,05;6.423,11 €;'sin fechas';31/07/2007;'RECIBO';'Gastos_Banco y organismos';'Hipoteca';'FIJO'
01/08/2007;31/07/2007;'AGENCIA DE LA MICROEMPRESA';1.233,60€;3.132,62 €;-2084;1.233,60;7.656,71 €;'sin fechas';31/07/2007;'AGENCIA';'Ingresos';'Nomina';'FIJO'
01/08/2007;01/08/2007;'CAFET.C T PRAT';-2,35€;3.130,27 €;-2083;-2,35;7.654,36 €;'sin fechas';01/08/2007;'CAFETC';'Gastos_Ocio y transporte';'Restaurantes';'VARIABLES'
01/08/2007;26/07/2007;'PEAJE XERTA';-3,20€;3.127,07 €;-2082;-3,20;7.651,16 €;'sin fechas';26/07/2007;'PEAJE';'Gastos_Ocio y transporte';'Parking y peaje';'VARIABLES'
01/08/2007;26/07/2007;'PEAJE XERTA';-3,20€;3.123,87 €;-2081;-3,20;7.647,96 €;'sin fechas';26/07/2007;'PEAJE';'Gastos_Ocio y transporte';'Parking y peaje';'VARIABLES'
02/08/2007;02/08/2007;'CAFET.C T PRAT';-2,50€;3.121,37 €;-2080;-2,50;7.645,46 €;'sin fechas';02/08/2007;'CAFETC';'Gastos_Ocio y transporte';'Restaurantes';'VARIABLES'
03/08/2007;03/08/2007;'CAFET.C T PRAT';-2,75€;3.118,62 €;-2079;-2,75;7.642,71 €;'sin fechas';03/08/2007;'CAFETC';'Gastos_Ocio y transporte';'Restaurantes';'VARIABLES'
03/08/2007;03/08/2007;'REINT.CAJERO';-40,00€;3.078,62 €;-2078;-40,00;7.602,71 €;'sin fechas';03/08/2007;'REINTCAJERO';'Gastos_Gastos varios';'Efectivo';'VARIABLES'
03/08/2007;03/08/2007;'RESTAURANTES';-23,25€;3.055,37 €;-2077;-23,25;7.579,46 €;'sin fechas';03/08/2007;'RESTAURANTES';'Gastos_Ocio y transporte';'Restaurantes';'VARIABLES'
04/08/2007;04/08/2007;'GASOLINA';-15,00€;3.040,37 €;-2076;-15,00;7.564,46 €;'sin fechas';04/08/2007;'GASOLINA';'Gastos_Ocio y transporte';'Gasolina';'VARIABLES'
04/08/2007;04/08/2007;'jump ordenadores hospitalet brain academi';-29,98€;3.010,39 €;-2075;-29,98;7.534,48 €;'sin fechas';04/08/2007;'JUMP';'Gastos_Compras';'Hobbys';'VARIABLES'
04/08/2007;04/08/2007;'KUROKAI';-24,99€;2.985,40 €;-2074;-24,99;7.509,49 €;'sin fechas';04/08/2007;'KUROKAI';'Gastos_Compras';'Ropa';'VARIABLES'
04/08/2007;04/08/2007;'RESTAURANTES';-35,31€;2.950,09 €;-2073;-35,31;7.474,18 €;'sin fechas';04/08/2007;'RESTAURANTES';'Gastos_Ocio y transporte';'Restaurantes';'VARIABLES'
06/08/2007;06/08/2007;'comercial suiza tortosa nunchuk y mario party';-69,98€;2.880,11 €;-2072;-69,98;7.404,20 €;'sin fechas';06/08/2007;'COMERCIAL';'Gastos_Compras';'Hobbys';'VARIABLES'
06/08/2007;06/08/2007;'FARMACIA';-13,75€;2.866,36 €;-2071;-13,75;7.390,45 €;'sin fechas';06/08/2007;'FARMACIA';'Gastos_Salud, saber y deporte';'Farmacia';'VARIABLES'
06/08/2007;06/08/2007;'FRANCE TELECOM';-10,44€;2.855,92 €;-2070;-10,44;7.380,01 €;'sin fechas';06/08/2007;'FRANCE';'Gastos_Servicios tipicos';'Telecomunicaciones';'FIJO'
06/08/2007;06/08/2007;'GAS NATURAL';-142,45€;2.713,47 €;-2069;-142,45;7.237,56 €;'sin fechas';06/08/2007;'GAS';'Gastos_Servicios tipicos';'Gas';'FIJO'
06/08/2007;06/08/2007;'REINT.CAJERO';-70,00€;2.643,47 €;-2068;-70,00;7.167,56 €;'sin fechas';06/08/2007;'REINTCAJERO';'Gastos_Gastos varios';'Efectivo';'VARIABLES'
09/08/2007;09/08/2007;'GROUPAMA PLUS';-42,57€;2.600,90 €;-2067;-42,57;7.124,99 €;'sin fechas';09/08/2007;'GROUPAMA';'Gastos_Seguros';'Seguro salud';'FIJO'
10/08/2007;10/08/2007;'GASOLINA';-26,50€;2.574,40 €;-2066;-26,50;7.098,49 €;'sin fechas';10/08/2007;'GASOLINA';'Gastos_Ocio y transporte';'Gasolina';'VARIABLES'
10/08/2007;04/08/2007;'PEAJE XERTA';-1,40€;2.573,00 €;-2065;-1,40;7.097,09 €;'sin fechas';04/08/2007;'PEAJE';'Gastos_Ocio y transporte';'Parking y peaje';'VARIABLES'
10/08/2007;04/08/2007;'PEAJE XERTA';-2,35€;2.570,65 €;-2064;-2,35;7.094,74 €;'sin fechas';04/08/2007;'PEAJE';'Gastos_Ocio y transporte';'Parking y peaje';'VARIABLES'
10/08/2007;04/08/2007;'PEAJE XERTA';-5,40€;2.565,25 €;-2063;-5,40;7.089,34 €;'sin fechas';04/08/2007;'PEAJE';'Gastos_Ocio y transporte';'Parking y peaje';'VARIABLES'
10/08/2007;10/08/2007;'REINT.CAJERO';-110,00€;2.455,25 €;-2062;-110,00;6.979,34 €;'sin fechas';10/08/2007;'REINTCAJERO';'Gastos_Gastos varios';'Efectivo';'VARIABLES'
13/08/2007;04/08/2007;'PEAJE XERTA';-4,85€;2.450,40 €;-2061;-4,85;6.974,49 €;'sin fechas';04/08/2007;'PEAJE';'Gastos_Ocio y transporte';'Parking y peaje';'VARIABLES'
13/08/2007;04/08/2007;'PEAJE XERTA';-2,72€;2.447,68 €;-2060;-2,72;6.971,77 €;'sin fechas';04/08/2007;'PEAJE';'Gastos_Ocio y transporte';'Parking y peaje';'VARIABLES'
15/08/2007;15/08/2007;'REINT.CAJERO';-70,00€;2.377,68 €;-2059;-70,00;6.901,77 €;'sin fechas';15/08/2007;'REINTCAJERO';'Gastos_Gastos varios';'Efectivo';'VARIABLES'
16/08/2007;16/08/2007;'SEG.AM.HIPITEC';-32,50€;2.345,18 €;-2058;-32,50;6.869,27 €;'sin fechas';16/08/2007;'SEGAMHIPITEC';'Gastos_Seguros';'Seguro vida';'FIJO'
17/08/2007;17/08/2007;'COMIDA XERTA';-6,00€;2.339,18 €;-2057;-6,00;6.863,27 €;'sin fechas';17/08/2007;'COMIDA';'Gastos_Compras';'Supermercado';'VARIABLES'
17/08/2007;17/08/2007;'GASOLINA';-27,85€;2.311,33 €;-2056;-27,85;6.835,42 €;'sin fechas';17/08/2007;'GASOLINA';'Gastos_Ocio y transporte';'Gasolina';'VARIABLES'
17/08/2007;17/08/2007;'ONO';-74,27€;2.237,06 €;-2055;-74,27;6.761,15 €;'sin fechas';17/08/2007;'ONO';'Gastos_Servicios tipicos';'Telecomunicaciones';'FIJO'
19/08/2007;19/08/2007;'REINT.CAJERO';-140,00€;2.097,06 €;-2054;-140,00;6.621,15 €;'sin fechas';19/08/2007;'REINTCAJERO';'Gastos_Gastos varios';'Efectivo';'VARIABLES'
20/08/2007;20/08/2007;'MINA PUBLICA DE LA CIUTAT';-54,00€;2.043,06 €;-2053;-54,00;6.567,15 €;'sin fechas';20/08/2007;'MINA';'Gastos_Servicios tipicos';'Agua';'FIJO'
20/08/2007;20/08/2007;'portaventura vila-seca';-20,45€;2.022,61 €;-2052;-20,45;6.546,70 €;'sin fechas';20/08/2007;'PORTAVENTURA';'Gastos_Ocio y transporte';'Vacaciones';'VARIABLES'
22/08/2007;22/08/2007;'BON AREA';-29,12€;1.993,49 €;-2051;-29,12;6.517,58 €;'sin fechas';22/08/2007;'BON';'Gastos_Compras';'Supermercado';'VARIABLES'
22/08/2007;22/08/2007;'GASOLINA';-22,85€;1.970,64 €;-2050;-22,85;6.494,73 €;'sin fechas';22/08/2007;'GASOLINA';'Gastos_Ocio y transporte';'Gasolina';'VARIABLES'
22/08/2007;22/08/2007;'RESTAURANTES';-28,94€;1.941,70 €;-2049;-28,94;6.465,79 €;'sin fechas';22/08/2007;'RESTAURANTES';'Gastos_Ocio y transporte';'Restaurantes';'VARIABLES'
24/08/2007;24/08/2007;'BARCELONA \\SANT QUIRZE D';-18,90€;1.922,80 €;-2048;-18,90;6.446,89 €;'sin fechas';24/08/2007;'BARCELONA';'Gastos_Compras';'Supermercado';'VARIABLES'
24/08/2007;24/08/2007;'FRANCE TELECOM';-18,51€;1.904,29 €;-2047;-18,51;6.428,38 €;'sin fechas';24/08/2007;'FRANCE';'Gastos_Servicios tipicos';'Telecomunicaciones';'FIJO'
24/08/2007;19/08/2007;'PEAJE XERTA';-4,30€;1.899,99 €;-2046;-4,30;6.424,08 €;'sin fechas';19/08/2007;'PEAJE';'Gastos_Ocio y transporte';'Parking y peaje';'VARIABLES'
24/08/2007;19/08/2007;'PEAJE XERTA';-4,30€;1.895,69 €;-2045;-4,30;6.419,78 €;'sin fechas';19/08/2007;'PEAJE';'Gastos_Ocio y transporte';'Parking y peaje';'VARIABLES'
27/08/2007;27/08/2007;'FARMACIA';-8,13€;1.887,56 €;-2044;-8,13;6.411,65 €;'sin fechas';27/08/2007;'FARMACIA';'Gastos_Salud, saber y deporte';'Farmacia';'VARIABLES'
27/08/2007;20/08/2007;'PEAJE XERTA';-4,59€;1.882,97 €;-2043;-4,59;6.407,06 €;'sin fechas';20/08/2007;'PEAJE';'Gastos_Ocio y transporte';'Parking y peaje';'VARIABLES'
27/08/2007;20/08/2007;'PEAJE XERTA';-5,40€;1.877,57 €;-2042;-5,40;6.401,66 €;'sin fechas';20/08/2007;'PEAJE';'Gastos_Ocio y transporte';'Parking y peaje';'VARIABLES'
28/08/2007;28/08/2007;'FARMACIA';-20,60€;1.856,97 €;-2041;-20,60;6.381,06 €;'sin fechas';28/08/2007;'FARMACIA';'Gastos_Salud, saber y deporte';'Farmacia';'VARIABLES'
29/08/2007;30/08/2007;'INFORMACIO I TECNOLOGIA DE CAT';1.252,66€;3.109,63 €;-2040;1.252,66;7.633,72 €;'sin fechas';30/08/2007;'INFORMACIO';'Ingresos';'Nomina';'FIJO'
31/08/2007;31/08/2007;'GASOLINA';-30,00€;3.079,63 €;-2039;-30,00;7.603,72 €;'sin fechas';31/08/2007;'GASOLINA';'Gastos_Ocio y transporte';'Gasolina';'VARIABLES'
31/08/2007;22/08/2007;'PEAJE XERTA';-2,35€;3.077,28 €;-2038;-2,35;7.601,37 €;'sin fechas';22/08/2007;'PEAJE';'Gastos_Ocio y transporte';'Parking y peaje';'VARIABLES'
31/08/2007;22/08/2007;'PEAJE XERTA';-3,20€;3.074,08 €;-2037;-3,20;7.598,17 €;'sin fechas';22/08/2007;'PEAJE';'Gastos_Ocio y transporte';'Parking y peaje';'VARIABLES'
31/08/2007;22/08/2007;'PEAJE XERTA';-2,50€;3.071,58 €;-2036;-2,50;7.595,67 €;'sin fechas';22/08/2007;'PEAJE';'Gastos_Ocio y transporte';'Parking y peaje';'VARIABLES'
31/08/2007;22/08/2007;'PEAJE XERTA';-4,59€;3.066,99 €;-2035;-4,59;7.591,08 €;'sin fechas';22/08/2007;'PEAJE';'Gastos_Ocio y transporte';'Parking y peaje';'VARIABLES'
31/08/2007;31/08/2007;'RECIBO PTMOS. 3061-0960004140';-177,24€;2.889,75 €;-2034;-177,24;7.413,84 €;'sin fechas';31/08/2007;'RECIBO';'Gastos_Banco y organismos';'Hipoteca';'FIJO'
31/08/2007;31/08/2007;'RECIBO PTMOS. 3061-0960001518';-798,05€;2.091,70 €;-2033;-798,05;6.615,79 €;'sin fechas';31/08/2007;'RECIBO';'Gastos_Banco y organismos';'Hipoteca';'FIJO'
31/08/2007;31/08/2007;'RESTAURANTES';-44,08€;2.047,62 €;-2032;-44,08;6.571,71 €;'sin fechas';31/08/2007;'RESTAURANTES';'Gastos_Ocio y transporte';'Restaurantes';'VARIABLES'
01/09/2007;31/08/2007;'AGENCIA DE LA MICROEMPRESA';1.001,40€;3.049,02 €;-2031;1.001,40;7.573,11 €;'sin fechas';31/08/2007;'AGENCIA';'Ingresos';'Nomina';'FIJO'
03/09/2007;03/09/2007;'CAFET.C T PRAT';-1,60€;3.047,42 €;-2030;-1,60;7.571,51 €;'sin fechas';03/09/2007;'CAFETC';'Gastos_Ocio y transporte';'Restaurantes';'VARIABLES'
03/09/2007;03/09/2007;'REINT.CAJERO';-200,00€;2.847,42 €;-2029;-200,00;7.371,51 €;'sin fechas';03/09/2007;'REINTCAJERO';'Gastos_Gastos varios';'Efectivo';'VARIABLES'
04/09/2007;04/09/2007;'FRANCE TELECOM';-10,44€;2.836,98 €;-2028;-10,44;7.361,07 €;'sin fechas';04/09/2007;'FRANCE';'Gastos_Servicios tipicos';'Telecomunicaciones';'FIJO'
04/09/2007;04/09/2007;'MERCADONA';-134,17€;2.702,81 €;-2027;-134,17;7.226,90 €;'sin fechas';04/09/2007;'MERCADONA';'Gastos_Compras';'Supermercado';'VARIABLES'
05/09/2007;05/09/2007;'CAFET.C T PRAT';-1,05€;2.701,76 €;-2026;-1,05;7.225,85 €;'sin fechas';05/09/2007;'CAFETC';'Gastos_Ocio y transporte';'Restaurantes';'VARIABLES'
05/09/2007;05/09/2007;'VIRGIN ACTIVE';-50,00€;2.651,76 €;-2025;-50,00;7.175,85 €;'sin fechas';05/09/2007;'VIRGIN';'Gastos_Salud, saber y deporte';'Deportes';'VARIABLES'
06/09/2007;06/09/2007;'BON AREA';-21,98€;2.629,78 €;-2024;-21,98;7.153,87 €;'sin fechas';06/09/2007;'BON';'Gastos_Compras';'Supermercado';'VARIABLES'
06/09/2007;06/09/2007;'FARMACIA';-2,67€;2.627,11 €;-2023;-2,67;7.151,20 €;'sin fechas';06/09/2007;'FARMACIA';'Gastos_Salud, saber y deporte';'Farmacia';'VARIABLES'
07/09/2007;07/09/2007;'CAFET.C T PRAT';-1,70€;2.625,41 €;-2022;-1,70;7.149,50 €;'sin fechas';07/09/2007;'CAFETC';'Gastos_Ocio y transporte';'Restaurantes';'VARIABLES'
07/09/2007;07/09/2007;'GROUPAMA PLUS';-42,57€;2.582,84 €;-2021;-42,57;7.106,93 €;'sin fechas';07/09/2007;'GROUPAMA';'Gastos_Seguros';'Seguro salud';'FIJO'
08/09/2007;08/09/2007;'CARREFOUR-[comida]';-43,85€;2.538,99 €;-2020;-43,85;7.063,08 €;'sin fechas';08/09/2007;'CARREFOURCOMIDA';'Gastos_Compras';'Supermercado';'VARIABLES'
10/09/2007;10/09/2007;'BON AREA';-20,29€;2.518,70 €;-2019;-20,29;7.042,79 €;'sin fechas';10/09/2007;'BON';'Gastos_Compras';'Supermercado';'VARIABLES'
10/09/2007;10/09/2007;'CAFET.C T PRAT';-2,05€;2.516,65 €;-2018;-2,05;7.040,74 €;'sin fechas';10/09/2007;'CAFETC';'Gastos_Ocio y transporte';'Restaurantes';'VARIABLES'
12/09/2007;12/09/2007;'GASOLINA';-30,00€;2.486,65 €;-2017;-30,00;7.010,74 €;'sin fechas';12/09/2007;'GASOLINA';'Gastos_Ocio y transporte';'Gasolina';'VARIABLES'
13/09/2007;13/09/2007;'CAFET.C T PRAT';-1,75€;2.484,90 €;-2016;-1,75;7.008,99 €;'sin fechas';13/09/2007;'CAFETC';'Gastos_Ocio y transporte';'Restaurantes';'VARIABLES'
13/09/2007;13/09/2007;'REINT.CAJERO';-150,00€;2.334,90 €;-2015;-150,00;6.858,99 €;'sin fechas';13/09/2007;'REINTCAJERO';'Gastos_Gastos varios';'Efectivo';'VARIABLES'
14/09/2007;14/09/2007;'CAFET.C T PRAT';-2,00€;2.332,90 €;-2014;-2,00;6.856,99 €;'sin fechas';14/09/2007;'CAFETC';'Gastos_Ocio y transporte';'Restaurantes';'VARIABLES'
14/09/2007;14/09/2007;'REINT.CAJERO';-20,00€;2.312,90 €;-2013;-20,00;6.836,99 €;'sin fechas';14/09/2007;'REINTCAJERO';'Gastos_Gastos varios';'Efectivo';'VARIABLES'
15/09/2007;15/09/2007;'BON AREA';-31,47€;2.281,43 €;-2012;-31,47;6.805,52 €;'sin fechas';15/09/2007;'BON';'Gastos_Compras';'Supermercado';'VARIABLES'
17/09/2007;17/09/2007;'CAFET.C T PRAT';-2,95€;2.278,48 €;-2011;-2,95;6.802,57 €;'sin fechas';17/09/2007;'CAFETC';'Gastos_Ocio y transporte';'Restaurantes';'VARIABLES'
17/09/2007;17/09/2007;'ONO';-75,15€;2.203,33 €;-2010;-75,15;6.727,42 €;'sin fechas';17/09/2007;'ONO';'Gastos_Servicios tipicos';'Telecomunicaciones';'FIJO'
17/09/2007;17/09/2007;'SEG.AM.HIPITEC';-32,45€;2.170,88 €;-2009;-32,45;6.694,97 €;'sin fechas';17/09/2007;'SEGAMHIPITEC';'Gastos_Seguros';'Seguro vida';'FIJO'
18/09/2007;18/09/2007;'CAFET.C T PRAT';-0,70€;2.170,18 €;-2008;-0,70;6.694,27 €;'sin fechas';18/09/2007;'CAFETC';'Gastos_Ocio y transporte';'Restaurantes';'VARIABLES'
18/09/2007;18/09/2007;'ENDESA DISTRIB';-56,83€;2.113,35 €;-2007;-56,83;6.637,44 €;'sin fechas';18/09/2007;'ENDESA';'Gastos_Servicios tipicos';'Electricidad';'FIJO'
18/09/2007;18/09/2007;'LEROY MERLIN';-32,20€;2.081,15 €;-2006;-32,20;6.605,24 €;'sin fechas';18/09/2007;'LEROY';'Gastos_Vivienda y vehiculo';'Mnto. hogar';'VARIABLES'
18/09/2007;18/09/2007;'REINT.CAJERO';-30,00€;2.051,15 €;-2005;-30,00;6.575,24 €;'sin fechas';18/09/2007;'REINTCAJERO';'Gastos_Gastos varios';'Efectivo';'VARIABLES'
19/09/2007;19/09/2007;'CAFET.C T PRAT';-2,05€;2.049,10 €;-2004;-2,05;6.573,19 €;'sin fechas';19/09/2007;'CAFETC';'Gastos_Ocio y transporte';'Restaurantes';'VARIABLES'
19/09/2007;20/09/2007;'DEV.TRIBUTARIA';962,08€;3.011,18 €;-2003;962,08;7.535,27 €;'sin fechas';20/09/2007;'DEVTRIBUTARIA';'Ingresos';'Devoluciones';'VARIABLES'
20/09/2007;20/09/2007;'MINA PUBLICA DE LA CIUTAT';-18,12€;2.993,06 €;-2002;-18,12;7.517,15 €;'sin fechas';20/09/2007;'MINA';'Gastos_Servicios tipicos';'Agua';'FIJO'
20/09/2007;20/09/2007;'REINT.CAJERO';-60,00€;2.933,06 €;-2001;-60,00;7.457,15 €;'sin fechas';20/09/2007;'REINTCAJERO';'Gastos_Gastos varios';'Efectivo';'VARIABLES'
21/09/2007;21/09/2007;'CAFET.C T PRAT';-1,85€;2.931,21 €;-2000;-1,85;7.455,30 €;'sin fechas';21/09/2007;'CAFETC';'Gastos_Ocio y transporte';'Restaurantes';'VARIABLES'
21/09/2007;21/09/2007;'CINE';-12,80€;2.918,41 €;-1999;-12,80;7.442,50 €;'sin fechas';21/09/2007;'CINE';'Gastos_Ocio y transporte';'Espectáculos';'VARIABLES'
21/09/2007;21/09/2007;'MERCADONA';-72,63€;2.845,78 €;-1998;-72,63;7.369,87 €;'sin fechas';21/09/2007;'MERCADONA';'Gastos_Compras';'Supermercado';'VARIABLES'
21/09/2007;20/09/2007;'SUSCRIP. FONDO';-900,00€;1.945,78 €;-1997;-900,00;6.469,87 €;'sin fechas';20/09/2007;'SUSCRIP';'Gastos_Gastos varios';'Transferencias';'VARIABLES'
22/09/2007;22/09/2007;'CARREFOUR-[comida]';-22,40€;1.923,38 €;-1996;-22,40;6.447,47 €;'sin fechas';22/09/2007;'CARREFOURCOMIDA';'Gastos_Compras';'Supermercado';'VARIABLES'
22/09/2007;22/09/2007;'GAME';-107,90€;1.815,48 €;-1995;-107,90;6.339,57 €;'sin fechas';22/09/2007;'GAME';'Gastos_Compras';'Hobbys';'VARIABLES'
22/09/2007;22/09/2007;'GASOLINA';-25,00€;1.790,48 €;-1994;-25,00;6.314,57 €;'sin fechas';22/09/2007;'GASOLINA';'Gastos_Ocio y transporte';'Gasolina';'VARIABLES'
22/09/2007;22/09/2007;'YVES ROCHER';-6,80€;1.783,68 €;-1993;-6,80;6.307,77 €;'sin fechas';22/09/2007;'YVES';'Gastos_Salud, saber y deporte';'Belleza';'VARIABLES'
24/09/2007;24/09/2007;'DECATHLON';-7,00€;1.776,68 €;-1992;-7,00;6.300,77 €;'sin fechas';24/09/2007;'DECATHLON';'Gastos_Compras';'Deportivo';'VARIABLES'
24/09/2007;24/09/2007;'GASOLINA';-4,50€;1.772,18 €;-1991;-4,50;6.296,27 €;'sin fechas';24/09/2007;'GASOLINA';'Gastos_Ocio y transporte';'Gasolina';'VARIABLES'
24/09/2007;24/09/2007;'RESTAURANTES';-37,08€;1.735,10 €;-1990;-37,08;6.259,19 €;'sin fechas';24/09/2007;'RESTAURANTES';'Gastos_Ocio y transporte';'Restaurantes';'VARIABLES'
25/09/2007;25/09/2007;'CAFET.C T PRAT';-2,05€;1.733,05 €;-1989;-2,05;6.257,14 €;'sin fechas';25/09/2007;'CAFETC';'Gastos_Ocio y transporte';'Restaurantes';'VARIABLES'
25/09/2007;25/09/2007;'FRANCE TELECOM';-27,32€;1.705,73 €;-1988;-27,32;6.229,82 €;'sin fechas';25/09/2007;'FRANCE';'Gastos_Servicios tipicos';'Telecomunicaciones';'FIJO'
26/09/2007;26/09/2007;'CAFET.C T PRAT';-2,95€;1.702,78 €;-1987;-2,95;6.226,87 €;'sin fechas';26/09/2007;'CAFETC';'Gastos_Ocio y transporte';'Restaurantes';'VARIABLES'
26/09/2007;26/09/2007;'MARCO ALDANY';-9,99€;1.692,79 €;-1986;-9,99;6.216,88 €;'sin fechas';26/09/2007;'MARCO';'Gastos_Salud, saber y deporte';'Belleza';'VARIABLES'
27/09/2007;27/09/2007;'CAFET.C T PRAT';-1,75€;1.691,04 €;-1985;-1,75;6.215,13 €;'sin fechas';27/09/2007;'CAFETC';'Gastos_Ocio y transporte';'Restaurantes';'VARIABLES'
28/09/2007;28/09/2007;'BON AREA';-33,23€;1.657,81 €;-1984;-33,23;6.181,90 €;'sin fechas';28/09/2007;'BON';'Gastos_Compras';'Supermercado';'VARIABLES'
28/09/2007;28/09/2007;'BOWLING PEDRALBES';-25,00€;1.632,81 €;-1983;-25,00;6.156,90 €;'sin fechas';28/09/2007;'BOWLING';'Gastos_Ocio y transporte';'Espectáculos';'VARIABLES'
28/09/2007;28/09/2007;'CAFET.C T PRAT';-2,55€;1.630,26 €;-1982;-2,55;6.154,35 €;'sin fechas';28/09/2007;'CAFETC';'Gastos_Ocio y transporte';'Restaurantes';'VARIABLES'
28/09/2007;30/09/2007;'INFORMACIO I TECNOLOGIA DE CAT';1.401,26€;3.031,52 €;-1981;1.401,26;7.555,61 €;'sin fechas';30/09/2007;'INFORMACIO';'Ingresos';'Nomina';'FIJO'
29/09/2007;30/09/2007;'AGENCIA DE LA MICROEMPRESA';1.001,40€;4.032,92 €;-1980;1.001,40;8.557,01 €;'sin fechas';30/09/2007;'AGENCIA';'Ingresos';'Nomina';'FIJO'
29/09/2007;29/09/2007;'GASOLINA';-30,00€;4.002,92 €;-1979;-30,00;8.527,01 €;'sin fechas';29/09/2007;'GASOLINA';'Gastos_Ocio y transporte';'Gasolina';'VARIABLES'
30/09/2007;30/09/2007;'REINT.CAJERO';-30,00€;3.972,92 €;-1978;-30,00;8.497,01 €;'sin fechas';30/09/2007;'REINTCAJERO';'Gastos_Gastos varios';'Efectivo';'VARIABLES'
01/10/2007;30/09/2007;'RECIBO PTMOS. 3061-0960004140';-177,24€;3.795,68 €;-1977;-177,24;8.319,77 €;'sin fechas';30/09/2007;'RECIBO';'Gastos_Banco y organismos';'Hipoteca';'FIJO'
01/10/2007;30/09/2007;'RECIBO PTMOS. 3061-0960001518';-798,05€;2.997,63 €;-1976;-798,05;7.521,72 €;'sin fechas';30/09/2007;'RECIBO';'Gastos_Banco y organismos';'Hipoteca';'FIJO'
02/10/2007;02/10/2007;'VIRGIN ACTIVE';-54,00€;2.943,63 €;-1975;-54,00;7.467,72 €;'sin fechas';02/10/2007;'VIRGIN';'Gastos_Salud, saber y deporte';'Deportes';'VARIABLES'
03/10/2007;03/10/2007;'CAFET.C T PRAT';-5,60€;2.938,03 €;-1974;-5,60;7.462,12 €;'sin fechas';03/10/2007;'CAFETC';'Gastos_Ocio y transporte';'Restaurantes';'VARIABLES'
04/10/2007;04/10/2007;'FRANCE TELECOM';-10,44€;2.927,59 €;-1973;-10,44;7.451,68 €;'sin fechas';04/10/2007;'FRANCE';'Gastos_Servicios tipicos';'Telecomunicaciones';'FIJO'
04/10/2007;04/10/2007;'GAS NATURAL';-251,55€;2.676,04 €;-1972;-251,55;7.200,13 €;'sin fechas';04/10/2007;'GAS';'Gastos_Servicios tipicos';'Gas';'FIJO'
05/10/2007;05/10/2007;'CARGO INTS.';-0,10€;2.675,94 €;-1971;-0,10;7.200,03 €;'sin fechas';05/10/2007;'CARGO';'Gastos_Banco y organismos';'Cargos banco';'FIJO'
05/10/2007;05/10/2007;'CINE';-8,00€;2.667,94 €;-1970;-8,00;7.192,03 €;'sin fechas';05/10/2007;'CINE';'Gastos_Ocio y transporte';'Espectáculos';'VARIABLES'
05/10/2007;05/10/2007;'COM. MANT. ACTIVAS DE LIQ.';-15,00€;2.652,94 €;-1969;-15,00;7.177,03 €;'sin fechas';05/10/2007;'COM';'Gastos_Banco y organismos';'Cargos banco';'FIJO'
05/10/2007;05/10/2007;'IMPUESTOS RETENIDOS A CUENTA';-0,05€;2.652,89 €;-1968;-0,05;7.176,98 €;'sin fechas';05/10/2007;'IMPUESTOS';'Gastos_Banco y organismos';'Impuestos';'FIJO'
05/10/2007;05/10/2007;'INTERESES';0,27€;2.653,16 €;-1967;0,27;7.177,25 €;'sin fechas';05/10/2007;'INTERESES';'Ingresos';'Rendimientos';
06/10/2007;06/10/2007;'CARREFOUR-[comida]';-27,80€;2.625,36 €;-1966;-27,80;7.149,45 €;'sin fechas';06/10/2007;'CARREFOURCOMIDA';'Gastos_Compras';'Supermercado';'VARIABLES'
06/10/2007;06/10/2007;'H&M';-144,50€;2.480,86 €;-1965;-144,50;7.004,95 €;'sin fechas';06/10/2007;'HM';'Gastos_Compras';'Ropa';'VARIABLES'
08/10/2007;08/10/2007;'FRUITES I VERDURES';-9,57€;2.471,29 €;-1964;-9,57;6.995,38 €;'sin fechas';08/10/2007;'FRUITES';'Gastos_Compras';'Supermercado';'VARIABLES'
08/10/2007;08/10/2007;'GROUPAMA PLUS';-42,57€;2.428,72 €;-1963;-42,57;6.952,81 €;'sin fechas';08/10/2007;'GROUPAMA';'Gastos_Seguros';'Seguro salud';'FIJO'
09/10/2007;09/10/2007;'CAFET.C T PRAT';-3,55€;2.425,17 €;-1962;-3,55;6.949,26 €;'sin fechas';09/10/2007;'CAFETC';'Gastos_Ocio y transporte';'Restaurantes';'VARIABLES'
09/10/2007;09/10/2007;'GASOLINA';-20,00€;2.405,17 €;-1961;-20,00;6.929,26 €;'sin fechas';09/10/2007;'GASOLINA';'Gastos_Ocio y transporte';'Gasolina';'VARIABLES'
10/10/2007;10/10/2007;'BON AREA';-39,19€;2.365,98 €;-1960;-39,19;6.890,07 €;'sin fechas';10/10/2007;'BON';'Gastos_Compras';'Supermercado';'VARIABLES'
11/10/2007;11/10/2007;'FARMACIA';-18,18€;2.347,80 €;-1959;-18,18;6.871,89 €;'sin fechas';11/10/2007;'FARMACIA';'Gastos_Salud, saber y deporte';'Farmacia';'VARIABLES'
13/10/2007;13/10/2007;'BON AREA';-21,29€;2.326,51 €;-1958;-21,29;6.850,60 €;'sin fechas';13/10/2007;'BON';'Gastos_Compras';'Supermercado';'VARIABLES'
15/10/2007;15/10/2007;'BON AREA';-9,19€;2.317,32 €;-1957;-9,19;6.841,41 €;'sin fechas';15/10/2007;'BON';'Gastos_Compras';'Supermercado';'VARIABLES'
15/10/2007;15/10/2007;'REINT.CAJERO';-20,00€;2.297,32 €;-1956;-20,00;6.821,41 €;'sin fechas';15/10/2007;'REINTCAJERO';'Gastos_Gastos varios';'Efectivo';'VARIABLES'
15/10/2007;15/10/2007;'REINT.CAJERO';-2,40€;2.294,92 €;-1955;-2,40;6.819,01 €;'sin fechas';15/10/2007;'REINTCAJERO';'Gastos_Gastos varios';'Efectivo';'VARIABLES'
15/10/2007;15/10/2007;'REINT.CAJERO';20,00€;2.314,92 €;-1954;20,00;6.839,01 €;'sin fechas';15/10/2007;'REINTCAJERO';'Gastos_Gastos varios';'Efectivo';'VARIABLES'
15/10/2007;15/10/2007;'REINT.CAJERO';2,40€;2.317,32 €;-1953;2,40;6.841,41 €;'sin fechas';15/10/2007;'REINTCAJERO';'Gastos_Gastos varios';'Efectivo';'VARIABLES'
15/10/2007;15/10/2007;'SEG.AM.HIPITEC';-32,40€;2.284,92 €;-1952;-32,40;6.809,01 €;'sin fechas';15/10/2007;'SEGAMHIPITEC';'Gastos_Seguros';'Seguro vida';'FIJO'
16/10/2007;16/10/2007;'CAFET.C T PRAT';-1,80€;2.283,12 €;-1951;-1,80;6.807,21 €;'sin fechas';16/10/2007;'CAFETC';'Gastos_Ocio y transporte';'Restaurantes';'VARIABLES'
17/10/2007;17/10/2007;'CAFET.C T PRAT';-1,80€;2.281,32 €;-1950;-1,80;6.805,41 €;'sin fechas';17/10/2007;'CAFETC';'Gastos_Ocio y transporte';'Restaurantes';'VARIABLES'
18/10/2007;18/10/2007;'FARMACIA';-11,67€;2.269,65 €;-1949;-11,67;6.793,74 €;'sin fechas';18/10/2007;'FARMACIA';'Gastos_Salud, saber y deporte';'Farmacia';'VARIABLES'
18/10/2007;18/10/2007;'GASOLINA';-30,00€;2.239,65 €;-1948;-30,00;6.763,74 €;'sin fechas';18/10/2007;'GASOLINA';'Gastos_Ocio y transporte';'Gasolina';'VARIABLES'
18/10/2007;19/10/2007;'ONO';-77,75€;2.161,90 €;-1947;-77,75;6.685,99 €;'sin fechas';19/10/2007;'ONO';'Gastos_Servicios tipicos';'Telecomunicaciones';'FIJO'
19/10/2007;19/10/2007;'MERCADONA';-108,47€;2.053,43 €;-1946;-108,47;6.577,52 €;'sin fechas';19/10/2007;'MERCADONA';'Gastos_Compras';'Supermercado';'VARIABLES'
20/10/2007;20/10/2007;'IKEA';-69,90€;1.983,53 €;-1945;-69,90;6.507,62 €;'sin fechas';20/10/2007;'IKEA';'Gastos_Vivienda y vehiculo';'Mnto. hogar';'VARIABLES'
20/10/2007;20/10/2007;'MERCADONA';-7,25€;1.976,28 €;-1944;-7,25;6.500,37 €;'sin fechas';20/10/2007;'MERCADONA';'Gastos_Compras';'Supermercado';'VARIABLES'
23/10/2007;05/10/2007;'C.MANTENIM. A';15,00€;1.991,28 €;-1943;15,00;6.515,37 €;'sin fechas';05/10/2007;'CMANTENIM';'Gastos_Banco y organismos';'Cargos banco';'FIJO'
23/10/2007;23/10/2007;'FRANCE TELECOM';-10,44€;1.980,84 €;-1942;-10,44;6.504,93 €;'sin fechas';23/10/2007;'FRANCE';'Gastos_Servicios tipicos';'Telecomunicaciones';'FIJO'
23/10/2007;23/10/2007;'REINT.CAJERO';-20,00€;1.960,84 €;-1941;-20,00;6.484,93 €;'sin fechas';23/10/2007;'REINTCAJERO';'Gastos_Gastos varios';'Efectivo';'VARIABLES'
24/10/2007;24/10/2007;'CAFET.C T PRAT';-3,00€;1.957,84 €;-1940;-3,00;6.481,93 €;'sin fechas';24/10/2007;'CAFETC';'Gastos_Ocio y transporte';'Restaurantes';'VARIABLES'
24/10/2007;24/10/2007;'REINT.CAJERO';-40,00€;1.917,84 €;-1939;-40,00;6.441,93 €;'sin fechas';24/10/2007;'REINTCAJERO';'Gastos_Gastos varios';'Efectivo';'VARIABLES'
25/10/2007;25/10/2007;'CAFET.C T PRAT';-1,05€;1.916,79 €;-1938;-1,05;6.440,88 €;'sin fechas';25/10/2007;'CAFETC';'Gastos_Ocio y transporte';'Restaurantes';'VARIABLES'
27/10/2007;27/10/2007;'BON AREA';-65,72€;1.851,07 €;-1937;-65,72;6.375,16 €;'sin fechas';27/10/2007;'BON';'Gastos_Compras';'Supermercado';'VARIABLES'
27/10/2007;27/10/2007;'CAPRABO';-24,35€;1.826,72 €;-1936;-24,35;6.350,81 €;'sin fechas';27/10/2007;'CAPRABO';'Gastos_Compras';'Supermercado';'VARIABLES'
27/10/2007;30/10/2007;'INFORMACIO I TECNOLOGIA DE CAT';1.956,69€;3.783,41 €;-1935;1.956,69;8.307,50 €;'sin fechas';30/10/2007;'INFORMACIO';'Ingresos';'Nomina';'FIJO'
29/10/2007;29/10/2007;'FARMACIA';-9,00€;3.774,41 €;-1934;-9,00;8.298,50 €;'sin fechas';29/10/2007;'FARMACIA';'Gastos_Salud, saber y deporte';'Farmacia';'VARIABLES'
29/10/2007;29/10/2007;'GASOLINA';-25,00€;3.749,41 €;-1933;-25,00;8.273,50 €;'sin fechas';29/10/2007;'GASOLINA';'Gastos_Ocio y transporte';'Gasolina';'VARIABLES'
30/10/2007;30/10/2007;'CAFET.C T PRAT';-1,05€;3.748,36 €;-1932;-1,05;8.272,45 €;'sin fechas';30/10/2007;'CAFETC';'Gastos_Ocio y transporte';'Restaurantes';'VARIABLES'
31/10/2007;31/10/2007;'CAFET.C T PRAT';-2,25€;3.746,11 €;-1931;-2,25;8.270,20 €;'sin fechas';31/10/2007;'CAFETC';'Gastos_Ocio y transporte';'Restaurantes';'VARIABLES'
31/10/2007;31/10/2007;'RECIBO PTMOS. 3061-0960004140';-177,24€;3.568,87 €;-1930;-177,24;8.092,96 €;'sin fechas';31/10/2007;'RECIBO';'Gastos_Banco y organismos';'Hipoteca';'FIJO'
31/10/2007;31/10/2007;'RECIBO PTMOS. 3061-0960001518';-798,05€;2.770,82 €;-1929;-798,05;7.294,91 €;'sin fechas';31/10/2007;'RECIBO';'Gastos_Banco y organismos';'Hipoteca';'FIJO'
01/11/2007;31/10/2007;'AGENCIA DE LA MICROEMPRESA';1.001,40€;3.772,22 €;-1928;1.001,40;8.296,31 €;'sin fechas';31/10/2007;'AGENCIA';'Ingresos';'Nomina';'FIJO'
02/11/2007;02/11/2007;'AJUNTAMENT DE TERRASSA';-51,36€;3.720,86 €;-1927;-51,36;8.244,95 €;'sin fechas';02/11/2007;'AJUNTAMENT';'Gastos_Banco y organismos';'Ayuntamiento';'FIJO'
02/11/2007;02/11/2007;'CAFET.C T PRAT';-2,75€;3.718,11 €;-1926;-2,75;8.242,20 €;'sin fechas';02/11/2007;'CAFETC';'Gastos_Ocio y transporte';'Restaurantes';'VARIABLES'
02/11/2007;02/11/2007;'GASOLINA';-35,80€;3.682,31 €;-1925;-35,80;8.206,40 €;'sin fechas';02/11/2007;'GASOLINA';'Gastos_Ocio y transporte';'Gasolina';'VARIABLES'
02/11/2007;02/11/2007;'RESTAURANTES';-17,55€;3.664,76 €;-1924;-17,55;8.188,85 €;'sin fechas';02/11/2007;'RESTAURANTES';'Gastos_Ocio y transporte';'Restaurantes';'VARIABLES'
04/11/2007;04/11/2007;'CINE';-10,00€;3.654,76 €;-1923;-10,00;8.178,85 €;'sin fechas';04/11/2007;'CINE';'Gastos_Ocio y transporte';'Espectáculos';'VARIABLES'
05/11/2007;05/11/2007;'CAFET.C T PRAT';-1,70€;3.653,06 €;-1922;-1,70;8.177,15 €;'sin fechas';05/11/2007;'CAFETC';'Gastos_Ocio y transporte';'Restaurantes';'VARIABLES'
05/11/2007;27/10/2007;'PEAJE XERTA';-0,45€;3.652,61 €;-1921;-0,45;8.176,70 €;'sin fechas';27/10/2007;'PEAJE';'Gastos_Ocio y transporte';'Parking y peaje';'VARIABLES'
05/11/2007;05/11/2007;'REINT.CAJERO';-30,00€;3.622,61 €;-1920;-30,00;8.146,70 €;'sin fechas';05/11/2007;'REINTCAJERO';'Gastos_Gastos varios';'Efectivo';'VARIABLES'
05/11/2007;05/11/2007;'REINT.CAJERO';-110,00€;3.512,61 €;-1919;-110,00;8.036,70 €;'sin fechas';05/11/2007;'REINTCAJERO';'Gastos_Gastos varios';'Efectivo';'VARIABLES'
05/11/2007;05/11/2007;'VIRGIN ACTIVE';-54,00€;3.458,61 €;-1918;-54,00;7.982,70 €;'sin fechas';05/11/2007;'VIRGIN';'Gastos_Salud, saber y deporte';'Deportes';'VARIABLES'
06/11/2007;06/11/2007;'CAFET.C T PRAT';-2,55€;3.456,06 €;-1917;-2,55;7.980,15 €;'sin fechas';06/11/2007;'CAFETC';'Gastos_Ocio y transporte';'Restaurantes';'VARIABLES'
06/11/2007;06/11/2007;'FRANCE TELECOM';-17,70€;3.438,36 €;-1916;-17,70;7.962,45 €;'sin fechas';06/11/2007;'FRANCE';'Gastos_Servicios tipicos';'Telecomunicaciones';'FIJO'
08/11/2007;08/11/2007;'CAFET.C T PRAT';-2,85€;3.435,51 €;-1915;-2,85;7.959,60 €;'sin fechas';08/11/2007;'CAFETC';'Gastos_Ocio y transporte';'Restaurantes';'VARIABLES'
08/11/2007;08/11/2007;'GASOLINA';-30,00€;3.405,51 €;-1914;-30,00;7.929,60 €;'sin fechas';08/11/2007;'GASOLINA';'Gastos_Ocio y transporte';'Gasolina';'VARIABLES'
08/11/2007;08/11/2007;'GROUPAMA PLUS';-42,57€;3.362,94 €;-1913;-42,57;7.887,03 €;'sin fechas';08/11/2007;'GROUPAMA';'Gastos_Seguros';'Seguro salud';'FIJO'
08/11/2007;08/11/2007;'QUICUINA';-8,40€;3.354,54 €;-1912;-8,40;7.878,63 €;'sin fechas';08/11/2007;'QUICUINA';'Gastos_Compras';'Supermercado';'VARIABLES'
09/11/2007;09/11/2007;'CINE';-12,80€;3.341,74 €;-1911;-12,80;7.865,83 €;'sin fechas';09/11/2007;'CINE';'Gastos_Ocio y transporte';'Espectáculos';'VARIABLES'
09/11/2007;04/11/2007;'PEAJE XERTA';-5,40€;3.336,34 €;-1910;-5,40;7.860,43 €;'sin fechas';04/11/2007;'PEAJE';'Gastos_Ocio y transporte';'Parking y peaje';'VARIABLES'
09/11/2007;02/11/2007;'PEAJE XERTA';-5,40€;3.330,94 €;-1909;-5,40;7.855,03 €;'sin fechas';02/11/2007;'PEAJE';'Gastos_Ocio y transporte';'Parking y peaje';'VARIABLES'
11/11/2007;11/11/2007;'REINT.CAJERO';-20,00€;3.310,94 €;-1908;-20,00;7.835,03 €;'sin fechas';11/11/2007;'REINTCAJERO';'Gastos_Gastos varios';'Efectivo';'VARIABLES'
12/11/2007;12/11/2007;'CAFET.C T PRAT';-2,10€;3.308,84 €;-1907;-2,10;7.832,93 €;'sin fechas';12/11/2007;'CAFETC';'Gastos_Ocio y transporte';'Restaurantes';'VARIABLES'
12/11/2007;02/11/2007;'PEAJE XERTA';-2,35€;3.306,49 €;-1906;-2,35;7.830,58 €;'sin fechas';02/11/2007;'PEAJE';'Gastos_Ocio y transporte';'Parking y peaje';'VARIABLES'
12/11/2007;02/11/2007;'PEAJE XERTA';-3,20€;3.303,29 €;-1905;-3,20;7.827,38 €;'sin fechas';02/11/2007;'PEAJE';'Gastos_Ocio y transporte';'Parking y peaje';'VARIABLES'
12/11/2007;04/11/2007;'PEAJE XERTA';-2,50€;3.300,79 €;-1904;-2,50;7.824,88 €;'sin fechas';04/11/2007;'PEAJE';'Gastos_Ocio y transporte';'Parking y peaje';'VARIABLES'
12/11/2007;04/11/2007;'PEAJE XERTA';-2,35€;3.298,44 €;-1903;-2,35;7.822,53 €;'sin fechas';04/11/2007;'PEAJE';'Gastos_Ocio y transporte';'Parking y peaje';'VARIABLES'
12/11/2007;02/11/2007;'PEAJE XERTA';-2,50€;3.295,94 €;-1902;-2,50;7.820,03 €;'sin fechas';02/11/2007;'PEAJE';'Gastos_Ocio y transporte';'Parking y peaje';'VARIABLES'
12/11/2007;04/11/2007;'PEAJE XERTA';-3,20€;3.292,74 €;-1901;-3,20;7.816,83 €;'sin fechas';04/11/2007;'PEAJE';'Gastos_Ocio y transporte';'Parking y peaje';'VARIABLES'
12/11/2007;01/11/2007;'PEAJE XERTA';-3,20€;3.289,54 €;-1900;-3,20;7.813,63 €;'sin fechas';01/11/2007;'PEAJE';'Gastos_Ocio y transporte';'Parking y peaje';'VARIABLES'
12/11/2007;01/11/2007;'PEAJE XERTA';-3,20€;3.286,34 €;-1899;-3,20;7.810,43 €;'sin fechas';01/11/2007;'PEAJE';'Gastos_Ocio y transporte';'Parking y peaje';'VARIABLES'
13/11/2007;13/11/2007;'CAFET.C T PRAT';-2,60€;3.283,74 €;-1898;-2,60;7.807,83 €;'sin fechas';13/11/2007;'CAFETC';'Gastos_Ocio y transporte';'Restaurantes';'VARIABLES'
14/11/2007;14/11/2007;'CAFET.C T PRAT';-2,00€;3.281,74 €;-1897;-2,00;7.805,83 €;'sin fechas';14/11/2007;'CAFETC';'Gastos_Ocio y transporte';'Restaurantes';'VARIABLES'
15/11/2007;15/11/2007;'CAFET.C T PRAT';-2,75€;3.278,99 €;-1896;-2,75;7.803,08 €;'sin fechas';15/11/2007;'CAFETC';'Gastos_Ocio y transporte';'Restaurantes';'VARIABLES'
15/11/2007;15/11/2007;'SEG.AM.HIPITEC';-32,35€;3.246,64 €;-1895;-32,35;7.770,73 €;'sin fechas';15/11/2007;'SEGAMHIPITEC';'Gastos_Seguros';'Seguro vida';'FIJO'
16/11/2007;16/11/2007;'CAFET.C T PRAT';-2,00€;3.244,64 €;-1894;-2,00;7.768,73 €;'sin fechas';16/11/2007;'CAFETC';'Gastos_Ocio y transporte';'Restaurantes';'VARIABLES'
16/11/2007;16/11/2007;'CINE';-12,80€;3.231,84 €;-1893;-12,80;7.755,93 €;'sin fechas';16/11/2007;'CINE';'Gastos_Ocio y transporte';'Espectáculos';'VARIABLES'
16/11/2007;16/11/2007;'ENDESA DISTRIB';-84,45€;3.147,39 €;-1892;-84,45;7.671,48 €;'sin fechas';16/11/2007;'ENDESA';'Gastos_Servicios tipicos';'Electricidad';'FIJO'
16/11/2007;16/11/2007;'GASOLINA';-30,00€;3.117,39 €;-1891;-30,00;7.641,48 €;'sin fechas';16/11/2007;'GASOLINA';'Gastos_Ocio y transporte';'Gasolina';'VARIABLES'
16/11/2007;16/11/2007;'MERCADONA';-144,51€;2.972,88 €;-1890;-144,51;7.496,97 €;'sin fechas';16/11/2007;'MERCADONA';'Gastos_Compras';'Supermercado';'VARIABLES'
17/11/2007;17/11/2007;'FF.CC.GENERALITAT';-19,00€;2.953,88 €;-1889;-19,00;7.477,97 €;'sin fechas';17/11/2007;'FFCCGENERALITAT';'Gastos_Ocio y transporte';'Transporte';'VARIABLES'
17/11/2007;17/11/2007;'FNAC';-49,95€;2.903,93 €;-1888;-49,95;7.428,02 €;'sin fechas';17/11/2007;'FNAC';'Gastos_Compras';'Supermercado';'VARIABLES'
17/11/2007;17/11/2007;'RESTAURANTES';-43,87€;2.860,06 €;-1887;-43,87;7.384,15 €;'sin fechas';17/11/2007;'RESTAURANTES';'Gastos_Ocio y transporte';'Restaurantes';'VARIABLES'
17/11/2007;17/11/2007;'RESTAURANTES';-11,00€;2.849,06 €;-1886;-11,00;7.373,15 €;'sin fechas';17/11/2007;'RESTAURANTES';'Gastos_Ocio y transporte';'Restaurantes';'VARIABLES'
17/11/2007;17/11/2007;'XIN HUA EXTREMO O';-48,27€;2.800,79 €;-1885;-48,27;7.324,88 €;'sin fechas';17/11/2007;'XIN';'Gastos_Ocio y transporte';'Restaurantes';'VARIABLES'
19/11/2007;19/11/2007;'ATRAPALO COM';-194,00€;2.606,79 €;-1884;-194,00;7.130,88 €;'sin fechas';19/11/2007;'ATRAPALO';'Gastos_Ocio y transporte';'Vacaciones';'VARIABLES'
19/11/2007;19/11/2007;'BON AREA';-20,12€;2.586,67 €;-1883;-20,12;7.110,76 €;'sin fechas';19/11/2007;'BON';'Gastos_Compras';'Supermercado';'VARIABLES'
19/11/2007;19/11/2007;'CAFET.C T PRAT';-2,50€;2.584,17 €;-1882;-2,50;7.108,26 €;'sin fechas';19/11/2007;'CAFETC';'Gastos_Ocio y transporte';'Restaurantes';'VARIABLES'
19/11/2007;19/11/2007;'ONO';-77,76€;2.506,41 €;-1881;-77,76;7.030,50 €;'sin fechas';19/11/2007;'ONO';'Gastos_Servicios tipicos';'Telecomunicaciones';'FIJO'
19/11/2007;19/11/2007;'REINT.CAJERO';-30,00€;2.476,41 €;-1880;-30,00;7.000,50 €;'sin fechas';19/11/2007;'REINTCAJERO';'Gastos_Gastos varios';'Efectivo';'VARIABLES'
20/11/2007;20/11/2007;'CAFET.C T PRAT';-2,00€;2.474,41 €;-1879;-2,00;6.998,50 €;'sin fechas';20/11/2007;'CAFETC';'Gastos_Ocio y transporte';'Restaurantes';'VARIABLES'
20/11/2007;20/11/2007;'GASOLINA';-5,40€;2.469,01 €;-1878;-5,40;6.993,10 €;'sin fechas';20/11/2007;'GASOLINA';'Gastos_Ocio y transporte';'Gasolina';'VARIABLES'
21/11/2007;21/11/2007;'CAFET.C T PRAT';-2,90€;2.466,11 €;-1877;-2,90;6.990,20 €;'sin fechas';21/11/2007;'CAFETC';'Gastos_Ocio y transporte';'Restaurantes';'VARIABLES'
22/11/2007;22/11/2007;'CAFET.C T PRAT';-3,85€;2.462,26 €;-1876;-3,85;6.986,35 €;'sin fechas';22/11/2007;'CAFETC';'Gastos_Ocio y transporte';'Restaurantes';'VARIABLES'
22/11/2007;22/11/2007;'MARINA SPORTS\\PRAT LLOBREGA';-25,00€;2.437,26 €;-1875;-25,00;6.961,35 €;'sin fechas';22/11/2007;'MARINA';'Gastos_Compras';'Ropa';'VARIABLES'
23/11/2007;23/11/2007;'FRANCE TELECOM';-11,52€;2.425,74 €;-1874;-11,52;6.949,83 €;'sin fechas';23/11/2007;'FRANCE';'Gastos_Servicios tipicos';'Telecomunicaciones';'FIJO'
23/11/2007;23/11/2007;'GASOLINA';-26,85€;2.398,89 €;-1873;-26,85;6.922,98 €;'sin fechas';23/11/2007;'GASOLINA';'Gastos_Ocio y transporte';'Gasolina';'VARIABLES'
23/11/2007;23/11/2007;'REINT.CAJERO';-110,00€;2.288,89 €;-1872;-110,00;6.812,98 €;'sin fechas';23/11/2007;'REINTCAJERO';'Gastos_Gastos varios';'Efectivo';'VARIABLES'
23/11/2007;23/11/2007;'RESTAURANTES';-63,24€;2.225,65 €;-1871;-63,24;6.749,74 €;'sin fechas';23/11/2007;'RESTAURANTES';'Gastos_Ocio y transporte';'Restaurantes';'VARIABLES'
24/11/2007;24/11/2007;'EROSKI-[COMIDA]';-18,53€;2.207,12 €;-1870;-18,53;6.731,21 €;'sin fechas';24/11/2007;'EROSKICOMIDA';'Gastos_Compras';'Supermercado';'VARIABLES'
26/11/2007;26/11/2007;'CAFET.C T PRAT';-2,00€;2.205,12 €;-1869;-2,00;6.729,21 €;'sin fechas';26/11/2007;'CAFETC';'Gastos_Ocio y transporte';'Restaurantes';'VARIABLES'
28/11/2007;28/11/2007;'CAFET.C T PRAT';-2,00€;2.203,12 €;-1868;-2,00;6.727,21 €;'sin fechas';28/11/2007;'CAFETC';'Gastos_Ocio y transporte';'Restaurantes';'VARIABLES'
28/11/2007;28/11/2007;'CINE';-8,00€;2.195,12 €;-1867;-8,00;6.719,21 €;'sin fechas';28/11/2007;'CINE';'Gastos_Ocio y transporte';'Espectáculos';'VARIABLES'
28/11/2007;28/11/2007;'GASOLINA';-35,00€;2.160,12 €;-1866;-35,00;6.684,21 €;'sin fechas';28/11/2007;'GASOLINA';'Gastos_Ocio y transporte';'Gasolina';'VARIABLES'
28/11/2007;23/11/2007;'PEAJE XERTA';-8,55€;2.151,57 €;-1865;-8,55;6.675,66 €;'sin fechas';23/11/2007;'PEAJE';'Gastos_Ocio y transporte';'Parking y peaje';'VARIABLES'
29/11/2007;29/11/2007;'CAFET.C T PRAT';-4,00€;2.147,57 €;-1864;-4,00;6.671,66 €;'sin fechas';29/11/2007;'CAFETC';'Gastos_Ocio y transporte';'Restaurantes';'VARIABLES'
29/11/2007;29/11/2007;'FRUITES I VERDURES';-7,33€;2.140,24 €;-1863;-7,33;6.664,33 €;'sin fechas';29/11/2007;'FRUITES';'Gastos_Compras';'Supermercado';'VARIABLES'
29/11/2007;30/11/2007;'INFORMACIO I TECNOLOGIA DE CAT';1.420,04€;3.560,28 €;-1862;1.420,04;8.084,37 €;'sin fechas';30/11/2007;'INFORMACIO';'Ingresos';'Nomina';'FIJO'
30/11/2007;30/11/2007;'CAFET.C T PRAT';-2,00€;3.558,28 €;-1861;-2,00;8.082,37 €;'sin fechas';30/11/2007;'CAFETC';'Gastos_Ocio y transporte';'Restaurantes';'VARIABLES'
30/11/2007;30/11/2007;'RECIBO PTMOS. 3061-0960004140';-177,24€;3.381,04 €;-1860;-177,24;7.905,13 €;'sin fechas';30/11/2007;'RECIBO';'Gastos_Banco y organismos';'Hipoteca';'FIJO'
30/11/2007;30/11/2007;'RECIBO PTMOS. 3061-0960001518';-798,05€;2.582,99 €;-1859;-798,05;7.107,08 €;'sin fechas';30/11/2007;'RECIBO';'Gastos_Banco y organismos';'Hipoteca';'FIJO'
01/12/2007;01/12/2007;'BON AREA';-24,70€;2.558,29 €;-1858;-24,70;7.082,38 €;'sin fechas';01/12/2007;'BON';'Gastos_Compras';'Supermercado';'VARIABLES'
01/12/2007;01/12/2007;'CINE';-21,60€;2.536,69 €;-1857;-21,60;7.060,78 €;'sin fechas';01/12/2007;'CINE';'Gastos_Ocio y transporte';'Espectáculos';'VARIABLES'
01/12/2007;01/12/2007;'RESTAURANTES';-41,80€;2.494,89 €;-1856;-41,80;7.018,98 €;'sin fechas';01/12/2007;'RESTAURANTES';'Gastos_Ocio y transporte';'Restaurantes';'VARIABLES'
02/12/2007;30/11/2007;'AGENCIA DE LA MICROEMPRESA';687,47€;3.182,36 €;-1855;687,47;7.706,45 €;'sin fechas';30/11/2007;'AGENCIA';'Ingresos';'Nomina';'FIJO'
02/12/2007;30/11/2007;'FUNDACIO PRIVADA';313,93€;3.496,29 €;-1854;313,93;8.020,38 €;'sin fechas';30/11/2007;'FUNDACIO';'Ingresos';'Nomina';'FIJO'
03/12/2007;26/11/2007;'PEAJE RUBI';-1,08€;3.495,21 €;-1853;-1,08;8.019,30 €;'sin fechas';26/11/2007;'PEAJE';'Gastos_Ocio y transporte';'Parking y peaje';'VARIABLES'
03/12/2007;25/11/2007;'PEAJE XERTA';-8,55€;3.486,66 €;-1852;-8,55;8.010,75 €;'sin fechas';25/11/2007;'PEAJE';'Gastos_Ocio y transporte';'Parking y peaje';'VARIABLES'
03/12/2007;03/12/2007;'REINT.CAJERO';-30,00€;3.456,66 €;-1851;-30,00;7.980,75 €;'sin fechas';03/12/2007;'REINTCAJERO';'Gastos_Gastos varios';'Efectivo';'VARIABLES'
03/12/2007;03/12/2007;'VIRGIN ACTIVE';-54,00€;3.402,66 €;-1850;-54,00;7.926,75 €;'sin fechas';03/12/2007;'VIRGIN';'Gastos_Salud, saber y deporte';'Deportes';'VARIABLES'
04/12/2007;04/12/2007;'CAFET.C T PRAT';-2,00€;3.400,66 €;-1849;-2,00;7.924,75 €;'sin fechas';04/12/2007;'CAFETC';'Gastos_Ocio y transporte';'Restaurantes';'VARIABLES'
04/12/2007;04/12/2007;'FRANCE TELECOM';-10,44€;3.390,22 €;-1848;-10,44;7.914,31 €;'sin fechas';04/12/2007;'FRANCE';'Gastos_Servicios tipicos';'Telecomunicaciones';'FIJO'
05/12/2007;05/12/2007;'CAFET.C T PRAT';-2,00€;3.388,22 €;-1847;-2,00;7.912,31 €;'sin fechas';05/12/2007;'CAFETC';'Gastos_Ocio y transporte';'Restaurantes';'VARIABLES'
05/12/2007;05/12/2007;'GROUPAMA PLUS';-42,57€;3.345,65 €;-1846;-42,57;7.869,74 €;'sin fechas';05/12/2007;'GROUPAMA';'Gastos_Seguros';'Seguro salud';'FIJO'
05/12/2007;05/12/2007;'REINT.CAJERO';-220,00€;3.125,65 €;-1845;-220,00;7.649,74 €;'sin fechas';05/12/2007;'REINTCAJERO';'Gastos_Gastos varios';'Efectivo';'VARIABLES'
06/12/2007;06/12/2007;'CARREFOUR-[comida]';-81,84€;3.043,81 €;-1844;-81,84;7.567,90 €;'sin fechas';06/12/2007;'CARREFOURCOMIDA';'Gastos_Compras';'Supermercado';'VARIABLES'
06/12/2007;06/12/2007;'CINE';-9,80€;3.034,01 €;-1843;-9,80;7.558,10 €;'sin fechas';06/12/2007;'CINE';'Gastos_Ocio y transporte';'Espectáculos';'VARIABLES'
06/12/2007;06/12/2007;'GASOLINA';-30,00€;3.004,01 €;-1842;-30,00;7.528,10 €;'sin fechas';06/12/2007;'GASOLINA';'Gastos_Ocio y transporte';'Gasolina';'VARIABLES'
06/12/2007;06/12/2007;'RESTAURANTES';-26,75€;2.977,26 €;-1841;-26,75;7.501,35 €;'sin fechas';06/12/2007;'RESTAURANTES';'Gastos_Ocio y transporte';'Restaurantes';'VARIABLES'
07/12/2007;07/12/2007;'GAS NATURAL';-164,65€;2.812,61 €;-1840;-164,65;7.336,70 €;'sin fechas';07/12/2007;'GAS';'Gastos_Servicios tipicos';'Gas';'FIJO'
07/12/2007;07/12/2007;'SUPER DE CARN TOT';-37,34€;2.775,27 €;-1839;-37,34;7.299,36 €;'sin fechas';07/12/2007;'SUPER';'Gastos_Compras';'Supermercado';'VARIABLES'
08/12/2007;08/12/2007;'REINT.CAJERO';-40,00€;2.735,27 €;-1838;-40,00;7.259,36 €;'sin fechas';08/12/2007;'REINTCAJERO';'Gastos_Gastos varios';'Efectivo';'VARIABLES'
08/12/2007;08/12/2007;'REINT.CAJERO';-80,00€;2.655,27 €;-1837;-80,00;7.179,36 €;'sin fechas';08/12/2007;'REINTCAJERO';'Gastos_Gastos varios';'Efectivo';'VARIABLES'
10/12/2007;10/12/2007;'CAFET.C T PRAT';-2,75€;2.652,52 €;-1836;-2,75;7.176,61 €;'sin fechas';10/12/2007;'CAFETC';'Gastos_Ocio y transporte';'Restaurantes';'VARIABLES'
10/12/2007;02/12/2007;'OTROS';-6,00€;2.646,52 €;-1835;-6,00;7.170,61 €;'sin fechas';02/12/2007;'OTROS';'Gastos_Gastos varios';'Otros gastos';'VARIABLES'
10/12/2007;10/12/2007;'REINT.CAJERO';-70,00€;2.576,52 €;-1834;-70,00;7.100,61 €;'sin fechas';10/12/2007;'REINTCAJERO';'Gastos_Gastos varios';'Efectivo';'VARIABLES'
14/12/2007;14/12/2007;'BIJOU BRIGITTE S';-19,85€;2.556,67 €;-1833;-19,85;7.080,76 €;'sin fechas';14/12/2007;'BIJOU';'Gastos_Compras';'Ropa';'VARIABLES'
14/12/2007;14/12/2007;'PERFU.ATALAYA';-18,14€;2.538,53 €;-1832;-18,14;7.062,62 €;'sin fechas';14/12/2007;'PERFUATALAYA';'Gastos_Compras';'Hogar';'VARIABLES'
14/12/2007;14/12/2007;'REINT.CAJERO';-40,00€;2.498,53 €;-1831;-40,00;7.022,62 €;'sin fechas';14/12/2007;'REINTCAJERO';'Gastos_Gastos varios';'Efectivo';'VARIABLES'
14/12/2007;14/12/2007;'TOYOTA ORIENT CARS';-152,76€;2.345,77 €;-1830;-152,76;6.869,86 €;'sin fechas';14/12/2007;'TOYOTA';'Gastos_Vivienda y vehiculo';'Mnto. vehiculo';'VARIABLE'
15/12/2007;15/12/2007;'CATEQUA';-151,00€;2.194,77 €;-1829;-151,00;6.718,86 €;'sin fechas';15/12/2007;'CATEQUA';'Gastos_Compras';'Supermercado';'VARIABLES'
15/12/2007;15/12/2007;'GASOLINA';-25,00€;2.169,77 €;-1828;-25,00;6.693,86 €;'sin fechas';15/12/2007;'GASOLINA';'Gastos_Ocio y transporte';'Gasolina';'VARIABLES'
15/12/2007;15/12/2007;'RESTAURANTES';-25,70€;2.144,07 €;-1827;-25,70;6.668,16 €;'sin fechas';15/12/2007;'RESTAURANTES';'Gastos_Ocio y transporte';'Restaurantes';'VARIABLES'
15/12/2007;15/12/2007;'RESTAURANTES';-24,72€;2.119,35 €;-1826;-24,72;6.643,44 €;'sin fechas';15/12/2007;'RESTAURANTES';'Gastos_Ocio y transporte';'Restaurantes';'VARIABLES'
15/12/2007;15/12/2007;'YVES ROCHER';-39,70€;2.079,65 €;-1825;-39,70;6.603,74 €;'sin fechas';15/12/2007;'YVES';'Gastos_Salud, saber y deporte';'Belleza';'VARIABLES'
17/12/2007;17/12/2007;'FARMACIA';-11,33€;2.068,32 €;-1824;-11,33;6.592,41 €;'sin fechas';17/12/2007;'FARMACIA';'Gastos_Salud, saber y deporte';'Farmacia';'VARIABLES'
17/12/2007;17/12/2007;'ONO';-78,94€;1.989,38 €;-1823;-78,94;6.513,47 €;'sin fechas';17/12/2007;'ONO';'Gastos_Servicios tipicos';'Telecomunicaciones';'FIJO'
17/12/2007;17/12/2007;'RESTAURANTES';-76,29€;1.913,09 €;-1822;-76,29;6.437,18 €;'sin fechas';17/12/2007;'RESTAURANTES';'Gastos_Ocio y transporte';'Restaurantes';'VARIABLES'
18/12/2007;18/12/2007;'PSP';-229,93€;1.683,16 €;-1821;-229,93;6.207,25 €;'sin fechas';18/12/2007;'PSP';'Gastos_Compras';'Hobbys';'VARIABLES'
18/12/2007;18/12/2007;'SEG.AM.HIPITEC';-32,31€;1.650,85 €;-1820;-32,31;6.174,94 €;'sin fechas';18/12/2007;'SEGAMHIPITEC';'Gastos_Seguros';'Seguro vida';'FIJO'
19/12/2007;19/12/2007;'CAFET.C T PRAT';-2,00€;1.648,85 €;-1819;-2,00;6.172,94 €;'sin fechas';19/12/2007;'CAFETC';'Gastos_Ocio y transporte';'Restaurantes';'VARIABLES'
19/12/2007;19/12/2007;'CAFET.C T PRAT';-1,55€;1.647,30 €;-1818;-1,55;6.171,39 €;'sin fechas';19/12/2007;'CAFETC';'Gastos_Ocio y transporte';'Restaurantes';'VARIABLES'
19/12/2007;20/12/2007;'INFORMACIO I TECNOLOGIA DE CAT';1.559,21€;3.206,51 €;-1817;1.559,21;7.730,60 €;'sin fechas';20/12/2007;'INFORMACIO';'Ingresos';'Nomina';'FIJO'
20/12/2007;20/12/2007;'CAFET.C T PRAT';-2,75€;3.203,76 €;-1816;-2,75;7.727,85 €;'sin fechas';20/12/2007;'CAFETC';'Gastos_Ocio y transporte';'Restaurantes';'VARIABLES'
20/12/2007;20/12/2007;'CAFET.C T PRAT';-0,70€;3.203,06 €;-1815;-0,70;7.727,15 €;'sin fechas';20/12/2007;'CAFETC';'Gastos_Ocio y transporte';'Restaurantes';'VARIABLES'
20/12/2007;20/12/2007;'CINE';-8,00€;3.195,06 €;-1814;-8,00;7.719,15 €;'sin fechas';20/12/2007;'CINE';'Gastos_Ocio y transporte';'Espectáculos';'VARIABLES'
20/12/2007;20/12/2007;'RESTAURANTES';-15,00€;3.180,06 €;-1813;-15,00;7.704,15 €;'sin fechas';20/12/2007;'RESTAURANTES';'Gastos_Ocio y transporte';'Restaurantes';'VARIABLES'
21/12/2007;21/12/2007;'REINT.CAJERO';-70,00€;3.110,06 €;-1812;-70,00;7.634,15 €;'sin fechas';21/12/2007;'REINTCAJERO';'Gastos_Gastos varios';'Efectivo';'VARIABLES'
22/12/2007;26/12/2007;'AGENCIA DE LA MICROEMPRESA';687,47€;3.797,53 €;-1811;687,47;8.321,62 €;'sin fechas';26/12/2007;'AGENCIA';'Ingresos';'Nomina';'FIJO'
22/12/2007;26/12/2007;'FUNDACIO PRIVADA';313,93€;4.111,46 €;-1810;313,93;8.635,55 €;'sin fechas';26/12/2007;'FUNDACIO';'Ingresos';'Nomina';'FIJO'
22/12/2007;22/12/2007;'GASOLINA';-38,95€;4.072,51 €;-1809;-38,95;8.596,60 €;'sin fechas';22/12/2007;'GASOLINA';'Gastos_Ocio y transporte';'Gasolina';'VARIABLES'
23/12/2007;23/12/2007;'RESTAURANTES';-21,90€;4.050,61 €;-1808;-21,90;8.574,70 €;'sin fechas';23/12/2007;'RESTAURANTES';'Gastos_Ocio y transporte';'Restaurantes';'VARIABLES'
24/12/2007;24/12/2007;'PC GREEN 8';-88,16€;3.962,45 €;-1807;-88,16;8.486,54 €;'sin fechas';24/12/2007;'GREEN';'Gastos_Compras';'Hobbys';'VARIABLES'
26/12/2007;26/12/2007;'FRANCE TELECOM';-10,44€;3.952,01 €;-1806;-10,44;8.476,10 €;'sin fechas';26/12/2007;'FRANCE';'Gastos_Servicios tipicos';'Telecomunicaciones';'FIJO'
26/12/2007;26/12/2007;'MINA PUBLICA DE LA CIUTAT';-21,25€;3.930,76 €;-1805;-21,25;8.454,85 €;'sin fechas';26/12/2007;'MINA';'Gastos_Servicios tipicos';'Agua';'FIJO'
27/12/2007;28/12/2007;'AJUNTAMENT DE TERRASSA';-33,64€;3.897,12 €;-1804;-33,64;8.421,21 €;'sin fechas';28/12/2007;'AJUNTAMENT';'Gastos_Banco y organismos';'Ayuntamiento';'FIJO'
27/12/2007;27/12/2007;'BON AREA';-25,78€;3.871,34 €;-1803;-25,78;8.395,43 €;'sin fechas';27/12/2007;'BON';'Gastos_Compras';'Supermercado';'VARIABLES'
27/12/2007;28/12/2007;'CASER HOGAR';-225,24€;3.646,10 €;-1802;-225,24;8.170,19 €;'sin fechas';28/12/2007;'CASER';'Ingresos';'Transferencias';'VARIABLES'
27/12/2007;27/12/2007;'MERCADONA';-109,87€;3.536,23 €;-1801;-109,87;8.060,32 €;'sin fechas';27/12/2007;'MERCADONA';'Gastos_Compras';'Supermercado';'VARIABLES'
28/12/2007;31/12/2007;'INFORMACIO I TECNOLOGIA DE CAT';1.420,04€;4.956,27 €;-1800;1.420,04;9.480,36 €;'sin fechas';31/12/2007;'INFORMACIO';'Ingresos';'Nomina';'FIJO'
31/12/2007;31/12/2007;'ENTREGA PTMO. 3061-0960001518';-3.000,00€;1.956,27 €;-1799;-3.000,00;6.480,36 €;'sin fechas';31/12/2007;'ENTREGA';'Gastos_Banco y organismos';'Hipoteca';'FIJO'
31/12/2007;31/12/2007;'RECIBO PTMOS. 3061-0960001518';-798,05€;1.158,22 €;-1798;-798,05;5.682,31 €;'sin fechas';31/12/2007;'RECIBO';'Gastos_Banco y organismos';'Hipoteca';'FIJO'
31/12/2007;31/12/2007;'RECIBO PTMOS. 3061-0960004140';-177,24€;980,98 €;-1797;-177,24;5.505,07 €;'sin fechas';31/12/2007;'RECIBO';'Gastos_Banco y organismos';'Hipoteca';'FIJO'
02/01/2008;02/01/2008;'CAFET.C T PRAT';-6,90€;974,08 €;-1796;-6,90;5.498,17 €;'sin fechas';02/01/2008;'CAFETC';'Gastos_Ocio y transporte';'Restaurantes';'VARIABLES'
02/01/2008;02/01/2008;'KEBAP PASSION \\GAVA';-8,90€;965,18 €;-1795;-8,90;5.489,27 €;'sin fechas';02/01/2008;'KEBAP';'Gastos_Ocio y transporte';'Restaurantes';'VARIABLES'
02/01/2008;31/12/2007;'REEMBOLSO FOND 003061000850';1.370,27€;2.335,45 €;-1794;1.370,27;6.859,54 €;'sin fechas';31/12/2007;'REEMBOLSO';'Ingresos';'Transferencias';'VARIABLES'
03/01/2008;03/01/2008;'CAFET.C T PRAT';-6,90€;2.328,55 €;-1793;-6,90;6.852,64 €;'sin fechas';03/01/2008;'CAFETC';'Gastos_Ocio y transporte';'Restaurantes';'VARIABLES'
03/01/2008;03/01/2008;'VIRGIN ACTIVE';-54,00€;2.274,55 €;-1792;-54,00;6.798,64 €;'sin fechas';03/01/2008;'VIRGIN';'Gastos_Salud, saber y deporte';'Deportes';'VARIABLES'
04/01/2008;04/01/2008;'CAFET.C T PRAT';-2,10€;2.272,45 €;-1791;-2,10;6.796,54 €;'sin fechas';04/01/2008;'CAFETC';'Gastos_Ocio y transporte';'Restaurantes';'VARIABLES'
04/01/2008;04/01/2008;'FRANCE TELECOM';-11,75€;2.260,70 €;-1790;-11,75;6.784,79 €;'sin fechas';04/01/2008;'FRANCE';'Gastos_Servicios tipicos';'Telecomunicaciones';'FIJO'
04/01/2008;04/01/2008;'GASOLINA';-30,00€;2.230,70 €;-1789;-30,00;6.754,79 €;'sin fechas';04/01/2008;'GASOLINA';'Gastos_Ocio y transporte';'Gasolina';'VARIABLES'
05/01/2008;05/01/2008;'CARREFOUR-[comida]';-90,60€;2.140,10 €;-1788;-90,60;6.664,19 €;'sin fechas';05/01/2008;'CARREFOURCOMIDA';'Gastos_Compras';'Supermercado';'VARIABLES'
05/01/2008;05/01/2008;'MEXTARRASSA S.L.';-40,18€;2.099,92 €;-1787;-40,18;6.624,01 €;'sin fechas';05/01/2008;'MEXTARRASSA';'Gastos_Ocio y transporte';'Restaurantes';'VARIABLES'
08/01/2008;08/01/2008;'CAFET.C T PRAT';-3,15€;2.096,77 €;-1786;-3,15;6.620,86 €;'sin fechas';08/01/2008;'CAFETC';'Gastos_Ocio y transporte';'Restaurantes';'VARIABLES'
08/01/2008;08/01/2008;'CAFET.C T PRAT';-6,55€;2.090,22 €;-1785;-6,55;6.614,31 €;'sin fechas';08/01/2008;'CAFETC';'Gastos_Ocio y transporte';'Restaurantes';'VARIABLES'
08/01/2008;08/01/2008;'PLATAFORMA CARNICA';-49,89€;2.040,33 €;-1784;-49,89;6.564,42 €;'sin fechas';08/01/2008;'PLATAFORMA';'Gastos_Compras';'Supermercado';'VARIABLES'
09/01/2008;09/01/2008;'CAFET.C T PRAT';-1,85€;2.038,48 €;-1783;-1,85;6.562,57 €;'sin fechas';09/01/2008;'CAFETC';'Gastos_Ocio y transporte';'Restaurantes';'VARIABLES'
09/01/2008;09/01/2008;'CAFET.C T PRAT';-0,80€;2.037,68 €;-1782;-0,80;6.561,77 €;'sin fechas';09/01/2008;'CAFETC';'Gastos_Ocio y transporte';'Restaurantes';'VARIABLES'
09/01/2008;09/01/2008;'GROUPAMA PLUS';-45,11€;1.992,57 €;-1781;-45,11;6.516,66 €;'sin fechas';09/01/2008;'GROUPAMA';'Gastos_Seguros';'Seguro salud';'FIJO'
10/01/2008;10/01/2008;'CAFET.C T PRAT';-2,60€;1.989,97 €;-1780;-2,60;6.514,06 €;'sin fechas';10/01/2008;'CAFETC';'Gastos_Ocio y transporte';'Restaurantes';'VARIABLES'
10/01/2008;10/01/2008;'REINT.CAJERO';-80,00€;1.909,97 €;-1779;-80,00;6.434,06 €;'sin fechas';10/01/2008;'REINTCAJERO';'Gastos_Gastos varios';'Efectivo';'VARIABLES'
11/01/2008;11/01/2008;'CAFET.C T PRAT';-2,90€;1.907,07 €;-1778;-2,90;6.431,16 €;'sin fechas';11/01/2008;'CAFETC';'Gastos_Ocio y transporte';'Restaurantes';'VARIABLES'
12/01/2008;12/01/2008;'CARREFOUR-[comida]';-61,00€;1.846,07 €;-1777;-61,00;6.370,16 €;'sin fechas';12/01/2008;'CARREFOURCOMIDA';'Gastos_Compras';'Supermercado';'VARIABLES'
12/01/2008;12/01/2008;'GASOLINA';-35,00€;1.811,07 €;-1776;-35,00;6.335,16 €;'sin fechas';12/01/2008;'GASOLINA';'Gastos_Ocio y transporte';'Gasolina';'VARIABLES'
12/01/2008;12/01/2008;'H&M';-32,35€;1.778,72 €;-1775;-32,35;6.302,81 €;'sin fechas';12/01/2008;'HM';'Gastos_Compras';'Ropa';'VARIABLES'
12/01/2008;12/01/2008;'JIANHONG ZHOU S.L.';-24,88€;1.753,84 €;-1774;-24,88;6.277,93 €;'sin fechas';12/01/2008;'JIANHONG';'Gastos_Ocio y transporte';'Restaurantes';'VARIABLES'
12/01/2008;12/01/2008;'KANAK BARCELONA S';-54,85€;1.698,99 €;-1773;-54,85;6.223,08 €;'sin fechas';12/01/2008;'KANAK';'Gastos_Compras';'Ropa';'VARIABLES'
12/01/2008;12/01/2008;'KUROKAI';-126,96€;1.572,03 €;-1772;-126,96;6.096,12 €;'sin fechas';12/01/2008;'KUROKAI';'Gastos_Compras';'Ropa';'VARIABLES'
12/01/2008;12/01/2008;'MC DONALDS';-5,30€;1.566,73 €;-1771;-5,30;6.090,82 €;'sin fechas';12/01/2008;'DONALDS';'Gastos_Ocio y transporte';'Restaurantes';'VARIABLES'
12/01/2008;14/01/2008;'SERGIO PSP Jose luis';-210,00€;1.356,73 €;-1770;-210,00;5.880,82 €;'sin fechas';14/01/2008;'SERGIO';'Gastos_Compras';'Hobbys';'VARIABLES'
13/01/2008;13/01/2008;'CARREFOUR-[comida]';-3,37€;1.353,36 €;-1769;-3,37;5.877,45 €;'sin fechas';13/01/2008;'CARREFOURCOMIDA';'Gastos_Compras';'Supermercado';'VARIABLES'
13/01/2008;13/01/2008;'LA BRASA';-22,37€;1.330,99 €;-1768;-22,37;5.855,08 €;'sin fechas';13/01/2008;'BRASA';'Gastos_Ocio y transporte';'Restaurantes';'VARIABLES'
14/01/2008;14/01/2008;'BON AREA';-21,68€;1.309,31 €;-1767;-21,68;5.833,40 €;'sin fechas';14/01/2008;'BON';'Gastos_Compras';'Supermercado';'VARIABLES'
14/01/2008;14/01/2008;'SABATERIA RODANA';-85,00€;1.224,31 €;-1766;-85,00;5.748,40 €;'sin fechas';14/01/2008;'SABATERIA';'Gastos_Compras';'Ropa';'VARIABLES'
15/01/2008;15/01/2008;'CAFET.C T PRAT';-2,10€;1.222,21 €;-1765;-2,10;5.746,30 €;'sin fechas';15/01/2008;'CAFETC';'Gastos_Ocio y transporte';'Restaurantes';'VARIABLES'
15/01/2008;15/01/2008;'CARREFOUR-[comida]';-2,00€;1.220,21 €;-1764;-2,00;5.744,30 €;'sin fechas';15/01/2008;'CARREFOURCOMIDA';'Gastos_Compras';'Supermercado';'VARIABLES'
15/01/2008;15/01/2008;'FARMACIA';-14,47€;1.205,74 €;-1763;-14,47;5.729,83 €;'sin fechas';15/01/2008;'FARMACIA';'Gastos_Salud, saber y deporte';'Farmacia';'VARIABLES'
15/01/2008;15/01/2008;'SEG.AM.HIPITEC';-31,60€;1.174,14 €;-1762;-31,60;5.698,23 €;'sin fechas';15/01/2008;'SEGAMHIPITEC';'Gastos_Seguros';'Seguro vida';'FIJO'
16/01/2008;16/01/2008;'CAFET.C T PRAT';-2,10€;1.172,04 €;-1761;-2,10;5.696,13 €;'sin fechas';16/01/2008;'CAFETC';'Gastos_Ocio y transporte';'Restaurantes';'VARIABLES'
17/01/2008;17/01/2008;'CAFET.C T PRAT';-4,25€;1.167,79 €;-1760;-4,25;5.691,88 €;'sin fechas';17/01/2008;'CAFETC';'Gastos_Ocio y transporte';'Restaurantes';'VARIABLES'
17/01/2008;17/01/2008;'ONO';-80,58€;1.087,21 €;-1759;-80,58;5.611,30 €;'sin fechas';17/01/2008;'ONO';'Gastos_Servicios tipicos';'Telecomunicaciones';'FIJO'
18/01/2008;18/01/2008;'CAFET.C T PRAT';-3,45€;1.083,76 €;-1758;-3,45;5.607,85 €;'sin fechas';18/01/2008;'CAFETC';'Gastos_Ocio y transporte';'Restaurantes';'VARIABLES'
18/01/2008;18/01/2008;'ENDESA DISTRIB';-93,68€;990,08 €;-1757;-93,68;5.514,17 €;'sin fechas';18/01/2008;'ENDESA';'Gastos_Servicios tipicos';'Electricidad';'FIJO'
18/01/2008;18/01/2008;'MERCADONA';-68,09€;921,99 €;-1756;-68,09;5.446,08 €;'sin fechas';18/01/2008;'MERCADONA';'Gastos_Compras';'Supermercado';'VARIABLES'
19/01/2008;19/01/2008;'ALCAMPO';-97,91€;824,08 €;-1755;-97,91;5.348,17 €;'sin fechas';19/01/2008;'ALCAMPO';'Gastos_Compras';'Supermercado';'VARIABLES'
19/01/2008;19/01/2008;'AMC PARC VALLES';-19,60€;804,48 €;-1754;-19,60;5.328,57 €;'sin fechas';19/01/2008;'AMC';'Gastos_Ocio y transporte';'Espectáculos';'VARIABLES'
19/01/2008;19/01/2008;'PEIXOS POVILL \\MONISTROL DE';-73,60€;730,88 €;-1753;-73,60;5.254,97 €;'sin fechas';19/01/2008;'PEIXOS';'Gastos_Compras';'Supermercado';'VARIABLES'
22/01/2008;22/01/2008;'GASOLINA';-30,00€;700,88 €;-1752;-30,00;5.224,97 €;'sin fechas';22/01/2008;'GASOLINA';'Gastos_Ocio y transporte';'Gasolina';'VARIABLES'
23/01/2008;23/01/2008;'FRANCE TELECOM';-26,39€;674,49 €;-1751;-26,39;5.198,58 €;'sin fechas';23/01/2008;'FRANCE';'Gastos_Servicios tipicos';'Telecomunicaciones';'FIJO'
24/01/2008;24/01/2008;'GIFI';-25,35€;649,14 €;-1750;-25,35;5.173,23 €;'sin fechas';24/01/2008;'GIFI';'Gastos_Compras';'Hogar';'VARIABLES'
25/01/2008;25/01/2008;'LA TORRETA';-12,18€;636,96 €;-1749;-12,18;5.161,05 €;'sin fechas';25/01/2008;'TORRETA';'Gastos_Ocio y transporte';'Restaurantes';'VARIABLES'
25/01/2008;25/01/2008;'LA TORRETA';-12,18€;624,78 €;-1748;-12,18;5.148,87 €;'sin fechas';25/01/2008;'TORRETA';'Gastos_Ocio y transporte';'Restaurantes';'VARIABLES'
25/01/2008;25/01/2008;'MERCADONA';-74,74€;550,04 €;-1747;-74,74;5.074,13 €;'sin fechas';25/01/2008;'MERCADONA';'Gastos_Compras';'Supermercado';'VARIABLES'
25/01/2008;25/01/2008;'OCEAN TECNOLOGIC S';-16,94€;533,10 €;-1746;-16,94;5.057,19 €;'sin fechas';25/01/2008;'OCEAN';'Gastos_Compras';'Hogar';'VARIABLES'
30/01/2008;30/01/2008;'CAFET.C T PRAT';-1,90€;531,20 €;-1745;-1,90;5.055,29 €;'sin fechas';30/01/2008;'CAFETC';'Gastos_Ocio y transporte';'Restaurantes';'VARIABLES'
30/01/2008;30/01/2008;'I TORRE TERRASA';-13,45€;517,75 €;-1744;-13,45;5.041,84 €;'sin fechas';30/01/2008;'TORRE';'Gastos_Ocio y transporte';'Restaurantes';'VARIABLES'
30/01/2008;31/01/2008;'INFORMACIO I TECNOLOGIA DE CAT';1.420,04€;1.937,79 €;-1743;1.420,04;6.461,88 €;'sin fechas';31/01/2008;'INFORMACIO';'Ingresos';'Nomina';'FIJO'
31/01/2008;31/01/2008;'CAFET.C T PRAT';-3,90€;1.933,89 €;-1742;-3,90;6.457,98 €;'sin fechas';31/01/2008;'CAFETC';'Gastos_Ocio y transporte';'Restaurantes';'VARIABLES'
31/01/2008;31/01/2008;'GASOLINA';-30,00€;1.903,89 €;-1741;-30,00;6.427,98 €;'sin fechas';31/01/2008;'GASOLINA';'Gastos_Ocio y transporte';'Gasolina';'VARIABLES'
31/01/2008;31/01/2008;'RECIBO PTMOS. 3061-0960001518';-814,88€;1.089,01 €;-1740;-814,88;5.613,10 €;'sin fechas';31/01/2008;'RECIBO';'Gastos_Banco y organismos';'Hipoteca';'FIJO'
31/01/2008;31/01/2008;'RECIBO PTMOS. 3061-0960004140';-177,24€;911,77 €;-1739;-177,24;5.435,86 €;'sin fechas';31/01/2008;'RECIBO';'Gastos_Banco y organismos';'Hipoteca';'FIJO'
01/02/2008;31/01/2008;'AGENCIA DE LA MICROEMPRESA';853,65€;1.765,42 €;-1738;853,65;6.289,51 €;'sin fechas';31/01/2008;'AGENCIA';'Ingresos';'Nomina';'FIJO'
01/02/2008;01/02/2008;'CAFET.C T PRAT';-2,10€;1.763,32 €;-1737;-2,10;6.287,41 €;'sin fechas';01/02/2008;'CAFETC';'Gastos_Ocio y transporte';'Restaurantes';'VARIABLES'
01/02/2008;31/01/2008;'FUNDACIO PRIVADA';300,60€;2.063,92 €;-1736;300,60;6.588,01 €;'sin fechas';31/01/2008;'FUNDACIO';'Ingresos';'Nomina';'FIJO'
02/02/2008;02/02/2008;'PELUQUERIAS';-21,70€;2.042,22 €;-1735;-21,70;6.566,31 €;'sin fechas';02/02/2008;'PELUQUERIAS';'Gastos_Salud, saber y deporte';'Belleza';'VARIABLES'
02/02/2008;02/02/2008;'REST.LA MASADA \\TORTOSA';-13,50€;2.028,72 €;-1734;-13,50;6.552,81 €;'sin fechas';02/02/2008;'RESTLA';'Gastos_Ocio y transporte';'Restaurantes';'VARIABLES'
03/02/2008;03/02/2008;'BURGUER KING PARK';-9,40€;2.019,32 €;-1733;-9,40;6.543,41 €;'sin fechas';03/02/2008;'BURGUER';'Gastos_Ocio y transporte';'Restaurantes';'VARIABLES'
03/02/2008;03/02/2008;'TEMPLE \\TORTOSA';-20,00€;1.999,32 €;-1732;-20,00;6.523,41 €;'sin fechas';03/02/2008;'TEMPLE';'Gastos_Ocio y transporte';'Gasolina';'VARIABLES'
04/02/2008;04/02/2008;'CAFET.C T PRAT';-2,35€;1.996,97 €;-1731;-2,35;6.521,06 €;'sin fechas';04/02/2008;'CAFETC';'Gastos_Ocio y transporte';'Restaurantes';'VARIABLES'
05/02/2008;05/02/2008;'CAFET.C T PRAT';-2,60€;1.994,37 €;-1730;-2,60;6.518,46 €;'sin fechas';05/02/2008;'CAFETC';'Gastos_Ocio y transporte';'Restaurantes';'VARIABLES'
05/02/2008;05/02/2008;'FRANCE TELECOM';-12,01€;1.982,36 €;-1729;-12,01;6.506,45 €;'sin fechas';05/02/2008;'FRANCE';'Gastos_Servicios tipicos';'Telecomunicaciones';'FIJO'
05/02/2008;05/02/2008;'GAS NATURAL';-170,02€;1.812,34 €;-1728;-170,02;6.336,43 €;'sin fechas';05/02/2008;'GAS';'Gastos_Servicios tipicos';'Gas';'FIJO'
05/02/2008;05/02/2008;'MERCADONA';-15,61€;1.796,73 €;-1727;-15,61;6.320,82 €;'sin fechas';05/02/2008;'MERCADONA';'Gastos_Compras';'Supermercado';'VARIABLES'
06/02/2008;06/02/2008;'CAFET.C T PRAT';-2,10€;1.794,63 €;-1726;-2,10;6.318,72 €;'sin fechas';06/02/2008;'CAFETC';'Gastos_Ocio y transporte';'Restaurantes';'VARIABLES'
07/02/2008;07/02/2008;'CAFET.C T PRAT';-2,10€;1.792,53 €;-1725;-2,10;6.316,62 €;'sin fechas';07/02/2008;'CAFETC';'Gastos_Ocio y transporte';'Restaurantes';'VARIABLES'
08/02/2008;08/02/2008;'CAFET.C T PRAT';-2,10€;1.790,43 €;-1724;-2,10;6.314,52 €;'sin fechas';08/02/2008;'CAFETC';'Gastos_Ocio y transporte';'Restaurantes';'VARIABLES'
08/02/2008;08/02/2008;'GASOLINA';-30,00€;1.760,43 €;-1723;-30,00;6.284,52 €;'sin fechas';08/02/2008;'GASOLINA';'Gastos_Ocio y transporte';'Gasolina';'VARIABLES'
08/02/2008;08/02/2008;'GROUPAMA PLUS';-49,61€;1.710,82 €;-1722;-49,61;6.234,91 €;'sin fechas';08/02/2008;'GROUPAMA';'Gastos_Seguros';'Seguro salud';'FIJO'
11/02/2008;11/02/2008;'BON AREA';-17,81€;1.693,01 €;-1721;-17,81;6.217,10 €;'sin fechas';11/02/2008;'BON';'Gastos_Compras';'Supermercado';'VARIABLES'
11/02/2008;03/02/2008;'COMPRA CON TARJETA';-5,55€;1.687,46 €;-1720;-5,55;6.211,55 €;'sin fechas';03/02/2008;'COMPRA';'Gastos_Compras';'Supermercado';'VARIABLES'
11/02/2008;01/02/2008;'COMPRA CON TARJETA';-5,55€;1.681,91 €;-1719;-5,55;6.206,00 €;'sin fechas';01/02/2008;'COMPRA';'Gastos_Compras';'Supermercado';'VARIABLES'
12/02/2008;03/02/2008;'COMPRA CON TARJETA';-2,40€;1.679,51 €;-1718;-2,40;6.203,60 €;'sin fechas';03/02/2008;'COMPRA';'Gastos_Compras';'Supermercado';'VARIABLES'
12/02/2008;01/02/2008;'COMPRA CON TARJETA';-2,40€;1.677,11 €;-1717;-2,40;6.201,20 €;'sin fechas';01/02/2008;'COMPRA';'Gastos_Compras';'Supermercado';'VARIABLES'
12/02/2008;03/02/2008;'COMPRA CON TARJETA';-2,60€;1.674,51 €;-1716;-2,60;6.198,60 €;'sin fechas';03/02/2008;'COMPRA';'Gastos_Compras';'Supermercado';'VARIABLES'
12/02/2008;03/02/2008;'COMPRA CON TARJETA';-3,30€;1.671,21 €;-1715;-3,30;6.195,30 €;'sin fechas';03/02/2008;'COMPRA';'Gastos_Compras';'Supermercado';'VARIABLES'
12/02/2008;01/02/2008;'COMPRA CON TARJETA';-2,60€;1.668,61 €;-1714;-2,60;6.192,70 €;'sin fechas';01/02/2008;'COMPRA';'Gastos_Compras';'Supermercado';'VARIABLES'
12/02/2008;01/02/2008;'COMPRA CON TARJETA';-3,30€;1.665,31 €;-1713;-3,30;6.189,40 €;'sin fechas';01/02/2008;'COMPRA';'Gastos_Compras';'Supermercado';'VARIABLES'
13/02/2008;13/02/2008;'CAFET.C T PRAT';-3,50€;1.661,81 €;-1712;-3,50;6.185,90 €;'sin fechas';13/02/2008;'CAFETC';'Gastos_Ocio y transporte';'Restaurantes';'VARIABLES'
13/02/2008;13/02/2008;'REINT.CAJERO';-70,00€;1.591,81 €;-1711;-70,00;6.115,90 €;'sin fechas';13/02/2008;'REINTCAJERO';'Gastos_Gastos varios';'Efectivo';'VARIABLES'
15/02/2008;15/02/2008;'CAFET.C T PRAT';-2,10€;1.589,71 €;-1710;-2,10;6.113,80 €;'sin fechas';15/02/2008;'CAFETC';'Gastos_Ocio y transporte';'Restaurantes';'VARIABLES'
15/02/2008;15/02/2008;'CINE';-12,80€;1.576,91 €;-1709;-12,80;6.101,00 €;'sin fechas';15/02/2008;'CINE';'Gastos_Ocio y transporte';'Espectáculos';'VARIABLES'
15/02/2008;15/02/2008;'SEG.AM.HIPITEC';-31,56€;1.545,35 €;-1708;-31,56;6.069,44 €;'sin fechas';15/02/2008;'SEGAMHIPITEC';'Gastos_Seguros';'Seguro vida';'FIJO'
16/02/2008;16/02/2008;'MERCADONA';-159,44€;1.385,91 €;-1707;-159,44;5.910,00 €;'sin fechas';16/02/2008;'MERCADONA';'Gastos_Compras';'Supermercado';'VARIABLES'
18/02/2008;18/02/2008;'GASOLINA';-35,00€;1.350,91 €;-1706;-35,00;5.875,00 €;'sin fechas';18/02/2008;'GASOLINA';'Gastos_Ocio y transporte';'Gasolina';'VARIABLES'
18/02/2008;18/02/2008;'ONO';-74,56€;1.276,35 €;-1705;-74,56;5.800,44 €;'sin fechas';18/02/2008;'ONO';'Gastos_Servicios tipicos';'Telecomunicaciones';'FIJO'
19/02/2008;19/02/2008;'FARMACIA';-7,12€;1.269,23 €;-1704;-7,12;5.793,32 €;'sin fechas';19/02/2008;'FARMACIA';'Gastos_Salud, saber y deporte';'Farmacia';'VARIABLES'
20/02/2008;20/02/2008;'CAFET.C T PRAT';-1,40€;1.267,83 €;-1703;-1,40;5.791,92 €;'sin fechas';20/02/2008;'CAFETC';'Gastos_Ocio y transporte';'Restaurantes';'VARIABLES'
20/02/2008;20/02/2008;'MERCADONA';-15,19€;1.252,64 €;-1702;-15,19;5.776,73 €;'sin fechas';20/02/2008;'MERCADONA';'Gastos_Compras';'Supermercado';'VARIABLES'
21/02/2008;21/02/2008;'CAFET.C T PRAT';-4,00€;1.248,64 €;-1701;-4,00;5.772,73 €;'sin fechas';21/02/2008;'CAFETC';'Gastos_Ocio y transporte';'Restaurantes';'VARIABLES'
22/02/2008;22/02/2008;'AMC PARC VALLES';-8,00€;1.240,64 €;-1700;-8,00;5.764,73 €;'sin fechas';22/02/2008;'AMC';'Gastos_Ocio y transporte';'Espectáculos';'VARIABLES'
22/02/2008;22/02/2008;'CAFET.C T PRAT';-0,80€;1.239,84 €;-1699;-0,80;5.763,93 €;'sin fechas';22/02/2008;'CAFETC';'Gastos_Ocio y transporte';'Restaurantes';'VARIABLES'
22/02/2008;22/02/2008;'CAFET.C T PRAT';-1,30€;1.238,54 €;-1698;-1,30;5.762,63 €;'sin fechas';22/02/2008;'CAFETC';'Gastos_Ocio y transporte';'Restaurantes';'VARIABLES'
23/02/2008;23/02/2008;'REINT.CAJERO';-40,00€;1.198,54 €;-1697;-40,00;5.722,63 €;'sin fechas';23/02/2008;'REINTCAJERO';'Gastos_Gastos varios';'Efectivo';'VARIABLES'
23/02/2008;23/02/2008;'SUPER DE CARN TOT';-77,94€;1.120,60 €;-1696;-77,94;5.644,69 €;'sin fechas';23/02/2008;'SUPER';'Gastos_Compras';'Supermercado';'VARIABLES'
25/02/2008;25/02/2008;'CAFET.C T PRAT';-1,95€;1.118,65 €;-1695;-1,95;5.642,74 €;'sin fechas';25/02/2008;'CAFETC';'Gastos_Ocio y transporte';'Restaurantes';'VARIABLES'
25/02/2008;25/02/2008;'FRANCE TELECOM';-19,31€;1.099,34 €;-1694;-19,31;5.623,43 €;'sin fechas';25/02/2008;'FRANCE';'Gastos_Servicios tipicos';'Telecomunicaciones';'FIJO'
28/02/2008;28/02/2008;'CAFET.C T PRAT';-4,20€;1.095,14 €;-1693;-4,20;5.619,23 €;'sin fechas';28/02/2008;'CAFETC';'Gastos_Ocio y transporte';'Restaurantes';'VARIABLES'
28/02/2008;28/02/2008;'GASOLINA';-40,85€;1.054,29 €;-1692;-40,85;5.578,38 €;'sin fechas';28/02/2008;'GASOLINA';'Gastos_Ocio y transporte';'Gasolina';'VARIABLES'
28/02/2008;29/02/2008;'INFORMACIO I TECNOLOGIA DE CAT';1.420,04€;2.474,33 €;-1691;1.420,04;6.998,42 €;'sin fechas';29/02/2008;'INFORMACIO';'Ingresos';'Nomina';'FIJO'
29/02/2008;29/02/2008;'CAFET.C T PRAT';-2,10€;2.472,23 €;-1690;-2,10;6.996,32 €;'sin fechas';29/02/2008;'CAFETC';'Gastos_Ocio y transporte';'Restaurantes';'VARIABLES'
29/02/2008;29/02/2008;'RECIBO PTMOS. 3061-0960001518';-814,88€;1.657,35 €;-1689;-814,88;6.181,44 €;'sin fechas';29/02/2008;'RECIBO';'Gastos_Banco y organismos';'Hipoteca';'FIJO'
29/02/2008;29/02/2008;'RECIBO PTMOS. 3061-0960004140';-177,24€;1.480,11 €;-1688;-177,24;6.004,20 €;'sin fechas';29/02/2008;'RECIBO';'Gastos_Banco y organismos';'Hipoteca';'FIJO'
29/02/2008;29/02/2008;'REINT.CAJERO';-50,00€;1.430,11 €;-1687;-50,00;5.954,20 €;'sin fechas';29/02/2008;'REINTCAJERO';'Gastos_Gastos varios';'Efectivo';'VARIABLES'
01/03/2008;29/02/2008;'CARROGIO SA DE 106910/0000001';853,65€;2.283,76 €;-1686;853,65;6.807,85 €;'sin fechas';29/02/2008;'CARROGIO';'Ingresos';'Nomina';'FIJO'
01/03/2008;29/02/2008;'FUNDACIO PRIVADA';300,60€;2.584,36 €;-1685;300,60;7.108,45 €;'sin fechas';29/02/2008;'FUNDACIO';'Ingresos';'Nomina';'FIJO'
03/03/2008;03/03/2008;'AJUNTAMENT DE TERRASSA';-35,24€;2.549,12 €;-1684;-35,24;7.073,21 €;'sin fechas';03/03/2008;'AJUNTAMENT';'Gastos_Banco y organismos';'Ayuntamiento';'FIJO'
03/03/2008;03/03/2008;'CAFET.C T PRAT';-1,90€;2.547,22 €;-1683;-1,90;7.071,31 €;'sin fechas';03/03/2008;'CAFETC';'Gastos_Ocio y transporte';'Restaurantes';'VARIABLES'
04/03/2008;04/03/2008;'CAFET.C T PRAT';-2,10€;2.545,12 €;-1682;-2,10;7.069,21 €;'sin fechas';04/03/2008;'CAFETC';'Gastos_Ocio y transporte';'Restaurantes';'VARIABLES'
04/03/2008;04/03/2008;'FRANCE TELECOM';-29,93€;2.515,19 €;-1681;-29,93;7.039,28 €;'sin fechas';04/03/2008;'FRANCE';'Gastos_Servicios tipicos';'Telecomunicaciones';'FIJO'
06/03/2008;06/03/2008;'CAFET.C T PRAT';-4,00€;2.511,19 €;-1680;-4,00;7.035,28 €;'sin fechas';06/03/2008;'CAFETC';'Gastos_Ocio y transporte';'Restaurantes';'VARIABLES'
07/03/2008;07/03/2008;'AMC PARC VALLES';-8,00€;2.503,19 €;-1679;-8,00;7.027,28 €;'sin fechas';07/03/2008;'AMC';'Gastos_Ocio y transporte';'Espectáculos';'VARIABLES'
07/03/2008;07/03/2008;'CAFET.C T PRAT';-2,80€;2.500,39 €;-1678;-2,80;7.024,48 €;'sin fechas';07/03/2008;'CAFETC';'Gastos_Ocio y transporte';'Restaurantes';'VARIABLES'
07/03/2008;07/03/2008;'CARREFOUR-[comida]';-33,90€;2.466,49 €;-1677;-33,90;6.990,58 €;'sin fechas';07/03/2008;'CARREFOURCOMIDA';'Gastos_Compras';'Supermercado';'VARIABLES'
07/03/2008;07/03/2008;'GROUPAMA PLUS';-49,61€;2.416,88 €;-1676;-49,61;6.940,97 €;'sin fechas';07/03/2008;'GROUPAMA';'Gastos_Seguros';'Seguro salud';'FIJO'
07/03/2008;07/03/2008;'MC DONALDS';-13,75€;2.403,13 €;-1675;-13,75;6.927,22 €;'sin fechas';07/03/2008;'DONALDS';'Gastos_Ocio y transporte';'Restaurantes';'VARIABLES'
07/03/2008;07/03/2008;'VIENA';-5,60€;2.397,53 €;-1674;-5,60;6.921,62 €;'sin fechas';07/03/2008;'VIENA';'Gastos_Ocio y transporte';'Restaurantes';'VARIABLES'
08/03/2008;08/03/2008;'C&A';-29,95€;2.367,58 €;-1673;-29,95;6.891,67 €;'sin fechas';08/03/2008;'CA';'Gastos_Compras';'Ropa';'VARIABLES'
08/03/2008;08/03/2008;'GASOLINA';-7,65€;2.359,93 €;-1672;-7,65;6.884,02 €;'sin fechas';08/03/2008;'GASOLINA';'Gastos_Ocio y transporte';'Gasolina';'VARIABLES'
08/03/2008;08/03/2008;'GASOLINA';-25,00€;2.334,93 €;-1671;-25,00;6.859,02 €;'sin fechas';08/03/2008;'GASOLINA';'Gastos_Ocio y transporte';'Gasolina';'VARIABLES'
08/03/2008;08/03/2008;'MAYDO';-8,40€;2.326,53 €;-1670;-8,40;6.850,62 €;'sin fechas';08/03/2008;'MAYDO';'Gastos_Compras';'Ropa';'VARIABLES'
10/03/2008;10/03/2008;'CAFET.C T PRAT';-2,10€;2.324,43 €;-1669;-2,10;6.848,52 €;'sin fechas';10/03/2008;'CAFETC';'Gastos_Ocio y transporte';'Restaurantes';'VARIABLES'
11/03/2008;11/03/2008;'CAFET.C T PRAT';-2,40€;2.322,03 €;-1668;-2,40;6.846,12 €;'sin fechas';11/03/2008;'CAFETC';'Gastos_Ocio y transporte';'Restaurantes';'VARIABLES'
12/03/2008;12/03/2008;'CAFET.C T PRAT';-2,10€;2.319,93 €;-1667;-2,10;6.844,02 €;'sin fechas';12/03/2008;'CAFETC';'Gastos_Ocio y transporte';'Restaurantes';'VARIABLES'
13/03/2008;13/03/2008;'CAFET.C T PRAT';-4,05€;2.315,88 €;-1666;-4,05;6.839,97 €;'sin fechas';13/03/2008;'CAFETC';'Gastos_Ocio y transporte';'Restaurantes';'VARIABLES'
13/03/2008;13/03/2008;'K-DELLET';-30,00€;2.285,88 €;-1665;-30,00;6.809,97 €;'sin fechas';13/03/2008;'KDELLET';'Gastos_Compras';'Hogar';'VARIABLES'
13/03/2008;13/03/2008;'REINT.CAJERO';-60,00€;2.225,88 €;-1664;-60,00;6.749,97 €;'sin fechas';13/03/2008;'REINTCAJERO';'Gastos_Gastos varios';'Efectivo';'VARIABLES'
14/03/2008;14/03/2008;'64903601 4b CAJ OFI';-2,00€;2.223,88 €;-1663;-2,00;6.747,97 €;'sin fechas';14/03/2008;'CAJ';'Gastos_Gastos varios';'Efectivo';'VARIABLES'
14/03/2008;14/03/2008;'AMC PARC VALLES';-8,00€;2.215,88 €;-1662;-8,00;6.739,97 €;'sin fechas';14/03/2008;'AMC';'Gastos_Ocio y transporte';'Espectáculos';'VARIABLES'
14/03/2008;14/03/2008;'CAFET.C T PRAT';-2,10€;2.213,78 €;-1661;-2,10;6.737,87 €;'sin fechas';14/03/2008;'CAFETC';'Gastos_Ocio y transporte';'Restaurantes';'VARIABLES'
14/03/2008;08/03/2008;'COMPRA CON TARJETA';-0,95€;2.212,83 €;-1660;-0,95;6.736,92 €;'sin fechas';08/03/2008;'COMPRA';'Gastos_Compras';'Supermercado';'VARIABLES'
14/03/2008;14/03/2008;'REINT.CAJERO';-200,00€;2.012,83 €;-1659;-200,00;6.536,92 €;'sin fechas';14/03/2008;'REINTCAJERO';'Gastos_Gastos varios';'Efectivo';'VARIABLES'
14/03/2008;14/03/2008;'SEG.AM.HIPITEC';-31,52€;1.981,31 €;-1658;-31,52;6.505,40 €;'sin fechas';14/03/2008;'SEGAMHIPITEC';'Gastos_Seguros';'Seguro vida';'FIJO'
15/03/2008;15/03/2008;'GASOLINA';-33,55€;1.947,76 €;-1657;-33,55;6.471,85 €;'sin fechas';15/03/2008;'GASOLINA';'Gastos_Ocio y transporte';'Gasolina';'VARIABLES'
15/03/2008;15/03/2008;'GIFI';-9,80€;1.937,96 €;-1656;-9,80;6.462,05 €;'sin fechas';15/03/2008;'GIFI';'Gastos_Compras';'Hogar';'VARIABLES'
16/03/2008;16/03/2008;'FLORS MARUJA';-40,00€;1.897,96 €;-1655;-40,00;6.422,05 €;'sin fechas';16/03/2008;'FLORS';'Gastos_Compras';'Hogar';'VARIABLES'
17/03/2008;17/03/2008;'CARREFOUR-[comida]';-11,58€;1.886,38 €;-1654;-11,58;6.410,47 €;'sin fechas';17/03/2008;'CARREFOURCOMIDA';'Gastos_Compras';'Supermercado';'VARIABLES'
17/03/2008;17/03/2008;'ONO';-72,11€;1.814,27 €;-1653;-72,11;6.338,36 €;'sin fechas';17/03/2008;'ONO';'Gastos_Servicios tipicos';'Telecomunicaciones';'FIJO'
18/03/2008;18/03/2008;'ENDESA DISTRIB';-86,28€;1.727,99 €;-1652;-86,28;6.252,08 €;'sin fechas';18/03/2008;'ENDESA';'Gastos_Servicios tipicos';'Electricidad';'FIJO'
18/03/2008;18/03/2008;'VIENA';-29,64€;1.698,35 €;-1651;-29,64;6.222,44 €;'sin fechas';18/03/2008;'VIENA';'Gastos_Ocio y transporte';'Restaurantes';'VARIABLES'
19/03/2008;19/03/2008;'GASOLINA';-17,70€;1.680,65 €;-1650;-17,70;6.204,74 €;'sin fechas';19/03/2008;'GASOLINA';'Gastos_Ocio y transporte';'Gasolina';'VARIABLES'
19/03/2008;19/03/2008;'VIENA';-9,75€;1.670,90 €;-1649;-9,75;6.194,99 €;'sin fechas';19/03/2008;'VIENA';'Gastos_Ocio y transporte';'Restaurantes';'VARIABLES'
20/03/2008;20/03/2008;'TIC TAC \\TORTOSA';-112,00€;1.558,90 €;-1648;-112,00;6.082,99 €;'sin fechas';20/03/2008;'TIC';'Gastos_Compras';'Hogar';'VARIABLES'
24/03/2008;24/03/2008;'GASOLINA';-33,01€;1.525,89 €;-1647;-33,01;6.049,98 €;'sin fechas';24/03/2008;'GASOLINA';'Gastos_Ocio y transporte';'Gasolina';'VARIABLES'
25/03/2008;25/03/2008;'CAFET.C T PRAT';-1,80€;1.524,09 €;-1646;-1,80;6.048,18 €;'sin fechas';25/03/2008;'CAFETC';'Gastos_Ocio y transporte';'Restaurantes';'VARIABLES'
25/03/2008;19/03/2008;'COMPRA CON TARJETA';-3,30€;1.520,79 €;-1645;-3,30;6.044,88 €;'sin fechas';19/03/2008;'COMPRA';'Gastos_Compras';'Supermercado';'VARIABLES'
25/03/2008;19/03/2008;'COMPRA CON TARJETA';-2,40€;1.518,39 €;-1644;-2,40;6.042,48 €;'sin fechas';19/03/2008;'COMPRA';'Gastos_Compras';'Supermercado';'VARIABLES'
25/03/2008;19/03/2008;'COMPRA CON TARJETA';-2,60€;1.515,79 €;-1643;-2,60;6.039,88 €;'sin fechas';19/03/2008;'COMPRA';'Gastos_Compras';'Supermercado';'VARIABLES'
25/03/2008;25/03/2008;'FRANCE TELECOM';-14,92€;1.500,87 €;-1642;-14,92;6.024,96 €;'sin fechas';25/03/2008;'FRANCE';'Gastos_Servicios tipicos';'Telecomunicaciones';'FIJO'
25/03/2008;25/03/2008;'MERCADONA';-21,97€;1.478,90 €;-1641;-21,97;6.002,99 €;'sin fechas';25/03/2008;'MERCADONA';'Gastos_Compras';'Supermercado';'VARIABLES'
26/03/2008;26/03/2008;'MINA PUBLICA DE LA CIUTAT';-22,34€;1.456,56 €;-1640;-22,34;5.980,65 €;'sin fechas';26/03/2008;'MINA';'Gastos_Servicios tipicos';'Agua';'FIJO'
28/03/2008;28/03/2008;'CAFET.C T PRAT';-2,10€;1.454,46 €;-1639;-2,10;5.978,55 €;'sin fechas';28/03/2008;'CAFETC';'Gastos_Ocio y transporte';'Restaurantes';'VARIABLES'
28/03/2008;31/03/2008;'TRANSF.CIT 242007/0006319 Endocrino';67,50€;1.521,96 €;-1638;67,50;6.046,05 €;'sin fechas';31/03/2008;'TRANSFCIT';'Ingresos';'Transferencias';'VARIABLES'
29/03/2008;29/03/2008;'INFORMACIO I TECNOLOGIA DE CAT';1.404,87€;2.926,83 €;-1637;1.404,87;7.450,92 €;'sin fechas';29/03/2008;'INFORMACIO';'Ingresos';'Nomina';'FIJO'
29/03/2008;29/03/2008;'JUGUETILANDIA TERR';-31,19€;2.895,64 €;-1636;-31,19;7.419,73 €;'sin fechas';29/03/2008;'JUGUETILANDIA';'Gastos_Compras';'Niños';'VARIABLES'
31/03/2008;31/03/2008;'CAFET.C T PRAT';-2,40€;2.893,24 €;-1635;-2,40;7.417,33 €;'sin fechas';31/03/2008;'CAFETC';'Gastos_Ocio y transporte';'Restaurantes';'VARIABLES'
31/03/2008;24/03/2008;'COMPRA CON TARJETA';-3,30€;2.889,94 €;-1634;-3,30;7.414,03 €;'sin fechas';24/03/2008;'COMPRA';'Gastos_Compras';'Supermercado';'VARIABLES'
31/03/2008;24/03/2008;'COMPRA CON TARJETA';-2,40€;2.887,54 €;-1633;-2,40;7.411,63 €;'sin fechas';24/03/2008;'COMPRA';'Gastos_Compras';'Supermercado';'VARIABLES'
31/03/2008;24/03/2008;'COMPRA CON TARJETA';-2,60€;2.884,94 €;-1632;-2,60;7.409,03 €;'sin fechas';24/03/2008;'COMPRA';'Gastos_Compras';'Supermercado';'VARIABLES'
31/03/2008;19/03/2008;'COMPRA CON TARJETA';-5,55€;2.879,39 €;-1631;-5,55;7.403,48 €;'sin fechas';19/03/2008;'COMPRA';'Gastos_Compras';'Supermercado';'VARIABLES'
31/03/2008;24/03/2008;'COMPRA CON TARJETA';-5,55€;2.873,84 €;-1630;-5,55;7.397,93 €;'sin fechas';24/03/2008;'COMPRA';'Gastos_Compras';'Supermercado';'VARIABLES'
31/03/2008;31/03/2008;'GAS NATURAL';-146,65€;2.727,19 €;-1629;-146,65;7.251,28 €;'sin fechas';31/03/2008;'GAS';'Gastos_Servicios tipicos';'Gas';'FIJO'
31/03/2008;31/03/2008;'GASOLINA';-36,85€;2.690,34 €;-1628;-36,85;7.214,43 €;'sin fechas';31/03/2008;'GASOLINA';'Gastos_Ocio y transporte';'Gasolina';'VARIABLES'
31/03/2008;31/03/2008;'RECIBO PTMOS. 3061-0960001518';-814,88€;1.875,46 €;-1627;-814,88;6.399,55 €;'sin fechas';31/03/2008;'RECIBO';'Gastos_Banco y organismos';'Hipoteca';'FIJO'
31/03/2008;31/03/2008;'RECIBO PTMOS. 3061-0960004140';-177,24€;1.698,22 €;-1626;-177,24;6.222,31 €;'sin fechas';31/03/2008;'RECIBO';'Gastos_Banco y organismos';'Hipoteca';'FIJO'
01/04/2008;31/03/2008;'AGENCIA DE LA MICROEMPRESA';853,65€;2.551,87 €;-1625;853,65;7.075,96 €;'sin fechas';31/03/2008;'AGENCIA';'Ingresos';'Nomina';'FIJO'
01/04/2008;01/04/2008;'AJUNTAMENT DE TERRASSA';-35,24€;2.516,63 €;-1624;-35,24;7.040,72 €;'sin fechas';01/04/2008;'AJUNTAMENT';'Gastos_Banco y organismos';'Ayuntamiento';'FIJO'
01/04/2008;01/04/2008;'CAFET.C T PRAT';-2,60€;2.514,03 €;-1623;-2,60;7.038,12 €;'sin fechas';01/04/2008;'CAFETC';'Gastos_Ocio y transporte';'Restaurantes';'VARIABLES'
01/04/2008;31/03/2008;'FUNDACIO PRIVADA';300,60€;2.814,63 €;-1622;300,60;7.338,72 €;'sin fechas';31/03/2008;'FUNDACIO';'Ingresos';'Nomina';'FIJO'
02/04/2008;02/04/2008;'BON AREA';-18,46€;2.796,17 €;-1621;-18,46;7.320,26 €;'sin fechas';02/04/2008;'BON';'Gastos_Compras';'Supermercado';'VARIABLES'
02/04/2008;02/04/2008;'CAFET.C T PRAT';-1,80€;2.794,37 €;-1620;-1,80;7.318,46 €;'sin fechas';02/04/2008;'CAFETC';'Gastos_Ocio y transporte';'Restaurantes';'VARIABLES'
02/04/2008;02/04/2008;'CAFET.C T PRAT';-1,60€;2.792,77 €;-1619;-1,60;7.316,86 €;'sin fechas';02/04/2008;'CAFETC';'Gastos_Ocio y transporte';'Restaurantes';'VARIABLES'
03/04/2008;03/04/2008;'MERCADONA';-143,09€;2.649,68 €;-1618;-143,09;7.173,77 €;'sin fechas';03/04/2008;'MERCADONA';'Gastos_Compras';'Supermercado';'VARIABLES'
03/04/2008;03/04/2008;'SEGS. CATALANA';-326,64€;2.323,04 €;-1617;-326,64;6.847,13 €;'sin fechas';03/04/2008;'SEGS';'Gastos_Seguros';'Seguro auto';'FIJO'
04/04/2008;04/04/2008;'FRANCE TELECOM';-10,44€;2.312,60 €;-1616;-10,44;6.836,69 €;'sin fechas';04/04/2008;'FRANCE';'Gastos_Servicios tipicos';'Telecomunicaciones';'FIJO'
05/04/2008;05/04/2008;'CASA TIO\\LES FRANQUESES DL';-51,76€;2.260,84 €;-1615;-51,76;6.784,93 €;'sin fechas';05/04/2008;'CASA';'Gastos_Ocio y transporte';'Restaurantes';'VARIABLES'
05/04/2008;05/04/2008;'FRUITES I VERDURES';-26,78€;2.234,06 €;-1614;-26,78;6.758,15 €;'sin fechas';05/04/2008;'FRUITES';'Gastos_Compras';'Supermercado';'VARIABLES'
07/04/2008;07/04/2008;'CAFET.C T PRAT';-1,90€;2.232,16 €;-1613;-1,90;6.756,25 €;'sin fechas';07/04/2008;'CAFETC';'Gastos_Ocio y transporte';'Restaurantes';'VARIABLES'
07/04/2008;07/04/2008;'GROUPAMA PLUS';-49,61€;2.182,55 €;-1612;-49,61;6.706,64 €;'sin fechas';07/04/2008;'GROUPAMA';'Gastos_Seguros';'Seguro salud';'FIJO'
08/04/2008;08/04/2008;'MARCO ALDANY';-9,99€;2.172,56 €;-1611;-9,99;6.696,65 €;'sin fechas';08/04/2008;'MARCO';'Gastos_Salud, saber y deporte';'Belleza';'VARIABLES'
09/04/2008;09/04/2008;'CAFET.C T PRAT';-1,90€;2.170,66 €;-1610;-1,90;6.694,75 €;'sin fechas';09/04/2008;'CAFETC';'Gastos_Ocio y transporte';'Restaurantes';'VARIABLES'
09/04/2008;09/04/2008;'GASOLINA';-35,00€;2.135,66 €;-1609;-35,00;6.659,75 €;'sin fechas';09/04/2008;'GASOLINA';'Gastos_Ocio y transporte';'Gasolina';'VARIABLES'
09/04/2008;09/04/2008;'GASOLINA';-2,60€;2.133,06 €;-1608;-2,60;6.657,15 €;'sin fechas';09/04/2008;'GASOLINA';'Gastos_Ocio y transporte';'Gasolina';'VARIABLES'
10/04/2008;10/04/2008;'CAFET.C T PRAT';-0,80€;2.132,26 €;-1607;-0,80;6.656,35 €;'sin fechas';10/04/2008;'CAFETC';'Gastos_Ocio y transporte';'Restaurantes';'VARIABLES'
10/04/2008;10/04/2008;'CAFET.C T PRAT';-2,10€;2.130,16 €;-1606;-2,10;6.654,25 €;'sin fechas';10/04/2008;'CAFETC';'Gastos_Ocio y transporte';'Restaurantes';'VARIABLES'
11/04/2008;11/04/2008;'AMC PARC VALLES';-8,00€;2.122,16 €;-1605;-8,00;6.646,25 €;'sin fechas';11/04/2008;'AMC';'Gastos_Ocio y transporte';'Espectáculos';'VARIABLES'
11/04/2008;11/04/2008;'BURGUER KING PARK';-13,40€;2.108,76 €;-1604;-13,40;6.632,85 €;'sin fechas';11/04/2008;'BURGUER';'Gastos_Ocio y transporte';'Restaurantes';'VARIABLES'
11/04/2008;11/04/2008;'CAFET.C T PRAT';-3,05€;2.105,71 €;-1603;-3,05;6.629,80 €;'sin fechas';11/04/2008;'CAFETC';'Gastos_Ocio y transporte';'Restaurantes';'VARIABLES'
11/04/2008;05/04/2008;'COMPRA CON TARJETA';-1,11€;2.104,60 €;-1602;-1,11;6.628,69 €;'sin fechas';05/04/2008;'COMPRA';'Gastos_Compras';'Supermercado';'VARIABLES'
12/04/2008;12/04/2008;'MERCADONA';-38,97€;2.065,63 €;-1601;-38,97;6.589,72 €;'sin fechas';12/04/2008;'MERCADONA';'Gastos_Compras';'Supermercado';'VARIABLES'
12/04/2008;12/04/2008;'RTE ARTAVI';-67,52€;1.998,11 €;-1600;-67,52;6.522,20 €;'sin fechas';12/04/2008;'RTE';'Gastos_Ocio y transporte';'Restaurantes';'VARIABLES'
14/04/2008;14/04/2008;'CAFET.C T PRAT';-2,90€;1.995,21 €;-1599;-2,90;6.519,30 €;'sin fechas';14/04/2008;'CAFETC';'Gastos_Ocio y transporte';'Restaurantes';'VARIABLES'
15/04/2008;15/04/2008;'SEG.AM.HIPITEC';-31,48€;1.963,73 €;-1598;-31,48;6.487,82 €;'sin fechas';15/04/2008;'SEGAMHIPITEC';'Gastos_Seguros';'Seguro vida';'FIJO'
15/04/2008;15/04/2008;'TOYS R US IBER\\S BOI LLOBRE Regalo Juanjo';-39,99€;1.923,74 €;-1597;-39,99;6.447,83 €;'sin fechas';15/04/2008;'TOYS';'Gastos_Compras';'Niños';'VARIABLES'
16/04/2008;16/04/2008;'BON AREA';-9,91€;1.913,83 €;-1596;-9,91;6.437,92 €;'sin fechas';16/04/2008;'BON';'Gastos_Compras';'Supermercado';'VARIABLES'
16/04/2008;16/04/2008;'CAFET.C T PRAT';-2,10€;1.911,73 €;-1595;-2,10;6.435,82 €;'sin fechas';16/04/2008;'CAFETC';'Gastos_Ocio y transporte';'Restaurantes';'VARIABLES'
17/04/2008;17/04/2008;'CAFET.C T PRAT';-4,05€;1.907,68 €;-1594;-4,05;6.431,77 €;'sin fechas';17/04/2008;'CAFETC';'Gastos_Ocio y transporte';'Restaurantes';'VARIABLES'
17/04/2008;17/04/2008;'FF.CC.GENERALITAT';-1,95€;1.905,73 €;-1593;-1,95;6.429,82 €;'sin fechas';17/04/2008;'FFCCGENERALITAT';'Gastos_Ocio y transporte';'Transporte';'VARIABLES'
17/04/2008;17/04/2008;'FF.CC.GENERALITAT';-1,95€;1.903,78 €;-1592;-1,95;6.427,87 €;'sin fechas';17/04/2008;'FFCCGENERALITAT';'Gastos_Ocio y transporte';'Transporte';'VARIABLES'
17/04/2008;17/04/2008;'ONO';-78,60€;1.825,18 €;-1591;-78,60;6.349,27 €;'sin fechas';17/04/2008;'ONO';'Gastos_Servicios tipicos';'Telecomunicaciones';'FIJO'
17/04/2008;17/04/2008;'REINT.CAJERO';-60,00€;1.765,18 €;-1590;-60,00;6.289,27 €;'sin fechas';17/04/2008;'REINTCAJERO';'Gastos_Gastos varios';'Efectivo';'VARIABLES'
18/04/2008;18/04/2008;'GASOLINA';-30,00€;1.735,18 €;-1589;-30,00;6.259,27 €;'sin fechas';18/04/2008;'GASOLINA';'Gastos_Ocio y transporte';'Gasolina';'VARIABLES'
19/04/2008;19/04/2008;'CIA COMIDA MEXICANA\\MANRESA';-55,43€;1.679,75 €;-1588;-55,43;6.203,84 €;'sin fechas';19/04/2008;'CIA';'Ingresos';'Devoluciones';'VARIABLES'
19/04/2008;19/04/2008;'JIP LA CASA DE\\SANT FRUITOS Tejanos';-48,95€;1.630,80 €;-1587;-48,95;6.154,89 €;'sin fechas';19/04/2008;'JIP';'Gastos_Compras';'Ropa';'VARIABLES'
19/04/2008;22/04/2008;'TRANSF.CIT 368560/0000300';6,85€;1.637,65 €;-1586;6,85;6.161,74 €;'sin fechas';22/04/2008;'TRANSFCIT';'Ingresos';'Transferencias';'VARIABLES'
21/04/2008;21/04/2008;'CAFET.C T PRAT';-2,10€;1.635,55 €;-1585;-2,10;6.159,64 €;'sin fechas';21/04/2008;'CAFETC';'Gastos_Ocio y transporte';'Restaurantes';'VARIABLES'
21/04/2008;21/04/2008;'TORMENTILA';-48,12€;1.587,43 €;-1584;-48,12;6.111,52 €;'sin fechas';21/04/2008;'TORMENTILA';'Gastos_Compras';'Supermercado';'VARIABLES'
22/04/2008;22/04/2008;'CAFET.C T PRAT';-2,10€;1.585,33 €;-1583;-2,10;6.109,42 €;'sin fechas';22/04/2008;'CAFETC';'Gastos_Ocio y transporte';'Restaurantes';'VARIABLES'
22/04/2008;22/04/2008;'FF.CC.GENERALITAT';-1,95€;1.583,38 €;-1582;-1,95;6.107,47 €;'sin fechas';22/04/2008;'FFCCGENERALITAT';'Gastos_Ocio y transporte';'Transporte';'VARIABLES'
22/04/2008;22/04/2008;'FF.CC.GENERALITAT';-1,95€;1.581,43 €;-1581;-1,95;6.105,52 €;'sin fechas';22/04/2008;'FFCCGENERALITAT';'Gastos_Ocio y transporte';'Transporte';'VARIABLES'
22/04/2008;22/04/2008;'REINT.CAJERO';-120,00€;1.461,43 €;-1580;-120,00;5.985,52 €;'sin fechas';22/04/2008;'REINTCAJERO';'Gastos_Gastos varios';'Efectivo';'VARIABLES'
22/04/2008;22/04/2008;'SABECO TORTOSA';-22,05€;1.439,38 €;-1579;-22,05;5.963,47 €;'sin fechas';22/04/2008;'SABECO';'Gastos_Compras';'Supermercado';'VARIABLES'
23/04/2008;23/04/2008;'CAFET.C T PRAT';-2,10€;1.437,28 €;-1578;-2,10;5.961,37 €;'sin fechas';23/04/2008;'CAFETC';'Gastos_Ocio y transporte';'Restaurantes';'VARIABLES'
23/04/2008;23/04/2008;'FRANCE TELECOM';-28,16€;1.409,12 €;-1577;-28,16;5.933,21 €;'sin fechas';23/04/2008;'FRANCE';'Gastos_Servicios tipicos';'Telecomunicaciones';'FIJO'
23/04/2008;23/04/2008;'GASOLINA';-44,50€;1.364,62 €;-1576;-44,50;5.888,71 €;'sin fechas';23/04/2008;'GASOLINA';'Gastos_Ocio y transporte';'Gasolina';'VARIABLES'
25/04/2008;25/04/2008;'MERCADONA';-49,46€;1.315,16 €;-1575;-49,46;5.839,25 €;'sin fechas';25/04/2008;'MERCADONA';'Gastos_Compras';'Supermercado';'VARIABLES'
26/04/2008;26/04/2008;'CAPRABO';-21,75€;1.293,41 €;-1574;-21,75;5.817,50 €;'sin fechas';26/04/2008;'CAPRABO';'Gastos_Compras';'Supermercado';'VARIABLES'
26/04/2008;26/04/2008;'PEIXOS POVILL \\MONISTROL DE';-54,87€;1.238,54 €;-1573;-54,87;5.762,63 €;'sin fechas';26/04/2008;'PEIXOS';'Gastos_Compras';'Supermercado';'VARIABLES'
29/04/2008;29/04/2008;'CAFET.C T PRAT';-3,40€;1.235,14 €;-1572;-3,40;5.759,23 €;'sin fechas';29/04/2008;'CAFETC';'Gastos_Ocio y transporte';'Restaurantes';'VARIABLES'
29/04/2008;29/04/2008;'EROSKI-[COMIDA]';-30,30€;1.204,84 €;-1571;-30,30;5.728,93 €;'sin fechas';29/04/2008;'EROSKICOMIDA';'Gastos_Compras';'Supermercado';'VARIABLES'
29/04/2008;29/04/2008;'EROSKI-[COMIDA]';-89,90€;1.114,94 €;-1570;-89,90;5.639,03 €;'sin fechas';29/04/2008;'EROSKICOMIDA';'Gastos_Compras';'Supermercado';'VARIABLES'
29/04/2008;30/04/2008;'INFORMACIO I TECNOLOGIA DE CAT';1.400,54€;2.515,48 €;-1569;1.400,54;7.039,57 €;'sin fechas';30/04/2008;'INFORMACIO';'Ingresos';'Nomina';'FIJO'
30/04/2008;30/04/2008;'CINE';-12,80€;2.502,68 €;-1568;-12,80;7.026,77 €;'sin fechas';30/04/2008;'CINE';'Gastos_Ocio y transporte';'Espectáculos';'VARIABLES'
30/04/2008;30/04/2008;'RECIBO PTMOS. 3061-0960001518';-814,88€;1.687,80 €;-1567;-814,88;6.211,89 €;'sin fechas';30/04/2008;'RECIBO';'Gastos_Banco y organismos';'Hipoteca';'FIJO'
30/04/2008;30/04/2008;'RECIBO PTMOS. 3061-0960004140';-177,24€;1.510,56 €;-1566;-177,24;6.034,65 €;'sin fechas';30/04/2008;'RECIBO';'Gastos_Banco y organismos';'Hipoteca';'FIJO'
01/05/2008;30/04/2008;'AGENCIA DE LA MICROEMPRESA';853,65€;2.364,21 €;-1565;853,65;6.888,30 €;'sin fechas';30/04/2008;'AGENCIA';'Ingresos';'Nomina';'FIJO'
01/05/2008;30/04/2008;'FUNDACIO PRIVADA';300,60€;2.664,81 €;-1564;300,60;7.188,90 €;'sin fechas';30/04/2008;'FUNDACIO';'Ingresos';'Nomina';'FIJO'
02/05/2008;02/05/2008;'AJUNTAMENT DE TERRASSA';-35,24€;2.629,57 €;-1563;-35,24;7.153,66 €;'sin fechas';02/05/2008;'AJUNTAMENT';'Gastos_Banco y organismos';'Ayuntamiento';'FIJO'
03/05/2008;03/05/2008;'BON AREA';-10,29€;2.619,28 €;-1562;-10,29;7.143,37 €;'sin fechas';03/05/2008;'BON';'Gastos_Compras';'Supermercado';'VARIABLES'
03/05/2008;03/05/2008;'C&A';-44,85€;2.574,43 €;-1561;-44,85;7.098,52 €;'sin fechas';03/05/2008;'CA';'Gastos_Compras';'Ropa';'VARIABLES'
03/05/2008;03/05/2008;'GASOLINA';-40,00€;2.534,43 €;-1560;-40,00;7.058,52 €;'sin fechas';03/05/2008;'GASOLINA';'Gastos_Ocio y transporte';'Gasolina';'VARIABLES'
05/05/2008;05/05/2008;'TORMENTILA';-20,91€;2.513,52 €;-1559;-20,91;7.037,61 €;'sin fechas';05/05/2008;'TORMENTILA';'Gastos_Compras';'Supermercado';'VARIABLES'
06/05/2008;06/05/2008;'FF.CC.GENERALITAT';-1,95€;2.511,57 €;-1558;-1,95;7.035,66 €;'sin fechas';06/05/2008;'FFCCGENERALITAT';'Gastos_Ocio y transporte';'Transporte';'VARIABLES'
06/05/2008;06/05/2008;'FF.CC.GENERALITAT';-1,95€;2.509,62 €;-1557;-1,95;7.033,71 €;'sin fechas';06/05/2008;'FFCCGENERALITAT';'Gastos_Ocio y transporte';'Transporte';'VARIABLES'
06/05/2008;06/05/2008;'FRANCE TELECOM';-10,44€;2.499,18 €;-1556;-10,44;7.023,27 €;'sin fechas';06/05/2008;'FRANCE';'Gastos_Servicios tipicos';'Telecomunicaciones';'FIJO'
06/05/2008;06/05/2008;'SABECO TORTOSA';-18,21€;2.480,97 €;-1555;-18,21;7.005,06 €;'sin fechas';06/05/2008;'SABECO';'Gastos_Compras';'Supermercado';'VARIABLES'
08/05/2008;08/05/2008;'REINT.CAJERO';-50,00€;2.430,97 €;-1554;-50,00;6.955,06 €;'sin fechas';08/05/2008;'REINTCAJERO';'Gastos_Gastos varios';'Efectivo';'VARIABLES'
09/05/2008;09/05/2008;'GROUPAMA PLUS';-49,61€;2.381,36 €;-1553;-49,61;6.905,45 €;'sin fechas';09/05/2008;'GROUPAMA';'Gastos_Seguros';'Seguro salud';'FIJO'
09/05/2008;09/05/2008;'RENFE';-5,20€;2.376,16 €;-1552;-5,20;6.900,25 €;'sin fechas';09/05/2008;'RENFE';'Gastos_Ocio y transporte';'Transporte';'VARIABLES'
09/05/2008;09/05/2008;'RENFE';-5,20€;2.370,96 €;-1551;-5,20;6.895,05 €;'sin fechas';09/05/2008;'RENFE';'Gastos_Ocio y transporte';'Transporte';'VARIABLES'
10/05/2008;10/05/2008;'IKEA';-30,05€;2.340,91 €;-1550;-30,05;6.865,00 €;'sin fechas';10/05/2008;'IKEA';'Gastos_Vivienda y vehiculo';'Mnto. hogar';'VARIABLES'
10/05/2008;10/05/2008;'IKEA';-76,32€;2.264,59 €;-1549;-76,32;6.788,68 €;'sin fechas';10/05/2008;'IKEA';'Gastos_Vivienda y vehiculo';'Mnto. hogar';'VARIABLES'
12/05/2008;12/05/2008;'AKI TERRASSA';-6,90€;2.257,69 €;-1548;-6,90;6.781,78 €;'sin fechas';12/05/2008;'AKI';'Gastos_Vivienda y vehiculo';'Mnto. hogar';'VARIABLES'
12/05/2008;12/05/2008;'CARREFOUR-[comida]';-8,50€;2.249,19 €;-1547;-8,50;6.773,28 €;'sin fechas';12/05/2008;'CARREFOURCOMIDA';'Gastos_Compras';'Supermercado';'VARIABLES'
12/05/2008;12/05/2008;'GASOLINA';-40,00€;2.209,19 €;-1546;-40,00;6.733,28 €;'sin fechas';12/05/2008;'GASOLINA';'Gastos_Ocio y transporte';'Gasolina';'VARIABLES'
12/05/2008;12/05/2008;'MERCADONA';-38,89€;2.170,30 €;-1545;-38,89;6.694,39 €;'sin fechas';12/05/2008;'MERCADONA';'Gastos_Compras';'Supermercado';'VARIABLES'
13/05/2008;13/05/2008;'REINT.CAJERO';-150,00€;2.020,30 €;-1544;-150,00;6.544,39 €;'sin fechas';13/05/2008;'REINTCAJERO';'Gastos_Gastos varios';'Efectivo';'VARIABLES'
14/05/2008;14/05/2008;'CINE';-8,00€;2.012,30 €;-1543;-8,00;6.536,39 €;'sin fechas';14/05/2008;'CINE';'Gastos_Ocio y transporte';'Espectáculos';'VARIABLES'
15/05/2008;15/05/2008;'MERCADONA';-46,78€;1.965,52 €;-1542;-46,78;6.489,61 €;'sin fechas';15/05/2008;'MERCADONA';'Gastos_Compras';'Supermercado';'VARIABLES'
15/05/2008;15/05/2008;'SEG.AM.HIPITEC';-31,43€;1.934,09 €;-1541;-31,43;6.458,18 €;'sin fechas';15/05/2008;'SEGAMHIPITEC';'Gastos_Seguros';'Seguro vida';'FIJO'
15/05/2008;15/05/2008;'TORMENTILA';-21,02€;1.913,07 €;-1540;-21,02;6.437,16 €;'sin fechas';15/05/2008;'TORMENTILA';'Gastos_Compras';'Supermercado';'VARIABLES'
16/05/2008;16/05/2008;'BON AREA';-10,27€;1.902,80 €;-1539;-10,27;6.426,89 €;'sin fechas';16/05/2008;'BON';'Gastos_Compras';'Supermercado';'VARIABLES'
16/05/2008;16/05/2008;'FARMACIA';-18,62€;1.884,18 €;-1538;-18,62;6.408,27 €;'sin fechas';16/05/2008;'FARMACIA';'Gastos_Salud, saber y deporte';'Farmacia';'VARIABLES'
17/05/2008;17/05/2008;'FERNANDEZ OLIVEA';-8,99€;1.875,19 €;-1537;-8,99;6.399,28 €;'sin fechas';17/05/2008;'FERNANDEZ';'Gastos_Compras';'Hogar';'VARIABLES'
17/05/2008;17/05/2008;'SUPER DE CARN TOT';-53,84€;1.821,35 €;-1536;-53,84;6.345,44 €;'sin fechas';17/05/2008;'SUPER';'Gastos_Compras';'Supermercado';'VARIABLES'
19/05/2008;11/05/2008;'COMPRA CON TARJETA';-3,30€;1.818,05 €;-1535;-3,30;6.342,14 €;'sin fechas';11/05/2008;'COMPRA';'Gastos_Compras';'Supermercado';'VARIABLES'
19/05/2008;11/05/2008;'COMPRA CON TARJETA';-3,30€;1.814,75 €;-1534;-3,30;6.338,84 €;'sin fechas';11/05/2008;'COMPRA';'Gastos_Compras';'Supermercado';'VARIABLES'
19/05/2008;19/05/2008;'ENDESA DISTRIB';-46,66€;1.768,09 €;-1533;-46,66;6.292,18 €;'sin fechas';19/05/2008;'ENDESA';'Gastos_Servicios tipicos';'Electricidad';'FIJO'
19/05/2008;19/05/2008;'FRUITES I VERDURES';-7,44€;1.760,65 €;-1532;-7,44;6.284,74 €;'sin fechas';19/05/2008;'FRUITES';'Gastos_Compras';'Supermercado';'VARIABLES'
19/05/2008;19/05/2008;'ONO';-80,52€;1.680,13 €;-1531;-80,52;6.204,22 €;'sin fechas';19/05/2008;'ONO';'Gastos_Servicios tipicos';'Telecomunicaciones';'FIJO'
19/05/2008;19/05/2008;'REINT.CAJERO';-20,00€;1.660,13 €;-1530;-20,00;6.184,22 €;'sin fechas';19/05/2008;'REINTCAJERO';'Gastos_Gastos varios';'Efectivo';'VARIABLES'
19/05/2008;19/05/2008;'TORMENTILA';-11,85€;1.648,28 €;-1529;-11,85;6.172,37 €;'sin fechas';19/05/2008;'TORMENTILA';'Gastos_Compras';'Supermercado';'VARIABLES'
20/05/2008;20/05/2008;'MARCO ALDANY';-9,99€;1.638,29 €;-1528;-9,99;6.162,38 €;'sin fechas';20/05/2008;'MARCO';'Gastos_Salud, saber y deporte';'Belleza';'VARIABLES'
21/05/2008;21/05/2008;'BON AREA';-12,41€;1.625,88 €;-1527;-12,41;6.149,97 €;'sin fechas';21/05/2008;'BON';'Gastos_Compras';'Supermercado';'VARIABLES'
23/05/2008;23/05/2008;'CINE';-18,40€;1.607,48 €;-1526;-18,40;6.131,57 €;'sin fechas';23/05/2008;'CINE';'Gastos_Ocio y transporte';'Espectáculos';'VARIABLES'
23/05/2008;23/05/2008;'FARMACIA';-12,49€;1.594,99 €;-1525;-12,49;6.119,08 €;'sin fechas';23/05/2008;'FARMACIA';'Gastos_Salud, saber y deporte';'Farmacia';'VARIABLES'
23/05/2008;23/05/2008;'FRANCE TELECOM';-16,03€;1.578,96 €;-1524;-16,03;6.103,05 €;'sin fechas';23/05/2008;'FRANCE';'Gastos_Servicios tipicos';'Telecomunicaciones';'FIJO'
23/05/2008;23/05/2008;'GASOLINA';-40,00€;1.538,96 €;-1523;-40,00;6.063,05 €;'sin fechas';23/05/2008;'GASOLINA';'Gastos_Ocio y transporte';'Gasolina';'VARIABLES'
23/05/2008;23/05/2008;'REST.FUJIYAMA';-54,65€;1.484,31 €;-1522;-54,65;6.008,40 €;'sin fechas';23/05/2008;'RESTFUJIYAMA';'Gastos_Ocio y transporte';'Restaurantes';'VARIABLES'
24/05/2008;24/05/2008;'C&A';-54,80€;1.429,51 €;-1521;-54,80;5.953,60 €;'sin fechas';24/05/2008;'CA';'Gastos_Compras';'Ropa';'VARIABLES'
25/05/2008;25/05/2008;'MEXTARRASSA S.L.';-27,75€;1.401,76 €;-1520;-27,75;5.925,85 €;'sin fechas';25/05/2008;'MEXTARRASSA';'Gastos_Ocio y transporte';'Restaurantes';'VARIABLES'
28/05/2008;28/05/2008;'CAFET.C T PRAT';-2,40€;1.399,36 €;-1519;-2,40;5.923,45 €;'sin fechas';28/05/2008;'CAFETC';'Gastos_Ocio y transporte';'Restaurantes';'VARIABLES'
28/05/2008;28/05/2008;'CAPRABO';-18,01€;1.381,35 €;-1518;-18,01;5.905,44 €;'sin fechas';28/05/2008;'CAPRABO';'Gastos_Compras';'Supermercado';'VARIABLES'
28/05/2008;28/05/2008;'GIFI';-5,95€;1.375,40 €;-1517;-5,95;5.899,49 €;'sin fechas';28/05/2008;'GIFI';'Gastos_Compras';'Hogar';'VARIABLES'
29/05/2008;30/05/2008;'INFORMACIO I TECNOLOGIA DE CAT';1.397,29€;2.772,69 €;-1516;1.397,29;7.296,78 €;'sin fechas';30/05/2008;'INFORMACIO';'Ingresos';'Nomina';'FIJO'
29/05/2008;29/05/2008;'REINT.CAJERO';-20,00€;2.752,69 €;-1515;-20,00;7.276,78 €;'sin fechas';29/05/2008;'REINTCAJERO';'Gastos_Gastos varios';'Efectivo';'VARIABLES'
29/05/2008;29/05/2008;'TORMENTILA';-21,95€;2.730,74 €;-1514;-21,95;7.254,83 €;'sin fechas';29/05/2008;'TORMENTILA';'Gastos_Compras';'Supermercado';'VARIABLES'
30/05/2008;30/05/2008;'CAPRABO';-19,42€;2.711,32 €;-1513;-19,42;7.235,41 €;'sin fechas';30/05/2008;'CAPRABO';'Gastos_Compras';'Supermercado';'VARIABLES'
30/05/2008;30/05/2008;'GAS NATURAL';-32,14€;2.679,18 €;-1512;-32,14;7.203,27 €;'sin fechas';30/05/2008;'GAS';'Gastos_Servicios tipicos';'Gas';'FIJO'
30/05/2008;30/05/2008;'GASOLINA';-40,00€;2.639,18 €;-1511;-40,00;7.163,27 €;'sin fechas';30/05/2008;'GASOLINA';'Gastos_Ocio y transporte';'Gasolina';'VARIABLES'
30/05/2008;30/05/2008;'GIFI';-20,95€;2.618,23 €;-1510;-20,95;7.142,32 €;'sin fechas';30/05/2008;'GIFI';'Gastos_Compras';'Hogar';'VARIABLES'
01/06/2008;01/06/2008;'LA BRASA';-18,00€;2.600,23 €;-1509;-18,00;7.124,32 €;'sin fechas';01/06/2008;'BRASA';'Gastos_Ocio y transporte';'Restaurantes';'VARIABLES'
02/06/2008;31/05/2008;'RECIBO PTMOS. 3061-0960001518';-814,88€;1.785,35 €;-1508;-814,88;6.309,44 €;'sin fechas';31/05/2008;'RECIBO';'Gastos_Banco y organismos';'Hipoteca';'FIJO'
02/06/2008;31/05/2008;'RECIBO PTMOS. 3061-0960004140';-177,24€;1.608,11 €;-1507;-177,24;6.132,20 €;'sin fechas';31/05/2008;'RECIBO';'Gastos_Banco y organismos';'Hipoteca';'FIJO'
03/06/2008;03/06/2008;'MERCADONA';-11,95€;1.596,16 €;-1506;-11,95;6.120,25 €;'sin fechas';03/06/2008;'MERCADONA';'Gastos_Compras';'Supermercado';'VARIABLES'
03/06/2008;31/05/2008;'TRANSF.CIT 613648/0011770';1.154,25€;2.750,41 €;-1505;1.154,25;7.274,50 €;'sin fechas';31/05/2008;'TRANSFCIT';'Ingresos';'Transferencias';'VARIABLES'
04/06/2008;04/06/2008;'CAFET.C T PRAT';-2,05€;2.748,36 €;-1504;-2,05;7.272,45 €;'sin fechas';04/06/2008;'CAFETC';'Gastos_Ocio y transporte';'Restaurantes';'VARIABLES'
04/06/2008;04/06/2008;'FRANCE TELECOM';-10,44€;2.737,92 €;-1503;-10,44;7.262,01 €;'sin fechas';04/06/2008;'FRANCE';'Gastos_Servicios tipicos';'Telecomunicaciones';'FIJO'
05/06/2008;05/06/2008;'MERCADONA';-15,62€;2.722,30 €;-1502;-15,62;7.246,39 €;'sin fechas';05/06/2008;'MERCADONA';'Gastos_Compras';'Supermercado';'VARIABLES'
05/06/2008;05/06/2008;'REINT.CAJERO';-30,00€;2.692,30 €;-1501;-30,00;7.216,39 €;'sin fechas';05/06/2008;'REINTCAJERO';'Gastos_Gastos varios';'Efectivo';'VARIABLES'
06/06/2008;06/06/2008;'AMC PARC VALLES';-8,00€;2.684,30 €;-1500;-8,00;7.208,39 €;'sin fechas';06/06/2008;'AMC';'Gastos_Ocio y transporte';'Espectáculos';'VARIABLES'
06/06/2008;06/06/2008;'CAFET.C T PRAT';-4,15€;2.680,15 €;-1499;-4,15;7.204,24 €;'sin fechas';06/06/2008;'CAFETC';'Gastos_Ocio y transporte';'Restaurantes';'VARIABLES'
06/06/2008;06/06/2008;'GROUPAMA PLUS';-49,61€;2.630,54 €;-1498;-49,61;7.154,63 €;'sin fechas';06/06/2008;'GROUPAMA';'Gastos_Seguros';'Seguro salud';'FIJO'
06/06/2008;06/06/2008;'JIANHONG ZHOU S.L.';-24,72€;2.605,82 €;-1497;-24,72;7.129,91 €;'sin fechas';06/06/2008;'JIANHONG';'Gastos_Ocio y transporte';'Restaurantes';'VARIABLES'
07/06/2008;07/06/2008;'BIER STUBE \\BARBERA DEL V';-29,00€;2.576,82 €;-1496;-29,00;7.100,91 €;'sin fechas';07/06/2008;'BIER';'Gastos_Ocio y transporte';'Restaurantes';'VARIABLES'
07/06/2008;07/06/2008;'GASOLINA';-30,00€;2.546,82 €;-1495;-30,00;7.070,91 €;'sin fechas';07/06/2008;'GASOLINA';'Gastos_Ocio y transporte';'Gasolina';'VARIABLES'
08/06/2008;08/06/2008;'COMISIONES';-1,50€;2.545,32 €;-1494;-1,50;7.069,41 €;'sin fechas';08/06/2008;'COMISIONES';'Gastos_Banco y organismos';'Cargos banco';'FIJO'
08/06/2008;08/06/2008;'COMISIONES';1,50€;2.546,82 €;-1493;1,50;7.070,91 €;'sin fechas';08/06/2008;'COMISIONES';'Gastos_Banco y organismos';'Cargos banco';'FIJO'
08/06/2008;08/06/2008;'REINT.CAJERO';-40,00€;2.506,82 €;-1492;-40,00;7.030,91 €;'sin fechas';08/06/2008;'REINTCAJERO';'Gastos_Gastos varios';'Efectivo';'VARIABLES'
08/06/2008;08/06/2008;'REINT.CAJERO';40,00€;2.546,82 €;-1491;40,00;7.070,91 €;'sin fechas';08/06/2008;'REINTCAJERO';'Gastos_Gastos varios';'Efectivo';'VARIABLES'
08/06/2008;08/06/2008;'REINT.CAJERO';-30,00€;2.516,82 €;-1490;-30,00;7.040,91 €;'sin fechas';08/06/2008;'REINTCAJERO';'Gastos_Gastos varios';'Efectivo';'VARIABLES'
08/06/2008;08/06/2008;'REINT.CAJERO';-10,00€;2.506,82 €;-1489;-10,00;7.030,91 €;'sin fechas';08/06/2008;'REINTCAJERO';'Gastos_Gastos varios';'Efectivo';'VARIABLES'
10/06/2008;10/06/2008;'MERCADONA';-54,54€;2.452,28 €;-1488;-54,54;6.976,37 €;'sin fechas';10/06/2008;'MERCADONA';'Gastos_Compras';'Supermercado';'VARIABLES'
11/06/2008;11/06/2008;'CAFET.C T PRAT';-6,90€;2.445,38 €;-1487;-6,90;6.969,47 €;'sin fechas';11/06/2008;'CAFETC';'Gastos_Ocio y transporte';'Restaurantes';'VARIABLES'
12/06/2008;12/06/2008;'CAFET.C T PRAT';-1,75€;2.443,63 €;-1486;-1,75;6.967,72 €;'sin fechas';12/06/2008;'CAFETC';'Gastos_Ocio y transporte';'Restaurantes';'VARIABLES'
12/06/2008;12/06/2008;'ONA NUIT \\EL PRAT DE LL';-12,95€;2.430,68 €;-1485;-12,95;6.954,77 €;'sin fechas';12/06/2008;'ONA';'Gastos_Ocio y transporte';'Restaurantes';'VARIABLES'
13/06/2008;13/06/2008;'CAFET.C T PRAT';-1,75€;2.428,93 €;-1484;-1,75;6.953,02 €;'sin fechas';13/06/2008;'CAFETC';'Gastos_Ocio y transporte';'Restaurantes';'VARIABLES'
13/06/2008;13/06/2008;'GASOLINA';-40,00€;2.388,93 €;-1483;-40,00;6.913,02 €;'sin fechas';13/06/2008;'GASOLINA';'Gastos_Ocio y transporte';'Gasolina';'VARIABLES'
13/06/2008;13/06/2008;'RENFE';-2,60€;2.386,33 €;-1482;-2,60;6.910,42 €;'sin fechas';13/06/2008;'RENFE';'Gastos_Ocio y transporte';'Transporte';'VARIABLES'
14/06/2008;14/06/2008;'AMC PARC VALLES';-10,00€;2.376,33 €;-1481;-10,00;6.900,42 €;'sin fechas';14/06/2008;'AMC';'Gastos_Ocio y transporte';'Espectáculos';'VARIABLES'
14/06/2008;14/06/2008;'EROSKI-[COMIDA]';-104,10€;2.272,23 €;-1480;-104,10;6.796,32 €;'sin fechas';14/06/2008;'EROSKICOMIDA';'Gastos_Compras';'Supermercado';'VARIABLES'
14/06/2008;14/06/2008;'GIFI';-23,45€;2.248,78 €;-1479;-23,45;6.772,87 €;'sin fechas';14/06/2008;'GIFI';'Gastos_Compras';'Hogar';'VARIABLES'
14/06/2008;14/06/2008;'MEXTARRASSA S.L.';-38,30€;2.210,48 €;-1478;-38,30;6.734,57 €;'sin fechas';14/06/2008;'MEXTARRASSA';'Gastos_Ocio y transporte';'Restaurantes';'VARIABLES'
15/06/2008;15/06/2008;'LA BRASA';-30,58€;2.179,90 €;-1477;-30,58;6.703,99 €;'sin fechas';15/06/2008;'BRASA';'Gastos_Ocio y transporte';'Restaurantes';'VARIABLES'
16/06/2008;16/06/2008;'64903601 4b CAJ OFI';-1,50€;2.178,40 €;-1476;-1,50;6.702,49 €;'sin fechas';16/06/2008;'CAJ';'Gastos_Gastos varios';'Efectivo';'VARIABLES'
16/06/2008;16/06/2008;'CAFET.C T PRAT';-2,05€;2.176,35 €;-1475;-2,05;6.700,44 €;'sin fechas';16/06/2008;'CAFETC';'Gastos_Ocio y transporte';'Restaurantes';'VARIABLES'
16/06/2008;16/06/2008;'CAFET.C T PRAT';-4,10€;2.172,25 €;-1474;-4,10;6.696,34 €;'sin fechas';16/06/2008;'CAFETC';'Gastos_Ocio y transporte';'Restaurantes';'VARIABLES'
16/06/2008;16/06/2008;'COMISIONES';1,50€;2.173,75 €;-1473;1,50;6.697,84 €;'sin fechas';16/06/2008;'COMISIONES';'Gastos_Banco y organismos';'Cargos banco';'FIJO'
16/06/2008;16/06/2008;'REINT.CAJERO';-40,00€;2.133,75 €;-1472;-40,00;6.657,84 €;'sin fechas';16/06/2008;'REINTCAJERO';'Gastos_Gastos varios';'Efectivo';'VARIABLES'
16/06/2008;16/06/2008;'REINT.CAJERO';40,00€;2.173,75 €;-1471;40,00;6.697,84 €;'sin fechas';16/06/2008;'REINTCAJERO';'Gastos_Gastos varios';'Efectivo';'VARIABLES'
16/06/2008;16/06/2008;'REINT.CAJERO';-50,00€;2.123,75 €;-1470;-50,00;6.647,84 €;'sin fechas';16/06/2008;'REINTCAJERO';'Gastos_Gastos varios';'Efectivo';'VARIABLES'
16/06/2008;16/06/2008;'SEG.AM.HIPITEC';-31,37€;2.092,38 €;-1469;-31,37;6.616,47 €;'sin fechas';16/06/2008;'SEGAMHIPITEC';'Gastos_Seguros';'Seguro vida';'FIJO'
17/06/2008;17/06/2008;'BON AREA';-12,44€;2.079,94 €;-1468;-12,44;6.604,03 €;'sin fechas';17/06/2008;'BON';'Gastos_Compras';'Supermercado';'VARIABLES'
17/06/2008;17/06/2008;'ONO';-78,05€;2.001,89 €;-1467;-78,05;6.525,98 €;'sin fechas';17/06/2008;'ONO';'Gastos_Servicios tipicos';'Telecomunicaciones';'FIJO'
18/06/2008;18/06/2008;'BON AREA';-10,57€;1.991,32 €;-1466;-10,57;6.515,41 €;'sin fechas';18/06/2008;'BON';'Gastos_Compras';'Supermercado';'VARIABLES'
18/06/2008;18/06/2008;'CAFET.C T PRAT';-4,10€;1.987,22 €;-1465;-4,10;6.511,31 €;'sin fechas';18/06/2008;'CAFETC';'Gastos_Ocio y transporte';'Restaurantes';'VARIABLES'
19/06/2008;19/06/2008;'CAFET.C T PRAT';-1,75€;1.985,47 €;-1464;-1,75;6.509,56 €;'sin fechas';19/06/2008;'CAFETC';'Gastos_Ocio y transporte';'Restaurantes';'VARIABLES'
19/06/2008;19/06/2008;'MINA PUBLICA DE LA CIUTAT';-22,52€;1.962,95 €;-1463;-22,52;6.487,04 €;'sin fechas';19/06/2008;'MINA';'Gastos_Servicios tipicos';'Agua';'FIJO'
19/06/2008;19/06/2008;'ONA NUIT \\EL PRAT DE LL';-12,95€;1.950,00 €;-1462;-12,95;6.474,09 €;'sin fechas';19/06/2008;'ONA';'Gastos_Ocio y transporte';'Restaurantes';'VARIABLES'
20/06/2008;20/06/2008;'CAFET.C T PRAT';-2,45€;1.947,55 €;-1461;-2,45;6.471,64 €;'sin fechas';20/06/2008;'CAFETC';'Gastos_Ocio y transporte';'Restaurantes';'VARIABLES'
20/06/2008;20/06/2008;'CAPRABO';-32,08€;1.915,47 €;-1460;-32,08;6.439,56 €;'sin fechas';20/06/2008;'CAPRABO';'Gastos_Compras';'Supermercado';'VARIABLES'
20/06/2008;20/06/2008;'FARMACIA';-5,00€;1.910,47 €;-1459;-5,00;6.434,56 €;'sin fechas';20/06/2008;'FARMACIA';'Gastos_Salud, saber y deporte';'Farmacia';'VARIABLES'
20/06/2008;20/06/2008;'VIENA';-3,30€;1.907,17 €;-1458;-3,30;6.431,26 €;'sin fechas';20/06/2008;'VIENA';'Gastos_Ocio y transporte';'Restaurantes';'VARIABLES'
23/06/2008;23/06/2008;'CAFET.C T PRAT';-1,75€;1.905,42 €;-1457;-1,75;6.429,51 €;'sin fechas';23/06/2008;'CAFETC';'Gastos_Ocio y transporte';'Restaurantes';'VARIABLES'
23/06/2008;23/06/2008;'CAFET.C T PRAT';-6,90€;1.898,52 €;-1456;-6,90;6.422,61 €;'sin fechas';23/06/2008;'CAFETC';'Gastos_Ocio y transporte';'Restaurantes';'VARIABLES'
23/06/2008;23/06/2008;'GASOLINA';-30,00€;1.868,52 €;-1455;-30,00;6.392,61 €;'sin fechas';23/06/2008;'GASOLINA';'Gastos_Ocio y transporte';'Gasolina';'VARIABLES'
24/06/2008;24/06/2008;'FRANCE TELECOM';-19,87€;1.848,65 €;-1454;-19,87;6.372,74 €;'sin fechas';24/06/2008;'FRANCE';'Gastos_Servicios tipicos';'Telecomunicaciones';'FIJO'
25/06/2008;25/06/2008;'AMC PARC VALLES';-8,00€;1.840,65 €;-1453;-8,00;6.364,74 €;'sin fechas';25/06/2008;'AMC';'Gastos_Ocio y transporte';'Espectáculos';'VARIABLES'
25/06/2008;25/06/2008;'CAFET.C T PRAT';-1,75€;1.838,90 €;-1452;-1,75;6.362,99 €;'sin fechas';25/06/2008;'CAFETC';'Gastos_Ocio y transporte';'Restaurantes';'VARIABLES'
25/06/2008;25/06/2008;'CAFET.C T PRAT';-6,90€;1.832,00 €;-1451;-6,90;6.356,09 €;'sin fechas';25/06/2008;'CAFETC';'Gastos_Ocio y transporte';'Restaurantes';'VARIABLES'
25/06/2008;25/06/2008;'CAPRABO';-14,50€;1.817,50 €;-1450;-14,50;6.341,59 €;'sin fechas';25/06/2008;'CAPRABO';'Gastos_Compras';'Supermercado';'VARIABLES'
25/06/2008;25/06/2008;'REINT.CAJERO';-300,00€;1.517,50 €;-1449;-300,00;6.041,59 €;'sin fechas';25/06/2008;'REINTCAJERO';'Gastos_Gastos varios';'Efectivo';'VARIABLES'
26/06/2008;26/06/2008;'CAFET.C T PRAT';-2,05€;1.515,45 €;-1448;-2,05;6.039,54 €;'sin fechas';26/06/2008;'CAFETC';'Gastos_Ocio y transporte';'Restaurantes';'VARIABLES'
26/06/2008;26/06/2008;'ONA NUIT \\EL PRAT DE LL';-12,95€;1.502,50 €;-1447;-12,95;6.026,59 €;'sin fechas';26/06/2008;'ONA';'Gastos_Ocio y transporte';'Restaurantes';'VARIABLES'
27/06/2008;27/06/2008;'AMC PARC VALLES';-8,00€;1.494,50 €;-1446;-8,00;6.018,59 €;'sin fechas';27/06/2008;'AMC';'Gastos_Ocio y transporte';'Espectáculos';'VARIABLES'
27/06/2008;27/06/2008;'CAFET.C T PRAT';-0,65€;1.493,85 €;-1445;-0,65;6.017,94 €;'sin fechas';27/06/2008;'CAFETC';'Gastos_Ocio y transporte';'Restaurantes';'VARIABLES'
27/06/2008;30/06/2008;'INFORMACIO I TECNOLOGIA DE CAT';1.597,29€;3.091,14 €;-1444;1.597,29;7.615,23 €;'sin fechas';30/06/2008;'INFORMACIO';'Ingresos';'Nomina';'FIJO'
27/06/2008;27/06/2008;'VIENA';-9,25€;3.081,89 €;-1443;-9,25;7.605,98 €;'sin fechas';27/06/2008;'VIENA';'Gastos_Ocio y transporte';'Restaurantes';'VARIABLES'
28/06/2008;28/06/2008;'EROSKI-[COMIDA]';-81,78€;3.000,11 €;-1442;-81,78;7.524,20 €;'sin fechas';28/06/2008;'EROSKICOMIDA';'Gastos_Compras';'Supermercado';'VARIABLES'
29/06/2008;29/06/2008;'GASOLINA';-30,00€;2.970,11 €;-1441;-30,00;7.494,20 €;'sin fechas';29/06/2008;'GASOLINA';'Gastos_Ocio y transporte';'Gasolina';'VARIABLES'
30/06/2008;30/06/2008;'CAFET.C T PRAT';-2,50€;2.967,61 €;-1440;-2,50;7.491,70 €;'sin fechas';30/06/2008;'CAFETC';'Gastos_Ocio y transporte';'Restaurantes';'VARIABLES'
30/06/2008;30/06/2008;'RECIBO PTMOS. 3061-0960001518';-814,88€;2.152,73 €;-1439;-814,88;6.676,82 €;'sin fechas';30/06/2008;'RECIBO';'Gastos_Banco y organismos';'Hipoteca';'FIJO'
30/06/2008;30/06/2008;'RECIBO PTMOS. 3061-0960004140';-177,24€;1.975,49 €;-1438;-177,24;6.499,58 €;'sin fechas';30/06/2008;'RECIBO';'Gastos_Banco y organismos';'Hipoteca';'FIJO'
01/07/2008;01/07/2008;'AJUNTAMENT DE TERRASSA';-35,24€;1.940,25 €;-1437;-35,24;6.464,34 €;'sin fechas';01/07/2008;'AJUNTAMENT';'Gastos_Banco y organismos';'Ayuntamiento';'FIJO'
01/07/2008;01/07/2008;'CAFET.C T PRAT';-2,45€;1.937,80 €;-1436;-2,45;6.461,89 €;'sin fechas';01/07/2008;'CAFETC';'Gastos_Ocio y transporte';'Restaurantes';'VARIABLES'
01/07/2008;30/06/2008;'CARROGIO SA DE 747652/0000001';1.259,25€;3.197,05 €;-1435;1.259,25;7.721,14 €;'sin fechas';30/06/2008;'CARROGIO';'Ingresos';'Nomina';'FIJO'
01/07/2008;01/07/2008;'EROSKI-[COMIDA]';-32,41€;3.164,64 €;-1434;-32,41;7.688,73 €;'sin fechas';01/07/2008;'EROSKICOMIDA';'Gastos_Compras';'Supermercado';'VARIABLES'
01/07/2008;01/07/2008;'MERKALZADOS TERRAS';-10,00€;3.154,64 €;-1433;-10,00;7.678,73 €;'sin fechas';01/07/2008;'MERKALZADOS';'Gastos_Compras';'Ropa';'VARIABLES'
01/07/2008;01/07/2008;'ULANKA';-27,00€;3.127,64 €;-1432;-27,00;7.651,73 €;'sin fechas';01/07/2008;'ULANKA';'Gastos_Compras';'Ropa';'VARIABLES'
02/07/2008;02/07/2008;'CAFET.C T PRAT';-2,05€;3.125,59 €;-1431;-2,05;7.649,68 €;'sin fechas';02/07/2008;'CAFETC';'Gastos_Ocio y transporte';'Restaurantes';'VARIABLES'
02/07/2008;02/07/2008;'CINE';-10,00€;3.115,59 €;-1430;-10,00;7.639,68 €;'sin fechas';02/07/2008;'CINE';'Gastos_Ocio y transporte';'Espectáculos';'VARIABLES'
02/07/2008;02/07/2008;'SABOR TERRAZA SL';-37,66€;3.077,93 €;-1429;-37,66;7.602,02 €;'sin fechas';02/07/2008;'SABOR';'Gastos_Ocio y transporte';'Restaurantes';'VARIABLES'
03/07/2008;03/07/2008;'CAFET.C T PRAT';-2,45€;3.075,48 €;-1428;-2,45;7.599,57 €;'sin fechas';03/07/2008;'CAFETC';'Gastos_Ocio y transporte';'Restaurantes';'VARIABLES'
03/07/2008;03/07/2008;'CAFET.C T PRAT';-6,90€;3.068,58 €;-1427;-6,90;7.592,67 €;'sin fechas';03/07/2008;'CAFETC';'Gastos_Ocio y transporte';'Restaurantes';'VARIABLES'
04/07/2008;04/07/2008;'CAFET.C T PRAT';-2,75€;3.065,83 €;-1426;-2,75;7.589,92 €;'sin fechas';04/07/2008;'CAFETC';'Gastos_Ocio y transporte';'Restaurantes';'VARIABLES'
04/07/2008;29/06/2008;'COMPRA CON TARJETA';-3,25€;3.062,58 €;-1425;-3,25;7.586,67 €;'sin fechas';29/06/2008;'COMPRA';'Gastos_Compras';'Supermercado';'VARIABLES'
04/07/2008;04/07/2008;'FRANCE TELECOM';-10,44€;3.052,14 €;-1424;-10,44;7.576,23 €;'sin fechas';04/07/2008;'FRANCE';'Gastos_Servicios tipicos';'Telecomunicaciones';'FIJO'
04/07/2008;04/07/2008;'GROUPAMA PLUS';-49,61€;3.002,53 €;-1423;-49,61;7.526,62 €;'sin fechas';04/07/2008;'GROUPAMA';'Gastos_Seguros';'Seguro salud';'FIJO'
06/07/2008;06/07/2008;'EROSKI-[COMIDA]';-136,17€;2.866,36 €;-1422;-136,17;7.390,45 €;'sin fechas';06/07/2008;'EROSKICOMIDA';'Gastos_Compras';'Supermercado';'VARIABLES'
06/07/2008;06/07/2008;'GAME';-94,90€;2.771,46 €;-1421;-94,90;7.295,55 €;'sin fechas';06/07/2008;'GAME';'Gastos_Compras';'Hobbys';'VARIABLES'
06/07/2008;06/07/2008;'GASOLINA';-35,00€;2.736,46 €;-1420;-35,00;7.260,55 €;'sin fechas';06/07/2008;'GASOLINA';'Gastos_Ocio y transporte';'Gasolina';'VARIABLES'
06/07/2008;06/07/2008;'IKEA';-13,10€;2.723,36 €;-1419;-13,10;7.247,45 €;'sin fechas';06/07/2008;'IKEA';'Gastos_Vivienda y vehiculo';'Mnto. hogar';'VARIABLES'
08/07/2008;08/07/2008;'Ventilador CPAC';-14,00€;2.709,36 €;-1418;-14,00;7.233,45 €;'sin fechas';08/07/2008;'VENTILADOR';'Gastos_Compras';'Supermercado';'VARIABLES'
09/07/2008;09/07/2008;'AMC PARC VALLES';-8,00€;2.701,36 €;-1417;-8,00;7.225,45 €;'sin fechas';09/07/2008;'AMC';'Gastos_Ocio y transporte';'Espectáculos';'VARIABLES'
09/07/2008;09/07/2008;'REINT.CAJERO';-200,00€;2.501,36 €;-1416;-200,00;7.025,45 €;'sin fechas';09/07/2008;'REINTCAJERO';'Gastos_Gastos varios';'Efectivo';'VARIABLES'
10/07/2008;10/07/2008;'MERCADONA';-117,47€;2.383,89 €;-1415;-117,47;6.907,98 €;'sin fechas';10/07/2008;'MERCADONA';'Gastos_Compras';'Supermercado';'VARIABLES'
11/07/2008;11/07/2008;'EROSKI-[COMIDA]';-17,20€;2.366,69 €;-1414;-17,20;6.890,78 €;'sin fechas';11/07/2008;'EROSKICOMIDA';'Gastos_Compras';'Supermercado';'VARIABLES'
13/07/2008;13/07/2008;'RESTAURACIO IM\\PREMIA DE MA';-111,66€;2.255,03 €;-1413;-111,66;6.779,12 €;'sin fechas';13/07/2008;'RESTAURACIO';'Gastos_Ocio y transporte';'Restaurantes';'VARIABLES'
15/07/2008;15/07/2008;'BON AREA';-13,14€;2.241,89 €;-1412;-13,14;6.765,98 €;'sin fechas';15/07/2008;'BON';'Gastos_Compras';'Supermercado';'VARIABLES'
15/07/2008;15/07/2008;'CAFET.C T PRAT';-2,05€;2.239,84 €;-1411;-2,05;6.763,93 €;'sin fechas';15/07/2008;'CAFETC';'Gastos_Ocio y transporte';'Restaurantes';'VARIABLES'
15/07/2008;15/07/2008;'SEG.AM.HIPITEC';-31,51€;2.208,33 €;-1410;-31,51;6.732,42 €;'sin fechas';15/07/2008;'SEGAMHIPITEC';'Gastos_Seguros';'Seguro vida';'FIJO'
16/07/2008;16/07/2008;'CAFET.C T PRAT';-1,75€;2.206,58 €;-1409;-1,75;6.730,67 €;'sin fechas';16/07/2008;'CAFETC';'Gastos_Ocio y transporte';'Restaurantes';'VARIABLES'
17/07/2008;17/07/2008;'CAFET.C T PRAT';-6,85€;2.199,73 €;-1408;-6,85;6.723,82 €;'sin fechas';17/07/2008;'CAFETC';'Gastos_Ocio y transporte';'Restaurantes';'VARIABLES'
17/07/2008;17/07/2008;'EROSKI-[COMIDA]';-38,54€;2.161,19 €;-1407;-38,54;6.685,28 €;'sin fechas';17/07/2008;'EROSKICOMIDA';'Gastos_Compras';'Supermercado';'VARIABLES'
17/07/2008;17/07/2008;'GASOLINA';-40,00€;2.121,19 €;-1406;-40,00;6.645,28 €;'sin fechas';17/07/2008;'GASOLINA';'Gastos_Ocio y transporte';'Gasolina';'VARIABLES'
17/07/2008;18/07/2008;'INFORMACIO I TECNOLOGIA DE CAT';1.581,57€;3.702,76 €;-1405;1.581,57;8.226,85 €;'sin fechas';18/07/2008;'INFORMACIO';'Ingresos';'Nomina';'FIJO'
17/07/2008;17/07/2008;'MCDONALDS TERRASSA';-9,55€;3.693,21 €;-1404;-9,55;8.217,30 €;'sin fechas';17/07/2008;'MCDONALDS';'Gastos_Ocio y transporte';'Restaurantes';'VARIABLES'
17/07/2008;17/07/2008;'ONO';-78,15€;3.615,06 €;-1403;-78,15;8.139,15 €;'sin fechas';17/07/2008;'ONO';'Gastos_Servicios tipicos';'Telecomunicaciones';'FIJO'
18/07/2008;18/07/2008;'CAFET.C T PRAT';-2,45€;3.612,61 €;-1402;-2,45;8.136,70 €;'sin fechas';18/07/2008;'CAFETC';'Gastos_Ocio y transporte';'Restaurantes';'VARIABLES'
18/07/2008;12/07/2008;'COMPRA CON TARJETA';-8,10€;3.604,51 €;-1401;-8,10;8.128,60 €;'sin fechas';12/07/2008;'COMPRA';'Gastos_Compras';'Supermercado';'VARIABLES'
18/07/2008;18/07/2008;'EL RACO GASTRONOMI';-10,50€;3.594,01 €;-1400;-10,50;8.118,10 €;'sin fechas';18/07/2008;'RACO';'Gastos_Ocio y transporte';'Restaurantes';'VARIABLES'
18/07/2008;18/07/2008;'ENDESA DISTRIB';-110,42€;3.483,59 €;-1399;-110,42;8.007,68 €;'sin fechas';18/07/2008;'ENDESA';'Gastos_Servicios tipicos';'Electricidad';'FIJO'
18/07/2008;18/07/2008;'TEL-ENTRADA CAIXA';-109,20€;3.374,39 €;-1398;-109,20;7.898,48 €;'sin fechas';18/07/2008;'TELENTRADA';'Gastos_Ocio y transporte';'Espectáculos';'VARIABLES'
18/07/2008;18/07/2008;'TOYOTA ORIENT CARS';-165,72€;3.208,67 €;-1397;-165,72;7.732,76 €;'sin fechas';18/07/2008;'TOYOTA';'Gastos_Vivienda y vehiculo';'Mnto. vehiculo';'VARIABLE'
19/07/2008;19/07/2008;'CANTINA MARIACHI';-27,40€;3.181,27 €;-1396;-27,40;7.705,36 €;'sin fechas';19/07/2008;'CANTINA';'Gastos_Ocio y transporte';'Restaurantes';'VARIABLES'
19/07/2008;19/07/2008;'CINE';-14,40€;3.166,87 €;-1395;-14,40;7.690,96 €;'sin fechas';19/07/2008;'CINE';'Gastos_Ocio y transporte';'Espectáculos';'VARIABLES'
19/07/2008;19/07/2008;'EL CORTE INGLES C Regalo Merche';-44,00€;3.122,87 €;-1394;-44,00;7.646,96 €;'sin fechas';19/07/2008;'CORTE';'Gastos_Compras';'Supermercado';'VARIABLES'
19/07/2008;19/07/2008;'EVANS \\MATARO';-58,50€;3.064,37 €;-1393;-58,50;7.588,46 €;'sin fechas';19/07/2008;'EVANS';'Gastos_Compras';'Ropa';'VARIABLES'
21/07/2008;21/07/2008;'MERCADONA';-17,92€;3.046,45 €;-1392;-17,92;7.570,54 €;'sin fechas';21/07/2008;'MERCADONA';'Gastos_Compras';'Supermercado';'VARIABLES'
22/07/2008;22/07/2008;'FARGA BETHOVEN';-3,20€;3.043,25 €;-1391;-3,20;7.567,34 €;'sin fechas';22/07/2008;'FARGA';'Gastos_Compras';'Hogar';'VARIABLES'
23/07/2008;23/07/2008;'CAFET.C T PRAT';-2,70€;3.040,55 €;-1390;-2,70;7.564,64 €;'sin fechas';23/07/2008;'CAFETC';'Gastos_Ocio y transporte';'Restaurantes';'VARIABLES'
23/07/2008;23/07/2008;'FRANCE TELECOM';-19,19€;3.021,36 €;-1389;-19,19;7.545,45 €;'sin fechas';23/07/2008;'FRANCE';'Gastos_Servicios tipicos';'Telecomunicaciones';'FIJO'
24/07/2008;24/07/2008;'CAFET.C T PRAT';-2,10€;3.019,26 €;-1388;-2,10;7.543,35 €;'sin fechas';24/07/2008;'CAFETC';'Gastos_Ocio y transporte';'Restaurantes';'VARIABLES'
24/07/2008;24/07/2008;'CAFET.C T PRAT';-6,90€;3.012,36 €;-1387;-6,90;7.536,45 €;'sin fechas';24/07/2008;'CAFETC';'Gastos_Ocio y transporte';'Restaurantes';'VARIABLES'
24/07/2008;24/07/2008;'REINT.CAJERO';-20,00€;2.992,36 €;-1386;-20,00;7.516,45 €;'sin fechas';24/07/2008;'REINTCAJERO';'Gastos_Gastos varios';'Efectivo';'VARIABLES'
25/07/2008;25/07/2008;'AMC PARC VALLES';-8,00€;2.984,36 €;-1385;-8,00;7.508,45 €;'sin fechas';25/07/2008;'AMC';'Gastos_Ocio y transporte';'Espectáculos';'VARIABLES'
25/07/2008;25/07/2008;'GASOLINA';-40,00€;2.944,36 €;-1384;-40,00;7.468,45 €;'sin fechas';25/07/2008;'GASOLINA';'Gastos_Ocio y transporte';'Gasolina';'VARIABLES'
25/07/2008;25/07/2008;'TEL-ENTRADA CAIXA';109,20€;3.053,56 €;-1383;109,20;7.577,65 €;'sin fechas';25/07/2008;'TELENTRADA';'Gastos_Ocio y transporte';'Espectáculos';'VARIABLES'
26/07/2008;26/07/2008;'CAPRABO';-14,70€;3.038,86 €;-1382;-14,70;7.562,95 €;'sin fechas';26/07/2008;'CAPRABO';'Gastos_Compras';'Supermercado';'VARIABLES'
26/07/2008;26/07/2008;'CARREFOUR-[comida]';-48,00€;2.990,86 €;-1381;-48,00;7.514,95 €;'sin fechas';26/07/2008;'CARREFOURCOMIDA';'Gastos_Compras';'Supermercado';'VARIABLES'
28/07/2008;28/07/2008;'CAFET.C T PRAT';-2,80€;2.988,06 €;-1380;-2,80;7.512,15 €;'sin fechas';28/07/2008;'CAFETC';'Gastos_Ocio y transporte';'Restaurantes';'VARIABLES'
28/07/2008;28/07/2008;'CAPRABO';-27,36€;2.960,70 €;-1379;-27,36;7.484,79 €;'sin fechas';28/07/2008;'CAPRABO';'Gastos_Compras';'Supermercado';'VARIABLES'
28/07/2008;19/07/2008;'COMPRA CON TARJETA';-7,10€;2.953,60 €;-1378;-7,10;7.477,69 €;'sin fechas';19/07/2008;'COMPRA';'Gastos_Compras';'Supermercado';'VARIABLES'
28/07/2008;19/07/2008;'COMPRA CON TARJETA';-1,11€;2.952,49 €;-1377;-1,11;7.476,58 €;'sin fechas';19/07/2008;'COMPRA';'Gastos_Compras';'Supermercado';'VARIABLES'
28/07/2008;19/07/2008;'COMPRA CON TARJETA';-1,11€;2.951,38 €;-1376;-1,11;7.475,47 €;'sin fechas';19/07/2008;'COMPRA';'Gastos_Compras';'Supermercado';'VARIABLES'
28/07/2008;28/07/2008;'MAYDO';-37,50€;2.913,88 €;-1375;-37,50;7.437,97 €;'sin fechas';28/07/2008;'MAYDO';'Gastos_Compras';'Ropa';'VARIABLES'
29/07/2008;30/07/2008;'INFORMACIO I TECNOLOGIA DE CAT';1.494,72€;4.408,60 €;-1374;1.494,72;8.932,69 €;'sin fechas';30/07/2008;'INFORMACIO';'Ingresos';'Nomina';'FIJO'
29/07/2008;22/07/2008;'ZONA AZUL ATMIRA';-3,00€;4.405,60 €;-1373;-3,00;8.929,69 €;'sin fechas';22/07/2008;'ZONA';'Gastos_Ocio y transporte';'Parking y peaje';'VARIABLES'
30/07/2008;30/07/2008;'AMC PARC VALLES';-8,00€;4.397,60 €;-1372;-8,00;8.921,69 €;'sin fechas';30/07/2008;'AMC';'Gastos_Ocio y transporte';'Espectáculos';'VARIABLES'
30/07/2008;30/07/2008;'CAFET.C T PRAT';-2,10€;4.395,50 €;-1371;-2,10;8.919,59 €;'sin fechas';30/07/2008;'CAFETC';'Gastos_Ocio y transporte';'Restaurantes';'VARIABLES'
30/07/2008;30/07/2008;'DECATHLON';-52,59€;4.342,91 €;-1370;-52,59;8.867,00 €;'sin fechas';30/07/2008;'DECATHLON';'Gastos_Compras';'Deportivo';'VARIABLES'
30/07/2008;30/07/2008;'MEXTARRASSA S.L.';-29,30€;4.313,61 €;-1369;-29,30;8.837,70 €;'sin fechas';30/07/2008;'MEXTARRASSA';'Gastos_Ocio y transporte';'Restaurantes';'VARIABLES'
30/07/2008;30/07/2008;'REINT.CAJERO';-500,00€;3.813,61 €;-1368;-500,00;8.337,70 €;'sin fechas';30/07/2008;'REINTCAJERO';'Gastos_Gastos varios';'Efectivo';'VARIABLES'
30/07/2008;30/07/2008;'REINT.CAJERO';-100,00€;3.713,61 €;-1367;-100,00;8.237,70 €;'sin fechas';30/07/2008;'REINTCAJERO';'Gastos_Gastos varios';'Efectivo';'VARIABLES'
30/07/2008;30/07/2008;'VIENA';-10,85€;3.702,76 €;-1366;-10,85;8.226,85 €;'sin fechas';30/07/2008;'VIENA';'Gastos_Ocio y transporte';'Restaurantes';'VARIABLES'
31/07/2008;31/07/2008;'CAFET.C T PRAT';-2,90€;3.699,86 €;-1365;-2,90;8.223,95 €;'sin fechas';31/07/2008;'CAFETC';'Gastos_Ocio y transporte';'Restaurantes';'VARIABLES'
31/07/2008;31/07/2008;'CAFET.C T PRAT';-6,90€;3.692,96 €;-1364;-6,90;8.217,05 €;'sin fechas';31/07/2008;'CAFETC';'Gastos_Ocio y transporte';'Restaurantes';'VARIABLES'
31/07/2008;30/07/2008;'CARROGIO SA DE 918908/0000001';1.203,48€;4.896,44 €;-1363;1.203,48;9.420,53 €;'sin fechas';30/07/2008;'CARROGIO';'Ingresos';'Nomina';'FIJO'
31/07/2008;01/08/2008;'DEV.TRIBUTARIA';1.230,62€;6.127,06 €;-1362;1.230,62;10.651,15 €;'sin fechas';01/08/2008;'DEVTRIBUTARIA';'Ingresos';'Devoluciones';'VARIABLES'
31/07/2008;31/07/2008;'RECIBO PTMOS. 3061-0960001518';-829,51€;5.297,55 €;-1361;-829,51;9.821,64 €;'sin fechas';31/07/2008;'RECIBO';'Gastos_Banco y organismos';'Hipoteca';'FIJO'
31/07/2008;31/07/2008;'RECIBO PTMOS. 3061-0960004140';-177,24€;5.120,31 €;-1360;-177,24;9.644,40 €;'sin fechas';31/07/2008;'RECIBO';'Gastos_Banco y organismos';'Hipoteca';'FIJO'
01/08/2008;01/08/2008;'AJUNTAMENT DE TERRASSA';-34,50€;5.085,81 €;-1359;-34,50;9.609,90 €;'sin fechas';01/08/2008;'AJUNTAMENT';'Gastos_Banco y organismos';'Ayuntamiento';'FIJO'
01/08/2008;01/08/2008;'DECATHLON';-56,23€;5.029,58 €;-1358;-56,23;9.553,67 €;'sin fechas';01/08/2008;'DECATHLON';'Gastos_Compras';'Deportivo';'VARIABLES'
01/08/2008;01/08/2008;'GASOLINA';-54,58€;4.975,00 €;-1357;-54,58;9.499,09 €;'sin fechas';01/08/2008;'GASOLINA';'Gastos_Ocio y transporte';'Gasolina';'VARIABLES'
01/08/2008;01/08/2008;'IKEA';-119,00€;4.856,00 €;-1356;-119,00;9.380,09 €;'sin fechas';01/08/2008;'IKEA';'Gastos_Vivienda y vehiculo';'Mnto. hogar';'VARIABLES'
01/08/2008;01/08/2008;'VACACIONES';-500,00€;4.356,00 €;-1355;-500,00;8.880,09 €;'sin fechas';01/08/2008;'VACACIONES';'Gastos_Ocio y transporte';'Vacaciones';'VARIABLES'
02/08/2008;05/08/2008;'DEV.TRIBUTARIA';465,59€;4.821,59 €;-1354;465,59;9.345,68 €;'sin fechas';05/08/2008;'DEVTRIBUTARIA';'Ingresos';'Devoluciones';'VARIABLES'
02/08/2008;02/08/2008;'MERCADONA';-146,78€;4.674,81 €;-1353;-146,78;9.198,90 €;'sin fechas';02/08/2008;'MERCADONA';'Gastos_Compras';'Supermercado';'VARIABLES'
05/08/2008;05/08/2008;'AGBAR INSTALAC';-56,61€;4.618,20 €;-1352;-56,61;9.142,29 €;'sin fechas';05/08/2008;'AGBAR';'Gastos_Servicios tipicos';'Agua';'FIJO'
05/08/2008;05/08/2008;'FRANCE TELECOM';-22,50€;4.595,70 €;-1351;-22,50;9.119,79 €;'sin fechas';05/08/2008;'FRANCE';'Gastos_Servicios tipicos';'Telecomunicaciones';'FIJO'
08/08/2008;01/08/2008;'COMPRA CON TARJETA';-5,55€;4.590,15 €;-1350;-5,55;9.114,24 €;'sin fechas';01/08/2008;'COMPRA';'Gastos_Compras';'Supermercado';'VARIABLES'
08/08/2008;08/08/2008;'GAS NATURAL';-201,43€;4.388,72 €;-1349;-201,43;8.912,81 €;'sin fechas';08/08/2008;'GAS';'Gastos_Servicios tipicos';'Gas';'FIJO'
09/08/2008;09/08/2008;'MAIKA ESTILISTES \\TORTOSA';-36,15€;4.352,57 €;-1348;-36,15;8.876,66 €;'sin fechas';09/08/2008;'MAIKA';'Gastos_Compras';'Hogar';'VARIABLES'
10/08/2008;10/08/2008;'CINE';-13,00€;4.339,57 €;-1347;-13,00;8.863,66 €;'sin fechas';10/08/2008;'CINE';'Gastos_Ocio y transporte';'Espectáculos';'VARIABLES'
11/08/2008;11/08/2008;'GROUPAMA PLUS';-49,61€;4.289,96 €;-1346;-49,61;8.814,05 €;'sin fechas';11/08/2008;'GROUPAMA';'Gastos_Seguros';'Seguro salud';'FIJO'
12/08/2008;01/08/2008;'COMPRA CON TARJETA';-3,85€;4.286,11 €;-1345;-3,85;8.810,20 €;'sin fechas';01/08/2008;'COMPRA';'Gastos_Compras';'Supermercado';'VARIABLES'
12/08/2008;01/08/2008;'COMPRA CON TARJETA';-5,07€;4.281,04 €;-1344;-5,07;8.805,13 €;'sin fechas';01/08/2008;'COMPRA';'Gastos_Compras';'Supermercado';'VARIABLES'
12/08/2008;01/08/2008;'COMPRA CON TARJETA';-2,91€;4.278,13 €;-1343;-2,91;8.802,22 €;'sin fechas';01/08/2008;'COMPRA';'Gastos_Compras';'Supermercado';'VARIABLES'
14/08/2008;14/08/2008;'CADENA LLUMS 10 RO\\ROQUETES';-35,35€;4.242,78 €;-1342;-35,35;8.766,87 €;'sin fechas';14/08/2008;'CADENA';'Gastos_Compras';'Hogar';'VARIABLES'
14/08/2008;14/08/2008;'GASOLINA';-42,00€;4.200,78 €;-1341;-42,00;8.724,87 €;'sin fechas';14/08/2008;'GASOLINA';'Gastos_Ocio y transporte';'Gasolina';'VARIABLES'
14/08/2008;14/08/2008;'SEG.AM.HIPITEC';-31,47€;4.169,31 €;-1340;-31,47;8.693,40 €;'sin fechas';14/08/2008;'SEGAMHIPITEC';'Gastos_Seguros';'Seguro vida';'FIJO'
18/08/2008;18/08/2008;'BURGUER KING PARK';-16,20€;4.153,11 €;-1339;-16,20;8.677,20 €;'sin fechas';18/08/2008;'BURGUER';'Gastos_Ocio y transporte';'Restaurantes';'VARIABLES'
18/08/2008;18/08/2008;'CAFET.C T PRAT';-3,10€;4.150,01 €;-1338;-3,10;8.674,10 €;'sin fechas';18/08/2008;'CAFETC';'Gastos_Ocio y transporte';'Restaurantes';'VARIABLES'
18/08/2008;18/08/2008;'ONO';-90,03€;4.059,98 €;-1337;-90,03;8.584,07 €;'sin fechas';18/08/2008;'ONO';'Gastos_Servicios tipicos';'Telecomunicaciones';'FIJO'
19/08/2008;19/08/2008;'CAFET.C T PRAT';-1,10€;4.058,88 €;-1336;-1,10;8.582,97 €;'sin fechas';19/08/2008;'CAFETC';'Gastos_Ocio y transporte';'Restaurantes';'VARIABLES'
19/08/2008;19/08/2008;'GASOLINA';-35,00€;4.023,88 €;-1335;-35,00;8.547,97 €;'sin fechas';19/08/2008;'GASOLINA';'Gastos_Ocio y transporte';'Gasolina';'VARIABLES'
20/08/2008;20/08/2008;'CAFET.C T PRAT';-2,60€;4.021,28 €;-1334;-2,60;8.545,37 €;'sin fechas';20/08/2008;'CAFETC';'Gastos_Ocio y transporte';'Restaurantes';'VARIABLES'
21/08/2008;21/08/2008;'CAFET.C T PRAT';-0,65€;4.020,63 €;-1333;-0,65;8.544,72 €;'sin fechas';21/08/2008;'CAFETC';'Gastos_Ocio y transporte';'Restaurantes';'VARIABLES'
21/08/2008;21/08/2008;'GASOLINA';-5,00€;4.015,63 €;-1332;-5,00;8.539,72 €;'sin fechas';21/08/2008;'GASOLINA';'Gastos_Ocio y transporte';'Gasolina';'VARIABLES'
22/08/2008;22/08/2008;'AMC PARC VALLES';-16,00€;3.999,63 €;-1331;-16,00;8.523,72 €;'sin fechas';22/08/2008;'AMC';'Gastos_Ocio y transporte';'Espectáculos';'VARIABLES'
22/08/2008;22/08/2008;'CAFET.C T PRAT';-3,80€;3.995,83 €;-1330;-3,80;8.519,92 €;'sin fechas';22/08/2008;'CAFETC';'Gastos_Ocio y transporte';'Restaurantes';'VARIABLES'
25/08/2008;25/08/2008;'CAFET.C T PRAT';-2,90€;3.992,93 €;-1329;-2,90;8.517,02 €;'sin fechas';25/08/2008;'CAFETC';'Gastos_Ocio y transporte';'Restaurantes';'VARIABLES'
25/08/2008;17/08/2008;'COMPRA CON TARJETA';-3,30€;3.989,63 €;-1328;-3,30;8.513,72 €;'sin fechas';17/08/2008;'COMPRA';'Gastos_Compras';'Supermercado';'VARIABLES'
25/08/2008;17/08/2008;'COMPRA CON TARJETA';-5,00€;3.984,63 €;-1327;-5,00;8.508,72 €;'sin fechas';17/08/2008;'COMPRA';'Gastos_Compras';'Supermercado';'VARIABLES'
25/08/2008;17/08/2008;'COMPRA CON TARJETA';-5,55€;3.979,08 €;-1326;-5,55;8.503,17 €;'sin fechas';17/08/2008;'COMPRA';'Gastos_Compras';'Supermercado';'VARIABLES'
25/08/2008;25/08/2008;'FARMACIA';-12,49€;3.966,59 €;-1325;-12,49;8.490,68 €;'sin fechas';25/08/2008;'FARMACIA';'Gastos_Salud, saber y deporte';'Farmacia';'VARIABLES'
25/08/2008;25/08/2008;'FRANCE TELECOM';-31,47€;3.935,12 €;-1324;-31,47;8.459,21 €;'sin fechas';25/08/2008;'FRANCE';'Gastos_Servicios tipicos';'Telecomunicaciones';'FIJO'
25/08/2008;25/08/2008;'MERCADONA';-39,39€;3.895,73 €;-1323;-39,39;8.419,82 €;'sin fechas';25/08/2008;'MERCADONA';'Gastos_Compras';'Supermercado';'VARIABLES'
26/08/2008;26/08/2008;'CAFET.C T PRAT';-2,60€;3.893,13 €;-1322;-2,60;8.417,22 €;'sin fechas';26/08/2008;'CAFETC';'Gastos_Ocio y transporte';'Restaurantes';'VARIABLES'
26/08/2008;26/08/2008;'EL CORTE INGLES';-172,00€;3.721,13 €;-1321;-172,00;8.245,22 €;'sin fechas';26/08/2008;'CORTE';'Gastos_Compras';'Supermercado';'VARIABLES'
26/08/2008;26/08/2008;'EL CORTE INGLES';-207,00€;3.514,13 €;-1320;-207,00;8.038,22 €;'sin fechas';26/08/2008;'CORTE';'Gastos_Compras';'Supermercado';'VARIABLES'
26/08/2008;26/08/2008;'GASOLINA';-40,00€;3.474,13 €;-1319;-40,00;7.998,22 €;'sin fechas';26/08/2008;'GASOLINA';'Gastos_Ocio y transporte';'Gasolina';'VARIABLES'
27/08/2008;27/08/2008;'CAFET.C T PRAT';-2,90€;3.471,23 €;-1318;-2,90;7.995,32 €;'sin fechas';27/08/2008;'CAFETC';'Gastos_Ocio y transporte';'Restaurantes';'VARIABLES'
27/08/2008;27/08/2008;'CARREFOUR-[comida]';-61,70€;3.409,53 €;-1317;-61,70;7.933,62 €;'sin fechas';27/08/2008;'CARREFOURCOMIDA';'Gastos_Compras';'Supermercado';'VARIABLES'
27/08/2008;27/08/2008;'MERCADONA';-94,19€;3.315,34 €;-1316;-94,19;7.839,43 €;'sin fechas';27/08/2008;'MERCADONA';'Gastos_Compras';'Supermercado';'VARIABLES'
28/08/2008;28/08/2008;'CAFET.C T PRAT';-3,40€;3.311,94 €;-1315;-3,40;7.836,03 €;'sin fechas';28/08/2008;'CAFETC';'Gastos_Ocio y transporte';'Restaurantes';'VARIABLES'
28/08/2008;28/08/2008;'IKEA';-19,20€;3.292,74 €;-1314;-19,20;7.816,83 €;'sin fechas';28/08/2008;'IKEA';'Gastos_Vivienda y vehiculo';'Mnto. hogar';'VARIABLES'
28/08/2008;28/08/2008;'IKEA';-114,96€;3.177,78 €;-1313;-114,96;7.701,87 €;'sin fechas';28/08/2008;'IKEA';'Gastos_Vivienda y vehiculo';'Mnto. hogar';'VARIABLES'
28/08/2008;29/08/2008;'INFORMACIO I TECNOLOGIA DE CAT';1.439,92€;4.617,70 €;-1312;1.439,92;9.141,79 €;'sin fechas';29/08/2008;'INFORMACIO';'Ingresos';'Nomina';'FIJO'
29/08/2008;29/08/2008;'AMC PARC VALLES';-16,00€;4.601,70 €;-1311;-16,00;9.125,79 €;'sin fechas';29/08/2008;'AMC';'Gastos_Ocio y transporte';'Espectáculos';'VARIABLES'
29/08/2008;29/08/2008;'CAFET.C T PRAT';-3,70€;4.598,00 €;-1310;-3,70;9.122,09 €;'sin fechas';29/08/2008;'CAFETC';'Gastos_Ocio y transporte';'Restaurantes';'VARIABLES'
29/08/2008;29/08/2008;'MEXTARRASSA S.L.';-54,90€;4.543,10 €;-1309;-54,90;9.067,19 €;'sin fechas';29/08/2008;'MEXTARRASSA';'Gastos_Ocio y transporte';'Restaurantes';'VARIABLES'
30/08/2008;30/08/2008;'BCT BARICENTRO\\BARBERA DEL';-14,80€;4.528,30 €;-1308;-14,80;9.052,39 €;'sin fechas';30/08/2008;'BCT';'Gastos_Ocio y transporte';'Gasolina';'VARIABLES'
30/08/2008;30/08/2008;'CARREFOUR-[comida]';-85,39€;4.442,91 €;-1307;-85,39;8.967,00 €;'sin fechas';30/08/2008;'CARREFOURCOMIDA';'Gastos_Compras';'Supermercado';'VARIABLES'
30/08/2008;29/08/2008;'CARROGIO SA DE 066859/0000001';1.203,48€;5.646,39 €;-1306;1.203,48;10.170,48 €;'sin fechas';29/08/2008;'CARROGIO';'Ingresos';'Nomina';'FIJO'
30/08/2008;30/08/2008;'KAATEN \\BARBERA DEL V';-213,00€;5.433,39 €;-1305;-213,00;9.957,48 €;'sin fechas';30/08/2008;'KAATEN';'Gastos_Compras';'Hogar';'VARIABLES'
01/09/2008;01/09/2008;'BRICOKING TERRASSA';-9,70€;5.423,69 €;-1304;-9,70;9.947,78 €;'sin fechas';01/09/2008;'BRICOKING';'Gastos_Vivienda y vehiculo';'Mnto. hogar';'VARIABLES'
01/09/2008;01/09/2008;'CAFET.C T PRAT';-3,70€;5.419,99 €;-1303;-3,70;9.944,08 €;'sin fechas';01/09/2008;'CAFETC';'Gastos_Ocio y transporte';'Restaurantes';'VARIABLES'
01/09/2008;01/09/2008;'CAFET.C T PRAT';-6,90€;5.413,09 €;-1302;-6,90;9.937,18 €;'sin fechas';01/09/2008;'CAFETC';'Gastos_Ocio y transporte';'Restaurantes';'VARIABLES'
01/09/2008;31/08/2008;'RECIBO PTMOS. 3061-0960001518';-829,51€;4.583,58 €;-1301;-829,51;9.107,67 €;'sin fechas';31/08/2008;'RECIBO';'Gastos_Banco y organismos';'Hipoteca';'FIJO'
01/09/2008;31/08/2008;'RECIBO PTMOS. 3061-0960004140';-177,24€;4.406,34 €;-1300;-177,24;8.930,43 €;'sin fechas';31/08/2008;'RECIBO';'Gastos_Banco y organismos';'Hipoteca';'FIJO'
02/09/2008;02/09/2008;'BON AREA';-19,83€;4.386,51 €;-1299;-19,83;8.910,60 €;'sin fechas';02/09/2008;'BON';'Gastos_Compras';'Supermercado';'VARIABLES'
02/09/2008;02/09/2008;'CAFET.C T PRAT';-2,90€;4.383,61 €;-1298;-2,90;8.907,70 €;'sin fechas';02/09/2008;'CAFETC';'Gastos_Ocio y transporte';'Restaurantes';'VARIABLES'
03/09/2008;03/09/2008;'BURGUER KING PARK';-13,00€;4.370,61 €;-1297;-13,00;8.894,70 €;'sin fechas';03/09/2008;'BURGUER';'Gastos_Ocio y transporte';'Restaurantes';'VARIABLES'
03/09/2008;03/09/2008;'CAFET.C T PRAT';-4,40€;4.366,21 €;-1296;-4,40;8.890,30 €;'sin fechas';03/09/2008;'CAFETC';'Gastos_Ocio y transporte';'Restaurantes';'VARIABLES'
03/09/2008;03/09/2008;'CAFET.C T PRAT';-6,90€;4.359,31 €;-1295;-6,90;8.883,40 €;'sin fechas';03/09/2008;'CAFETC';'Gastos_Ocio y transporte';'Restaurantes';'VARIABLES'
03/09/2008;03/09/2008;'EL CORTE INGLES';-92,00€;4.267,31 €;-1294;-92,00;8.791,40 €;'sin fechas';03/09/2008;'CORTE';'Gastos_Compras';'Supermercado';'VARIABLES'
03/09/2008;03/09/2008;'GASOLINA';-40,00€;4.227,31 €;-1293;-40,00;8.751,40 €;'sin fechas';03/09/2008;'GASOLINA';'Gastos_Ocio y transporte';'Gasolina';'VARIABLES'
04/09/2008;04/09/2008;'BRICOKING TERRASSA';-12,80€;4.214,51 €;-1292;-12,80;8.738,60 €;'sin fechas';04/09/2008;'BRICOKING';'Gastos_Vivienda y vehiculo';'Mnto. hogar';'VARIABLES'
04/09/2008;04/09/2008;'CAFET.C T PRAT';-2,90€;4.211,61 €;-1291;-2,90;8.735,70 €;'sin fechas';04/09/2008;'CAFETC';'Gastos_Ocio y transporte';'Restaurantes';'VARIABLES'
04/09/2008;04/09/2008;'FRANCE TELECOM';-36,09€;4.175,52 €;-1290;-36,09;8.699,61 €;'sin fechas';04/09/2008;'FRANCE';'Gastos_Servicios tipicos';'Telecomunicaciones';'FIJO'
05/09/2008;05/09/2008;'BIJOU BRIGITTE S';-38,80€;4.136,72 €;-1289;-38,80;8.660,81 €;'sin fechas';05/09/2008;'BIJOU';'Gastos_Compras';'Ropa';'VARIABLES'
05/09/2008;05/09/2008;'CAFET.C T PRAT';-3,10€;4.133,62 €;-1288;-3,10;8.657,71 €;'sin fechas';05/09/2008;'CAFETC';'Gastos_Ocio y transporte';'Restaurantes';'VARIABLES'
05/09/2008;05/09/2008;'GROUPAMA PLUS';-49,61€;4.084,01 €;-1287;-49,61;8.608,10 €;'sin fechas';05/09/2008;'GROUPAMA';'Gastos_Seguros';'Seguro salud';'FIJO'
06/09/2008;06/09/2008;'FARMACIA';-8,80€;4.075,21 €;-1286;-8,80;8.599,30 €;'sin fechas';06/09/2008;'FARMACIA';'Gastos_Salud, saber y deporte';'Farmacia';'VARIABLES'
06/09/2008;06/09/2008;'FARMACIA';-6,90€;4.068,31 €;-1285;-6,90;8.592,40 €;'sin fechas';06/09/2008;'FARMACIA';'Gastos_Salud, saber y deporte';'Farmacia';'VARIABLES'
06/09/2008;06/09/2008;'KURZ AND GUT MATARO \\MATARO';-6,80€;4.061,51 €;-1284;-6,80;8.585,60 €;'sin fechas';06/09/2008;'KURZ';'Gastos_Ocio y transporte';'Restaurantes';'VARIABLES'
06/09/2008;06/09/2008;'Regalo Oscar y Cinta';-300,00€;3.761,51 €;-1283;-300,00;8.285,60 €;'sin fechas';06/09/2008;'REGALO';'Gastos_Compras';'Hogar';'VARIABLES'
08/09/2008;08/09/2008;'BON AREA';-15,67€;3.745,84 €;-1282;-15,67;8.269,93 €;'sin fechas';08/09/2008;'BON';'Gastos_Compras';'Supermercado';'VARIABLES'
08/09/2008;08/09/2008;'CAFET.C T PRAT';-2,90€;3.742,94 €;-1281;-2,90;8.267,03 €;'sin fechas';08/09/2008;'CAFETC';'Gastos_Ocio y transporte';'Restaurantes';'VARIABLES'
09/09/2008;09/09/2008;'CAFET.C T PRAT';-1,90€;3.741,04 €;-1280;-1,90;8.265,13 €;'sin fechas';09/09/2008;'CAFETC';'Gastos_Ocio y transporte';'Restaurantes';'VARIABLES'
09/09/2008;09/09/2008;'CINE';-12,00€;3.729,04 €;-1279;-12,00;8.253,13 €;'sin fechas';09/09/2008;'CINE';'Gastos_Ocio y transporte';'Espectáculos';'VARIABLES'
09/09/2008;09/09/2008;'SABOR TERRAZA SL';-35,52€;3.693,52 €;-1278;-35,52;8.217,61 €;'sin fechas';09/09/2008;'SABOR';'Gastos_Ocio y transporte';'Restaurantes';'VARIABLES'
10/09/2008;10/09/2008;'CAFET.C T PRAT';-2,90€;3.690,62 €;-1277;-2,90;8.214,71 €;'sin fechas';10/09/2008;'CAFETC';'Gastos_Ocio y transporte';'Restaurantes';'VARIABLES'
10/09/2008;10/09/2008;'I TORRE TERRASA';-13,10€;3.677,52 €;-1276;-13,10;8.201,61 €;'sin fechas';10/09/2008;'TORRE';'Gastos_Ocio y transporte';'Restaurantes';'VARIABLES'
11/09/2008;11/09/2008;'GASOLINA';-30,00€;3.647,52 €;-1275;-30,00;8.171,61 €;'sin fechas';11/09/2008;'GASOLINA';'Gastos_Ocio y transporte';'Gasolina';'VARIABLES'
12/09/2008;12/09/2008;'JIANHONG ZHOU S.L.';-24,72€;3.622,80 €;-1274;-24,72;8.146,89 €;'sin fechas';12/09/2008;'JIANHONG';'Gastos_Ocio y transporte';'Restaurantes';'VARIABLES'
12/09/2008;12/09/2008;'REINT.CAJERO';-260,00€;3.362,80 €;-1273;-260,00;7.886,89 €;'sin fechas';12/09/2008;'REINTCAJERO';'Gastos_Gastos varios';'Efectivo';'VARIABLES'
12/09/2008;12/09/2008;'VIENA';-13,00€;3.349,80 €;-1272;-13,00;7.873,89 €;'sin fechas';12/09/2008;'VIENA';'Gastos_Ocio y transporte';'Restaurantes';'VARIABLES'
13/09/2008;13/09/2008;'CARREFOUR-[comida]';-90,76€;3.259,04 €;-1271;-90,76;7.783,13 €;'sin fechas';13/09/2008;'CARREFOURCOMIDA';'Gastos_Compras';'Supermercado';'VARIABLES'
13/09/2008;13/09/2008;'EROSKI-[COMIDA]';-51,96€;3.207,08 €;-1270;-51,96;7.731,17 €;'sin fechas';13/09/2008;'EROSKICOMIDA';'Gastos_Compras';'Supermercado';'VARIABLES'
13/09/2008;13/09/2008;'IKEA';31,99€;3.239,07 €;-1269;31,99;7.763,16 €;'sin fechas';13/09/2008;'IKEA';'Gastos_Vivienda y vehiculo';'Mnto. hogar';'VARIABLES'
13/09/2008;13/09/2008;'IKEA';-12,40€;3.226,67 €;-1268;-12,40;7.750,76 €;'sin fechas';13/09/2008;'IKEA';'Gastos_Vivienda y vehiculo';'Mnto. hogar';'VARIABLES'
13/09/2008;13/09/2008;'IKEA';-317,32€;2.909,35 €;-1267;-317,32;7.433,44 €;'sin fechas';13/09/2008;'IKEA';'Gastos_Vivienda y vehiculo';'Mnto. hogar';'VARIABLES'
13/09/2008;13/09/2008;'VIENA';-9,45€;2.899,90 €;-1266;-9,45;7.423,99 €;'sin fechas';13/09/2008;'VIENA';'Gastos_Ocio y transporte';'Restaurantes';'VARIABLES'
15/09/2008;15/09/2008;'CAFET.C T PRAT';-2,90€;2.897,00 €;-1265;-2,90;7.421,09 €;'sin fechas';15/09/2008;'CAFETC';'Gastos_Ocio y transporte';'Restaurantes';'VARIABLES'
15/09/2008;06/09/2008;'COMPRA CON TARJETA';-1,84€;2.895,16 €;-1264;-1,84;7.419,25 €;'sin fechas';06/09/2008;'COMPRA';'Gastos_Compras';'Supermercado';'VARIABLES'
15/09/2008;06/09/2008;'COMPRA CON TARJETA';-1,11€;2.894,05 €;-1263;-1,11;7.418,14 €;'sin fechas';06/09/2008;'COMPRA';'Gastos_Compras';'Supermercado';'VARIABLES'
15/09/2008;07/09/2008;'COMPRA CON TARJETA';-1,11€;2.892,94 €;-1262;-1,11;7.417,03 €;'sin fechas';07/09/2008;'COMPRA';'Gastos_Compras';'Supermercado';'VARIABLES'
15/09/2008;15/09/2008;'MERCADONA';-47,81€;2.845,13 €;-1261;-47,81;7.369,22 €;'sin fechas';15/09/2008;'MERCADONA';'Gastos_Compras';'Supermercado';'VARIABLES'
15/09/2008;15/09/2008;'SEG.AM.HIPITEC';-31,43€;2.813,70 €;-1260;-31,43;7.337,79 €;'sin fechas';15/09/2008;'SEGAMHIPITEC';'Gastos_Seguros';'Seguro vida';'FIJO'
16/09/2008;16/09/2008;'CAFET.C T PRAT';-2,05€;2.811,65 €;-1259;-2,05;7.335,74 €;'sin fechas';16/09/2008;'CAFETC';'Gastos_Ocio y transporte';'Restaurantes';'VARIABLES'
17/09/2008;17/09/2008;'CAFET.C T PRAT';-2,75€;2.808,90 €;-1258;-2,75;7.332,99 €;'sin fechas';17/09/2008;'CAFETC';'Gastos_Ocio y transporte';'Restaurantes';'VARIABLES'
17/09/2008;17/09/2008;'ENDESA DISTRIB';-64,96€;2.743,94 €;-1257;-64,96;7.268,03 €;'sin fechas';17/09/2008;'ENDESA';'Gastos_Servicios tipicos';'Electricidad';'FIJO'
17/09/2008;17/09/2008;'ONO';-78,52€;2.665,42 €;-1256;-78,52;7.189,51 €;'sin fechas';17/09/2008;'ONO';'Gastos_Servicios tipicos';'Telecomunicaciones';'FIJO'
18/09/2008;18/09/2008;'CAFET.C T PRAT';-3,10€;2.662,32 €;-1255;-3,10;7.186,41 €;'sin fechas';18/09/2008;'CAFETC';'Gastos_Ocio y transporte';'Restaurantes';'VARIABLES'
18/09/2008;18/09/2008;'GASOLINA';-30,00€;2.632,32 €;-1254;-30,00;7.156,41 €;'sin fechas';18/09/2008;'GASOLINA';'Gastos_Ocio y transporte';'Gasolina';'VARIABLES'
19/09/2008;19/09/2008;'CAFET.C T PRAT';-2,80€;2.629,52 €;-1253;-2,80;7.153,61 €;'sin fechas';19/09/2008;'CAFETC';'Gastos_Ocio y transporte';'Restaurantes';'VARIABLES'
19/09/2008;19/09/2008;'MINA PUBLICA DE LA CIUTAT';-21,76€;2.607,76 €;-1252;-21,76;7.131,85 €;'sin fechas';19/09/2008;'MINA';'Gastos_Servicios tipicos';'Agua';'FIJO'
20/09/2008;20/09/2008;'REINT.CAJERO';-40,00€;2.567,76 €;-1251;-40,00;7.091,85 €;'sin fechas';20/09/2008;'REINTCAJERO';'Gastos_Gastos varios';'Efectivo';'VARIABLES'
22/09/2008;22/09/2008;'LA TORRETA';-38,30€;2.529,46 €;-1250;-38,30;7.053,55 €;'sin fechas';22/09/2008;'TORRETA';'Gastos_Ocio y transporte';'Restaurantes';'VARIABLES'
23/09/2008;23/09/2008;'BURGUER KING PARK';-12,49€;2.516,97 €;-1249;-12,49;7.041,06 €;'sin fechas';23/09/2008;'BURGUER';'Gastos_Ocio y transporte';'Restaurantes';'VARIABLES'
23/09/2008;23/09/2008;'EROSKI-[COMIDA]';-29,59€;2.487,38 €;-1248;-29,59;7.011,47 €;'sin fechas';23/09/2008;'EROSKICOMIDA';'Gastos_Compras';'Supermercado';'VARIABLES'
23/09/2008;23/09/2008;'FRANCE TELECOM';-37,89€;2.449,49 €;-1247;-37,89;6.973,58 €;'sin fechas';23/09/2008;'FRANCE';'Gastos_Servicios tipicos';'Telecomunicaciones';'FIJO'
23/09/2008;23/09/2008;'VIENA';-5,05€;2.444,44 €;-1246;-5,05;6.968,53 €;'sin fechas';23/09/2008;'VIENA';'Gastos_Ocio y transporte';'Restaurantes';'VARIABLES'
24/09/2008;24/09/2008;'CARREFOUR-[comida]';-139,00€;2.305,44 €;-1245;-139,00;6.829,53 €;'sin fechas';24/09/2008;'CARREFOURCOMIDA';'Gastos_Compras';'Supermercado';'VARIABLES'
24/09/2008;24/09/2008;'I TORRE TERRASA';-14,25€;2.291,19 €;-1244;-14,25;6.815,28 €;'sin fechas';24/09/2008;'TORRE';'Gastos_Ocio y transporte';'Restaurantes';'VARIABLES'
25/09/2008;25/09/2008;'BON AREA';-50,24€;2.240,95 €;-1243;-50,24;6.765,04 €;'sin fechas';25/09/2008;'BON';'Gastos_Compras';'Supermercado';'VARIABLES'
25/09/2008;25/09/2008;'GASOLINA';-35,00€;2.205,95 €;-1242;-35,00;6.730,04 €;'sin fechas';25/09/2008;'GASOLINA';'Gastos_Ocio y transporte';'Gasolina';'VARIABLES'
26/09/2008;26/09/2008;'CANTINA MARIACHI';-25,95€;2.180,00 €;-1241;-25,95;6.704,09 €;'sin fechas';26/09/2008;'CANTINA';'Gastos_Ocio y transporte';'Restaurantes';'VARIABLES'
26/09/2008;26/09/2008;'KAATEN \\BARBERA DEL V';8,20€;2.188,20 €;-1240;8,20;6.712,29 €;'sin fechas';26/09/2008;'KAATEN';'Gastos_Compras';'Hogar';'VARIABLES'
27/09/2008;30/09/2008;'INFORMACIO I TECNOLOGIA DE CAT';1.534,23€;3.722,43 €;-1239;1.534,23;8.246,52 €;'sin fechas';30/09/2008;'INFORMACIO';'Ingresos';'Nomina';'FIJO'
30/09/2008;30/09/2008;'DHR TRADE SL';-11,10€;3.711,33 €;-1238;-11,10;8.235,42 €;'sin fechas';30/09/2008;'DHR';'Gastos_Ocio y transporte';'Gasolina';'VARIABLES'
30/09/2008;30/09/2008;'RECIBO PTMOS. 3061-0960001518';-829,51€;2.881,82 €;-1237;-829,51;7.405,91 €;'sin fechas';30/09/2008;'RECIBO';'Gastos_Banco y organismos';'Hipoteca';'FIJO'
30/09/2008;30/09/2008;'RECIBO PTMOS. 3061-0960004140';-177,24€;2.704,58 €;-1236;-177,24;7.228,67 €;'sin fechas';30/09/2008;'RECIBO';'Gastos_Banco y organismos';'Hipoteca';'FIJO'
30/09/2008;30/09/2008;'TOYOTA ORIENT CARS';-18,85€;2.685,73 €;-1235;-18,85;7.209,82 €;'sin fechas';30/09/2008;'TOYOTA';'Gastos_Vivienda y vehiculo';'Mnto. vehiculo';'VARIABLE'
01/10/2008;01/10/2008;'AJUNTAMENT DE TERRASSA';-35,24€;2.650,49 €;-1234;-35,24;7.174,58 €;'sin fechas';01/10/2008;'AJUNTAMENT';'Gastos_Banco y organismos';'Ayuntamiento';'FIJO'
01/10/2008;30/09/2008;'CARROGIO SA DE 205104/0000001';1.203,48€;3.853,97 €;-1233;1.203,48;8.378,06 €;'sin fechas';30/09/2008;'CARROGIO';'Ingresos';'Nomina';'FIJO'
01/10/2008;01/10/2008;'REINT.CAJERO';-300,00€;3.553,97 €;-1232;-300,00;8.078,06 €;'sin fechas';01/10/2008;'REINTCAJERO';'Gastos_Gastos varios';'Efectivo';'VARIABLES'
02/10/2008;02/10/2008;'EROSKI-[COMIDA]';-42,92€;3.511,05 €;-1231;-42,92;8.035,14 €;'sin fechas';02/10/2008;'EROSKICOMIDA';'Gastos_Compras';'Supermercado';'VARIABLES'
03/10/2008;03/10/2008;'CAFET.C T PRAT';-3,10€;3.507,95 €;-1230;-3,10;8.032,04 €;'sin fechas';03/10/2008;'CAFETC';'Gastos_Ocio y transporte';'Restaurantes';'VARIABLES'
03/10/2008;03/10/2008;'GROUPAMA PLUS';-49,61€;3.458,34 €;-1229;-49,61;7.982,43 €;'sin fechas';03/10/2008;'GROUPAMA';'Gastos_Seguros';'Seguro salud';'FIJO'
03/10/2008;03/10/2008;'PANSGLORIAS';-6,95€;3.451,39 €;-1228;-6,95;7.975,48 €;'sin fechas';03/10/2008;'PANSGLORIAS';'Gastos_Ocio y transporte';'Restaurantes';'VARIABLES'
04/10/2008;04/10/2008;'BON AREA';-38,89€;3.412,50 €;-1227;-38,89;7.936,59 €;'sin fechas';04/10/2008;'BON';'Gastos_Compras';'Supermercado';'VARIABLES'
04/10/2008;05/10/2008;'COM. MANT. ACTIVAS DE LIQ.';-15,00€;3.397,50 €;-1226;-15,00;7.921,59 €;'sin fechas';05/10/2008;'COM';'Gastos_Banco y organismos';'Cargos banco';'FIJO'
04/10/2008;05/10/2008;'IMPUESTOS RETENIDOS A CUENTA';-0,04€;3.397,46 €;-1225;-0,04;7.921,55 €;'sin fechas';05/10/2008;'IMPUESTOS';'Gastos_Banco y organismos';'Impuestos';'FIJO'
04/10/2008;05/10/2008;'INTERESES';0,24€;3.397,70 €;-1224;0,24;7.921,79 €;'sin fechas';05/10/2008;'INTERESES';'Ingresos';'Rendimientos';
06/10/2008;06/10/2008;'CAFET.C T PRAT';-1,90€;3.395,80 €;-1223;-1,90;7.919,89 €;'sin fechas';06/10/2008;'CAFETC';'Gastos_Ocio y transporte';'Restaurantes';'VARIABLES'
06/10/2008;08/10/2008;'Devolución Seguro';248,72€;3.644,52 €;-1222;248,72;8.168,61 €;'sin fechas';08/10/2008;'DEVOLUCIN';'Gastos_Seguros';'Seguro hogar';'FIJO'
06/10/2008;06/10/2008;'FARMACIA';-9,00€;3.635,52 €;-1221;-9,00;8.159,61 €;'sin fechas';06/10/2008;'FARMACIA';'Gastos_Salud, saber y deporte';'Farmacia';'VARIABLES'
06/10/2008;06/10/2008;'FRANCE TELECOM';-10,44€;3.625,08 €;-1220;-10,44;8.149,17 €;'sin fechas';06/10/2008;'FRANCE';'Gastos_Servicios tipicos';'Telecomunicaciones';'FIJO'
06/10/2008;06/10/2008;'GASOLINA';-44,17€;3.580,91 €;-1219;-44,17;8.105,00 €;'sin fechas';06/10/2008;'GASOLINA';'Gastos_Ocio y transporte';'Gasolina';'VARIABLES'
07/10/2008;07/10/2008;'CAFET.C T PRAT';-2,20€;3.578,71 €;-1218;-2,20;8.102,80 €;'sin fechas';07/10/2008;'CAFETC';'Gastos_Ocio y transporte';'Restaurantes';'VARIABLES'
10/10/2008;10/10/2008;'CAFET.C T PRAT';-2,30€;3.576,41 €;-1217;-2,30;8.100,50 €;'sin fechas';10/10/2008;'CAFETC';'Gastos_Ocio y transporte';'Restaurantes';'VARIABLES'
10/10/2008;10/10/2008;'EROSKI-[COMIDA]';-27,54€;3.548,87 €;-1216;-27,54;8.072,96 €;'sin fechas';10/10/2008;'EROSKICOMIDA';'Gastos_Compras';'Supermercado';'VARIABLES'
10/10/2008;10/10/2008;'QUICUINA';-17,00€;3.531,87 €;-1215;-17,00;8.055,96 €;'sin fechas';10/10/2008;'QUICUINA';'Gastos_Compras';'Supermercado';'VARIABLES'
12/10/2008;12/10/2008;'EROSKI-[COMIDA]';-117,14€;3.414,73 €;-1214;-117,14;7.938,82 €;'sin fechas';12/10/2008;'EROSKICOMIDA';'Gastos_Compras';'Supermercado';'VARIABLES'
12/10/2008;12/10/2008;'VIENA';-10,40€;3.404,33 €;-1213;-10,40;7.928,42 €;'sin fechas';12/10/2008;'VIENA';'Gastos_Ocio y transporte';'Restaurantes';'VARIABLES'
13/10/2008;13/10/2008;'CAFET.C T PRAT';-2,60€;3.401,73 €;-1212;-2,60;7.925,82 €;'sin fechas';13/10/2008;'CAFETC';'Gastos_Ocio y transporte';'Restaurantes';'VARIABLES'
13/10/2008;13/10/2008;'GAS NATURAL';-89,36€;3.312,37 €;-1211;-89,36;7.836,46 €;'sin fechas';13/10/2008;'GAS';'Gastos_Servicios tipicos';'Gas';'FIJO'
14/10/2008;14/10/2008;'FARMACIA';-3,51€;3.308,86 €;-1210;-3,51;7.832,95 €;'sin fechas';14/10/2008;'FARMACIA';'Gastos_Salud, saber y deporte';'Farmacia';'VARIABLES'
14/10/2008;14/10/2008;'TRANSFERENCIASCARGO';-100,00€;3.208,86 €;-1209;-100,00;7.732,95 €;'sin fechas';14/10/2008;'TRANSFERENCIASCARGO';'Gastos_Gastos varios';'Transferencias';'VARIABLES'
14/10/2008;14/10/2008;'TRANSFERENCIASFAVOR';100,00€;3.308,86 €;-1208;100,00;7.832,95 €;'sin fechas';14/10/2008;'TRANSFERENCIASFAVOR';'Ingresos';'Transferencias';'VARIABLES'
15/10/2008;15/10/2008;'SEG.AM.HIPITEC';-31,38€;3.277,48 €;-1207;-31,38;7.801,57 €;'sin fechas';15/10/2008;'SEGAMHIPITEC';'Gastos_Seguros';'Seguro vida';'FIJO'
16/10/2008;16/10/2008;'CARREFOUR-[comida]';-56,38€;3.221,10 €;-1206;-56,38;7.745,19 €;'sin fechas';16/10/2008;'CARREFOURCOMIDA';'Gastos_Compras';'Supermercado';'VARIABLES'
16/10/2008;16/10/2008;'EL MESON DEL JAMON';-20,01€;3.201,09 €;-1205;-20,01;7.725,18 €;'sin fechas';16/10/2008;'MESON';'Gastos_Ocio y transporte';'Restaurantes';'VARIABLES'
16/10/2008;16/10/2008;'MERCADONA';-120,47€;3.080,62 €;-1204;-120,47;7.604,71 €;'sin fechas';16/10/2008;'MERCADONA';'Gastos_Compras';'Supermercado';'VARIABLES'
17/10/2008;17/10/2008;'CAFET.C T PRAT';-1,75€;3.078,87 €;-1203;-1,75;7.602,96 €;'sin fechas';17/10/2008;'CAFETC';'Gastos_Ocio y transporte';'Restaurantes';'VARIABLES'
17/10/2008;17/10/2008;'EROSKI-[COMIDA]';-11,39€;3.067,48 €;-1202;-11,39;7.591,57 €;'sin fechas';17/10/2008;'EROSKICOMIDA';'Gastos_Compras';'Supermercado';'VARIABLES'
17/10/2008;17/10/2008;'ONO';-86,34€;2.981,14 €;-1201;-86,34;7.505,23 €;'sin fechas';17/10/2008;'ONO';'Gastos_Servicios tipicos';'Telecomunicaciones';'FIJO'
18/10/2008;18/10/2008;'GASOLINA';-30,00€;2.951,14 €;-1200;-30,00;7.475,23 €;'sin fechas';18/10/2008;'GASOLINA';'Gastos_Ocio y transporte';'Gasolina';'VARIABLES'
20/10/2008;20/10/2008;'BONIFICACION';15,00€;2.966,14 €;-1199;15,00;7.490,23 €;'sin fechas';20/10/2008;'BONIFICACION';'Ingresos';'Otros ingresos';'VARIABLES'
20/10/2008;20/10/2008;'CAFET.C T PRAT';-2,05€;2.964,09 €;-1198;-2,05;7.488,18 €;'sin fechas';20/10/2008;'CAFETC';'Gastos_Ocio y transporte';'Restaurantes';'VARIABLES'
21/10/2008;21/10/2008;'CAFET.C T PRAT';-1,75€;2.962,34 €;-1197;-1,75;7.486,43 €;'sin fechas';21/10/2008;'CAFETC';'Gastos_Ocio y transporte';'Restaurantes';'VARIABLES'
21/10/2008;21/10/2008;'MISAKO';-25,00€;2.937,34 €;-1196;-25,00;7.461,43 €;'sin fechas';21/10/2008;'MISAKO';'Gastos_Compras';'Ropa';'VARIABLES'
22/10/2008;22/10/2008;'CAFET.C T PRAT';-3,25€;2.934,09 €;-1195;-3,25;7.458,18 €;'sin fechas';22/10/2008;'CAFETC';'Gastos_Ocio y transporte';'Restaurantes';'VARIABLES'
23/10/2008;23/10/2008;'CAFET.C T PRAT';-0,80€;2.933,29 €;-1194;-0,80;7.457,38 €;'sin fechas';23/10/2008;'CAFETC';'Gastos_Ocio y transporte';'Restaurantes';'VARIABLES'
23/10/2008;23/10/2008;'FOTOPRIX';-6,96€;2.926,33 €;-1193;-6,96;7.450,42 €;'sin fechas';23/10/2008;'FOTOPRIX';'Gastos_Compras';'Niños';'VARIABLES'
23/10/2008;23/10/2008;'FRANCE TELECOM';-26,31€;2.900,02 €;-1192;-26,31;7.424,11 €;'sin fechas';23/10/2008;'FRANCE';'Gastos_Servicios tipicos';'Telecomunicaciones';'FIJO'
24/10/2008;24/10/2008;'CAFET.C T PRAT';-1,55€;2.898,47 €;-1191;-1,55;7.422,56 €;'sin fechas';24/10/2008;'CAFETC';'Gastos_Ocio y transporte';'Restaurantes';'VARIABLES'
24/10/2008;24/10/2008;'EROSKI-[COMIDA]';-65,98€;2.832,49 €;-1190;-65,98;7.356,58 €;'sin fechas';24/10/2008;'EROSKICOMIDA';'Gastos_Compras';'Supermercado';'VARIABLES'
24/10/2008;24/10/2008;'MCDONALDS TERRASSA';-8,50€;2.823,99 €;-1189;-8,50;7.348,08 €;'sin fechas';24/10/2008;'MCDONALDS';'Gastos_Ocio y transporte';'Restaurantes';'VARIABLES'
25/10/2008;25/10/2008;'BON AREA';-4,98€;2.819,01 €;-1188;-4,98;7.343,10 €;'sin fechas';25/10/2008;'BON';'Gastos_Compras';'Supermercado';'VARIABLES'
25/10/2008;25/10/2008;'GASOLINA';-18,20€;2.800,81 €;-1187;-18,20;7.324,90 €;'sin fechas';25/10/2008;'GASOLINA';'Gastos_Ocio y transporte';'Gasolina';'VARIABLES'
27/10/2008;27/10/2008;'CAFET.C T PRAT';-2,75€;2.798,06 €;-1186;-2,75;7.322,15 €;'sin fechas';27/10/2008;'CAFETC';'Gastos_Ocio y transporte';'Restaurantes';'VARIABLES'
27/10/2008;27/10/2008;'CAFET.C T PRAT';-5,65€;2.792,41 €;-1185;-5,65;7.316,50 €;'sin fechas';27/10/2008;'CAFETC';'Gastos_Ocio y transporte';'Restaurantes';'VARIABLES'
28/10/2008;28/10/2008;'CAFET.C T PRAT';-1,90€;2.790,51 €;-1184;-1,90;7.314,60 €;'sin fechas';28/10/2008;'CAFETC';'Gastos_Ocio y transporte';'Restaurantes';'VARIABLES'
29/10/2008;29/10/2008;'CAFET.C T PRAT';-4,65€;2.785,86 €;-1183;-4,65;7.309,95 €;'sin fechas';29/10/2008;'CAFETC';'Gastos_Ocio y transporte';'Restaurantes';'VARIABLES'
30/10/2008;30/10/2008;'CAFET.C T PRAT';-2,65€;2.783,21 €;-1182;-2,65;7.307,30 €;'sin fechas';30/10/2008;'CAFETC';'Gastos_Ocio y transporte';'Restaurantes';'VARIABLES'
30/10/2008;31/10/2008;'INFORMACIO I TECNOLOGIA DE CAT';1.674,22€;4.457,43 €;-1181;1.674,22;8.981,52 €;'sin fechas';31/10/2008;'INFORMACIO';'Ingresos';'Nomina';'FIJO'
30/10/2008;30/10/2008;'REINT.CAJERO';-60,00€;4.397,43 €;-1180;-60,00;8.921,52 €;'sin fechas';30/10/2008;'REINTCAJERO';'Gastos_Gastos varios';'Efectivo';'VARIABLES'
31/10/2008;31/10/2008;'CAFET.C T PRAT';-2,35€;4.395,08 €;-1179;-2,35;8.919,17 €;'sin fechas';31/10/2008;'CAFETC';'Gastos_Ocio y transporte';'Restaurantes';'VARIABLES'
31/10/2008;31/10/2008;'GASOLINA';-30,00€;4.365,08 €;-1178;-30,00;8.889,17 €;'sin fechas';31/10/2008;'GASOLINA';'Gastos_Ocio y transporte';'Gasolina';'VARIABLES'
31/10/2008;31/10/2008;'LA BRASA';-12,90€;4.352,18 €;-1177;-12,90;8.876,27 €;'sin fechas';31/10/2008;'BRASA';'Gastos_Ocio y transporte';'Restaurantes';'VARIABLES'
31/10/2008;31/10/2008;'MARCO ALDANY';-9,99€;4.342,19 €;-1176;-9,99;8.866,28 €;'sin fechas';31/10/2008;'MARCO';'Gastos_Salud, saber y deporte';'Belleza';'VARIABLES'
31/10/2008;31/10/2008;'METRO';-1,30€;4.340,89 €;-1175;-1,30;8.864,98 €;'sin fechas';31/10/2008;'METRO';'Gastos_Ocio y transporte';'Transporte';'VARIABLES'
31/10/2008;31/10/2008;'RECIBO PTMOS. 3061-0960001518';-829,51€;3.511,38 €;-1174;-829,51;8.035,47 €;'sin fechas';31/10/2008;'RECIBO';'Gastos_Banco y organismos';'Hipoteca';'FIJO'
31/10/2008;31/10/2008;'RECIBO PTMOS. 3061-0960004140';-177,24€;3.334,14 €;-1173;-177,24;7.858,23 €;'sin fechas';31/10/2008;'RECIBO';'Gastos_Banco y organismos';'Hipoteca';'FIJO'
01/11/2008;01/11/2008;'C&A';-32,41€;3.301,73 €;-1172;-32,41;7.825,82 €;'sin fechas';01/11/2008;'CA';'Gastos_Compras';'Ropa';'VARIABLES'
01/11/2008;31/10/2008;'CARROGIO SA DE 379083/0000001';1.203,49€;4.505,22 €;-1171;1.203,49;9.029,31 €;'sin fechas';31/10/2008;'CARROGIO';'Ingresos';'Nomina';'FIJO'
01/11/2008;01/11/2008;'FILMAX CASTELL\\CASTELLDEFEL';-12,60€;4.492,62 €;-1170;-12,60;9.016,71 €;'sin fechas';01/11/2008;'FILMAX';'Gastos_Ocio y transporte';'Espectáculos';'VARIABLES'
01/11/2008;01/11/2008;'KIABI SANT BOI';-147,90€;4.344,72 €;-1169;-147,90;8.868,81 €;'sin fechas';01/11/2008;'KIABI';'Gastos_Compras';'Ropa';'VARIABLES'
02/11/2008;02/11/2008;'VIENA';-6,80€;4.337,92 €;-1168;-6,80;8.862,01 €;'sin fechas';02/11/2008;'VIENA';'Gastos_Ocio y transporte';'Restaurantes';'VARIABLES'
03/11/2008;03/11/2008;'CAFET.C T PRAT';-1,90€;4.336,02 €;-1167;-1,90;8.860,11 €;'sin fechas';03/11/2008;'CAFETC';'Gastos_Ocio y transporte';'Restaurantes';'VARIABLES'
03/11/2008;03/11/2008;'MERCADONA';-20,54€;4.315,48 €;-1166;-20,54;8.839,57 €;'sin fechas';03/11/2008;'MERCADONA';'Gastos_Compras';'Supermercado';'VARIABLES'
04/11/2008;04/11/2008;'CAFET.C T PRAT';-3,35€;4.312,13 €;-1165;-3,35;8.836,22 €;'sin fechas';04/11/2008;'CAFETC';'Gastos_Ocio y transporte';'Restaurantes';'VARIABLES'
05/11/2008;05/11/2008;'CAFET.C T PRAT';-2,90€;4.309,23 €;-1164;-2,90;8.833,32 €;'sin fechas';05/11/2008;'CAFETC';'Gastos_Ocio y transporte';'Restaurantes';'VARIABLES'
05/11/2008;05/11/2008;'FRANCE TELECOM';-10,44€;4.298,79 €;-1163;-10,44;8.822,88 €;'sin fechas';05/11/2008;'FRANCE';'Gastos_Servicios tipicos';'Telecomunicaciones';'FIJO'
05/11/2008;05/11/2008;'REINT.CAJERO';-60,00€;4.238,79 €;-1162;-60,00;8.762,88 €;'sin fechas';05/11/2008;'REINTCAJERO';'Gastos_Gastos varios';'Efectivo';'VARIABLES'
05/11/2008;05/11/2008;'RENFE';-2,05€;4.236,74 €;-1161;-2,05;8.760,83 €;'sin fechas';05/11/2008;'RENFE';'Gastos_Ocio y transporte';'Transporte';'VARIABLES'
05/11/2008;05/11/2008;'RENFE';-1,40€;4.235,34 €;-1160;-1,40;8.759,43 €;'sin fechas';05/11/2008;'RENFE';'Gastos_Ocio y transporte';'Transporte';'VARIABLES'
06/11/2008;06/11/2008;'CAFET.C T PRAT';-2,65€;4.232,69 €;-1159;-2,65;8.756,78 €;'sin fechas';06/11/2008;'CAFETC';'Gastos_Ocio y transporte';'Restaurantes';'VARIABLES'
06/11/2008;06/11/2008;'ONA NUIT \\EL PRAT DE LL';-12,95€;4.219,74 €;-1158;-12,95;8.743,83 €;'sin fechas';06/11/2008;'ONA';'Gastos_Ocio y transporte';'Restaurantes';'VARIABLES'
07/11/2008;07/11/2008;'GROUPAMA PLUS';-49,61€;4.170,13 €;-1157;-49,61;8.694,22 €;'sin fechas';07/11/2008;'GROUPAMA';'Gastos_Seguros';'Seguro salud';'FIJO'
07/11/2008;07/11/2008;'INURSA \\MONCADA REIXA';-39,00€;4.131,13 €;-1156;-39,00;8.655,22 €;'sin fechas';07/11/2008;'INURSA';'Gastos_Compras';'Supermercado';'VARIABLES'
08/11/2008;08/11/2008;'ALCAMPO';-201,89€;3.929,24 €;-1155;-201,89;8.453,33 €;'sin fechas';08/11/2008;'ALCAMPO';'Gastos_Compras';'Supermercado';'VARIABLES'
08/11/2008;08/11/2008;'BARCELONA \\SANT QUIRZE D';-30,85€;3.898,39 €;-1154;-30,85;8.422,48 €;'sin fechas';08/11/2008;'BARCELONA';'Gastos_Compras';'Supermercado';'VARIABLES'
08/11/2008;08/11/2008;'EROSKI-[COMIDA]';-55,99€;3.842,40 €;-1153;-55,99;8.366,49 €;'sin fechas';08/11/2008;'EROSKICOMIDA';'Gastos_Compras';'Supermercado';'VARIABLES'
08/11/2008;08/11/2008;'GIFI';-15,00€;3.827,40 €;-1152;-15,00;8.351,49 €;'sin fechas';08/11/2008;'GIFI';'Gastos_Compras';'Hogar';'VARIABLES'
08/11/2008;08/11/2008;'MERKALZADOS TERRAS';-53,90€;3.773,50 €;-1151;-53,90;8.297,59 €;'sin fechas';08/11/2008;'MERKALZADOS';'Gastos_Compras';'Ropa';'VARIABLES'
08/11/2008;08/11/2008;'VIENA';-9,35€;3.764,15 €;-1150;-9,35;8.288,24 €;'sin fechas';08/11/2008;'VIENA';'Gastos_Ocio y transporte';'Restaurantes';'VARIABLES'
08/11/2008;08/11/2008;'ALCAMPO-[OTROS]';-349,00€;3.415,15 €;-1149;-349,00;7.939,24 €;'sin fechas';08/11/2008;'ALCAMPOOTROS';'Gastos_Compras';'Hogar';'VARIABLES'
10/11/2008;10/11/2008;'CAFET.C T PRAT';-0,80€;3.414,35 €;-1148;-0,80;7.938,44 €;'sin fechas';10/11/2008;'CAFETC';'Gastos_Ocio y transporte';'Restaurantes';'VARIABLES'
10/11/2008;10/11/2008;'CAFET.C T PRAT';-6,90€;3.407,45 €;-1147;-6,90;7.931,54 €;'sin fechas';10/11/2008;'CAFETC';'Gastos_Ocio y transporte';'Restaurantes';'VARIABLES'
11/11/2008;11/11/2008;'CAFET.C T PRAT';-0,80€;3.406,65 €;-1146;-0,80;7.930,74 €;'sin fechas';11/11/2008;'CAFETC';'Gastos_Ocio y transporte';'Restaurantes';'VARIABLES'
11/11/2008;11/11/2008;'CAFET.C T PRAT';-6,90€;3.399,75 €;-1145;-6,90;7.923,84 €;'sin fechas';11/11/2008;'CAFETC';'Gastos_Ocio y transporte';'Restaurantes';'VARIABLES'
12/11/2008;12/11/2008;'CAFET.C T PRAT';-1,70€;3.398,05 €;-1144;-1,70;7.922,14 €;'sin fechas';12/11/2008;'CAFETC';'Gastos_Ocio y transporte';'Restaurantes';'VARIABLES'
12/11/2008;12/11/2008;'CAFET.C T PRAT';-6,90€;3.391,15 €;-1143;-6,90;7.915,24 €;'sin fechas';12/11/2008;'CAFETC';'Gastos_Ocio y transporte';'Restaurantes';'VARIABLES'
12/11/2008;12/11/2008;'COMISIONES';-1,50€;3.389,65 €;-1142;-1,50;7.913,74 €;'sin fechas';12/11/2008;'COMISIONES';'Gastos_Banco y organismos';'Cargos banco';'FIJO'
12/11/2008;12/11/2008;'COMISIONES';1,50€;3.391,15 €;-1141;1,50;7.915,24 €;'sin fechas';12/11/2008;'COMISIONES';'Gastos_Banco y organismos';'Cargos banco';'FIJO'
12/11/2008;12/11/2008;'REINT.CAJERO';-40,00€;3.351,15 €;-1140;-40,00;7.875,24 €;'sin fechas';12/11/2008;'REINTCAJERO';'Gastos_Gastos varios';'Efectivo';'VARIABLES'
12/11/2008;12/11/2008;'REINT.CAJERO';40,00€;3.391,15 €;-1139;40,00;7.915,24 €;'sin fechas';12/11/2008;'REINTCAJERO';'Gastos_Gastos varios';'Efectivo';'VARIABLES'
13/11/2008;13/11/2008;'BURGUER KING PARK';-15,80€;3.375,35 €;-1138;-15,80;7.899,44 €;'sin fechas';13/11/2008;'BURGUER';'Gastos_Ocio y transporte';'Restaurantes';'VARIABLES'
13/11/2008;13/11/2008;'CAFET.C T PRAT';-1,55€;3.373,80 €;-1137;-1,55;7.897,89 €;'sin fechas';13/11/2008;'CAFETC';'Gastos_Ocio y transporte';'Restaurantes';'VARIABLES'
13/11/2008;13/11/2008;'REINT.CAJERO';-60,00€;3.313,80 €;-1136;-60,00;7.837,89 €;'sin fechas';13/11/2008;'REINTCAJERO';'Gastos_Gastos varios';'Efectivo';'VARIABLES'
14/11/2008;14/11/2008;'CAFET.C T PRAT';-3,65€;3.310,15 €;-1135;-3,65;7.834,24 €;'sin fechas';14/11/2008;'CAFETC';'Gastos_Ocio y transporte';'Restaurantes';'VARIABLES'
14/11/2008;14/11/2008;'MERCADONA';-9,83€;3.300,32 €;-1134;-9,83;7.824,41 €;'sin fechas';14/11/2008;'MERCADONA';'Gastos_Compras';'Supermercado';'VARIABLES'
15/11/2008;15/11/2008;'BON AREA';-31,25€;3.269,07 €;-1133;-31,25;7.793,16 €;'sin fechas';15/11/2008;'BON';'Gastos_Compras';'Supermercado';'VARIABLES'
15/11/2008;15/11/2008;'CAPRABO';-3,66€;3.265,41 €;-1132;-3,66;7.789,50 €;'sin fechas';15/11/2008;'CAPRABO';'Gastos_Compras';'Supermercado';'VARIABLES'
15/11/2008;15/11/2008;'GRINZING';-4,30€;3.261,11 €;-1131;-4,30;7.785,20 €;'sin fechas';15/11/2008;'GRINZING';'Gastos_Ocio y transporte';'Restaurantes';'VARIABLES'
15/11/2008;15/11/2008;'GRINZING';-3,70€;3.257,41 €;-1130;-3,70;7.781,50 €;'sin fechas';15/11/2008;'GRINZING';'Gastos_Ocio y transporte';'Restaurantes';'VARIABLES'
16/11/2008;16/11/2008;'COMISIONES';-0,30€;3.257,11 €;-1129;-0,30;7.781,20 €;'sin fechas';16/11/2008;'COMISIONES';'Gastos_Banco y organismos';'Cargos banco';'FIJO'
16/11/2008;16/11/2008;'COMISIONES';0,30€;3.257,41 €;-1128;0,30;7.781,50 €;'sin fechas';16/11/2008;'COMISIONES';'Gastos_Banco y organismos';'Cargos banco';'FIJO'
16/11/2008;16/11/2008;'GASOLINA';-20,00€;3.237,41 €;-1127;-20,00;7.761,50 €;'sin fechas';16/11/2008;'GASOLINA';'Gastos_Ocio y transporte';'Gasolina';'VARIABLES'
16/11/2008;16/11/2008;'REINT.CAJERO';-100,00€;3.137,41 €;-1126;-100,00;7.661,50 €;'sin fechas';16/11/2008;'REINTCAJERO';'Gastos_Gastos varios';'Efectivo';'VARIABLES'
16/11/2008;16/11/2008;'VIENA';-10,70€;3.126,71 €;-1125;-10,70;7.650,80 €;'sin fechas';16/11/2008;'VIENA';'Gastos_Ocio y transporte';'Restaurantes';'VARIABLES'
17/11/2008;17/11/2008;'CAFET.C T PRAT';-2,95€;3.123,76 €;-1124;-2,95;7.647,85 €;'sin fechas';17/11/2008;'CAFETC';'Gastos_Ocio y transporte';'Restaurantes';'VARIABLES'
17/11/2008;17/11/2008;'ONO';-77,71€;3.046,05 €;-1123;-77,71;7.570,14 €;'sin fechas';17/11/2008;'ONO';'Gastos_Servicios tipicos';'Telecomunicaciones';'FIJO'
17/11/2008;17/11/2008;'RENFE';-2,05€;3.044,00 €;-1122;-2,05;7.568,09 €;'sin fechas';17/11/2008;'RENFE';'Gastos_Ocio y transporte';'Transporte';'VARIABLES'
17/11/2008;17/11/2008;'RENFE';-2,05€;3.041,95 €;-1121;-2,05;7.566,04 €;'sin fechas';17/11/2008;'RENFE';'Gastos_Ocio y transporte';'Transporte';'VARIABLES'
17/11/2008;17/11/2008;'SEG.AM.HIPITEC';-31,33€;3.010,62 €;-1120;-31,33;7.534,71 €;'sin fechas';17/11/2008;'SEGAMHIPITEC';'Gastos_Seguros';'Seguro vida';'FIJO'
18/11/2008;18/11/2008;'CAFET.C T PRAT';-2,65€;3.007,97 €;-1119;-2,65;7.532,06 €;'sin fechas';18/11/2008;'CAFETC';'Gastos_Ocio y transporte';'Restaurantes';'VARIABLES'
18/11/2008;18/11/2008;'CAPRABO';-11,52€;2.996,45 €;-1118;-11,52;7.520,54 €;'sin fechas';18/11/2008;'CAPRABO';'Gastos_Compras';'Supermercado';'VARIABLES'
18/11/2008;18/11/2008;'RENFE';-2,05€;2.994,40 €;-1117;-2,05;7.518,49 €;'sin fechas';18/11/2008;'RENFE';'Gastos_Ocio y transporte';'Transporte';'VARIABLES'
18/11/2008;18/11/2008;'RENFE';-2,05€;2.992,35 €;-1116;-2,05;7.516,44 €;'sin fechas';18/11/2008;'RENFE';'Gastos_Ocio y transporte';'Transporte';'VARIABLES'
19/11/2008;19/11/2008;'CAFET.C T PRAT';-3,65€;2.988,70 €;-1115;-3,65;7.512,79 €;'sin fechas';19/11/2008;'CAFETC';'Gastos_Ocio y transporte';'Restaurantes';'VARIABLES'
19/11/2008;19/11/2008;'ENDESA DISTRIB';-97,36€;2.891,34 €;-1114;-97,36;7.415,43 €;'sin fechas';19/11/2008;'ENDESA';'Gastos_Servicios tipicos';'Electricidad';'FIJO'
19/11/2008;19/11/2008;'RENFE';-2,05€;2.889,29 €;-1113;-2,05;7.413,38 €;'sin fechas';19/11/2008;'RENFE';'Gastos_Ocio y transporte';'Transporte';'VARIABLES'
19/11/2008;19/11/2008;'RENFE';-1,40€;2.887,89 €;-1112;-1,40;7.411,98 €;'sin fechas';19/11/2008;'RENFE';'Gastos_Ocio y transporte';'Transporte';'VARIABLES'
20/11/2008;20/11/2008;'CAFET.C T PRAT';-2,65€;2.885,24 €;-1111;-2,65;7.409,33 €;'sin fechas';20/11/2008;'CAFETC';'Gastos_Ocio y transporte';'Restaurantes';'VARIABLES'
20/11/2008;20/11/2008;'MERCADONA';-8,33€;2.876,91 €;-1110;-8,33;7.401,00 €;'sin fechas';20/11/2008;'MERCADONA';'Gastos_Compras';'Supermercado';'VARIABLES'
20/11/2008;20/11/2008;'ONA NUIT \\EL PRAT DE LL';-12,95€;2.863,96 €;-1109;-12,95;7.388,05 €;'sin fechas';20/11/2008;'ONA';'Gastos_Ocio y transporte';'Restaurantes';'VARIABLES'
21/11/2008;21/11/2008;'CAFET.C T PRAT';-3,35€;2.860,61 €;-1108;-3,35;7.384,70 €;'sin fechas';21/11/2008;'CAFETC';'Gastos_Ocio y transporte';'Restaurantes';'VARIABLES'
21/11/2008;16/11/2008;'COMPRA CON TARJETA';-5,70€;2.854,91 €;-1107;-5,70;7.379,00 €;'sin fechas';16/11/2008;'COMPRA';'Gastos_Compras';'Supermercado';'VARIABLES'
21/11/2008;16/11/2008;'COMPRA CON TARJETA';-5,70€;2.849,21 €;-1106;-5,70;7.373,30 €;'sin fechas';16/11/2008;'COMPRA';'Gastos_Compras';'Supermercado';'VARIABLES'
21/11/2008;21/11/2008;'GASOLINA';-30,00€;2.819,21 €;-1105;-30,00;7.343,30 €;'sin fechas';21/11/2008;'GASOLINA';'Gastos_Ocio y transporte';'Gasolina';'VARIABLES'
21/11/2008;21/11/2008;'KUROKAI';-17,98€;2.801,23 €;-1104;-17,98;7.325,32 €;'sin fechas';21/11/2008;'KUROKAI';'Gastos_Compras';'Ropa';'VARIABLES'
22/11/2008;22/11/2008;'CARREFOUR-[comida]';-124,94€;2.676,29 €;-1103;-124,94;7.200,38 €;'sin fechas';22/11/2008;'CARREFOURCOMIDA';'Gastos_Compras';'Supermercado';'VARIABLES'
22/11/2008;22/11/2008;'EROSKI-[COMIDA]';-25,42€;2.650,87 €;-1102;-25,42;7.174,96 €;'sin fechas';22/11/2008;'EROSKICOMIDA';'Gastos_Compras';'Supermercado';'VARIABLES'
23/11/2008;23/11/2008;'REINT.CAJERO';-60,00€;2.590,87 €;-1101;-60,00;7.114,96 €;'sin fechas';23/11/2008;'REINTCAJERO';'Gastos_Gastos varios';'Efectivo';'VARIABLES'
24/11/2008;24/11/2008;'CAFET.C T PRAT';-2,20€;2.588,67 €;-1100;-2,20;7.112,76 €;'sin fechas';24/11/2008;'CAFETC';'Gastos_Ocio y transporte';'Restaurantes';'VARIABLES'
24/11/2008;24/11/2008;'CAFET.C T PRAT';-5,65€;2.583,02 €;-1099;-5,65;7.107,11 €;'sin fechas';24/11/2008;'CAFETC';'Gastos_Ocio y transporte';'Restaurantes';'VARIABLES'
24/11/2008;15/11/2008;'COMPRA CON TARJETA';-4,30€;2.578,72 €;-1098;-4,30;7.102,81 €;'sin fechas';15/11/2008;'COMPRA';'Gastos_Compras';'Supermercado';'VARIABLES'
24/11/2008;24/11/2008;'FRANCE TELECOM';-18,49€;2.560,23 €;-1097;-18,49;7.084,32 €;'sin fechas';24/11/2008;'FRANCE';'Gastos_Servicios tipicos';'Telecomunicaciones';'FIJO'
25/11/2008;25/11/2008;'CAFET.C T PRAT';-1,90€;2.558,33 €;-1096;-1,90;7.082,42 €;'sin fechas';25/11/2008;'CAFETC';'Gastos_Ocio y transporte';'Restaurantes';'VARIABLES'
25/11/2008;25/11/2008;'CAFET.C T PRAT';-6,90€;2.551,43 €;-1095;-6,90;7.075,52 €;'sin fechas';25/11/2008;'CAFETC';'Gastos_Ocio y transporte';'Restaurantes';'VARIABLES'
26/11/2008;26/11/2008;'MERCADONA';-20,22€;2.531,21 €;-1094;-20,22;7.055,30 €;'sin fechas';26/11/2008;'MERCADONA';'Gastos_Compras';'Supermercado';'VARIABLES'
26/11/2008;26/11/2008;'REINT.CAJERO';-60,00€;2.471,21 €;-1093;-60,00;6.995,30 €;'sin fechas';26/11/2008;'REINTCAJERO';'Gastos_Gastos varios';'Efectivo';'VARIABLES'
27/11/2008;27/11/2008;'CAFET.C T PRAT';-1,80€;2.469,41 €;-1092;-1,80;6.993,50 €;'sin fechas';27/11/2008;'CAFETC';'Gastos_Ocio y transporte';'Restaurantes';'VARIABLES'
28/11/2008;22/11/2008;'COMPRA CON TARJETA';-6,20€;2.463,21 €;-1091;-6,20;6.987,30 €;'sin fechas';22/11/2008;'COMPRA';'Gastos_Compras';'Supermercado';'VARIABLES'
28/11/2008;30/11/2008;'FOMENT DE TERRASSA, S.A. FOMEN';1.365,21€;3.828,42 €;-1090;1.365,21;8.352,51 €;'sin fechas';30/11/2008;'FOMENT';'Ingresos';'Nomina';'FIJO'
28/11/2008;30/11/2008;'INFORMACIO I TECNOLOGIA DE CAT';1.534,23€;5.362,65 €;-1089;1.534,23;9.886,74 €;'sin fechas';30/11/2008;'INFORMACIO';'Ingresos';'Nomina';'FIJO'
28/11/2008;28/11/2008;'MERCADONA';-104,64€;5.258,01 €;-1088;-104,64;9.782,10 €;'sin fechas';28/11/2008;'MERCADONA';'Gastos_Compras';'Supermercado';'VARIABLES'
29/11/2008;29/11/2008;'CANTINA MARIACHI';-56,65€;5.201,36 €;-1087;-56,65;9.725,45 €;'sin fechas';29/11/2008;'CANTINA';'Gastos_Ocio y transporte';'Restaurantes';'VARIABLES'
29/11/2008;29/11/2008;'CARREFOUR-[comida]';-44,00€;5.157,36 €;-1086;-44,00;9.681,45 €;'sin fechas';29/11/2008;'CARREFOURCOMIDA';'Gastos_Compras';'Supermercado';'VARIABLES'
29/11/2008;29/11/2008;'GASOLINA';-36,50€;5.120,86 €;-1085;-36,50;9.644,95 €;'sin fechas';29/11/2008;'GASOLINA';'Gastos_Ocio y transporte';'Gasolina';'VARIABLES'
29/11/2008;29/11/2008;'GLORIAS MULTICINE';-27,20€;5.093,66 €;-1084;-27,20;9.617,75 €;'sin fechas';29/11/2008;'GLORIAS';'Gastos_Ocio y transporte';'Espectáculos';'VARIABLES'
01/12/2008;01/12/2008;'AJUNTAMENT DE TERRASSA';-35,26€;5.058,40 €;-1083;-35,26;9.582,49 €;'sin fechas';01/12/2008;'AJUNTAMENT';'Gastos_Banco y organismos';'Ayuntamiento';'FIJO'
01/12/2008;01/12/2008;'CAFET.C T PRAT';-2,95€;5.055,45 €;-1082;-2,95;9.579,54 €;'sin fechas';01/12/2008;'CAFETC';'Gastos_Ocio y transporte';'Restaurantes';'VARIABLES'
01/12/2008;02/12/2008;'Carbajo - CBFEROS';-7,00€;5.048,45 €;-1081;-7,00;9.572,54 €;'sin fechas';02/12/2008;'CARBAJO';'Gastos_Ocio y transporte';'Restaurantes';'VARIABLES'
01/12/2008;01/12/2008;'MERCADONA';-19,35€;5.029,10 €;-1080;-19,35;9.553,19 €;'sin fechas';01/12/2008;'MERCADONA';'Gastos_Compras';'Supermercado';'VARIABLES'
01/12/2008;30/11/2008;'RECIBO PTMOS. 3061-0960001518';-829,51€;4.199,59 €;-1079;-829,51;8.723,68 €;'sin fechas';30/11/2008;'RECIBO';'Gastos_Banco y organismos';'Hipoteca';'FIJO'
01/12/2008;30/11/2008;'RECIBO PTMOS. 3061-0960004140';-177,24€;4.022,35 €;-1078;-177,24;8.546,44 €;'sin fechas';30/11/2008;'RECIBO';'Gastos_Banco y organismos';'Hipoteca';'FIJO'
02/12/2008;02/12/2008;'CAFET.C T PRAT';-2,95€;4.019,40 €;-1077;-2,95;8.543,49 €;'sin fechas';02/12/2008;'CAFETC';'Gastos_Ocio y transporte';'Restaurantes';'VARIABLES'
02/12/2008;02/12/2008;'CAFET.C T PRAT';-6,90€;4.012,50 €;-1076;-6,90;8.536,59 €;'sin fechas';02/12/2008;'CAFETC';'Gastos_Ocio y transporte';'Restaurantes';'VARIABLES'
03/12/2008;03/12/2008;'CAFET.C T PRAT';-2,95€;4.009,55 €;-1075;-2,95;8.533,64 €;'sin fechas';03/12/2008;'CAFETC';'Gastos_Ocio y transporte';'Restaurantes';'VARIABLES'
04/12/2008;04/12/2008;'EL GOURMET DEL\\PRAT LLOBREG';-7,95€;4.001,60 €;-1074;-7,95;8.525,69 €;'sin fechas';04/12/2008;'GOURMET';'Gastos_Ocio y transporte';'Restaurantes';'VARIABLES'
05/12/2008;29/11/2008;'COMPRA CON TARJETA';-1,75€;3.999,85 €;-1073;-1,75;8.523,94 €;'sin fechas';29/11/2008;'COMPRA';'Gastos_Compras';'Supermercado';'VARIABLES'
05/12/2008;29/11/2008;'COMPRA CON TARJETA';-6,55€;3.993,30 €;-1072;-6,55;8.517,39 €;'sin fechas';29/11/2008;'COMPRA';'Gastos_Compras';'Supermercado';'VARIABLES'
05/12/2008;05/12/2008;'FRANCE TELECOM';-13,27€;3.980,03 €;-1071;-13,27;8.504,12 €;'sin fechas';05/12/2008;'FRANCE';'Gastos_Servicios tipicos';'Telecomunicaciones';'FIJO'
05/12/2008;05/12/2008;'GROUPAMA PLUS';-49,61€;3.930,42 €;-1070;-49,61;8.454,51 €;'sin fechas';05/12/2008;'GROUPAMA';'Gastos_Seguros';'Seguro salud';'FIJO'
05/12/2008;05/12/2008;'varios - REGALO MAMA';-44,00€;3.886,42 €;-1069;-44,00;8.410,51 €;'sin fechas';05/12/2008;'VARIOS';'Gastos_Ocio y transporte';'Restaurantes';'VARIABLES'
06/12/2008;06/12/2008;'METRO';-7,20€;3.879,22 €;-1068;-7,20;8.403,31 €;'sin fechas';06/12/2008;'METRO';'Gastos_Ocio y transporte';'Transporte';'VARIABLES'
06/12/2008;06/12/2008;'REINT.CAJERO';-100,00€;3.779,22 €;-1067;-100,00;8.303,31 €;'sin fechas';06/12/2008;'REINTCAJERO';'Gastos_Gastos varios';'Efectivo';'VARIABLES'
07/12/2008;07/12/2008;'BIJOU BRIGITTE S';-12,90€;3.766,32 €;-1066;-12,90;8.290,41 €;'sin fechas';07/12/2008;'BIJOU';'Gastos_Compras';'Ropa';'VARIABLES'
07/12/2008;07/12/2008;'FILMAX CASTELL\\CASTELLDEFEL';-12,60€;3.753,72 €;-1065;-12,60;8.277,81 €;'sin fechas';07/12/2008;'FILMAX';'Gastos_Ocio y transporte';'Espectáculos';'VARIABLES'
08/12/2008;08/12/2008;'BURGUER KING PARK';-11,40€;3.742,32 €;-1064;-11,40;8.266,41 €;'sin fechas';08/12/2008;'BURGUER';'Gastos_Ocio y transporte';'Restaurantes';'VARIABLES'
08/12/2008;08/12/2008;'GASOLINA';-28,00€;3.714,32 €;-1063;-28,00;8.238,41 €;'sin fechas';08/12/2008;'GASOLINA';'Gastos_Ocio y transporte';'Gasolina';'VARIABLES'
08/12/2008;08/12/2008;'VIENA';-9,40€;3.704,92 €;-1062;-9,40;8.229,01 €;'sin fechas';08/12/2008;'VIENA';'Gastos_Ocio y transporte';'Restaurantes';'VARIABLES'
09/12/2008;09/12/2008;'CAFET.C T PRAT';-2,65€;3.702,27 €;-1061;-2,65;8.226,36 €;'sin fechas';09/12/2008;'CAFETC';'Gastos_Ocio y transporte';'Restaurantes';'VARIABLES'
09/12/2008;09/12/2008;'FARMACIA';-17,51€;3.684,76 €;-1060;-17,51;8.208,85 €;'sin fechas';09/12/2008;'FARMACIA';'Gastos_Salud, saber y deporte';'Farmacia';'VARIABLES'
09/12/2008;09/12/2008;'MERCADONA';-23,48€;3.661,28 €;-1059;-23,48;8.185,37 €;'sin fechas';09/12/2008;'MERCADONA';'Gastos_Compras';'Supermercado';'VARIABLES'
09/12/2008;09/12/2008;'REINT.CAJERO';-40,00€;3.621,28 €;-1058;-40,00;8.145,37 €;'sin fechas';09/12/2008;'REINTCAJERO';'Gastos_Gastos varios';'Efectivo';'VARIABLES'
10/12/2008;10/12/2008;'CAFET.C T PRAT';-2,90€;3.618,38 €;-1057;-2,90;8.142,47 €;'sin fechas';10/12/2008;'CAFETC';'Gastos_Ocio y transporte';'Restaurantes';'VARIABLES'
12/12/2008;12/12/2008;'CAFET.C T PRAT';-2,75€;3.615,63 €;-1056;-2,75;8.139,72 €;'sin fechas';12/12/2008;'CAFETC';'Gastos_Ocio y transporte';'Restaurantes';'VARIABLES'
13/12/2008;13/12/2008;'AMC PARC VALLES';-10,40€;3.605,23 €;-1055;-10,40;8.129,32 €;'sin fechas';13/12/2008;'AMC';'Gastos_Ocio y transporte';'Espectáculos';'VARIABLES'
13/12/2008;13/12/2008;'ARTAVI TERRASSA, S';-27,91€;3.577,32 €;-1054;-27,91;8.101,41 €;'sin fechas';13/12/2008;'ARTAVI';'Gastos_Ocio y transporte';'Restaurantes';'VARIABLES'
13/12/2008;15/12/2008;'Deuda Loteria';-10,00€;3.567,32 €;-1053;-10,00;8.091,41 €;'sin fechas';15/12/2008;'DEUDA';'Gastos_Ocio y transporte';'Restaurantes';'VARIABLES'
13/12/2008;13/12/2008;'KIABI SANT BOI';-150,92€;3.416,40 €;-1052;-150,92;7.940,49 €;'sin fechas';13/12/2008;'KIABI';'Gastos_Compras';'Ropa';'VARIABLES'
13/12/2008;13/12/2008;'PANSSANTBOI L';-12,40€;3.404,00 €;-1051;-12,40;7.928,09 €;'sin fechas';13/12/2008;'PANSSANTBOI';'Gastos_Ocio y transporte';'Restaurantes';'VARIABLES'
14/12/2008;14/12/2008;'CARREFOUR-[comida]';-74,60€;3.329,40 €;-1050;-74,60;7.853,49 €;'sin fechas';14/12/2008;'CARREFOURCOMIDA';'Gastos_Compras';'Supermercado';'VARIABLES'
14/12/2008;14/12/2008;'EROSKI-[COMIDA]';-32,68€;3.296,72 €;-1049;-32,68;7.820,81 €;'sin fechas';14/12/2008;'EROSKICOMIDA';'Gastos_Compras';'Supermercado';'VARIABLES'
14/12/2008;14/12/2008;'GIFI';-25,72€;3.271,00 €;-1048;-25,72;7.795,09 €;'sin fechas';14/12/2008;'GIFI';'Gastos_Compras';'Hogar';'VARIABLES'
14/12/2008;14/12/2008;'VIENA';-9,85€;3.261,15 €;-1047;-9,85;7.785,24 €;'sin fechas';14/12/2008;'VIENA';'Gastos_Ocio y transporte';'Restaurantes';'VARIABLES'
15/12/2008;08/12/2008;'COMPRA CON TARJETA';-3,30€;3.257,85 €;-1046;-3,30;7.781,94 €;'sin fechas';08/12/2008;'COMPRA';'Gastos_Compras';'Supermercado';'VARIABLES'
15/12/2008;08/12/2008;'COMPRA CON TARJETA';-3,30€;3.254,55 €;-1045;-3,30;7.778,64 €;'sin fechas';08/12/2008;'COMPRA';'Gastos_Compras';'Supermercado';'VARIABLES'
15/12/2008;15/12/2008;'GAS NATURAL';-54,30€;3.200,25 €;-1044;-54,30;7.724,34 €;'sin fechas';15/12/2008;'GAS';'Gastos_Servicios tipicos';'Gas';'FIJO'
15/12/2008;15/12/2008;'SEG.AM.HIPITEC';-31,28€;3.168,97 €;-1043;-31,28;7.693,06 €;'sin fechas';15/12/2008;'SEGAMHIPITEC';'Gastos_Seguros';'Seguro vida';'FIJO'
16/12/2008;16/12/2008;'CAFET.C T PRAT';-3,65€;3.165,32 €;-1042;-3,65;7.689,41 €;'sin fechas';16/12/2008;'CAFETC';'Gastos_Ocio y transporte';'Restaurantes';'VARIABLES'
16/12/2008;16/12/2008;'FF.CC.GENERALITAT';-2,70€;3.162,62 €;-1041;-2,70;7.686,71 €;'sin fechas';16/12/2008;'FFCCGENERALITAT';'Gastos_Ocio y transporte';'Transporte';'VARIABLES'
16/12/2008;16/12/2008;'METRO';-1,30€;3.161,32 €;-1040;-1,30;7.685,41 €;'sin fechas';16/12/2008;'METRO';'Gastos_Ocio y transporte';'Transporte';'VARIABLES'
16/12/2008;16/12/2008;'REINT.CAJERO';-200,00€;2.961,32 €;-1039;-200,00;7.485,41 €;'sin fechas';16/12/2008;'REINTCAJERO';'Gastos_Gastos varios';'Efectivo';'VARIABLES'
17/12/2008;17/12/2008;'GASOLINA';-33,00€;2.928,32 €;-1038;-33,00;7.452,41 €;'sin fechas';17/12/2008;'GASOLINA';'Gastos_Ocio y transporte';'Gasolina';'VARIABLES'
17/12/2008;17/12/2008;'ONO';-78,85€;2.849,47 €;-1037;-78,85;7.373,56 €;'sin fechas';17/12/2008;'ONO';'Gastos_Servicios tipicos';'Telecomunicaciones';'FIJO'
18/12/2008;18/12/2008;'CAFET.C T PRAT';-2,20€;2.847,27 €;-1036;-2,20;7.371,36 €;'sin fechas';18/12/2008;'CAFETC';'Gastos_Ocio y transporte';'Restaurantes';'VARIABLES'
18/12/2008;19/12/2008;'INFORMACIO I TECNOLOGIA DE CAT';1.827,40€;4.674,67 €;-1035;1.827,40;9.198,76 €;'sin fechas';19/12/2008;'INFORMACIO';'Ingresos';'Nomina';'FIJO'
18/12/2008;18/12/2008;'MINA PUBLICA DE LA CIUTAT';-23,06€;4.651,61 €;-1034;-23,06;9.175,70 €;'sin fechas';18/12/2008;'MINA';'Gastos_Servicios tipicos';'Agua';'FIJO'
19/12/2008;19/12/2008;'BURGUER KING PARK';-11,60€;4.640,01 €;-1033;-11,60;9.164,10 €;'sin fechas';19/12/2008;'BURGUER';'Gastos_Ocio y transporte';'Restaurantes';'VARIABLES'
19/12/2008;19/12/2008;'CAFET.C T PRAT';-3,65€;4.636,36 €;-1032;-3,65;9.160,45 €;'sin fechas';19/12/2008;'CAFETC';'Gastos_Ocio y transporte';'Restaurantes';'VARIABLES'
19/12/2008;19/12/2008;'ENDESA DISTRIB';-32,28€;4.604,08 €;-1031;-32,28;9.128,17 €;'sin fechas';19/12/2008;'ENDESA';'Gastos_Servicios tipicos';'Electricidad';'FIJO'
19/12/2008;23/12/2008;'FOMENT DE TERRASSA, S.A. FOMEN';1.711,70€;6.315,78 €;-1030;1.711,70;10.839,87 €;'sin fechas';23/12/2008;'FOMENT';'Ingresos';'Nomina';'FIJO'
19/12/2008;19/12/2008;'GLASGOW \\CASTELLDEFELS';-13,50€;6.302,28 €;-1029;-13,50;10.826,37 €;'sin fechas';19/12/2008;'GLASGOW';'Gastos_Ocio y transporte';'Restaurantes';'VARIABLES'
20/12/2008;20/12/2008;'AMC PARC VALLES';-10,40€;6.291,88 €;-1028;-10,40;10.815,97 €;'sin fechas';20/12/2008;'AMC';'Gastos_Ocio y transporte';'Espectáculos';'VARIABLES'
20/12/2008;20/12/2008;'CARREFOUR-[comida]';-130,38€;6.161,50 €;-1027;-130,38;10.685,59 €;'sin fechas';20/12/2008;'CARREFOURCOMIDA';'Gastos_Compras';'Supermercado';'VARIABLES'
20/12/2008;20/12/2008;'JIANHONG ZHOU S.L.';-24,72€;6.136,78 €;-1026;-24,72;10.660,87 €;'sin fechas';20/12/2008;'JIANHONG';'Gastos_Ocio y transporte';'Restaurantes';'VARIABLES'
21/12/2008;21/12/2008;'EROSKI-[COMIDA]';-35,59€;6.101,19 €;-1025;-35,59;10.625,28 €;'sin fechas';21/12/2008;'EROSKICOMIDA';'Gastos_Compras';'Supermercado';'VARIABLES'
21/12/2008;22/12/2008;'COMUNIDAD Pago 4-3 de derrama 2008 bajan';-320,00€;5.781,19 €;-1024;-320,00;10.305,28 €;'sin fechas';22/12/2008;'COMUNIDAD';'Gastos_Vivienda y vehiculo';'Comunidad';'FIJO'
21/12/2008;22/12/2008;'COMUNIDAD Pago 4-3 de Enero a Diciembre';-204,00€;5.577,19 €;-1023;-204,00;10.101,28 €;'sin fechas';22/12/2008;'COMUNIDAD';'Gastos_Vivienda y vehiculo';'Comunidad';'FIJO'
21/12/2008;22/12/2008;'COMUNIDAD Pago 4-3 de Enero a Junio 2009';-102,00€;5.475,19 €;-1022;-102,00;9.999,28 €;'sin fechas';22/12/2008;'COMUNIDAD';'Gastos_Vivienda y vehiculo';'Comunidad';'FIJO'
21/12/2008;21/12/2008;'VIENA';-9,70€;5.465,49 €;-1021;-9,70;9.989,58 €;'sin fechas';21/12/2008;'VIENA';'Gastos_Ocio y transporte';'Restaurantes';'VARIABLES'
22/12/2008;22/12/2008;'CAFET.C T PRAT';-3,35€;5.462,14 €;-1020;-3,35;9.986,23 €;'sin fechas';22/12/2008;'CAFETC';'Gastos_Ocio y transporte';'Restaurantes';'VARIABLES'
22/12/2008;22/12/2008;'CAFET.C T PRAT';-6,90€;5.455,24 €;-1019;-6,90;9.979,33 €;'sin fechas';22/12/2008;'CAFETC';'Gastos_Ocio y transporte';'Restaurantes';'VARIABLES'
23/12/2008;23/12/2008;'BON AREA';-16,23€;5.439,01 €;-1018;-16,23;9.963,10 €;'sin fechas';23/12/2008;'BON';'Gastos_Compras';'Supermercado';'VARIABLES'
23/12/2008;23/12/2008;'CAFET.C T PRAT';-2,90€;5.436,11 €;-1017;-2,90;9.960,20 €;'sin fechas';23/12/2008;'CAFETC';'Gastos_Ocio y transporte';'Restaurantes';'VARIABLES'
23/12/2008;23/12/2008;'CAFET.C T PRAT';-6,90€;5.429,21 €;-1016;-6,90;9.953,30 €;'sin fechas';23/12/2008;'CAFETC';'Gastos_Ocio y transporte';'Restaurantes';'VARIABLES'
23/12/2008;23/12/2008;'FRANCE TELECOM';-38,24€;5.390,97 €;-1015;-38,24;9.915,06 €;'sin fechas';23/12/2008;'FRANCE';'Gastos_Servicios tipicos';'Telecomunicaciones';'FIJO'
24/12/2008;24/12/2008;'CAFET.C T PRAT';-1,95€;5.389,02 €;-1014;-1,95;9.913,11 €;'sin fechas';24/12/2008;'CAFETC';'Gastos_Ocio y transporte';'Restaurantes';'VARIABLES'
26/12/2008;29/12/2008;'Ordenador';-40,00€;5.349,02 €;-1013;-40,00;9.873,11 €;'sin fechas';29/12/2008;'ORDENADOR';'Gastos_Compras';'Hobbys';'VARIABLES'
26/12/2008;29/12/2008;'Prestado';-1.000,00€;4.349,02 €;-1012;-1.000,00;8.873,11 €;'sin fechas';29/12/2008;'PRESTADO';'Gastos_Compras';'Ropa';'VARIABLES'
27/12/2008;30/12/2008;'INFORMACIO I TECNOLOGIA DE CAT';1.679,03€;6.028,05 €;-1011;1.679,03;10.552,14 €;'sin fechas';30/12/2008;'INFORMACIO';'Ingresos';'Nomina';'FIJO'
27/12/2008;27/12/2008;'LA BRASA';-23,44€;6.004,61 €;-1010;-23,44;10.528,70 €;'sin fechas';27/12/2008;'BRASA';'Gastos_Ocio y transporte';'Restaurantes';'VARIABLES'
28/12/2008;28/12/2008;'BLADE CENTER';-39,95€;5.964,66 €;-1009;-39,95;10.488,75 €;'sin fechas';28/12/2008;'BLADE';'Gastos_Compras';'Hobbys';'VARIABLES'
28/12/2008;28/12/2008;'CAPRABO';-15,98€;5.948,68 €;-1008;-15,98;10.472,77 €;'sin fechas';28/12/2008;'CAPRABO';'Gastos_Compras';'Supermercado';'VARIABLES'
28/12/2008;28/12/2008;'VIENA';-9,40€;5.939,28 €;-1007;-9,40;10.463,37 €;'sin fechas';28/12/2008;'VIENA';'Gastos_Ocio y transporte';'Restaurantes';'VARIABLES'
29/12/2008;29/12/2008;'ARTAVI TERRASSA, S';-21,89€;5.917,39 €;-1006;-21,89;10.441,48 €;'sin fechas';29/12/2008;'ARTAVI';'Gastos_Ocio y transporte';'Restaurantes';'VARIABLES'
29/12/2008;05/01/2009;'COMPRA CON TARJETA';-3,30€;5.914,09 €;-1005;-3,30;10.438,18 €;'sin fechas';05/01/2009;'COMPRA';'Gastos_Compras';'Supermercado';'VARIABLES'
29/12/2008;05/01/2009;'COMPRA CON TARJETA';-5,00€;5.909,09 €;-1004;-5,00;10.433,18 €;'sin fechas';05/01/2009;'COMPRA';'Gastos_Compras';'Supermercado';'VARIABLES'
29/12/2008;05/01/2009;'COMPRA CON TARJETA';-5,55€;5.903,54 €;-1003;-5,55;10.427,63 €;'sin fechas';05/01/2009;'COMPRA';'Gastos_Compras';'Supermercado';'VARIABLES'
29/12/2008;29/12/2008;'CRACKER-JACK SOCI\\BENICARLO';-57,95€;5.845,59 €;-1002;-57,95;10.369,68 €;'sin fechas';29/12/2008;'CRACKERJACK';'Gastos_Ocio y transporte';'Restaurantes';'VARIABLES'
29/12/2008;29/12/2008;'GASOLINA';-27,94€;5.817,65 €;-1001;-27,94;10.341,74 €;'sin fechas';29/12/2008;'GASOLINA';'Gastos_Ocio y transporte';'Gasolina';'VARIABLES'
29/12/2008;29/12/2008;'L ARENA GIOVANNI,\\BENICARLO';-88,30€;5.729,35 €;-1000;-88,30;10.253,44 €;'sin fechas';29/12/2008;'ARENA';'Gastos_Compras';'Ropa';'VARIABLES'
30/12/2008;30/12/2008;'AJUNTAMENT DE TERRASSA';-34,50€;5.694,85 €;-999;-34,50;10.218,94 €;'sin fechas';30/12/2008;'AJUNTAMENT';'Gastos_Banco y organismos';'Ayuntamiento';'FIJO'
30/12/2008;30/12/2008;'CASER HOGAR';-261,43€;5.433,42 €;-998;-261,43;9.957,51 €;'sin fechas';30/12/2008;'CASER';'Ingresos';'Transferencias';'VARIABLES'
31/12/2008;31/12/2008;'RECIBO PTMOS. 3061-0960001518';-829,51€;4.603,91 €;-997;-829,51;9.128,00 €;'sin fechas';31/12/2008;'RECIBO';'Gastos_Banco y organismos';'Hipoteca';'FIJO'
31/12/2008;31/12/2008;'RECIBO PTMOS. 3061-0960004140';-177,24€;4.426,67 €;-996;-177,24;8.950,76 €;'sin fechas';31/12/2008;'RECIBO';'Gastos_Banco y organismos';'Hipoteca';'FIJO'
03/01/2009;12/01/2009;'COMPRA CON TARJETA';-5,80€;4.420,87 €;-995;-5,80;8.944,96 €;'sin fechas';12/01/2009;'COMPRA';'Gastos_Compras';'Supermercado';'VARIABLES'
03/01/2009;19/01/2009;'COMPRA CON TARJETA';-3,40€;4.417,47 €;-994;-3,40;8.941,56 €;'sin fechas';19/01/2009;'COMPRA';'Gastos_Compras';'Supermercado';'VARIABLES'
03/01/2009;19/01/2009;'COMPRA CON TARJETA';-5,25€;4.412,22 €;-993;-5,25;8.936,31 €;'sin fechas';19/01/2009;'COMPRA';'Gastos_Compras';'Supermercado';'VARIABLES'
04/01/2009;04/01/2009;'EROSKI-[COMIDA]';-108,62€;4.303,60 €;-992;-108,62;8.827,69 €;'sin fechas';04/01/2009;'EROSKICOMIDA';'Gastos_Compras';'Supermercado';'VARIABLES'
04/01/2009;04/01/2009;'GASOLINA';-20,00€;4.283,60 €;-991;-20,00;8.807,69 €;'sin fechas';04/01/2009;'GASOLINA';'Gastos_Ocio y transporte';'Gasolina';'VARIABLES'
05/01/2009;05/01/2009;'CAFET.C T PRAT';-7,15€;4.276,45 €;-990;-7,15;8.800,54 €;'sin fechas';05/01/2009;'CAFETC';'Gastos_Ocio y transporte';'Restaurantes';'VARIABLES'
05/01/2009;05/01/2009;'FRANCE TELECOM';-17,04€;4.259,41 €;-989;-17,04;8.783,50 €;'sin fechas';05/01/2009;'FRANCE';'Gastos_Servicios tipicos';'Telecomunicaciones';'FIJO'
05/01/2009;03/01/2009;'TRANSFERENCIASCARGO';-100,00€;4.159,41 €;-988;-100,00;8.683,50 €;'sin fechas';03/01/2009;'TRANSFERENCIASCARGO';'Gastos_Gastos varios';'Transferencias';'VARIABLES'
05/01/2009;03/01/2009;'TRANSFERENCIASFAVOR';100,00€;4.259,41 €;-987;100,00;8.783,50 €;'sin fechas';03/01/2009;'TRANSFERENCIASFAVOR';'Ingresos';'Transferencias';'VARIABLES'
07/01/2009;07/01/2009;'CAFET.C T PRAT';-7,85€;4.251,56 €;-986;-7,85;8.775,65 €;'sin fechas';07/01/2009;'CAFETC';'Gastos_Ocio y transporte';'Restaurantes';'VARIABLES'
07/01/2009;07/01/2009;'CAPRABO';-103,43€;4.148,13 €;-985;-103,43;8.672,22 €;'sin fechas';07/01/2009;'CAPRABO';'Gastos_Compras';'Supermercado';'VARIABLES'
08/01/2009;08/01/2009;'CAFET.C T PRAT';-1,45€;4.146,68 €;-984;-1,45;8.670,77 €;'sin fechas';08/01/2009;'CAFETC';'Gastos_Ocio y transporte';'Restaurantes';'VARIABLES'
08/01/2009;08/01/2009;'CAFET.C T PRAT';-7,15€;4.139,53 €;-983;-7,15;8.663,62 €;'sin fechas';08/01/2009;'CAFETC';'Gastos_Ocio y transporte';'Restaurantes';'VARIABLES'
09/01/2009;09/01/2009;'CAFET.C T PRAT';-3,00€;4.136,53 €;-982;-3,00;8.660,62 €;'sin fechas';09/01/2009;'CAFETC';'Gastos_Ocio y transporte';'Restaurantes';'VARIABLES'
10/01/2009;10/01/2009;'AMC PARC VALLES';-10,40€;4.126,13 €;-981;-10,40;8.650,22 €;'sin fechas';10/01/2009;'AMC';'Gastos_Ocio y transporte';'Espectáculos';'VARIABLES'
10/01/2009;10/01/2009;'BURGUER KING PARK';-12,20€;4.113,93 €;-980;-12,20;8.638,02 €;'sin fechas';10/01/2009;'BURGUER';'Gastos_Ocio y transporte';'Restaurantes';'VARIABLES'
10/01/2009;10/01/2009;'CASA AMETLLER SL';-11,01€;4.102,92 €;-979;-11,01;8.627,01 €;'sin fechas';10/01/2009;'CASA';'Gastos_Ocio y transporte';'Restaurantes';'VARIABLES'
10/01/2009;10/01/2009;'DECATHLON';-58,70€;4.044,22 €;-978;-58,70;8.568,31 €;'sin fechas';10/01/2009;'DECATHLON';'Gastos_Compras';'Deportivo';'VARIABLES'
10/01/2009;10/01/2009;'KUROKAI';-59,99€;3.984,23 €;-977;-59,99;8.508,32 €;'sin fechas';10/01/2009;'KUROKAI';'Gastos_Compras';'Ropa';'VARIABLES'
14/01/2009;14/01/2009;'CAFET.C T PRAT';-2,15€;3.982,08 €;-976;-2,15;8.506,17 €;'sin fechas';14/01/2009;'CAFETC';'Gastos_Ocio y transporte';'Restaurantes';'VARIABLES'
15/01/2009;15/01/2009;'CAFET.C T PRAT';-2,90€;3.979,18 €;-975;-2,90;8.503,27 €;'sin fechas';15/01/2009;'CAFETC';'Gastos_Ocio y transporte';'Restaurantes';'VARIABLES'
15/01/2009;15/01/2009;'CAFET.C T PRAT';-2,15€;3.977,03 €;-974;-2,15;8.501,12 €;'sin fechas';15/01/2009;'CAFETC';'Gastos_Ocio y transporte';'Restaurantes';'VARIABLES'
15/01/2009;15/01/2009;'SEG.AM.HIPITEC';-31,23€;3.945,80 €;-973;-31,23;8.469,89 €;'sin fechas';15/01/2009;'SEGAMHIPITEC';'Gastos_Seguros';'Seguro vida';'FIJO'
16/01/2009;16/01/2009;'AMC PARC VALLES';-8,40€;3.937,40 €;-972;-8,40;8.461,49 €;'sin fechas';16/01/2009;'AMC';'Gastos_Ocio y transporte';'Espectáculos';'VARIABLES'
16/01/2009;16/01/2009;'EROSKI-[COMIDA]';-115,76€;3.821,64 €;-971;-115,76;8.345,73 €;'sin fechas';16/01/2009;'EROSKICOMIDA';'Gastos_Compras';'Supermercado';'VARIABLES'
16/01/2009;16/01/2009;'GASOLINA';-30,00€;3.791,64 €;-970;-30,00;8.315,73 €;'sin fechas';16/01/2009;'GASOLINA';'Gastos_Ocio y transporte';'Gasolina';'VARIABLES'
16/01/2009;16/01/2009;'I TORRE TERRASA';-18,30€;3.773,34 €;-969;-18,30;8.297,43 €;'sin fechas';16/01/2009;'TORRE';'Gastos_Ocio y transporte';'Restaurantes';'VARIABLES'
17/01/2009;17/01/2009;'DECIMAS HOSPIT\\HOSPITALET D';-39,90€;3.733,44 €;-968;-39,90;8.257,53 €;'sin fechas';17/01/2009;'DECIMAS';'Gastos_Ocio y transporte';'Restaurantes';'VARIABLES'
17/01/2009;17/01/2009;'INTERKITS';-79,99€;3.653,45 €;-967;-79,99;8.177,54 €;'sin fechas';17/01/2009;'INTERKITS';'Gastos_Compras';'Niños';'VARIABLES'
17/01/2009;17/01/2009;'KIABI SANT BOI';-190,85€;3.462,60 €;-966;-190,85;7.986,69 €;'sin fechas';17/01/2009;'KIABI';'Gastos_Compras';'Ropa';'VARIABLES'
17/01/2009;17/01/2009;'KIKO';-18,50€;3.444,10 €;-965;-18,50;7.968,19 €;'sin fechas';17/01/2009;'KIKO';'Gastos_Salud, saber y deporte';'Belleza';'VARIABLES'
17/01/2009;17/01/2009;'KUROKAI';-29,98€;3.414,12 €;-964;-29,98;7.938,21 €;'sin fechas';17/01/2009;'KUROKAI';'Gastos_Compras';'Ropa';'VARIABLES'
17/01/2009;17/01/2009;'MERKALZADOS TARRAS';-40,00€;3.374,12 €;-963;-40,00;7.898,21 €;'sin fechas';17/01/2009;'MERKALZADOS';'Gastos_Compras';'Ropa';'VARIABLES'
17/01/2009;17/01/2009;'VIENA';-3,95€;3.370,17 €;-962;-3,95;7.894,26 €;'sin fechas';17/01/2009;'VIENA';'Gastos_Ocio y transporte';'Restaurantes';'VARIABLES'
17/01/2009;17/01/2009;'WOKGU';-26,90€;3.343,27 €;-961;-26,90;7.867,36 €;'sin fechas';17/01/2009;'WOKGU';'Gastos_Ocio y transporte';'Restaurantes';'VARIABLES'
18/01/2009;18/01/2009;'MARCO ALDANY';-8,99€;3.334,28 €;-960;-8,99;7.858,37 €;'sin fechas';18/01/2009;'MARCO';'Gastos_Salud, saber y deporte';'Belleza';'VARIABLES'
18/01/2009;18/01/2009;'VIENA';-1,30€;3.332,98 €;-959;-1,30;7.857,07 €;'sin fechas';18/01/2009;'VIENA';'Gastos_Ocio y transporte';'Restaurantes';'VARIABLES'
19/01/2009;19/01/2009;'COMISIONES';-1,50€;3.331,48 €;-958;-1,50;7.855,57 €;'sin fechas';19/01/2009;'COMISIONES';'Gastos_Banco y organismos';'Cargos banco';'FIJO'
19/01/2009;19/01/2009;'COMISIONES';1,50€;3.332,98 €;-957;1,50;7.857,07 €;'sin fechas';19/01/2009;'COMISIONES';'Gastos_Banco y organismos';'Cargos banco';'FIJO'
19/01/2009;19/01/2009;'MERCADONA';-18,96€;3.314,02 €;-956;-18,96;7.838,11 €;'sin fechas';19/01/2009;'MERCADONA';'Gastos_Compras';'Supermercado';'VARIABLES'
19/01/2009;19/01/2009;'REINT.CAJERO';-40,00€;3.274,02 €;-955;-40,00;7.798,11 €;'sin fechas';19/01/2009;'REINTCAJERO';'Gastos_Gastos varios';'Efectivo';'VARIABLES'
19/01/2009;19/01/2009;'REINT.CAJERO';-40,00€;3.234,02 €;-954;-40,00;7.758,11 €;'sin fechas';19/01/2009;'REINTCAJERO';'Gastos_Gastos varios';'Efectivo';'VARIABLES'
19/01/2009;19/01/2009;'REINT.CAJERO';40,00€;3.274,02 €;-953;40,00;7.798,11 €;'sin fechas';19/01/2009;'REINTCAJERO';'Gastos_Gastos varios';'Efectivo';'VARIABLES'
20/01/2009;20/01/2009;'ONO';-82,59€;3.191,43 €;-952;-82,59;7.715,52 €;'sin fechas';20/01/2009;'ONO';'Gastos_Servicios tipicos';'Telecomunicaciones';'FIJO'
20/01/2009;20/01/2009;'SEGS. CATALANA';-323,67€;2.867,76 €;-951;-323,67;7.391,85 €;'sin fechas';20/01/2009;'SEGS';'Gastos_Seguros';'Seguro auto';'FIJO'
21/01/2009;21/01/2009;'CAFET.C T PRAT';-3,45€;2.864,31 €;-950;-3,45;7.388,40 €;'sin fechas';21/01/2009;'CAFETC';'Gastos_Ocio y transporte';'Restaurantes';'VARIABLES'
22/01/2009;22/01/2009;'CAFET.C T PRAT';-3,55€;2.860,76 €;-949;-3,55;7.384,85 €;'sin fechas';22/01/2009;'CAFETC';'Gastos_Ocio y transporte';'Restaurantes';'VARIABLES'
22/01/2009;22/01/2009;'CIA. DE SEGUROS 006662671613';-33,90€;2.826,86 €;-948;-33,90;7.350,95 €;'sin fechas';22/01/2009;'CIA';'Ingresos';'Devoluciones';'VARIABLES'
22/01/2009;22/01/2009;'ENDESA DISTRIB';-71,35€;2.755,51 €;-947;-71,35;7.279,60 €;'sin fechas';22/01/2009;'ENDESA';'Gastos_Servicios tipicos';'Electricidad';'FIJO'
23/01/2009;23/01/2009;'CAFET.C T PRAT';-3,75€;2.751,76 €;-946;-3,75;7.275,85 €;'sin fechas';23/01/2009;'CAFETC';'Gastos_Ocio y transporte';'Restaurantes';'VARIABLES'
23/01/2009;23/01/2009;'CONVERTERSOFT DIST';-86,90€;2.664,86 €;-945;-86,90;7.188,95 €;'sin fechas';23/01/2009;'CONVERTERSOFT';'Gastos_Ocio y transporte';'Restaurantes';'VARIABLES'
23/01/2009;23/01/2009;'EROSKI-[COMIDA]';-37,15€;2.627,71 €;-944;-37,15;7.151,80 €;'sin fechas';23/01/2009;'EROSKICOMIDA';'Gastos_Compras';'Supermercado';'VARIABLES'
23/01/2009;23/01/2009;'EROSKI-[COMIDA]';-5,99€;2.621,72 €;-943;-5,99;7.145,81 €;'sin fechas';23/01/2009;'EROSKICOMIDA';'Gastos_Compras';'Supermercado';'VARIABLES'
23/01/2009;23/01/2009;'FRANCE TELECOM';-10,44€;2.611,28 €;-942;-10,44;7.135,37 €;'sin fechas';23/01/2009;'FRANCE';'Gastos_Servicios tipicos';'Telecomunicaciones';'FIJO'
23/01/2009;23/01/2009;'MERCADONA';-41,07€;2.570,21 €;-941;-41,07;7.094,30 €;'sin fechas';23/01/2009;'MERCADONA';'Gastos_Compras';'Supermercado';'VARIABLES'
24/01/2009;24/01/2009;'CAPRABO';-31,55€;2.538,66 €;-940;-31,55;7.062,75 €;'sin fechas';24/01/2009;'CAPRABO';'Gastos_Compras';'Supermercado';'VARIABLES'
26/01/2009;26/01/2009;'CAFET.C T PRAT';-2,90€;2.535,76 €;-939;-2,90;7.059,85 €;'sin fechas';26/01/2009;'CAFETC';'Gastos_Ocio y transporte';'Restaurantes';'VARIABLES'
26/01/2009;26/01/2009;'GASOLINA';-32,20€;2.503,56 €;-938;-32,20;7.027,65 €;'sin fechas';26/01/2009;'GASOLINA';'Gastos_Ocio y transporte';'Gasolina';'VARIABLES'
27/01/2009;27/01/2009;'CAFET.C T PRAT';-6,65€;2.496,91 €;-937;-6,65;7.021,00 €;'sin fechas';27/01/2009;'CAFETC';'Gastos_Ocio y transporte';'Restaurantes';'VARIABLES'
28/01/2009;28/01/2009;'CAFET.C T PRAT';-2,70€;2.494,21 €;-936;-2,70;7.018,30 €;'sin fechas';28/01/2009;'CAFETC';'Gastos_Ocio y transporte';'Restaurantes';'VARIABLES'
28/01/2009;28/01/2009;'CAFET.C T PRAT';-1,05€;2.493,16 €;-935;-1,05;7.017,25 €;'sin fechas';28/01/2009;'CAFETC';'Gastos_Ocio y transporte';'Restaurantes';'VARIABLES'
28/01/2009;28/01/2009;'MERCADONA';-34,39€;2.458,77 €;-934;-34,39;6.982,86 €;'sin fechas';28/01/2009;'MERCADONA';'Gastos_Compras';'Supermercado';'VARIABLES'
29/01/2009;29/01/2009;'CAFET.C T PRAT';-3,35€;2.455,42 €;-933;-3,35;6.979,51 €;'sin fechas';29/01/2009;'CAFETC';'Gastos_Ocio y transporte';'Restaurantes';'VARIABLES'
29/01/2009;29/01/2009;'MERCADONA';-17,50€;2.437,92 €;-932;-17,50;6.962,01 €;'sin fechas';29/01/2009;'MERCADONA';'Gastos_Compras';'Supermercado';'VARIABLES'
30/01/2009;30/01/2009;'CAFET.C T PRAT';-2,60€;2.435,32 €;-931;-2,60;6.959,41 €;'sin fechas';30/01/2009;'CAFETC';'Gastos_Ocio y transporte';'Restaurantes';'VARIABLES'
30/01/2009;30/01/2009;'CARREFOUR-[comida]';-71,50€;2.363,82 €;-930;-71,50;6.887,91 €;'sin fechas';30/01/2009;'CARREFOURCOMIDA';'Gastos_Compras';'Supermercado';'VARIABLES'
30/01/2009;28/01/2009;'FOMENT DE TERRASSA, S.A. FOMEN';1.621,55€;3.985,37 €;-929;1.621,55;8.509,46 €;'sin fechas';28/01/2009;'FOMENT';'Ingresos';'Nomina';'FIJO'
30/01/2009;30/01/2009;'FRANCE TELECOM';-13,51€;3.971,86 €;-928;-13,51;8.495,95 €;'sin fechas';30/01/2009;'FRANCE';'Gastos_Servicios tipicos';'Telecomunicaciones';'FIJO'
30/01/2009;29/01/2009;'INFORMACIO I TECNOLOGIA DE CAT';1.652,30€;5.624,16 €;-927;1.652,30;10.148,25 €;'sin fechas';29/01/2009;'INFORMACIO';'Ingresos';'Nomina';'FIJO'
30/01/2009;30/01/2009;'LLESQUERIA AIXI DE \\TERRASA';-21,30€;5.602,86 €;-926;-21,30;10.126,95 €;'sin fechas';30/01/2009;'LLESQUERIA';'Gastos_Seguros';'Seguro hogar';'FIJO'
30/01/2009;30/01/2009;'VIRGIN ACTIVE';-50,00€;5.552,86 €;-925;-50,00;10.076,95 €;'sin fechas';30/01/2009;'VIRGIN';'Gastos_Salud, saber y deporte';'Deportes';'VARIABLES'
31/01/2009;31/01/2009;'KIABI SANT BOI';-99,95€;5.452,91 €;-924;-99,95;9.977,00 €;'sin fechas';31/01/2009;'KIABI';'Gastos_Compras';'Ropa';'VARIABLES'
31/01/2009;31/01/2009;'KIABI SANT BOI';-47,95€;5.404,96 €;-923;-47,95;9.929,05 €;'sin fechas';31/01/2009;'KIABI';'Gastos_Compras';'Ropa';'VARIABLES'
31/01/2009;28/01/2009;'RECIBO PTMOS. 3061-0960001518';-865,73€;4.539,23 €;-922;-865,73;9.063,32 €;'sin fechas';28/01/2009;'RECIBO';'Gastos_Banco y organismos';'Hipoteca';'FIJO'
31/01/2009;28/01/2009;'RECIBO PTMOS. 3061-0960004140';-177,24€;4.361,99 €;-921;-177,24;8.886,08 €;'sin fechas';28/01/2009;'RECIBO';'Gastos_Banco y organismos';'Hipoteca';'FIJO'
31/01/2009;31/01/2009;'VIENA';-9,70€;4.352,29 €;-920;-9,70;8.876,38 €;'sin fechas';31/01/2009;'VIENA';'Gastos_Ocio y transporte';'Restaurantes';'VARIABLES'
02/02/2009;02/02/2009;'CAFET.C T PRAT';-3,40€;4.348,89 €;-919;-3,40;8.872,98 €;'sin fechas';02/02/2009;'CAFETC';'Gastos_Ocio y transporte';'Restaurantes';'VARIABLES'
02/02/2009;02/02/2009;'MERCADONA';-18,61€;4.330,28 €;-918;-18,61;8.854,37 €;'sin fechas';02/02/2009;'MERCADONA';'Gastos_Compras';'Supermercado';'VARIABLES'
02/02/2009;30/01/2009;'Ordenador';-100,00€;4.230,28 €;-917;-100,00;8.754,37 €;'sin fechas';30/01/2009;'ORDENADOR';'Gastos_Compras';'Hobbys';'VARIABLES'
03/02/2009;03/02/2009;'CAFET.C T PRAT';-1,65€;4.228,63 €;-916;-1,65;8.752,72 €;'sin fechas';03/02/2009;'CAFETC';'Gastos_Ocio y transporte';'Restaurantes';'VARIABLES'
03/02/2009;03/02/2009;'CIA. DE SEGUROS 006662671613';-33,90€;4.194,73 €;-915;-33,90;8.718,82 €;'sin fechas';03/02/2009;'CIA';'Ingresos';'Devoluciones';'VARIABLES'
04/02/2009;04/02/2009;'CAFET.C T PRAT';-3,70€;4.191,03 €;-914;-3,70;8.715,12 €;'sin fechas';04/02/2009;'CAFETC';'Gastos_Ocio y transporte';'Restaurantes';'VARIABLES'
04/02/2009;04/02/2009;'RENFE';-2,20€;4.188,83 €;-913;-2,20;8.712,92 €;'sin fechas';04/02/2009;'RENFE';'Gastos_Ocio y transporte';'Transporte';'VARIABLES'
04/02/2009;04/02/2009;'RENFE';-1,50€;4.187,33 €;-912;-1,50;8.711,42 €;'sin fechas';04/02/2009;'RENFE';'Gastos_Ocio y transporte';'Transporte';'VARIABLES'
04/02/2009;04/02/2009;'VIRGIN ACTIVE';-59,00€;4.128,33 €;-911;-59,00;8.652,42 €;'sin fechas';04/02/2009;'VIRGIN';'Gastos_Salud, saber y deporte';'Deportes';'VARIABLES'
04/02/2009;04/02/2009;'VIRGIN ACTIVE';-59,00€;4.069,33 €;-910;-59,00;8.593,42 €;'sin fechas';04/02/2009;'VIRGIN';'Gastos_Salud, saber y deporte';'Deportes';'VARIABLES'
05/02/2009;05/02/2009;'ACE SEGUROS';-16,27€;4.053,06 €;-909;-16,27;8.577,15 €;'sin fechas';05/02/2009;'ACE';'Gastos_Compras';'Ropa';'VARIABLES'
05/02/2009;05/02/2009;'CAFET.C T PRAT';-3,25€;4.049,81 €;-908;-3,25;8.573,90 €;'sin fechas';05/02/2009;'CAFETC';'Gastos_Ocio y transporte';'Restaurantes';'VARIABLES'
05/02/2009;05/02/2009;'EL GOURMET DEL\\PRAT LLOBREG';-7,95€;4.041,86 €;-907;-7,95;8.565,95 €;'sin fechas';05/02/2009;'GOURMET';'Gastos_Ocio y transporte';'Restaurantes';'VARIABLES'
05/02/2009;05/02/2009;'GASOLINA';-31,10€;4.010,76 €;-906;-31,10;8.534,85 €;'sin fechas';05/02/2009;'GASOLINA';'Gastos_Ocio y transporte';'Gasolina';'VARIABLES'
06/02/2009;06/02/2009;'AMC PARC VALLES';-8,40€;4.002,36 €;-905;-8,40;8.526,45 €;'sin fechas';06/02/2009;'AMC';'Gastos_Ocio y transporte';'Espectáculos';'VARIABLES'
06/02/2009;06/02/2009;'CAFET.C T PRAT';-3,70€;3.998,66 €;-904;-3,70;8.522,75 €;'sin fechas';06/02/2009;'CAFETC';'Gastos_Ocio y transporte';'Restaurantes';'VARIABLES'
06/02/2009;16/02/2009;'COMPRA CON TARJETA';-1,85€;3.996,81 €;-903;-1,85;8.520,90 €;'sin fechas';16/02/2009;'COMPRA';'Gastos_Compras';'Supermercado';'VARIABLES'
06/02/2009;16/02/2009;'COMPRA CON TARJETA';-1,50€;3.995,31 €;-902;-1,50;8.519,40 €;'sin fechas';16/02/2009;'COMPRA';'Gastos_Compras';'Supermercado';'VARIABLES'
06/02/2009;06/02/2009;'JIANHONG ZHOU S.L.';-26,38€;3.968,93 €;-901;-26,38;8.493,02 €;'sin fechas';06/02/2009;'JIANHONG';'Gastos_Ocio y transporte';'Restaurantes';'VARIABLES'
06/02/2009;06/02/2009;'M&S';-47,99€;3.920,94 €;-900;-47,99;8.445,03 €;'sin fechas';06/02/2009;'MS';'Gastos_Compras';'Ropa';'VARIABLES'
07/02/2009;07/02/2009;'C&A';-26,90€;3.894,04 €;-899;-26,90;8.418,13 €;'sin fechas';07/02/2009;'CA';'Gastos_Compras';'Ropa';'VARIABLES'
07/02/2009;07/02/2009;'CARREFOUR-[comida]';-65,00€;3.829,04 €;-898;-65,00;8.353,13 €;'sin fechas';07/02/2009;'CARREFOURCOMIDA';'Gastos_Compras';'Supermercado';'VARIABLES'
07/02/2009;16/02/2009;'COMPRA CON TARJETA';-1,16€;3.827,88 €;-897;-1,16;8.351,97 €;'sin fechas';16/02/2009;'COMPRA';'Gastos_Compras';'Supermercado';'VARIABLES'
07/02/2009;16/02/2009;'COMPRA CON TARJETA';-1,16€;3.826,72 €;-896;-1,16;8.350,81 €;'sin fechas';16/02/2009;'COMPRA';'Gastos_Compras';'Supermercado';'VARIABLES'
07/02/2009;07/02/2009;'NERAP 27 S.L. \\MATARO';-21,90€;3.804,82 €;-895;-21,90;8.328,91 €;'sin fechas';07/02/2009;'NERAP';'Gastos_Ocio y transporte';'Restaurantes';'VARIABLES'
07/02/2009;07/02/2009;'VIENA';-9,70€;3.795,12 €;-894;-9,70;8.319,21 €;'sin fechas';07/02/2009;'VIENA';'Gastos_Ocio y transporte';'Restaurantes';'VARIABLES'
09/02/2009;09/02/2009;'CAFET.C T PRAT';-2,95€;3.792,17 €;-893;-2,95;8.316,26 €;'sin fechas';09/02/2009;'CAFETC';'Gastos_Ocio y transporte';'Restaurantes';'VARIABLES'
09/02/2009;09/02/2009;'CAFET.C T PRAT';-1,00€;3.791,17 €;-892;-1,00;8.315,26 €;'sin fechas';09/02/2009;'CAFETC';'Gastos_Ocio y transporte';'Restaurantes';'VARIABLES'
09/02/2009;09/02/2009;'MERCADONA';-23,27€;3.767,90 €;-891;-23,27;8.291,99 €;'sin fechas';09/02/2009;'MERCADONA';'Gastos_Compras';'Supermercado';'VARIABLES'
10/02/2009;10/02/2009;'CAFET.C T PRAT';-5,25€;3.762,65 €;-890;-5,25;8.286,74 €;'sin fechas';10/02/2009;'CAFETC';'Gastos_Ocio y transporte';'Restaurantes';'VARIABLES'
10/02/2009;09/02/2009;'Cena del 40 Aniversario Santap';-38,00€;3.724,65 €;-889;-38,00;8.248,74 €;'sin fechas';09/02/2009;'CENA';'Gastos_Ocio y transporte';'Restaurantes';'VARIABLES'
11/02/2009;11/02/2009;'CAFET.C T PRAT';-1,95€;3.722,70 €;-888;-1,95;8.246,79 €;'sin fechas';11/02/2009;'CAFETC';'Gastos_Ocio y transporte';'Restaurantes';'VARIABLES'
12/02/2009;12/02/2009;'CAFET.C T PRAT';-3,10€;3.719,60 €;-887;-3,10;8.243,69 €;'sin fechas';12/02/2009;'CAFETC';'Gastos_Ocio y transporte';'Restaurantes';'VARIABLES'
12/02/2009;12/02/2009;'GAS NATURAL';-165,65€;3.553,95 €;-886;-165,65;8.078,04 €;'sin fechas';12/02/2009;'GAS';'Gastos_Servicios tipicos';'Gas';'FIJO'
12/02/2009;12/02/2009;'LLAMARADA \\EL PRAT DE LL';-38,80€;3.515,15 €;-885;-38,80;8.039,24 €;'sin fechas';12/02/2009;'LLAMARADA';'Gastos_Compras';'Ropa';'VARIABLES'
13/02/2009;13/02/2009;'CAFET.C T PRAT';-3,20€;3.511,95 €;-884;-3,20;8.036,04 €;'sin fechas';13/02/2009;'CAFETC';'Gastos_Ocio y transporte';'Restaurantes';'VARIABLES'
13/02/2009;13/02/2009;'GASOLINA';-30,00€;3.481,95 €;-883;-30,00;8.006,04 €;'sin fechas';13/02/2009;'GASOLINA';'Gastos_Ocio y transporte';'Gasolina';'VARIABLES'
14/02/2009;14/02/2009;'64903601 4b CAJ OFI';-1,50€;3.480,45 €;-882;-1,50;8.004,54 €;'sin fechas';14/02/2009;'CAJ';'Gastos_Gastos varios';'Efectivo';'VARIABLES'
14/02/2009;14/02/2009;'CARREFOUR-[comida]';-38,88€;3.441,57 €;-881;-38,88;7.965,66 €;'sin fechas';14/02/2009;'CARREFOURCOMIDA';'Gastos_Compras';'Supermercado';'VARIABLES'
14/02/2009;20/02/2009;'COMPRA CON TARJETA';-6,54€;3.435,03 €;-880;-6,54;7.959,12 €;'sin fechas';20/02/2009;'COMPRA';'Gastos_Compras';'Supermercado';'VARIABLES'
14/02/2009;14/02/2009;'PARKING TORRE CAT';-15,20€;3.419,83 €;-879;-15,20;7.943,92 €;'sin fechas';14/02/2009;'PARKING';'Gastos_Ocio y transporte';'Parking y peaje';'VARIABLES'
14/02/2009;14/02/2009;'REINT.CAJERO';-100,00€;3.319,83 €;-878;-100,00;7.843,92 €;'sin fechas';14/02/2009;'REINTCAJERO';'Gastos_Gastos varios';'Efectivo';'VARIABLES'
16/02/2009;16/02/2009;'CAFET.C T PRAT';-2,50€;3.317,33 €;-877;-2,50;7.841,42 €;'sin fechas';16/02/2009;'CAFETC';'Gastos_Ocio y transporte';'Restaurantes';'VARIABLES'
16/02/2009;16/02/2009;'SEG.AM.HIPITEC';-31,20€;3.286,13 €;-876;-31,20;7.810,22 €;'sin fechas';16/02/2009;'SEGAMHIPITEC';'Gastos_Seguros';'Seguro vida';'FIJO'
17/02/2009;17/02/2009;'CAFET.C T PRAT';-3,55€;3.282,58 €;-875;-3,55;7.806,67 €;'sin fechas';17/02/2009;'CAFETC';'Gastos_Ocio y transporte';'Restaurantes';'VARIABLES'
17/02/2009;17/02/2009;'ONO';-78,39€;3.204,19 €;-874;-78,39;7.728,28 €;'sin fechas';17/02/2009;'ONO';'Gastos_Servicios tipicos';'Telecomunicaciones';'FIJO'
18/02/2009;18/02/2009;'CAFET.C T PRAT';-3,05€;3.201,14 €;-873;-3,05;7.725,23 €;'sin fechas';18/02/2009;'CAFETC';'Gastos_Ocio y transporte';'Restaurantes';'VARIABLES'
18/02/2009;18/02/2009;'RENFE';-2,20€;3.198,94 €;-872;-2,20;7.723,03 €;'sin fechas';18/02/2009;'RENFE';'Gastos_Ocio y transporte';'Transporte';'VARIABLES'
18/02/2009;18/02/2009;'RENFE';-1,50€;3.197,44 €;-871;-1,50;7.721,53 €;'sin fechas';18/02/2009;'RENFE';'Gastos_Ocio y transporte';'Transporte';'VARIABLES'
19/02/2009;19/02/2009;'CAFET.C T PRAT';-0,80€;3.196,64 €;-870;-0,80;7.720,73 €;'sin fechas';19/02/2009;'CAFETC';'Gastos_Ocio y transporte';'Restaurantes';'VARIABLES'
19/02/2009;19/02/2009;'ENDESA DISTRIB';-30,06€;3.166,58 €;-869;-30,06;7.690,67 €;'sin fechas';19/02/2009;'ENDESA';'Gastos_Servicios tipicos';'Electricidad';'FIJO'
20/02/2009;20/02/2009;'AMC PARC VALLES';-8,40€;3.158,18 €;-868;-8,40;7.682,27 €;'sin fechas';20/02/2009;'AMC';'Gastos_Ocio y transporte';'Espectáculos';'VARIABLES'
20/02/2009;20/02/2009;'BURGUER KING PARK';-12,00€;3.146,18 €;-867;-12,00;7.670,27 €;'sin fechas';20/02/2009;'BURGUER';'Gastos_Ocio y transporte';'Restaurantes';'VARIABLES'
20/02/2009;20/02/2009;'CAFET.C T PRAT';-1,50€;3.144,68 €;-866;-1,50;7.668,77 €;'sin fechas';20/02/2009;'CAFETC';'Gastos_Ocio y transporte';'Restaurantes';'VARIABLES'
21/02/2009;02/03/2009;'COMPRA CON TARJETA';-3,40€;3.141,28 €;-865;-3,40;7.665,37 €;'sin fechas';02/03/2009;'COMPRA';'Gastos_Compras';'Supermercado';'VARIABLES'
21/02/2009;02/03/2009;'COMPRA CON TARJETA';-3,40€;3.137,88 €;-864;-3,40;7.661,97 €;'sin fechas';02/03/2009;'COMPRA';'Gastos_Compras';'Supermercado';'VARIABLES'
21/02/2009;21/02/2009;'GASOLINA';-32,95€;3.104,93 €;-863;-32,95;7.629,02 €;'sin fechas';21/02/2009;'GASOLINA';'Gastos_Ocio y transporte';'Gasolina';'VARIABLES'
21/02/2009;21/02/2009;'LA BRASA';-39,55€;3.065,38 €;-862;-39,55;7.589,47 €;'sin fechas';21/02/2009;'BRASA';'Gastos_Ocio y transporte';'Restaurantes';'VARIABLES'
23/02/2009;23/02/2009;'CAFET.C T PRAT';-2,95€;3.062,43 €;-861;-2,95;7.586,52 €;'sin fechas';23/02/2009;'CAFETC';'Gastos_Ocio y transporte';'Restaurantes';'VARIABLES'
23/02/2009;23/02/2009;'DECATHLON';-25,80€;3.036,63 €;-860;-25,80;7.560,72 €;'sin fechas';23/02/2009;'DECATHLON';'Gastos_Compras';'Deportivo';'VARIABLES'
23/02/2009;23/02/2009;'REINT.CAJERO';-60,00€;2.976,63 €;-859;-60,00;7.500,72 €;'sin fechas';23/02/2009;'REINTCAJERO';'Gastos_Gastos varios';'Efectivo';'VARIABLES'
24/02/2009;24/02/2009;'CAFET.C T PRAT';-1,85€;2.974,78 €;-858;-1,85;7.498,87 €;'sin fechas';24/02/2009;'CAFETC';'Gastos_Ocio y transporte';'Restaurantes';'VARIABLES'
24/02/2009;24/02/2009;'FRANCE TELECOM';-11,66€;2.963,12 €;-857;-11,66;7.487,21 €;'sin fechas';24/02/2009;'FRANCE';'Gastos_Servicios tipicos';'Telecomunicaciones';'FIJO'
24/02/2009;24/02/2009;'MERCADONA';-11,93€;2.951,19 €;-856;-11,93;7.475,28 €;'sin fechas';24/02/2009;'MERCADONA';'Gastos_Compras';'Supermercado';'VARIABLES'
25/02/2009;25/02/2009;'CAFET.C T PRAT';-0,60€;2.950,59 €;-855;-0,60;7.474,68 €;'sin fechas';25/02/2009;'CAFETC';'Gastos_Ocio y transporte';'Restaurantes';'VARIABLES'
25/02/2009;25/02/2009;'FARMACIA';-9,73€;2.940,86 €;-854;-9,73;7.464,95 €;'sin fechas';25/02/2009;'FARMACIA';'Gastos_Salud, saber y deporte';'Farmacia';'VARIABLES'
26/02/2009;26/02/2009;'CAFET.C T PRAT';-1,55€;2.939,31 €;-853;-1,55;7.463,40 €;'sin fechas';26/02/2009;'CAFETC';'Gastos_Ocio y transporte';'Restaurantes';'VARIABLES'
27/02/2009;27/02/2009;'CAFET.C T PRAT';-3,25€;2.936,06 €;-852;-3,25;7.460,15 €;'sin fechas';27/02/2009;'CAFETC';'Gastos_Ocio y transporte';'Restaurantes';'VARIABLES'
27/02/2009;09/03/2009;'COMPRA CON TARJETA';-5,20€;2.930,86 €;-851;-5,20;7.454,95 €;'sin fechas';09/03/2009;'COMPRA';'Gastos_Compras';'Supermercado';'VARIABLES'
27/02/2009;27/02/2009;'FRANCE TELECOM';-11,30€;2.919,56 €;-850;-11,30;7.443,65 €;'sin fechas';27/02/2009;'FRANCE';'Gastos_Servicios tipicos';'Telecomunicaciones';'FIJO'
27/02/2009;26/02/2009;'INFORMACIO I TECNOLOGIA DE CAT';1.580,23€;4.499,79 €;-849;1.580,23;9.023,88 €;'sin fechas';26/02/2009;'INFORMACIO';'Ingresos';'Nomina';'FIJO'
27/02/2009;27/02/2009;'RESTAURANT SAPPORO';-29,53€;4.470,26 €;-848;-29,53;8.994,35 €;'sin fechas';27/02/2009;'RESTAURANT';'Gastos_Ocio y transporte';'Restaurantes';'VARIABLES'
27/02/2009;27/02/2009;'XIN HUA EXTREMO O';-42,10€;4.428,16 €;-847;-42,10;8.952,25 €;'sin fechas';27/02/2009;'XIN';'Gastos_Ocio y transporte';'Restaurantes';'VARIABLES'
28/02/2009;06/03/2009;'COMPRA CON TARJETA';-5,30€;4.422,86 €;-846;-5,30;8.946,95 €;'sin fechas';06/03/2009;'COMPRA';'Gastos_Compras';'Supermercado';'VARIABLES'
28/02/2009;06/03/2009;'COMPRA CON TARJETA';-3,11€;4.419,75 €;-845;-3,11;8.943,84 €;'sin fechas';06/03/2009;'COMPRA';'Gastos_Compras';'Supermercado';'VARIABLES'
28/02/2009;06/03/2009;'COMPRA CON TARJETA';-3,11€;4.416,64 €;-844;-3,11;8.940,73 €;'sin fechas';06/03/2009;'COMPRA';'Gastos_Compras';'Supermercado';'VARIABLES'
28/02/2009;06/03/2009;'COMPRA CON TARJETA';-5,30€;4.411,34 €;-843;-5,30;8.935,43 €;'sin fechas';06/03/2009;'COMPRA';'Gastos_Compras';'Supermercado';'VARIABLES'
28/02/2009;28/02/2009;'PIELES DE MALL';-26,90€;4.384,44 €;-842;-26,90;8.908,53 €;'sin fechas';28/02/2009;'PIELES';'Gastos_Ocio y transporte';'Restaurantes';'VARIABLES'
28/02/2009;27/02/2009;'RECIBO PTMOS. 3061-0960001518';-865,73€;3.518,71 €;-841;-865,73;8.042,80 €;'sin fechas';27/02/2009;'RECIBO';'Gastos_Banco y organismos';'Hipoteca';'FIJO'
28/02/2009;27/02/2009;'RECIBO PTMOS. 3061-0960004140';-177,24€;3.341,47 €;-840;-177,24;7.865,56 €;'sin fechas';27/02/2009;'RECIBO';'Gastos_Banco y organismos';'Hipoteca';'FIJO'
28/02/2009;28/02/2009;'VIENA';-9,70€;3.331,77 €;-839;-9,70;7.855,86 €;'sin fechas';28/02/2009;'VIENA';'Gastos_Ocio y transporte';'Restaurantes';'VARIABLES'
01/03/2009;01/03/2009;'AMC PARC VALLES';-10,40€;3.321,37 €;-838;-10,40;7.845,46 €;'sin fechas';01/03/2009;'AMC';'Gastos_Ocio y transporte';'Espectáculos';'VARIABLES'
01/03/2009;01/03/2009;'GASOLINA';-30,00€;3.291,37 €;-837;-30,00;7.815,46 €;'sin fechas';01/03/2009;'GASOLINA';'Gastos_Ocio y transporte';'Gasolina';'VARIABLES'
01/03/2009;01/03/2009;'KEBAP - ISTANBUL';-10,80€;3.280,57 €;-836;-10,80;7.804,66 €;'sin fechas';01/03/2009;'KEBAP';'Gastos_Ocio y transporte';'Restaurantes';'VARIABLES'
01/03/2009;01/03/2009;'VIENA';-9,75€;3.270,82 €;-835;-9,75;7.794,91 €;'sin fechas';01/03/2009;'VIENA';'Gastos_Ocio y transporte';'Restaurantes';'VARIABLES'
02/03/2009;02/03/2009;'AJUNTAMENT DE TERRASSA';-36,81€;3.234,01 €;-834;-36,81;7.758,10 €;'sin fechas';02/03/2009;'AJUNTAMENT';'Gastos_Banco y organismos';'Ayuntamiento';'FIJO'
02/03/2009;02/03/2009;'CAFET.C T PRAT';-1,60€;3.232,41 €;-833;-1,60;7.756,50 €;'sin fechas';02/03/2009;'CAFETC';'Gastos_Ocio y transporte';'Restaurantes';'VARIABLES'
02/03/2009;02/03/2009;'MERCADONA';-26,24€;3.206,17 €;-832;-26,24;7.730,26 €;'sin fechas';02/03/2009;'MERCADONA';'Gastos_Compras';'Supermercado';'VARIABLES'
03/03/2009;03/03/2009;'CAFET.C T PRAT';-2,70€;3.203,47 €;-831;-2,70;7.727,56 €;'sin fechas';03/03/2009;'CAFETC';'Gastos_Ocio y transporte';'Restaurantes';'VARIABLES'
03/03/2009;03/03/2009;'CAFET.C T PRAT';-2,60€;3.200,87 €;-830;-2,60;7.724,96 €;'sin fechas';03/03/2009;'CAFETC';'Gastos_Ocio y transporte';'Restaurantes';'VARIABLES'
03/03/2009;27/02/2009;'FOMENT DE TERRASSA, S.A. FOMEN';1.621,55€;4.822,42 €;-829;1.621,55;9.346,51 €;'sin fechas';27/02/2009;'FOMENT';'Ingresos';'Nomina';'FIJO'
03/03/2009;03/03/2009;'MERCADONA';-6,01€;4.816,41 €;-828;-6,01;9.340,50 €;'sin fechas';03/03/2009;'MERCADONA';'Gastos_Compras';'Supermercado';'VARIABLES'
04/03/2009;04/03/2009;'ACE SEGUROS';-16,27€;4.800,14 €;-827;-16,27;9.324,23 €;'sin fechas';04/03/2009;'ACE';'Gastos_Compras';'Ropa';'VARIABLES'
04/03/2009;04/03/2009;'CIA. DE SEGUROS 006662671613';-33,90€;4.766,24 €;-826;-33,90;9.290,33 €;'sin fechas';04/03/2009;'CIA';'Ingresos';'Devoluciones';'VARIABLES'
04/03/2009;04/03/2009;'RENFE';-2,20€;4.764,04 €;-825;-2,20;9.288,13 €;'sin fechas';04/03/2009;'RENFE';'Gastos_Ocio y transporte';'Transporte';'VARIABLES'
04/03/2009;04/03/2009;'RENFE';-1,50€;4.762,54 €;-824;-1,50;9.286,63 €;'sin fechas';04/03/2009;'RENFE';'Gastos_Ocio y transporte';'Transporte';'VARIABLES'
04/03/2009;04/03/2009;'VIRGIN ACTIVE';-59,00€;4.703,54 €;-823;-59,00;9.227,63 €;'sin fechas';04/03/2009;'VIRGIN';'Gastos_Salud, saber y deporte';'Deportes';'VARIABLES'
04/03/2009;04/03/2009;'VIRGIN ACTIVE';-59,00€;4.644,54 €;-822;-59,00;9.168,63 €;'sin fechas';04/03/2009;'VIRGIN';'Gastos_Salud, saber y deporte';'Deportes';'VARIABLES'
05/03/2009;05/03/2009;'CAFET.C T PRAT';-1,65€;4.642,89 €;-821;-1,65;9.166,98 €;'sin fechas';05/03/2009;'CAFETC';'Gastos_Ocio y transporte';'Restaurantes';'VARIABLES'
05/03/2009;05/03/2009;'FARMACIA';-4,65€;4.638,24 €;-820;-4,65;9.162,33 €;'sin fechas';05/03/2009;'FARMACIA';'Gastos_Salud, saber y deporte';'Farmacia';'VARIABLES'
06/03/2009;06/03/2009;'MESON LAS FORCAS S';-11,25€;4.626,99 €;-819;-11,25;9.151,08 €;'sin fechas';06/03/2009;'MESON';'Gastos_Ocio y transporte';'Restaurantes';'VARIABLES'
07/03/2009;07/03/2009;'AMC PARC VALLES';-10,40€;4.616,59 €;-818;-10,40;9.140,68 €;'sin fechas';07/03/2009;'AMC';'Gastos_Ocio y transporte';'Espectáculos';'VARIABLES'
07/03/2009;07/03/2009;'CAPRABO';-13,45€;4.603,14 €;-817;-13,45;9.127,23 €;'sin fechas';07/03/2009;'CAPRABO';'Gastos_Compras';'Supermercado';'VARIABLES'
07/03/2009;07/03/2009;'GIFI';-14,48€;4.588,66 €;-816;-14,48;9.112,75 €;'sin fechas';07/03/2009;'GIFI';'Gastos_Compras';'Hogar';'VARIABLES'
07/03/2009;07/03/2009;'JIANHONG ZHOU S.L.';-28,84€;4.559,82 €;-815;-28,84;9.083,91 €;'sin fechas';07/03/2009;'JIANHONG';'Gastos_Ocio y transporte';'Restaurantes';'VARIABLES'
08/03/2009;13/03/2009;'COMPRA CON TARJETA';-8,00€;4.551,82 €;-814;-8,00;9.075,91 €;'sin fechas';13/03/2009;'COMPRA';'Gastos_Compras';'Supermercado';'VARIABLES'
08/03/2009;08/03/2009;'FIRA DE BARCELONA';-12,00€;4.539,82 €;-813;-12,00;9.063,91 €;'sin fechas';08/03/2009;'FIRA';'Gastos_Ocio y transporte';'Restaurantes';'VARIABLES'
08/03/2009;08/03/2009;'REINT.CAJERO';-150,00€;4.389,82 €;-812;-150,00;8.913,91 €;'sin fechas';08/03/2009;'REINTCAJERO';'Gastos_Gastos varios';'Efectivo';'VARIABLES'
09/03/2009;09/03/2009;'CAFET.C T PRAT';-1,85€;4.387,97 €;-811;-1,85;8.912,06 €;'sin fechas';09/03/2009;'CAFETC';'Gastos_Ocio y transporte';'Restaurantes';'VARIABLES'
09/03/2009;09/03/2009;'FF.CC.GENERALITAT';-2,85€;4.385,12 €;-810;-2,85;8.909,21 €;'sin fechas';09/03/2009;'FFCCGENERALITAT';'Gastos_Ocio y transporte';'Transporte';'VARIABLES'
09/03/2009;08/03/2009;'Ordenador';-34,00€;4.351,12 €;-809;-34,00;8.875,21 €;'sin fechas';08/03/2009;'ORDENADOR';'Gastos_Compras';'Hobbys';'VARIABLES'
11/03/2009;11/03/2009;'BON AREA';-6,32€;4.344,80 €;-808;-6,32;8.868,89 €;'sin fechas';11/03/2009;'BON';'Gastos_Compras';'Supermercado';'VARIABLES'
11/03/2009;11/03/2009;'CAFET.C T PRAT';-2,65€;4.342,15 €;-807;-2,65;8.866,24 €;'sin fechas';11/03/2009;'CAFETC';'Gastos_Ocio y transporte';'Restaurantes';'VARIABLES'
12/03/2009;12/03/2009;'CAFET.C T PRAT';-2,65€;4.339,50 €;-806;-2,65;8.863,59 €;'sin fechas';12/03/2009;'CAFETC';'Gastos_Ocio y transporte';'Restaurantes';'VARIABLES'
12/03/2009;12/03/2009;'GASOLINA';-37,57€;4.301,93 €;-805;-37,57;8.826,02 €;'sin fechas';12/03/2009;'GASOLINA';'Gastos_Ocio y transporte';'Gasolina';'VARIABLES'
13/03/2009;13/03/2009;'TOYOTA ORIENT CARS';-179,75€;4.122,18 €;-804;-179,75;8.646,27 €;'sin fechas';13/03/2009;'TOYOTA';'Gastos_Vivienda y vehiculo';'Mnto. vehiculo';'VARIABLE'
15/03/2009;15/03/2009;'AMC PARC VALLES';-10,40€;4.111,78 €;-803;-10,40;8.635,87 €;'sin fechas';15/03/2009;'AMC';'Gastos_Ocio y transporte';'Espectáculos';'VARIABLES'
15/03/2009;15/03/2009;'VIENA';-9,70€;4.102,08 €;-802;-9,70;8.626,17 €;'sin fechas';15/03/2009;'VIENA';'Gastos_Ocio y transporte';'Restaurantes';'VARIABLES'
16/03/2009;16/03/2009;'CAFET.C T PRAT';-1,85€;4.100,23 €;-801;-1,85;8.624,32 €;'sin fechas';16/03/2009;'CAFETC';'Gastos_Ocio y transporte';'Restaurantes';'VARIABLES'
16/03/2009;16/03/2009;'SEG.AM.HIPITEC';-31,16€;4.069,07 €;-800;-31,16;8.593,16 €;'sin fechas';16/03/2009;'SEGAMHIPITEC';'Gastos_Seguros';'Seguro vida';'FIJO'
17/03/2009;17/03/2009;'CAFET.C T PRAT';-3,85€;4.065,22 €;-799;-3,85;8.589,31 €;'sin fechas';17/03/2009;'CAFETC';'Gastos_Ocio y transporte';'Restaurantes';'VARIABLES'
17/03/2009;17/03/2009;'MERCADONA';-6,50€;4.058,72 €;-798;-6,50;8.582,81 €;'sin fechas';17/03/2009;'MERCADONA';'Gastos_Compras';'Supermercado';'VARIABLES'
18/03/2009;18/03/2009;'AMC PARC VALLES';-8,40€;4.050,32 €;-797;-8,40;8.574,41 €;'sin fechas';18/03/2009;'AMC';'Gastos_Ocio y transporte';'Espectáculos';'VARIABLES'
18/03/2009;18/03/2009;'BURGUER KING PARK';-13,59€;4.036,73 €;-796;-13,59;8.560,82 €;'sin fechas';18/03/2009;'BURGUER';'Gastos_Ocio y transporte';'Restaurantes';'VARIABLES'
18/03/2009;18/03/2009;'CAFET.C T PRAT';-3,15€;4.033,58 €;-795;-3,15;8.557,67 €;'sin fechas';18/03/2009;'CAFETC';'Gastos_Ocio y transporte';'Restaurantes';'VARIABLES'
18/03/2009;18/03/2009;'ENDESA DISTRIB';-59,14€;3.974,44 €;-794;-59,14;8.498,53 €;'sin fechas';18/03/2009;'ENDESA';'Gastos_Servicios tipicos';'Electricidad';'FIJO'
18/03/2009;18/03/2009;'ONO';-81,06€;3.893,38 €;-793;-81,06;8.417,47 €;'sin fechas';18/03/2009;'ONO';'Gastos_Servicios tipicos';'Telecomunicaciones';'FIJO'
18/03/2009;18/03/2009;'REINT.CAJERO';-20,00€;3.873,38 €;-792;-20,00;8.397,47 €;'sin fechas';18/03/2009;'REINTCAJERO';'Gastos_Gastos varios';'Efectivo';'VARIABLES'
19/03/2009;19/03/2009;'CAFET.C T PRAT';-3,15€;3.870,23 €;-791;-3,15;8.394,32 €;'sin fechas';19/03/2009;'CAFETC';'Gastos_Ocio y transporte';'Restaurantes';'VARIABLES'
19/03/2009;19/03/2009;'CENTRES AUTOEQUIP';-20,00€;3.850,23 €;-790;-20,00;8.374,32 €;'sin fechas';19/03/2009;'CENTRES';'Gastos_Vivienda y vehiculo';'Mnto. vehiculo';'VARIABLE'
19/03/2009;19/03/2009;'MINA PUBLICA DE LA CIUTAT';-26,22€;3.824,01 €;-789;-26,22;8.348,10 €;'sin fechas';19/03/2009;'MINA';'Gastos_Servicios tipicos';'Agua';'FIJO'
20/03/2009;20/03/2009;'CAFET.C T PRAT';-3,30€;3.820,71 €;-788;-3,30;8.344,80 €;'sin fechas';20/03/2009;'CAFETC';'Gastos_Ocio y transporte';'Restaurantes';'VARIABLES'
20/03/2009;20/03/2009;'CARREFOUR-[comida]';-24,90€;3.795,81 €;-787;-24,90;8.319,90 €;'sin fechas';20/03/2009;'CARREFOURCOMIDA';'Gastos_Compras';'Supermercado';'VARIABLES'
20/03/2009;20/03/2009;'EROSKI-[COMIDA]';-63,30€;3.732,51 €;-786;-63,30;8.256,60 €;'sin fechas';20/03/2009;'EROSKICOMIDA';'Gastos_Compras';'Supermercado';'VARIABLES'
20/03/2009;20/03/2009;'LA BRASA';-25,81€;3.706,70 €;-785;-25,81;8.230,79 €;'sin fechas';20/03/2009;'BRASA';'Gastos_Ocio y transporte';'Restaurantes';'VARIABLES'
22/03/2009;27/03/2009;'COMPRA CON TARJETA';-6,54€;3.700,16 €;-784;-6,54;8.224,25 €;'sin fechas';27/03/2009;'COMPRA';'Gastos_Compras';'Supermercado';'VARIABLES'
22/03/2009;22/03/2009;'GASOLINA';-8,10€;3.692,06 €;-783;-8,10;8.216,15 €;'sin fechas';22/03/2009;'GASOLINA';'Gastos_Ocio y transporte';'Gasolina';'VARIABLES'
22/03/2009;22/03/2009;'REINT.CAJERO';-150,00€;3.542,06 €;-782;-150,00;8.066,15 €;'sin fechas';22/03/2009;'REINTCAJERO';'Gastos_Gastos varios';'Efectivo';'VARIABLES'
22/03/2009;22/03/2009;'VIENA';-9,70€;3.532,36 €;-781;-9,70;8.056,45 €;'sin fechas';22/03/2009;'VIENA';'Gastos_Ocio y transporte';'Restaurantes';'VARIABLES'
23/03/2009;23/03/2009;'CAFET.C T PRAT';-3,15€;3.529,21 €;-780;-3,15;8.053,30 €;'sin fechas';23/03/2009;'CAFETC';'Gastos_Ocio y transporte';'Restaurantes';'VARIABLES'
24/03/2009;24/03/2009;'FRANCE TELECOM';-10,44€;3.518,77 €;-779;-10,44;8.042,86 €;'sin fechas';24/03/2009;'FRANCE';'Gastos_Servicios tipicos';'Telecomunicaciones';'FIJO'
24/03/2009;24/03/2009;'GASOLINA';-34,05€;3.484,72 €;-778;-34,05;8.008,81 €;'sin fechas';24/03/2009;'GASOLINA';'Gastos_Ocio y transporte';'Gasolina';'VARIABLES'
25/03/2009;25/03/2009;'CAFET.C T PRAT';-2,65€;3.482,07 €;-777;-2,65;8.006,16 €;'sin fechas';25/03/2009;'CAFETC';'Gastos_Ocio y transporte';'Restaurantes';'VARIABLES'
25/03/2009;25/03/2009;'MERCADONA';-25,54€;3.456,53 €;-776;-25,54;7.980,62 €;'sin fechas';25/03/2009;'MERCADONA';'Gastos_Compras';'Supermercado';'VARIABLES'
26/03/2009;26/03/2009;'CAFET.C T PRAT';-3,60€;3.452,93 €;-775;-3,60;7.977,02 €;'sin fechas';26/03/2009;'CAFETC';'Gastos_Ocio y transporte';'Restaurantes';'VARIABLES'
26/03/2009;26/03/2009;'MESON EL CORTI\\EL PRAT DE L';-10,00€;3.442,93 €;-774;-10,00;7.967,02 €;'sin fechas';26/03/2009;'MESON';'Gastos_Ocio y transporte';'Restaurantes';'VARIABLES'
26/03/2009;26/03/2009;'REINT.CAJERO';-300,00€;3.142,93 €;-773;-300,00;7.667,02 €;'sin fechas';26/03/2009;'REINTCAJERO';'Gastos_Gastos varios';'Efectivo';'VARIABLES'
27/03/2009;27/03/2009;'CAFET.C T PRAT';-3,70€;3.139,23 €;-772;-3,70;7.663,32 €;'sin fechas';27/03/2009;'CAFETC';'Gastos_Ocio y transporte';'Restaurantes';'VARIABLES'
27/03/2009;27/03/2009;'REST.NAGANO';-73,35€;3.065,88 €;-771;-73,35;7.589,97 €;'sin fechas';27/03/2009;'RESTNAGANO';'Gastos_Compras';'Ropa';'VARIABLES'
28/03/2009;28/03/2009;'CENTRES AUTOEQUIP';-225,60€;2.840,28 €;-770;-225,60;7.364,37 €;'sin fechas';28/03/2009;'CENTRES';'Gastos_Vivienda y vehiculo';'Mnto. vehiculo';'VARIABLE'
28/03/2009;28/03/2009;'JUGUETILANDIA TERR';-35,45€;2.804,83 €;-769;-35,45;7.328,92 €;'sin fechas';28/03/2009;'JUGUETILANDIA';'Gastos_Compras';'Niños';'VARIABLES'
28/03/2009;28/03/2009;'MARCO ALDANY';-9,99€;2.794,84 €;-768;-9,99;7.318,93 €;'sin fechas';28/03/2009;'MARCO';'Gastos_Salud, saber y deporte';'Belleza';'VARIABLES'
28/03/2009;28/03/2009;'VIENA';-4,70€;2.790,14 €;-767;-4,70;7.314,23 €;'sin fechas';28/03/2009;'VIENA';'Gastos_Ocio y transporte';'Restaurantes';'VARIABLES'
30/03/2009;30/03/2009;'CAFET.C T PRAT';-3,45€;2.786,69 €;-766;-3,45;7.310,78 €;'sin fechas';30/03/2009;'CAFETC';'Gastos_Ocio y transporte';'Restaurantes';'VARIABLES'
30/03/2009;30/03/2009;'CAFET.C T PRAT';-7,15€;2.779,54 €;-765;-7,15;7.303,63 €;'sin fechas';30/03/2009;'CAFETC';'Gastos_Ocio y transporte';'Restaurantes';'VARIABLES'
30/03/2009;30/03/2009;'MERCADONA';-15,93€;2.763,61 €;-764;-15,93;7.287,70 €;'sin fechas';30/03/2009;'MERCADONA';'Gastos_Compras';'Supermercado';'VARIABLES'
31/03/2009;31/03/2009;'CAFET.C T PRAT';-6,05€;2.757,56 €;-763;-6,05;7.281,65 €;'sin fechas';31/03/2009;'CAFETC';'Gastos_Ocio y transporte';'Restaurantes';'VARIABLES'
31/03/2009;27/03/2009;'FOMENT DE TERRASSA, S.A. FOMEN';1.621,56€;4.379,12 €;-762;1.621,56;8.903,21 €;'sin fechas';27/03/2009;'FOMENT';'Ingresos';'Nomina';'FIJO'
31/03/2009;31/03/2009;'FRANCE TELECOM';-12,62€;4.366,50 €;-761;-12,62;8.890,59 €;'sin fechas';31/03/2009;'FRANCE';'Gastos_Servicios tipicos';'Telecomunicaciones';'FIJO'
31/03/2009;28/03/2009;'INFORMACIO I TECNOLOGIA DE CAT';1.580,23€;5.946,73 €;-760;1.580,23;10.470,82 €;'sin fechas';28/03/2009;'INFORMACIO';'Ingresos';'Nomina';'FIJO'
31/03/2009;30/03/2009;'Ordenador';-34,00€;5.912,73 €;-759;-34,00;10.436,82 €;'sin fechas';30/03/2009;'ORDENADOR';'Gastos_Compras';'Hobbys';'VARIABLES'
31/03/2009;31/03/2009;'RECIBO PTMOS. 3061-0960001518';-865,73€;5.047,00 €;-758;-865,73;9.571,09 €;'sin fechas';31/03/2009;'RECIBO';'Gastos_Banco y organismos';'Hipoteca';'FIJO'
31/03/2009;31/03/2009;'RECIBO PTMOS. 3061-0960004140';-177,24€;4.869,76 €;-757;-177,24;9.393,85 €;'sin fechas';31/03/2009;'RECIBO';'Gastos_Banco y organismos';'Hipoteca';'FIJO'
31/03/2009;30/03/2009;'TRANSFERENCIASCARGO';-600,00€;4.269,76 €;-756;-600,00;8.793,85 €;'sin fechas';30/03/2009;'TRANSFERENCIASCARGO';'Gastos_Gastos varios';'Transferencias';'VARIABLES'
31/03/2009;30/03/2009;'TRANSFERENCIASFAVOR';600,00€;4.869,76 €;-755;600,00;9.393,85 €;'sin fechas';30/03/2009;'TRANSFERENCIASFAVOR';'Ingresos';'Transferencias';'VARIABLES'
01/04/2009;01/04/2009;'AJUNTAMENT DE TERRASSA';-36,81€;4.832,95 €;-754;-36,81;9.357,04 €;'sin fechas';01/04/2009;'AJUNTAMENT';'Gastos_Banco y organismos';'Ayuntamiento';'FIJO'
01/04/2009;01/04/2009;'CAFET.C T PRAT';-2,95€;4.830,00 €;-753;-2,95;9.354,09 €;'sin fechas';01/04/2009;'CAFETC';'Gastos_Ocio y transporte';'Restaurantes';'VARIABLES'
01/04/2009;01/04/2009;'CIA. DE SEGUROS 006662671613';-33,90€;4.796,10 €;-752;-33,90;9.320,19 €;'sin fechas';01/04/2009;'CIA';'Ingresos';'Devoluciones';'VARIABLES'
02/04/2009;02/04/2009;'CAFET.C T PRAT';-3,10€;4.793,00 €;-751;-3,10;9.317,09 €;'sin fechas';02/04/2009;'CAFETC';'Gastos_Ocio y transporte';'Restaurantes';'VARIABLES'
02/04/2009;02/04/2009;'GASOLINA';-33,40€;4.759,60 €;-750;-33,40;9.283,69 €;'sin fechas';02/04/2009;'GASOLINA';'Gastos_Ocio y transporte';'Gasolina';'VARIABLES'
02/04/2009;02/04/2009;'VIRGIN ACTIVE';-59,00€;4.700,60 €;-749;-59,00;9.224,69 €;'sin fechas';02/04/2009;'VIRGIN';'Gastos_Salud, saber y deporte';'Deportes';'VARIABLES'
02/04/2009;02/04/2009;'VIRGIN ACTIVE';-59,00€;4.641,60 €;-748;-59,00;9.165,69 €;'sin fechas';02/04/2009;'VIRGIN';'Gastos_Salud, saber y deporte';'Deportes';'VARIABLES'
03/04/2009;03/04/2009;'AMC PARC VALLES';-13,00€;4.628,60 €;-747;-13,00;9.152,69 €;'sin fechas';03/04/2009;'AMC';'Gastos_Ocio y transporte';'Espectáculos';'VARIABLES'
03/04/2009;03/04/2009;'CAFET.C T PRAT';-5,40€;4.623,20 €;-746;-5,40;9.147,29 €;'sin fechas';03/04/2009;'CAFETC';'Gastos_Ocio y transporte';'Restaurantes';'VARIABLES'
03/04/2009;03/04/2009;'LA BRASA';-28,01€;4.595,19 €;-745;-28,01;9.119,28 €;'sin fechas';03/04/2009;'BRASA';'Gastos_Ocio y transporte';'Restaurantes';'VARIABLES'
03/04/2009;03/04/2009;'SEGS. CATALANA';-331,17€;4.264,02 €;-744;-331,17;8.788,11 €;'sin fechas';03/04/2009;'SEGS';'Gastos_Seguros';'Seguro auto';'FIJO'
04/04/2009;04/04/2009;'EROSKI-[COMIDA]';-43,69€;4.220,33 €;-743;-43,69;8.744,42 €;'sin fechas';04/04/2009;'EROSKICOMIDA';'Gastos_Compras';'Supermercado';'VARIABLES'
04/04/2009;04/04/2009;'GRAN SIGLO';-28,15€;4.192,18 €;-742;-28,15;8.716,27 €;'sin fechas';04/04/2009;'GRAN';'Gastos_Ocio y transporte';'Restaurantes';'VARIABLES'
06/04/2009;06/04/2009;'ACE SEGUROS';-16,27€;4.175,91 €;-741;-16,27;8.700,00 €;'sin fechas';06/04/2009;'ACE';'Gastos_Compras';'Ropa';'VARIABLES'
06/04/2009;06/04/2009;'BON AREA';-15,72€;4.160,19 €;-740;-15,72;8.684,28 €;'sin fechas';06/04/2009;'BON';'Gastos_Compras';'Supermercado';'VARIABLES'
06/04/2009;06/04/2009;'CAFET.C T PRAT';-3,70€;4.156,49 €;-739;-3,70;8.680,58 €;'sin fechas';06/04/2009;'CAFETC';'Gastos_Ocio y transporte';'Restaurantes';'VARIABLES'
07/04/2009;07/04/2009;'CAFET.C T PRAT';-2,80€;4.153,69 €;-738;-2,80;8.677,78 €;'sin fechas';07/04/2009;'CAFETC';'Gastos_Ocio y transporte';'Restaurantes';'VARIABLES'
07/04/2009;07/04/2009;'EROSKI-[COMIDA]';-119,00€;4.034,69 €;-737;-119,00;8.558,78 €;'sin fechas';07/04/2009;'EROSKICOMIDA';'Gastos_Compras';'Supermercado';'VARIABLES'
08/04/2009;08/04/2009;'CAFET.C T PRAT';-2,80€;4.031,89 €;-736;-2,80;8.555,98 €;'sin fechas';08/04/2009;'CAFETC';'Gastos_Ocio y transporte';'Restaurantes';'VARIABLES'
09/04/2009;09/04/2009;'CAFET.C T PRAT';-4,70€;4.027,19 €;-735;-4,70;8.551,28 €;'sin fechas';09/04/2009;'CAFETC';'Gastos_Ocio y transporte';'Restaurantes';'VARIABLES'
09/04/2009;14/04/2009;'COMPRA CON TARJETA';-3,40€;4.023,79 €;-734;-3,40;8.547,88 €;'sin fechas';14/04/2009;'COMPRA';'Gastos_Compras';'Supermercado';'VARIABLES'
09/04/2009;14/04/2009;'COMPRA CON TARJETA';-5,25€;4.018,54 €;-733;-5,25;8.542,63 €;'sin fechas';14/04/2009;'COMPRA';'Gastos_Compras';'Supermercado';'VARIABLES'
09/04/2009;20/04/2009;'COMPRA CON TARJETA';-5,80€;4.012,74 €;-732;-5,80;8.536,83 €;'sin fechas';20/04/2009;'COMPRA';'Gastos_Compras';'Supermercado';'VARIABLES'
09/04/2009;09/04/2009;'GAS NATURAL';-45,07€;3.967,67 €;-731;-45,07;8.491,76 €;'sin fechas';09/04/2009;'GAS';'Gastos_Servicios tipicos';'Gas';'FIJO'
09/04/2009;09/04/2009;'GASOLINA';-20,00€;3.947,67 €;-730;-20,00;8.471,76 €;'sin fechas';09/04/2009;'GASOLINA';'Gastos_Ocio y transporte';'Gasolina';'VARIABLES'
09/04/2009;09/04/2009;'VIENA';-21,20€;3.926,47 €;-729;-21,20;8.450,56 €;'sin fechas';09/04/2009;'VIENA';'Gastos_Ocio y transporte';'Restaurantes';'VARIABLES'
10/04/2009;10/04/2009;'CELLER CAL MENESCAL \\BOT';-46,70€;3.879,77 €;-728;-46,70;8.403,86 €;'sin fechas';10/04/2009;'CELLER';'Gastos_Ocio y transporte';'Restaurantes';'VARIABLES'
11/04/2009;11/04/2009;'BIJOU BRIGITTE S';-24,85€;3.854,92 €;-727;-24,85;8.379,01 €;'sin fechas';11/04/2009;'BIJOU';'Gastos_Compras';'Ropa';'VARIABLES'
11/04/2009;11/04/2009;'DEPOR.PIÑANA S.L. \\VINAROS';-34,00€;3.820,92 €;-726;-34,00;8.345,01 €;'sin fechas';11/04/2009;'DEPORPI';'Gastos_Compras';'Hogar';'VARIABLES'
11/04/2009;11/04/2009;'NEOCINE \\BENICARLO';-11,80€;3.809,12 €;-725;-11,80;8.333,21 €;'sin fechas';11/04/2009;'NEOCINE';'Gastos_Ocio y transporte';'Espectáculos';'VARIABLES'
12/04/2009;20/04/2009;'COMPRA CON TARJETA';-1,10€;3.808,02 €;-724;-1,10;8.332,11 €;'sin fechas';20/04/2009;'COMPRA';'Gastos_Compras';'Supermercado';'VARIABLES'
12/04/2009;20/04/2009;'COMPRA CON TARJETA';-1,10€;3.806,92 €;-723;-1,10;8.331,01 €;'sin fechas';20/04/2009;'COMPRA';'Gastos_Compras';'Supermercado';'VARIABLES'
12/04/2009;12/04/2009;'REINT.CAJERO';-200,00€;3.606,92 €;-722;-200,00;8.131,01 €;'sin fechas';12/04/2009;'REINTCAJERO';'Gastos_Gastos varios';'Efectivo';'VARIABLES'
13/04/2009;20/04/2009;'COMPRA CON TARJETA';-3,95€;3.602,97 €;-721;-3,95;8.127,06 €;'sin fechas';20/04/2009;'COMPRA';'Gastos_Compras';'Supermercado';'VARIABLES'
14/04/2009;21/04/2009;'COMPRA CON TARJETA';-13,09€;3.589,88 €;-720;-13,09;8.113,97 €;'sin fechas';21/04/2009;'COMPRA';'Gastos_Compras';'Supermercado';'VARIABLES'
14/04/2009;14/04/2009;'EL CORTE INGLES';-20,00€;3.569,88 €;-719;-20,00;8.093,97 €;'sin fechas';14/04/2009;'CORTE';'Gastos_Compras';'Supermercado';'VARIABLES'
14/04/2009;14/04/2009;'EXCIN SA \\VALENCIA';-12,40€;3.557,48 €;-718;-12,40;8.081,57 €;'sin fechas';14/04/2009;'EXCIN';'Gastos_Ocio y transporte';'Restaurantes';'VARIABLES'
14/04/2009;14/04/2009;'FARMACIA';-10,49€;3.546,99 €;-717;-10,49;8.071,08 €;'sin fechas';14/04/2009;'FARMACIA';'Gastos_Salud, saber y deporte';'Farmacia';'VARIABLES'
14/04/2009;14/04/2009;'NECO SALER \\VALENCIA';-22,10€;3.524,89 €;-716;-22,10;8.048,98 €;'sin fechas';14/04/2009;'NECO';'Gastos_Ocio y transporte';'Restaurantes';'VARIABLES'
14/04/2009;14/04/2009;'OSAKA CENTRO JAPON\\VALENCIA';-31,73€;3.493,16 €;-715;-31,73;8.017,25 €;'sin fechas';14/04/2009;'OSAKA';'Gastos_Ocio y transporte';'Restaurantes';'VARIABLES'
14/04/2009;14/04/2009;'SOLVASA VALENCIA \\VALENCIA';-149,80€;3.343,36 €;-714;-149,80;7.867,45 €;'sin fechas';14/04/2009;'SOLVASA';'Gastos_Ocio y transporte';'Vacaciones';'VARIABLES'
14/04/2009;14/04/2009;'STARBUCKS COFFEE';-8,60€;3.334,76 €;-713;-8,60;7.858,85 €;'sin fechas';14/04/2009;'STARBUCKS';'Gastos_Ocio y transporte';'Restaurantes';'VARIABLES'
15/04/2009;15/04/2009;'EL CORTE INGLES';-22,04€;3.312,72 €;-712;-22,04;7.836,81 €;'sin fechas';15/04/2009;'CORTE';'Gastos_Compras';'Supermercado';'VARIABLES'
15/04/2009;15/04/2009;'SEG.AM.HIPITEC';-31,11€;3.281,61 €;-711;-31,11;7.805,70 €;'sin fechas';15/04/2009;'SEGAMHIPITEC';'Gastos_Seguros';'Seguro vida';'FIJO'
16/04/2009;21/04/2009;'COMPRA CON TARJETA';-9,69€;3.271,92 €;-710;-9,69;7.796,01 €;'sin fechas';21/04/2009;'COMPRA';'Gastos_Compras';'Supermercado';'VARIABLES'
16/04/2009;21/04/2009;'COMPRA CON TARJETA';-9,69€;3.262,23 €;-709;-9,69;7.786,32 €;'sin fechas';21/04/2009;'COMPRA';'Gastos_Compras';'Supermercado';'VARIABLES'
16/04/2009;16/04/2009;'ENDESA DISTRIB';-22,10€;3.240,13 €;-708;-22,10;7.764,22 €;'sin fechas';16/04/2009;'ENDESA';'Gastos_Servicios tipicos';'Electricidad';'FIJO'
16/04/2009;16/04/2009;'GASOLINA';-24,15€;3.215,98 €;-707;-24,15;7.740,07 €;'sin fechas';16/04/2009;'GASOLINA';'Gastos_Ocio y transporte';'Gasolina';'VARIABLES'
16/04/2009;16/04/2009;'REINT.CAJERO';-40,00€;3.175,98 €;-706;-40,00;7.700,07 €;'sin fechas';16/04/2009;'REINTCAJERO';'Gastos_Gastos varios';'Efectivo';'VARIABLES'
16/04/2009;16/04/2009;'TERRA MITICA-TAQUI\\BENIDORM';-34,00€;3.141,98 €;-705;-34,00;7.666,07 €;'sin fechas';16/04/2009;'TERRA';'Gastos_Ocio y transporte';'Restaurantes';'VARIABLES'
17/04/2009;27/04/2009;'COMPRA CON TARJETA';-13,09€;3.128,89 €;-704;-13,09;7.652,98 €;'sin fechas';27/04/2009;'COMPRA';'Gastos_Compras';'Supermercado';'VARIABLES'
17/04/2009;17/04/2009;'LA MAMMA CUCINA PE\\VALENCIA';-21,07€;3.107,82 €;-703;-21,07;7.631,91 €;'sin fechas';17/04/2009;'MAMMA';'Gastos_Ocio y transporte';'Restaurantes';'VARIABLES'
17/04/2009;17/04/2009;'SOLVASA VALENCIA \\VALENCIA';-54,00€;3.053,82 €;-702;-54,00;7.577,91 €;'sin fechas';17/04/2009;'SOLVASA';'Gastos_Ocio y transporte';'Vacaciones';'VARIABLES'
18/04/2009;18/04/2009;'MERCADONA';-27,12€;3.026,70 €;-701;-27,12;7.550,79 €;'sin fechas';18/04/2009;'MERCADONA';'Gastos_Compras';'Supermercado';'VARIABLES'
18/04/2009;18/04/2009;'SABECO TORTOSA';-32,27€;2.994,43 €;-700;-32,27;7.518,52 €;'sin fechas';18/04/2009;'SABECO';'Gastos_Compras';'Supermercado';'VARIABLES'
19/04/2009;27/04/2009;'COMPRA CON TARJETA';-5,25€;2.989,18 €;-699;-5,25;7.513,27 €;'sin fechas';27/04/2009;'COMPRA';'Gastos_Compras';'Supermercado';'VARIABLES'
19/04/2009;27/04/2009;'COMPRA CON TARJETA';-3,40€;2.985,78 €;-698;-3,40;7.509,87 €;'sin fechas';27/04/2009;'COMPRA';'Gastos_Compras';'Supermercado';'VARIABLES'
19/04/2009;27/04/2009;'COMPRA CON TARJETA';-4,93€;2.980,85 €;-697;-4,93;7.504,94 €;'sin fechas';27/04/2009;'COMPRA';'Gastos_Compras';'Supermercado';'VARIABLES'
20/04/2009;20/04/2009;'CAFET.C T PRAT';-2,95€;2.977,90 €;-696;-2,95;7.501,99 €;'sin fechas';20/04/2009;'CAFETC';'Gastos_Ocio y transporte';'Restaurantes';'VARIABLES'
20/04/2009;20/04/2009;'EROSKI-[COMIDA]';119,00€;3.096,90 €;-695;119,00;7.620,99 €;'sin fechas';20/04/2009;'EROSKICOMIDA';'Gastos_Compras';'Supermercado';'VARIABLES'
20/04/2009;20/04/2009;'EROSKI-[COMIDA]';-116,50€;2.980,40 €;-694;-116,50;7.504,49 €;'sin fechas';20/04/2009;'EROSKICOMIDA';'Gastos_Compras';'Supermercado';'VARIABLES'
20/04/2009;20/04/2009;'ONO';-83,96€;2.896,44 €;-693;-83,96;7.420,53 €;'sin fechas';20/04/2009;'ONO';'Gastos_Servicios tipicos';'Telecomunicaciones';'FIJO'
21/04/2009;21/04/2009;'CAFET.C T PRAT';-2,80€;2.893,64 €;-692;-2,80;7.417,73 €;'sin fechas';21/04/2009;'CAFETC';'Gastos_Ocio y transporte';'Restaurantes';'VARIABLES'
21/04/2009;21/04/2009;'GASOLINA';-30,00€;2.863,64 €;-691;-30,00;7.387,73 €;'sin fechas';21/04/2009;'GASOLINA';'Gastos_Ocio y transporte';'Gasolina';'VARIABLES'
21/04/2009;21/04/2009;'REINT.CAJERO';-60,00€;2.803,64 €;-690;-60,00;7.327,73 €;'sin fechas';21/04/2009;'REINTCAJERO';'Gastos_Gastos varios';'Efectivo';'VARIABLES'
22/04/2009;22/04/2009;'CAFET.C T PRAT';-3,15€;2.800,49 €;-689;-3,15;7.324,58 €;'sin fechas';22/04/2009;'CAFETC';'Gastos_Ocio y transporte';'Restaurantes';'VARIABLES'
22/04/2009;22/04/2009;'MERCADONA';-158,47€;2.642,02 €;-688;-158,47;7.166,11 €;'sin fechas';22/04/2009;'MERCADONA';'Gastos_Compras';'Supermercado';'VARIABLES'
22/04/2009;22/04/2009;'MERCADONA';-19,78€;2.622,24 €;-687;-19,78;7.146,33 €;'sin fechas';22/04/2009;'MERCADONA';'Gastos_Compras';'Supermercado';'VARIABLES'
23/04/2009;23/04/2009;'CAFET.C T PRAT';-3,85€;2.618,39 €;-686;-3,85;7.142,48 €;'sin fechas';23/04/2009;'CAFETC';'Gastos_Ocio y transporte';'Restaurantes';'VARIABLES'
23/04/2009;23/04/2009;'FRANCE TELECOM';-13,47€;2.604,92 €;-685;-13,47;7.129,01 €;'sin fechas';23/04/2009;'FRANCE';'Gastos_Servicios tipicos';'Telecomunicaciones';'FIJO'
23/04/2009;23/04/2009;'LLIBR.SANT JORDI';-20,60€;2.584,32 €;-684;-20,60;7.108,41 €;'sin fechas';23/04/2009;'LLIBRSANT';'Gastos_Compras';'Libreria';'VARIABLES'
24/04/2009;24/04/2009;'CAFET.C T PRAT';-3,70€;2.580,62 €;-683;-3,70;7.104,71 €;'sin fechas';24/04/2009;'CAFETC';'Gastos_Ocio y transporte';'Restaurantes';'VARIABLES'
24/04/2009;24/04/2009;'RESTAURANT EL CEP';-21,96€;2.558,66 €;-682;-21,96;7.082,75 €;'sin fechas';24/04/2009;'RESTAURANT';'Gastos_Ocio y transporte';'Restaurantes';'VARIABLES'
25/04/2009;25/04/2009;'CRACK';-21,82€;2.536,84 €;-681;-21,82;7.060,93 €;'sin fechas';25/04/2009;'CRACK';'Gastos_Compras';'Otras compras';'VARIABLES'
25/04/2009;25/04/2009;'REST.AROMA DE WASA';-35,74€;2.501,10 €;-680;-35,74;7.025,19 €;'sin fechas';25/04/2009;'RESTAROMA';'Gastos_Ocio y transporte';'Restaurantes';'VARIABLES'
27/04/2009;27/04/2009;'CAFET.C T PRAT';-1,85€;2.499,25 €;-679;-1,85;7.023,34 €;'sin fechas';27/04/2009;'CAFETC';'Gastos_Ocio y transporte';'Restaurantes';'VARIABLES'
27/04/2009;27/04/2009;'CAFET.C T PRAT';-7,15€;2.492,10 €;-678;-7,15;7.016,19 €;'sin fechas';27/04/2009;'CAFETC';'Gastos_Ocio y transporte';'Restaurantes';'VARIABLES'
27/04/2009;27/04/2009;'MERCADONA';-25,60€;2.466,50 €;-677;-25,60;6.990,59 €;'sin fechas';27/04/2009;'MERCADONA';'Gastos_Compras';'Supermercado';'VARIABLES'
28/04/2009;28/04/2009;'CAFET.C T PRAT';-0,60€;2.465,90 €;-676;-0,60;6.989,99 €;'sin fechas';28/04/2009;'CAFETC';'Gastos_Ocio y transporte';'Restaurantes';'VARIABLES'
28/04/2009;28/04/2009;'FARMACIA';-11,65€;2.454,25 €;-675;-11,65;6.978,34 €;'sin fechas';28/04/2009;'FARMACIA';'Gastos_Salud, saber y deporte';'Farmacia';'VARIABLES'
29/04/2009;29/04/2009;'CAFET.C T PRAT';-2,85€;2.451,40 €;-674;-2,85;6.975,49 €;'sin fechas';29/04/2009;'CAFETC';'Gastos_Ocio y transporte';'Restaurantes';'VARIABLES'
29/04/2009;05/05/2009;'COMPRA CON TARJETA';-4,75€;2.446,65 €;-673;-4,75;6.970,74 €;'sin fechas';05/05/2009;'COMPRA';'Gastos_Compras';'Supermercado';'VARIABLES'
29/04/2009;29/04/2009;'FF.CC.GENERALITAT';-2,85€;2.443,80 €;-672;-2,85;6.967,89 €;'sin fechas';29/04/2009;'FFCCGENERALITAT';'Gastos_Ocio y transporte';'Transporte';'VARIABLES'
29/04/2009;29/04/2009;'METRO';-1,35€;2.442,45 €;-671;-1,35;6.966,54 €;'sin fechas';29/04/2009;'METRO';'Gastos_Ocio y transporte';'Transporte';'VARIABLES'
29/04/2009;29/04/2009;'REINT.CAJERO';-40,00€;2.402,45 €;-670;-40,00;6.926,54 €;'sin fechas';29/04/2009;'REINTCAJERO';'Gastos_Gastos varios';'Efectivo';'VARIABLES'
30/04/2009;30/04/2009;'CAFET.C T PRAT';-2,55€;2.399,90 €;-669;-2,55;6.923,99 €;'sin fechas';30/04/2009;'CAFETC';'Gastos_Ocio y transporte';'Restaurantes';'VARIABLES'
30/04/2009;28/04/2009;'FOMENT DE TERRASSA, S.A. FOMEN';1.621,55€;4.021,45 €;-668;1.621,55;8.545,54 €;'sin fechas';28/04/2009;'FOMENT';'Ingresos';'Nomina';'FIJO'
30/04/2009;30/04/2009;'FRANCE TELECOM';-11,89€;4.009,56 €;-667;-11,89;8.533,65 €;'sin fechas';30/04/2009;'FRANCE';'Gastos_Servicios tipicos';'Telecomunicaciones';'FIJO'
30/04/2009;29/04/2009;'INFORMACIO I TECNOLOGIA DE CAT';1.652,30€;5.661,86 €;-666;1.652,30;10.185,95 €;'sin fechas';29/04/2009;'INFORMACIO';'Ingresos';'Nomina';'FIJO'
30/04/2009;30/04/2009;'RECIBO PTMOS. 3061-0960001518';-865,73€;4.796,13 €;-665;-865,73;9.320,22 €;'sin fechas';30/04/2009;'RECIBO';'Gastos_Banco y organismos';'Hipoteca';'FIJO'
30/04/2009;30/04/2009;'RECIBO PTMOS. 3061-0960004140';-177,24€;4.618,89 €;-664;-177,24;9.142,98 €;'sin fechas';30/04/2009;'RECIBO';'Gastos_Banco y organismos';'Hipoteca';'FIJO'
02/05/2009;02/05/2009;'CINE';-22,80€;4.596,09 €;-663;-22,80;9.120,18 €;'sin fechas';02/05/2009;'CINE';'Gastos_Ocio y transporte';'Espectáculos';'VARIABLES'
02/05/2009;02/05/2009;'DECATHLON';-18,85€;4.577,24 €;-662;-18,85;9.101,33 €;'sin fechas';02/05/2009;'DECATHLON';'Gastos_Compras';'Deportivo';'VARIABLES'
02/05/2009;02/05/2009;'DRIM VILAMARINA \\VILADECANS';-29,99€;4.547,25 €;-661;-29,99;9.071,34 €;'sin fechas';02/05/2009;'DRIM';'Gastos_Compras';'Niños';'VARIABLES'
02/05/2009;02/05/2009;'GASOLINA';-30,24€;4.517,01 €;-660;-30,24;9.041,10 €;'sin fechas';02/05/2009;'GASOLINA';'Gastos_Ocio y transporte';'Gasolina';'VARIABLES'
02/05/2009;02/05/2009;'KIABI SANT BOI';-166,90€;4.350,11 €;-659;-166,90;8.874,20 €;'sin fechas';02/05/2009;'KIABI';'Gastos_Compras';'Ropa';'VARIABLES'
02/05/2009;02/05/2009;'VIENA';-10,50€;4.339,61 €;-658;-10,50;8.863,70 €;'sin fechas';02/05/2009;'VIENA';'Gastos_Ocio y transporte';'Restaurantes';'VARIABLES'
02/05/2009;02/05/2009;'WOKGU';-27,00€;4.312,61 €;-657;-27,00;8.836,70 €;'sin fechas';02/05/2009;'WOKGU';'Gastos_Ocio y transporte';'Restaurantes';'VARIABLES'
04/05/2009;04/05/2009;'AJUNTAMENT DE TERRASSA';-36,81€;4.275,80 €;-656;-36,81;8.799,89 €;'sin fechas';04/05/2009;'AJUNTAMENT';'Gastos_Banco y organismos';'Ayuntamiento';'FIJO'
04/05/2009;04/05/2009;'CAFET.C T PRAT';-2,85€;4.272,95 €;-655;-2,85;8.797,04 €;'sin fechas';04/05/2009;'CAFETC';'Gastos_Ocio y transporte';'Restaurantes';'VARIABLES'
04/05/2009;04/05/2009;'CIA. DE SEGUROS 006662671613';-33,90€;4.239,05 €;-654;-33,90;8.763,14 €;'sin fechas';04/05/2009;'CIA';'Ingresos';'Devoluciones';'VARIABLES'
04/05/2009;11/05/2009;'COMPRA CON TARJETA';-0,85€;4.238,20 €;-653;-0,85;8.762,29 €;'sin fechas';11/05/2009;'COMPRA';'Gastos_Compras';'Supermercado';'VARIABLES'
04/05/2009;04/05/2009;'EROSKI-[OTROS]';99,00€;4.337,20 €;-652;99,00;8.861,29 €;'sin fechas';04/05/2009;'EROSKIOTROS';'Gastos_Compras';'Supermercado';'VARIABLES'
04/05/2009;04/05/2009;'MERCADONA';-27,20€;4.310,00 €;-651;-27,20;8.834,09 €;'sin fechas';04/05/2009;'MERCADONA';'Gastos_Compras';'Supermercado';'VARIABLES'
04/05/2009;04/05/2009;'SWAROVSKI TERRASSA';-125,00€;4.185,00 €;-650;-125,00;8.709,09 €;'sin fechas';04/05/2009;'SWAROVSKI';'Gastos_Ocio y transporte';'Restaurantes';'VARIABLES'
06/05/2009;06/05/2009;'CAFET.C T PRAT';-2,75€;4.182,25 €;-649;-2,75;8.706,34 €;'sin fechas';06/05/2009;'CAFETC';'Gastos_Ocio y transporte';'Restaurantes';'VARIABLES'
06/05/2009;06/05/2009;'VIRGIN ACTIVE';-59,00€;4.123,25 €;-648;-59,00;8.647,34 €;'sin fechas';06/05/2009;'VIRGIN';'Gastos_Salud, saber y deporte';'Deportes';'VARIABLES'
06/05/2009;06/05/2009;'VIRGIN ACTIVE';-59,00€;4.064,25 €;-647;-59,00;8.588,34 €;'sin fechas';06/05/2009;'VIRGIN';'Gastos_Salud, saber y deporte';'Deportes';'VARIABLES'
07/05/2009;07/05/2009;'ACE SEGUROS';-16,27€;4.047,98 €;-646;-16,27;8.572,07 €;'sin fechas';07/05/2009;'ACE';'Gastos_Compras';'Ropa';'VARIABLES'
07/05/2009;07/05/2009;'CAFET.C T PRAT';-2,95€;4.045,03 €;-645;-2,95;8.569,12 €;'sin fechas';07/05/2009;'CAFETC';'Gastos_Ocio y transporte';'Restaurantes';'VARIABLES'
08/05/2009;08/05/2009;'AMC PARC VALLES';-9,00€;4.036,03 €;-644;-9,00;8.560,12 €;'sin fechas';08/05/2009;'AMC';'Gastos_Ocio y transporte';'Espectáculos';'VARIABLES'
08/05/2009;08/05/2009;'CAFET.C T PRAT';-4,00€;4.032,03 €;-643;-4,00;8.556,12 €;'sin fechas';08/05/2009;'CAFETC';'Gastos_Ocio y transporte';'Restaurantes';'VARIABLES'
08/05/2009;13/05/2009;'COMPRA CON TARJETA';-2,90€;4.029,13 €;-642;-2,90;8.553,22 €;'sin fechas';13/05/2009;'COMPRA';'Gastos_Compras';'Supermercado';'VARIABLES'
08/05/2009;08/05/2009;'MERCADONA';-96,52€;3.932,61 €;-641;-96,52;8.456,70 €;'sin fechas';08/05/2009;'MERCADONA';'Gastos_Compras';'Supermercado';'VARIABLES'
08/05/2009;08/05/2009;'YVES ROCHER';-17,10€;3.915,51 €;-640;-17,10;8.439,60 €;'sin fechas';08/05/2009;'YVES';'Gastos_Salud, saber y deporte';'Belleza';'VARIABLES'
10/05/2009;10/05/2009;'LA BRASA';-18,96€;3.896,55 €;-639;-18,96;8.420,64 €;'sin fechas';10/05/2009;'BRASA';'Gastos_Ocio y transporte';'Restaurantes';'VARIABLES'
10/05/2009;10/05/2009;'REINT.CAJERO';-100,00€;3.796,55 €;-638;-100,00;8.320,64 €;'sin fechas';10/05/2009;'REINTCAJERO';'Gastos_Gastos varios';'Efectivo';'VARIABLES'
10/05/2009;10/05/2009;'REINT.CAJERO';-100,00€;3.696,55 €;-637;-100,00;8.220,64 €;'sin fechas';10/05/2009;'REINTCAJERO';'Gastos_Gastos varios';'Efectivo';'VARIABLES'
10/05/2009;10/05/2009;'REINT.CAJERO';100,00€;3.796,55 €;-636;100,00;8.320,64 €;'sin fechas';10/05/2009;'REINTCAJERO';'Gastos_Gastos varios';'Efectivo';'VARIABLES'
11/05/2009;11/05/2009;'CAFET.C T PRAT';-2,65€;3.793,90 €;-635;-2,65;8.317,99 €;'sin fechas';11/05/2009;'CAFETC';'Gastos_Ocio y transporte';'Restaurantes';'VARIABLES'
12/05/2009;12/05/2009;'CAFET.C T PRAT';-5,90€;3.788,00 €;-634;-5,90;8.312,09 €;'sin fechas';12/05/2009;'CAFETC';'Gastos_Ocio y transporte';'Restaurantes';'VARIABLES'
12/05/2009;08/05/2009;'FOMENT DE TERRASSA, S.A. FOMEN';63,90€;3.851,90 €;-633;63,90;8.375,99 €;'sin fechas';08/05/2009;'FOMENT';'Ingresos';'Nomina';'FIJO'
12/05/2009;11/05/2009;'Ordenador';-34,00€;3.817,90 €;-632;-34,00;8.341,99 €;'sin fechas';11/05/2009;'ORDENADOR';'Gastos_Compras';'Hobbys';'VARIABLES'
13/05/2009;13/05/2009;'CAFET.C T PRAT';-3,15€;3.814,75 €;-631;-3,15;8.338,84 €;'sin fechas';13/05/2009;'CAFETC';'Gastos_Ocio y transporte';'Restaurantes';'VARIABLES'
13/05/2009;13/05/2009;'GASOLINA';-32,56€;3.782,19 €;-630;-32,56;8.306,28 €;'sin fechas';13/05/2009;'GASOLINA';'Gastos_Ocio y transporte';'Gasolina';'VARIABLES'
14/05/2009;14/05/2009;'CAFET.C T PRAT';-2,95€;3.779,24 €;-629;-2,95;8.303,33 €;'sin fechas';14/05/2009;'CAFETC';'Gastos_Ocio y transporte';'Restaurantes';'VARIABLES'
14/05/2009;14/05/2009;'FF.CC.GENERALITAT';-2,85€;3.776,39 €;-628;-2,85;8.300,48 €;'sin fechas';14/05/2009;'FFCCGENERALITAT';'Gastos_Ocio y transporte';'Transporte';'VARIABLES'
14/05/2009;14/05/2009;'FF.CC.GENERALITAT';-2,85€;3.773,54 €;-627;-2,85;8.297,63 €;'sin fechas';14/05/2009;'FFCCGENERALITAT';'Gastos_Ocio y transporte';'Transporte';'VARIABLES'
14/05/2009;14/05/2009;'METRO';-1,35€;3.772,19 €;-626;-1,35;8.296,28 €;'sin fechas';14/05/2009;'METRO';'Gastos_Ocio y transporte';'Transporte';'VARIABLES'
14/05/2009;14/05/2009;'METRO';-1,35€;3.770,84 €;-625;-1,35;8.294,93 €;'sin fechas';14/05/2009;'METRO';'Gastos_Ocio y transporte';'Transporte';'VARIABLES'
14/05/2009;14/05/2009;'METRO';-1,35€;3.769,49 €;-624;-1,35;8.293,58 €;'sin fechas';14/05/2009;'METRO';'Gastos_Ocio y transporte';'Transporte';'VARIABLES'
15/05/2009;15/05/2009;'SEG.AM.HIPITEC';-31,07€;3.738,42 €;-623;-31,07;8.262,51 €;'sin fechas';15/05/2009;'SEGAMHIPITEC';'Gastos_Seguros';'Seguro vida';'FIJO'
16/05/2009;21/05/2009;'COMPRA CON TARJETA';-3,15€;3.735,27 €;-622;-3,15;8.259,36 €;'sin fechas';21/05/2009;'COMPRA';'Gastos_Compras';'Supermercado';'VARIABLES'
16/05/2009;16/05/2009;'KANAK BARCELONA S';-47,90€;3.687,37 €;-621;-47,90;8.211,46 €;'sin fechas';16/05/2009;'KANAK';'Gastos_Compras';'Ropa';'VARIABLES'
16/05/2009;16/05/2009;'MEDIA MARKT';-134,99€;3.552,38 €;-620;-134,99;8.076,47 €;'sin fechas';16/05/2009;'MEDIA';'Gastos_Compras';'Hobbys';'VARIABLES'
18/05/2009;18/05/2009;'CAFET.C T PRAT';-3,70€;3.548,68 €;-619;-3,70;8.072,77 €;'sin fechas';18/05/2009;'CAFETC';'Gastos_Ocio y transporte';'Restaurantes';'VARIABLES'
19/05/2009;19/05/2009;'AMC PARC VALLES';-8,40€;3.540,28 €;-618;-8,40;8.064,37 €;'sin fechas';19/05/2009;'AMC';'Gastos_Ocio y transporte';'Espectáculos';'VARIABLES'
19/05/2009;19/05/2009;'CAFET.C T PRAT';-3,20€;3.537,08 €;-617;-3,20;8.061,17 €;'sin fechas';19/05/2009;'CAFETC';'Gastos_Ocio y transporte';'Restaurantes';'VARIABLES'
19/05/2009;19/05/2009;'DECATHLON';-19,80€;3.517,28 €;-616;-19,80;8.041,37 €;'sin fechas';19/05/2009;'DECATHLON';'Gastos_Compras';'Deportivo';'VARIABLES'
19/05/2009;19/05/2009;'I TORRE TERRASA';-9,30€;3.507,98 €;-615;-9,30;8.032,07 €;'sin fechas';19/05/2009;'TORRE';'Gastos_Ocio y transporte';'Restaurantes';'VARIABLES'
19/05/2009;19/05/2009;'ONO';-78,10€;3.429,88 €;-614;-78,10;7.953,97 €;'sin fechas';19/05/2009;'ONO';'Gastos_Servicios tipicos';'Telecomunicaciones';'FIJO'
19/05/2009;19/05/2009;'VIENA';-9,75€;3.420,13 €;-613;-9,75;7.944,22 €;'sin fechas';19/05/2009;'VIENA';'Gastos_Ocio y transporte';'Restaurantes';'VARIABLES'
20/05/2009;20/05/2009;'CAFET.C T PRAT';-3,45€;3.416,68 €;-612;-3,45;7.940,77 €;'sin fechas';20/05/2009;'CAFETC';'Gastos_Ocio y transporte';'Restaurantes';'VARIABLES'
21/05/2009;21/05/2009;'CAFET.C T PRAT';-2,55€;3.414,13 €;-611;-2,55;7.938,22 €;'sin fechas';21/05/2009;'CAFETC';'Gastos_Ocio y transporte';'Restaurantes';'VARIABLES'
21/05/2009;21/05/2009;'ENDESA DISTRIB';-67,64€;3.346,49 €;-610;-67,64;7.870,58 €;'sin fechas';21/05/2009;'ENDESA';'Gastos_Servicios tipicos';'Electricidad';'FIJO'
21/05/2009;21/05/2009;'FRANCE TELECOM';-31,34€;3.315,15 €;-609;-31,34;7.839,24 €;'sin fechas';21/05/2009;'FRANCE';'Gastos_Servicios tipicos';'Telecomunicaciones';'FIJO'
21/05/2009;21/05/2009;'REINT.CAJERO';-30,00€;3.285,15 €;-608;-30,00;7.809,24 €;'sin fechas';21/05/2009;'REINTCAJERO';'Gastos_Gastos varios';'Efectivo';'VARIABLES'
22/05/2009;22/05/2009;'CAFET.C T PRAT';-2,55€;3.282,60 €;-607;-2,55;7.806,69 €;'sin fechas';22/05/2009;'CAFETC';'Gastos_Ocio y transporte';'Restaurantes';'VARIABLES'
22/05/2009;22/05/2009;'MERCADONA';-117,22€;3.165,38 €;-606;-117,22;7.689,47 €;'sin fechas';22/05/2009;'MERCADONA';'Gastos_Compras';'Supermercado';'VARIABLES'
23/05/2009;23/05/2009;'CARREFOUR-[comida]';-48,75€;3.116,63 €;-605;-48,75;7.640,72 €;'sin fechas';23/05/2009;'CARREFOURCOMIDA';'Gastos_Compras';'Supermercado';'VARIABLES'
23/05/2009;23/05/2009;'CARREFOUR-[comida]';-155,33€;2.961,30 €;-604;-155,33;7.485,39 €;'sin fechas';23/05/2009;'CARREFOURCOMIDA';'Gastos_Compras';'Supermercado';'VARIABLES'
23/05/2009;23/05/2009;'GASOLINA';-29,59€;2.931,71 €;-603;-29,59;7.455,80 €;'sin fechas';23/05/2009;'GASOLINA';'Gastos_Ocio y transporte';'Gasolina';'VARIABLES'
23/05/2009;23/05/2009;'IKEA';-22,30€;2.909,41 €;-602;-22,30;7.433,50 €;'sin fechas';23/05/2009;'IKEA';'Gastos_Vivienda y vehiculo';'Mnto. hogar';'VARIABLES'
23/05/2009;23/05/2009;'IKEA';-23,64€;2.885,77 €;-601;-23,64;7.409,86 €;'sin fechas';23/05/2009;'IKEA';'Gastos_Vivienda y vehiculo';'Mnto. hogar';'VARIABLES'
23/05/2009;23/05/2009;'KIABI SANT BOI';-30,95€;2.854,82 €;-600;-30,95;7.378,91 €;'sin fechas';23/05/2009;'KIABI';'Gastos_Compras';'Ropa';'VARIABLES'
25/05/2009;25/05/2009;'CAFET.C T PRAT';-2,65€;2.852,17 €;-599;-2,65;7.376,26 €;'sin fechas';25/05/2009;'CAFETC';'Gastos_Ocio y transporte';'Restaurantes';'VARIABLES'
26/05/2009;26/05/2009;'CAFET.C T PRAT';-4,95€;2.847,22 €;-598;-4,95;7.371,31 €;'sin fechas';26/05/2009;'CAFETC';'Gastos_Ocio y transporte';'Restaurantes';'VARIABLES'
26/05/2009;26/05/2009;'CARREFOUR-[comida]';79,00€;2.926,22 €;-597;79,00;7.450,31 €;'sin fechas';26/05/2009;'CARREFOURCOMIDA';'Gastos_Compras';'Supermercado';'VARIABLES'
27/05/2009;27/05/2009;'AMC PARC VALLES';-8,40€;2.917,82 €;-596;-8,40;7.441,91 €;'sin fechas';27/05/2009;'AMC';'Gastos_Ocio y transporte';'Espectáculos';'VARIABLES'
27/05/2009;27/05/2009;'CAFET.C T PRAT';-2,15€;2.915,67 €;-595;-2,15;7.439,76 €;'sin fechas';27/05/2009;'CAFETC';'Gastos_Ocio y transporte';'Restaurantes';'VARIABLES'
27/05/2009;27/05/2009;'CAFET.C T PRAT';-2,15€;2.913,52 €;-594;-2,15;7.437,61 €;'sin fechas';27/05/2009;'CAFETC';'Gastos_Ocio y transporte';'Restaurantes';'VARIABLES'
27/05/2009;02/06/2009;'COMPRA CON TARJETA';-6,85€;2.906,67 €;-593;-6,85;7.430,76 €;'sin fechas';02/06/2009;'COMPRA';'Gastos_Compras';'Supermercado';'VARIABLES'
27/05/2009;27/05/2009;'FRANCE TELECOM';-14,48€;2.892,19 €;-592;-14,48;7.416,28 €;'sin fechas';27/05/2009;'FRANCE';'Gastos_Servicios tipicos';'Telecomunicaciones';'FIJO'
27/05/2009;27/05/2009;'LA TORRE TERRASA';-12,15€;2.880,04 €;-591;-12,15;7.404,13 €;'sin fechas';27/05/2009;'TORRE';'Gastos_Ocio y transporte';'Restaurantes';'VARIABLES'
28/05/2009;28/05/2009;'CAFET.C T PRAT';-3,70€;2.876,34 €;-590;-3,70;7.400,43 €;'sin fechas';28/05/2009;'CAFETC';'Gastos_Ocio y transporte';'Restaurantes';'VARIABLES'
29/05/2009;29/05/2009;'CAFET.C T PRAT';-3,25€;2.873,09 €;-589;-3,25;7.397,18 €;'sin fechas';29/05/2009;'CAFETC';'Gastos_Ocio y transporte';'Restaurantes';'VARIABLES'
29/05/2009;28/05/2009;'INFORMACIO I TECNOLOGIA DE CAT';1.580,24€;4.453,33 €;-588;1.580,24;8.977,42 €;'sin fechas';28/05/2009;'INFORMACIO';'Ingresos';'Nomina';'FIJO'
29/05/2009;29/05/2009;'JIANHONG ZHOU S.L.';-44,94€;4.408,39 €;-587;-44,94;8.932,48 €;'sin fechas';29/05/2009;'JIANHONG';'Gastos_Ocio y transporte';'Restaurantes';'VARIABLES'
29/05/2009;29/05/2009;'Ordenador';-34,00€;4.374,39 €;-586;-34,00;8.898,48 €;'sin fechas';29/05/2009;'ORDENADOR';'Gastos_Compras';'Hobbys';'VARIABLES'
30/05/2009;30/05/2009;'IKEA';-8,05€;4.366,34 €;-585;-8,05;8.890,43 €;'sin fechas';30/05/2009;'IKEA';'Gastos_Vivienda y vehiculo';'Mnto. hogar';'VARIABLES'
30/05/2009;30/05/2009;'IKEA';-40,84€;4.325,50 €;-584;-40,84;8.849,59 €;'sin fechas';30/05/2009;'IKEA';'Gastos_Vivienda y vehiculo';'Mnto. hogar';'VARIABLES'
30/05/2009;30/05/2009;'VIENA';-15,30€;4.310,20 €;-583;-15,30;8.834,29 €;'sin fechas';30/05/2009;'VIENA';'Gastos_Ocio y transporte';'Restaurantes';'VARIABLES'
31/05/2009;31/05/2009;'LA BRASA';-11,65€;4.298,55 €;-582;-11,65;8.822,64 €;'sin fechas';31/05/2009;'BRASA';'Gastos_Ocio y transporte';'Restaurantes';'VARIABLES'
31/05/2009;28/05/2009;'RECIBO PTMOS. 3061-0960001518';-865,73€;3.432,82 €;-581;-865,73;7.956,91 €;'sin fechas';28/05/2009;'RECIBO';'Gastos_Banco y organismos';'Hipoteca';'FIJO'
31/05/2009;28/05/2009;'RECIBO PTMOS. 3061-0960004140';-177,24€;3.255,58 €;-580;-177,24;7.779,67 €;'sin fechas';28/05/2009;'RECIBO';'Gastos_Banco y organismos';'Hipoteca';'FIJO'
01/06/2009;01/06/2009;'CIA. DE SEGUROS 006662671613';-33,90€;3.221,68 €;-579;-33,90;7.745,77 €;'sin fechas';01/06/2009;'CIA';'Ingresos';'Devoluciones';'VARIABLES'
01/06/2009;28/05/2009;'FOMENT DE TERRASSA, S.A. FOMEN';1.632,21€;4.853,89 €;-578;1.632,21;9.377,98 €;'sin fechas';28/05/2009;'FOMENT';'Ingresos';'Nomina';'FIJO'
01/06/2009;01/06/2009;'GASOLINA';-31,13€;4.822,76 €;-577;-31,13;9.346,85 €;'sin fechas';01/06/2009;'GASOLINA';'Gastos_Ocio y transporte';'Gasolina';'VARIABLES'
01/06/2009;01/06/2009;'MARCO ALDANY';-9,99€;4.812,77 €;-576;-9,99;9.336,86 €;'sin fechas';01/06/2009;'MARCO';'Gastos_Salud, saber y deporte';'Belleza';'VARIABLES'
01/06/2009;01/06/2009;'REST.JAPONES KIYOT';-31,94€;4.780,83 €;-575;-31,94;9.304,92 €;'sin fechas';01/06/2009;'RESTJAPONES';'Gastos_Ocio y transporte';'Restaurantes';'VARIABLES'
02/06/2009;02/06/2009;'BURGUER KING PARK';-9,40€;4.771,43 €;-574;-9,40;9.295,52 €;'sin fechas';02/06/2009;'BURGUER';'Gastos_Ocio y transporte';'Restaurantes';'VARIABLES'
02/06/2009;02/06/2009;'CAFET.C T PRAT';-2,55€;4.768,88 €;-573;-2,55;9.292,97 €;'sin fechas';02/06/2009;'CAFETC';'Gastos_Ocio y transporte';'Restaurantes';'VARIABLES'
02/06/2009;02/06/2009;'CAPRABO';-12,61€;4.756,27 €;-572;-12,61;9.280,36 €;'sin fechas';02/06/2009;'CAPRABO';'Gastos_Compras';'Supermercado';'VARIABLES'
02/06/2009;02/06/2009;'FF.CC.GENERALITAT';-2,05€;4.754,22 €;-571;-2,05;9.278,31 €;'sin fechas';02/06/2009;'FFCCGENERALITAT';'Gastos_Ocio y transporte';'Transporte';'VARIABLES'
03/06/2009;03/06/2009;'AMC PARC VALLES';-8,40€;4.745,82 €;-570;-8,40;9.269,91 €;'sin fechas';03/06/2009;'AMC';'Gastos_Ocio y transporte';'Espectáculos';'VARIABLES'
03/06/2009;03/06/2009;'CAFET.C T PRAT';-2,60€;4.743,22 €;-569;-2,60;9.267,31 €;'sin fechas';03/06/2009;'CAFETC';'Gastos_Ocio y transporte';'Restaurantes';'VARIABLES'
03/06/2009;03/06/2009;'JIANHONG ZHOU S.L.';-21,93€;4.721,29 €;-568;-21,93;9.245,38 €;'sin fechas';03/06/2009;'JIANHONG';'Gastos_Ocio y transporte';'Restaurantes';'VARIABLES'
03/06/2009;03/06/2009;'REINT.CAJERO';-100,00€;4.621,29 €;-567;-100,00;9.145,38 €;'sin fechas';03/06/2009;'REINTCAJERO';'Gastos_Gastos varios';'Efectivo';'VARIABLES'
04/06/2009;04/06/2009;'ACE SEGUROS';-16,27€;4.605,02 €;-566;-16,27;9.129,11 €;'sin fechas';04/06/2009;'ACE';'Gastos_Compras';'Ropa';'VARIABLES'
04/06/2009;04/06/2009;'CAFET.C T PRAT';-1,85€;4.603,17 €;-565;-1,85;9.127,26 €;'sin fechas';04/06/2009;'CAFETC';'Gastos_Ocio y transporte';'Restaurantes';'VARIABLES'
05/06/2009;05/06/2009;'FARMACIA';-20,42€;4.582,75 €;-564;-20,42;9.106,84 €;'sin fechas';05/06/2009;'FARMACIA';'Gastos_Salud, saber y deporte';'Farmacia';'VARIABLES'
05/06/2009;05/06/2009;'GRINZING';-4,95€;4.577,80 €;-563;-4,95;9.101,89 €;'sin fechas';05/06/2009;'GRINZING';'Gastos_Ocio y transporte';'Restaurantes';'VARIABLES'
05/06/2009;05/06/2009;'MERCADONA';-21,96€;4.555,84 €;-562;-21,96;9.079,93 €;'sin fechas';05/06/2009;'MERCADONA';'Gastos_Compras';'Supermercado';'VARIABLES'
05/06/2009;05/06/2009;'VIRGIN ACTIVE';-59,00€;4.496,84 €;-561;-59,00;9.020,93 €;'sin fechas';05/06/2009;'VIRGIN';'Gastos_Salud, saber y deporte';'Deportes';'VARIABLES'
05/06/2009;05/06/2009;'VIRGIN ACTIVE';-59,00€;4.437,84 €;-560;-59,00;8.961,93 €;'sin fechas';05/06/2009;'VIRGIN';'Gastos_Salud, saber y deporte';'Deportes';'VARIABLES'
07/06/2009;07/06/2009;'FILMAX CASTELL\\CASTELLDEFEL';-13,00€;4.424,84 €;-559;-13,00;8.948,93 €;'sin fechas';07/06/2009;'FILMAX';'Gastos_Ocio y transporte';'Espectáculos';'VARIABLES'
07/06/2009;07/06/2009;'SPRINGFIELD';-33,90€;4.390,94 €;-558;-33,90;8.915,03 €;'sin fechas';07/06/2009;'SPRINGFIELD';'Gastos_Compras';'Ropa';'VARIABLES'
09/06/2009;09/06/2009;'CAFET.C T PRAT';-2,55€;4.388,39 €;-557;-2,55;8.912,48 €;'sin fechas';09/06/2009;'CAFETC';'Gastos_Ocio y transporte';'Restaurantes';'VARIABLES'
09/06/2009;09/06/2009;'FF.CC.GENERALITAT';-1,35€;4.387,04 €;-556;-1,35;8.911,13 €;'sin fechas';09/06/2009;'FFCCGENERALITAT';'Gastos_Ocio y transporte';'Transporte';'VARIABLES'
09/06/2009;09/06/2009;'GAS NATURAL';-89,37€;4.297,67 €;-555;-89,37;8.821,76 €;'sin fechas';09/06/2009;'GAS';'Gastos_Servicios tipicos';'Gas';'FIJO'
10/06/2009;10/06/2009;'MERCADONA';-29,35€;4.268,32 €;-554;-29,35;8.792,41 €;'sin fechas';10/06/2009;'MERCADONA';'Gastos_Compras';'Supermercado';'VARIABLES'
11/06/2009;11/06/2009;'VIENA';-5,00€;4.263,32 €;-553;-5,00;8.787,41 €;'sin fechas';11/06/2009;'VIENA';'Gastos_Ocio y transporte';'Restaurantes';'VARIABLES'
12/06/2009;12/06/2009;'AMC PARC VALLES';-14,00€;4.249,32 €;-552;-14,00;8.773,41 €;'sin fechas';12/06/2009;'AMC';'Gastos_Ocio y transporte';'Espectáculos';'VARIABLES'
12/06/2009;12/06/2009;'CAFET.C T PRAT';-3,70€;4.245,62 €;-551;-3,70;8.769,71 €;'sin fechas';12/06/2009;'CAFETC';'Gastos_Ocio y transporte';'Restaurantes';'VARIABLES'
12/06/2009;12/06/2009;'GASOLINA';-35,54€;4.210,08 €;-550;-35,54;8.734,17 €;'sin fechas';12/06/2009;'GASOLINA';'Gastos_Ocio y transporte';'Gasolina';'VARIABLES'
12/06/2009;12/06/2009;'VIENA';-14,05€;4.196,03 €;-549;-14,05;8.720,12 €;'sin fechas';12/06/2009;'VIENA';'Gastos_Ocio y transporte';'Restaurantes';'VARIABLES'
13/06/2009;13/06/2009;'ALCAMPO';-45,65€;4.150,38 €;-548;-45,65;8.674,47 €;'sin fechas';13/06/2009;'ALCAMPO';'Gastos_Compras';'Supermercado';'VARIABLES'
13/06/2009;13/06/2009;'CARREFOUR-[comida]';-109,05€;4.041,33 €;-547;-109,05;8.565,42 €;'sin fechas';13/06/2009;'CARREFOURCOMIDA';'Gastos_Compras';'Supermercado';'VARIABLES'
13/06/2009;13/06/2009;'CINE';-15,20€;4.026,13 €;-546;-15,20;8.550,22 €;'sin fechas';13/06/2009;'CINE';'Gastos_Ocio y transporte';'Espectáculos';'VARIABLES'
13/06/2009;13/06/2009;'GAME';-39,95€;3.986,18 €;-545;-39,95;8.510,27 €;'sin fechas';13/06/2009;'GAME';'Gastos_Compras';'Hobbys';'VARIABLES'
13/06/2009;13/06/2009;'H&M';-24,90€;3.961,28 €;-544;-24,90;8.485,37 €;'sin fechas';13/06/2009;'HM';'Gastos_Compras';'Ropa';'VARIABLES'
13/06/2009;13/06/2009;'KIABI SANT BOI';-60,85€;3.900,43 €;-543;-60,85;8.424,52 €;'sin fechas';13/06/2009;'KIABI';'Gastos_Compras';'Ropa';'VARIABLES'
13/06/2009;13/06/2009;'MAYDO';-46,90€;3.853,53 €;-542;-46,90;8.377,62 €;'sin fechas';13/06/2009;'MAYDO';'Gastos_Compras';'Ropa';'VARIABLES'
13/06/2009;13/06/2009;'REST.NOU PORT';-23,65€;3.829,88 €;-541;-23,65;8.353,97 €;'sin fechas';13/06/2009;'RESTNOU';'Gastos_Ocio y transporte';'Restaurantes';'VARIABLES'
13/06/2009;13/06/2009;'SPRINGFIELD';-60,80€;3.769,08 €;-540;-60,80;8.293,17 €;'sin fechas';13/06/2009;'SPRINGFIELD';'Gastos_Compras';'Ropa';'VARIABLES'
13/06/2009;13/06/2009;'VIENA';-10,35€;3.758,73 €;-539;-10,35;8.282,82 €;'sin fechas';13/06/2009;'VIENA';'Gastos_Ocio y transporte';'Restaurantes';'VARIABLES'
15/06/2009;15/06/2009;'CAFET.C T PRAT';-2,95€;3.755,78 €;-538;-2,95;8.279,87 €;'sin fechas';15/06/2009;'CAFETC';'Gastos_Ocio y transporte';'Restaurantes';'VARIABLES'
15/06/2009;15/06/2009;'MERCADONA';-18,98€;3.736,80 €;-537;-18,98;8.260,89 €;'sin fechas';15/06/2009;'MERCADONA';'Gastos_Compras';'Supermercado';'VARIABLES'
15/06/2009;15/06/2009;'SEG.AM.HIPITEC';-31,02€;3.705,78 €;-536;-31,02;8.229,87 €;'sin fechas';15/06/2009;'SEGAMHIPITEC';'Gastos_Seguros';'Seguro vida';'FIJO'
16/06/2009;16/06/2009;'CAFET.C T PRAT';-3,85€;3.701,93 €;-535;-3,85;8.226,02 €;'sin fechas';16/06/2009;'CAFETC';'Gastos_Ocio y transporte';'Restaurantes';'VARIABLES'
17/06/2009;17/06/2009;'ENDESA DISTRIB';-34,59€;3.667,34 €;-534;-34,59;8.191,43 €;'sin fechas';17/06/2009;'ENDESA';'Gastos_Servicios tipicos';'Electricidad';'FIJO'
18/06/2009;18/06/2009;'CAFET.C T PRAT';-3,40€;3.663,94 €;-533;-3,40;8.188,03 €;'sin fechas';18/06/2009;'CAFETC';'Gastos_Ocio y transporte';'Restaurantes';'VARIABLES'
18/06/2009;18/06/2009;'MINA PUBLICA DE LA CIUTAT';-24,58€;3.639,36 €;-532;-24,58;8.163,45 €;'sin fechas';18/06/2009;'MINA';'Gastos_Servicios tipicos';'Agua';'FIJO'
18/06/2009;18/06/2009;'ONO';-83,68€;3.555,68 €;-531;-83,68;8.079,77 €;'sin fechas';18/06/2009;'ONO';'Gastos_Servicios tipicos';'Telecomunicaciones';'FIJO'
18/06/2009;18/06/2009;'REINT.CAJERO';-60,00€;3.495,68 €;-530;-60,00;8.019,77 €;'sin fechas';18/06/2009;'REINTCAJERO';'Gastos_Gastos varios';'Efectivo';'VARIABLES'
19/06/2009;19/06/2009;'CAFET.C T PRAT';-3,40€;3.492,28 €;-529;-3,40;8.016,37 €;'sin fechas';19/06/2009;'CAFETC';'Gastos_Ocio y transporte';'Restaurantes';'VARIABLES'
20/06/2009;20/06/2009;'CIA TROPICO DE CA';-21,50€;3.470,78 €;-528;-21,50;7.994,87 €;'sin fechas';20/06/2009;'CIA';'Ingresos';'Devoluciones';'VARIABLES'
20/06/2009;20/06/2009;'EROSKI-[COMIDA]';-61,70€;3.409,08 €;-527;-61,70;7.933,17 €;'sin fechas';20/06/2009;'EROSKICOMIDA';'Gastos_Compras';'Supermercado';'VARIABLES'
20/06/2009;20/06/2009;'KANAK BARCELONA S';-100,75€;3.308,33 €;-526;-100,75;7.832,42 €;'sin fechas';20/06/2009;'KANAK';'Gastos_Compras';'Ropa';'VARIABLES'
20/06/2009;20/06/2009;'M&S';-33,93€;3.274,40 €;-525;-33,93;7.798,49 €;'sin fechas';20/06/2009;'MS';'Gastos_Compras';'Ropa';'VARIABLES'
20/06/2009;20/06/2009;'VIENA';-3,15€;3.271,25 €;-524;-3,15;7.795,34 €;'sin fechas';20/06/2009;'VIENA';'Gastos_Ocio y transporte';'Restaurantes';'VARIABLES'
22/06/2009;22/06/2009;'GASOLINA';-36,45€;3.234,80 €;-523;-36,45;7.758,89 €;'sin fechas';22/06/2009;'GASOLINA';'Gastos_Ocio y transporte';'Gasolina';'VARIABLES'
23/06/2009;23/06/2009;'CAFET.C T PRAT';-2,95€;3.231,85 €;-522;-2,95;7.755,94 €;'sin fechas';23/06/2009;'CAFETC';'Gastos_Ocio y transporte';'Restaurantes';'VARIABLES'
23/06/2009;19/06/2009;'FOMENT DE TERRASSA, S.A. FOMEN';3.417,27€;6.649,12 €;-521;3.417,27;11.173,21 €;'sin fechas';19/06/2009;'FOMENT';'Ingresos';'Nomina';'FIJO'
23/06/2009;23/06/2009;'FRANCE TELECOM';-10,44€;6.638,68 €;-520;-10,44;11.162,77 €;'sin fechas';23/06/2009;'FRANCE';'Gastos_Servicios tipicos';'Telecomunicaciones';'FIJO'
25/06/2009;25/06/2009;'EROSKI-[COMIDA]';-65,48€;6.573,20 €;-519;-65,48;11.097,29 €;'sin fechas';25/06/2009;'EROSKICOMIDA';'Gastos_Compras';'Supermercado';'VARIABLES'
25/06/2009;25/06/2009;'REINT.CAJERO';-200,00€;6.373,20 €;-518;-200,00;10.897,29 €;'sin fechas';25/06/2009;'REINTCAJERO';'Gastos_Gastos varios';'Efectivo';'VARIABLES'
26/06/2009;26/06/2009;'FRANCE TELECOM';-19,23€;6.353,97 €;-517;-19,23;10.878,06 €;'sin fechas';26/06/2009;'FRANCE';'Gastos_Servicios tipicos';'Telecomunicaciones';'FIJO'
26/06/2009;26/06/2009;'PEIXOS POVILL \\MONISTROL DE';-44,49€;6.309,48 €;-516;-44,49;10.833,57 €;'sin fechas';26/06/2009;'PEIXOS';'Gastos_Compras';'Supermercado';'VARIABLES'
27/06/2009;27/06/2009;'LACTUCA';-21,40€;6.288,08 €;-515;-21,40;10.812,17 €;'sin fechas';27/06/2009;'LACTUCA';'Gastos_Ocio y transporte';'Restaurantes';'VARIABLES'
27/06/2009;27/06/2009;'STARBUCKS COFFEE';-8,65€;6.279,43 €;-514;-8,65;10.803,52 €;'sin fechas';27/06/2009;'STARBUCKS';'Gastos_Ocio y transporte';'Restaurantes';'VARIABLES'
29/06/2009;29/06/2009;'CAFET.C T PRAT';-2,00€;6.277,43 €;-513;-2,00;10.801,52 €;'sin fechas';29/06/2009;'CAFETC';'Gastos_Ocio y transporte';'Restaurantes';'VARIABLES'
29/06/2009;26/06/2009;'INFORMACIO I TECNOLOGIA DE CAT';1.580,24€;7.857,67 €;-512;1.580,24;12.381,76 €;'sin fechas';26/06/2009;'INFORMACIO';'Ingresos';'Nomina';'FIJO'
30/06/2009;30/06/2009;'C&A';-8,50€;7.849,17 €;-511;-8,50;12.373,26 €;'sin fechas';30/06/2009;'CA';'Gastos_Compras';'Ropa';'VARIABLES'
30/06/2009;30/06/2009;'CAFET.C T PRAT';-2,15€;7.847,02 €;-510;-2,15;12.371,11 €;'sin fechas';30/06/2009;'CAFETC';'Gastos_Ocio y transporte';'Restaurantes';'VARIABLES'
30/06/2009;30/06/2009;'FARMACIA';-20,23€;7.826,79 €;-509;-20,23;12.350,88 €;'sin fechas';30/06/2009;'FARMACIA';'Gastos_Salud, saber y deporte';'Farmacia';'VARIABLES'
30/06/2009;30/06/2009;'MERCADONA';-157,20€;7.669,59 €;-508;-157,20;12.193,68 €;'sin fechas';30/06/2009;'MERCADONA';'Gastos_Compras';'Supermercado';'VARIABLES'
30/06/2009;30/06/2009;'RECIBO PTMOS. 3061-0960001518';-865,73€;6.803,86 €;-507;-865,73;11.327,95 €;'sin fechas';30/06/2009;'RECIBO';'Gastos_Banco y organismos';'Hipoteca';'FIJO'
30/06/2009;30/06/2009;'RECIBO PTMOS. 3061-0960004140';-177,24€;6.626,62 €;-506;-177,24;11.150,71 €;'sin fechas';30/06/2009;'RECIBO';'Gastos_Banco y organismos';'Hipoteca';'FIJO'
01/07/2009;01/07/2009;'AJUNTAMENT DE TERRASSA';-36,81€;6.589,81 €;-505;-36,81;11.113,90 €;'sin fechas';01/07/2009;'AJUNTAMENT';'Gastos_Banco y organismos';'Ayuntamiento';'FIJO'
01/07/2009;01/07/2009;'AMC PARC VALLES';-8,40€;6.581,41 €;-504;-8,40;11.105,50 €;'sin fechas';01/07/2009;'AMC';'Gastos_Ocio y transporte';'Espectáculos';'VARIABLES'
01/07/2009;01/07/2009;'CAFET.C T PRAT';-3,40€;6.578,01 €;-503;-3,40;11.102,10 €;'sin fechas';01/07/2009;'CAFETC';'Gastos_Ocio y transporte';'Restaurantes';'VARIABLES'
01/07/2009;01/07/2009;'CIA. DE SEGUROS 006662671613';-33,90€;6.544,11 €;-502;-33,90;11.068,20 €;'sin fechas';01/07/2009;'CIA';'Ingresos';'Devoluciones';'VARIABLES'
01/07/2009;07/07/2009;'COMPRA CON TARJETA';-2,50€;6.541,61 €;-501;-2,50;11.065,70 €;'sin fechas';07/07/2009;'COMPRA';'Gastos_Compras';'Supermercado';'VARIABLES'
02/07/2009;02/07/2009;'CAFET.C T PRAT';-2,95€;6.538,66 €;-500;-2,95;11.062,75 €;'sin fechas';02/07/2009;'CAFETC';'Gastos_Ocio y transporte';'Restaurantes';'VARIABLES'
02/07/2009;02/07/2009;'GASOLINA';-42,72€;6.495,94 €;-499;-42,72;11.020,03 €;'sin fechas';02/07/2009;'GASOLINA';'Gastos_Ocio y transporte';'Gasolina';'VARIABLES'
03/07/2009;03/07/2009;'ACE SEGUROS';-16,27€;6.479,67 €;-498;-16,27;11.003,76 €;'sin fechas';03/07/2009;'ACE';'Gastos_Compras';'Ropa';'VARIABLES'
03/07/2009;03/07/2009;'CAFET.C T PRAT';-7,15€;6.472,52 €;-497;-7,15;10.996,61 €;'sin fechas';03/07/2009;'CAFETC';'Gastos_Ocio y transporte';'Restaurantes';'VARIABLES'
03/07/2009;03/07/2009;'CINE';-22,80€;6.449,72 €;-496;-22,80;10.973,81 €;'sin fechas';03/07/2009;'CINE';'Gastos_Ocio y transporte';'Espectáculos';'VARIABLES'
03/07/2009;03/07/2009;'METRO';-1,35€;6.448,37 €;-495;-1,35;10.972,46 €;'sin fechas';03/07/2009;'METRO';'Gastos_Ocio y transporte';'Transporte';'VARIABLES'
03/07/2009;03/07/2009;'RENFE';-1,35€;6.447,02 €;-494;-1,35;10.971,11 €;'sin fechas';03/07/2009;'RENFE';'Gastos_Ocio y transporte';'Transporte';'VARIABLES'
03/07/2009;03/07/2009;'VIRGIN ACTIVE';-59,00€;6.388,02 €;-493;-59,00;10.912,11 €;'sin fechas';03/07/2009;'VIRGIN';'Gastos_Salud, saber y deporte';'Deportes';'VARIABLES'
03/07/2009;03/07/2009;'VIRGIN ACTIVE';-59,00€;6.329,02 €;-492;-59,00;10.853,11 €;'sin fechas';03/07/2009;'VIRGIN';'Gastos_Salud, saber y deporte';'Deportes';'VARIABLES'
04/07/2009;04/07/2009;'CANTINA MARIACHI';-63,50€;6.265,52 €;-491;-63,50;10.789,61 €;'sin fechas';04/07/2009;'CANTINA';'Gastos_Ocio y transporte';'Restaurantes';'VARIABLES'
04/07/2009;04/07/2009;'KIABI SANT BOI';-16,98€;6.248,54 €;-490;-16,98;10.772,63 €;'sin fechas';04/07/2009;'KIABI';'Gastos_Compras';'Ropa';'VARIABLES'
04/07/2009;04/07/2009;'SPRINGFIELD';-39,95€;6.208,59 €;-489;-39,95;10.732,68 €;'sin fechas';04/07/2009;'SPRINGFIELD';'Gastos_Compras';'Ropa';'VARIABLES'
06/07/2009;06/07/2009;'CAFET.C T PRAT';-7,15€;6.201,44 €;-488;-7,15;10.725,53 €;'sin fechas';06/07/2009;'CAFETC';'Gastos_Ocio y transporte';'Restaurantes';'VARIABLES'
06/07/2009;06/07/2009;'Ordenador';-34,00€;6.167,44 €;-487;-34,00;10.691,53 €;'sin fechas';06/07/2009;'ORDENADOR';'Gastos_Compras';'Hobbys';'VARIABLES'
06/07/2009;06/07/2009;'Parking Julio,Agosto, Septiemb';-180,00€;5.987,44 €;-486;-180,00;10.511,53 €;'sin fechas';06/07/2009;'PARKING';'Gastos_Ocio y transporte';'Parking y peaje';'VARIABLES'
07/07/2009;07/07/2009;'CAFET.C T PRAT';-3,40€;5.984,04 €;-485;-3,40;10.508,13 €;'sin fechas';07/07/2009;'CAFETC';'Gastos_Ocio y transporte';'Restaurantes';'VARIABLES'
08/07/2009;08/07/2009;'CAFET.C T PRAT';-2,90€;5.981,14 €;-484;-2,90;10.505,23 €;'sin fechas';08/07/2009;'CAFETC';'Gastos_Ocio y transporte';'Restaurantes';'VARIABLES'
09/07/2009;09/07/2009;'ALCAMPO';-54,39€;5.926,75 €;-483;-54,39;10.450,84 €;'sin fechas';09/07/2009;'ALCAMPO';'Gastos_Compras';'Supermercado';'VARIABLES'
09/07/2009;09/07/2009;'BON AREA';-10,32€;5.916,43 €;-482;-10,32;10.440,52 €;'sin fechas';09/07/2009;'BON';'Gastos_Compras';'Supermercado';'VARIABLES'
09/07/2009;09/07/2009;'CAFET.C T PRAT';-3,50€;5.912,93 €;-481;-3,50;10.437,02 €;'sin fechas';09/07/2009;'CAFETC';'Gastos_Ocio y transporte';'Restaurantes';'VARIABLES'
09/07/2009;09/07/2009;'EROSKI-[COMIDA]';-26,25€;5.886,68 €;-480;-26,25;10.410,77 €;'sin fechas';09/07/2009;'EROSKICOMIDA';'Gastos_Compras';'Supermercado';'VARIABLES'
10/07/2009;10/07/2009;'CAFET.C T PRAT';-3,25€;5.883,43 €;-479;-3,25;10.407,52 €;'sin fechas';10/07/2009;'CAFETC';'Gastos_Ocio y transporte';'Restaurantes';'VARIABLES'
10/07/2009;10/07/2009;'CAPRABO';-19,78€;5.863,65 €;-478;-19,78;10.387,74 €;'sin fechas';10/07/2009;'CAPRABO';'Gastos_Compras';'Supermercado';'VARIABLES'
10/07/2009;10/07/2009;'GASOLINA';-31,66€;5.831,99 €;-477;-31,66;10.356,08 €;'sin fechas';10/07/2009;'GASOLINA';'Gastos_Ocio y transporte';'Gasolina';'VARIABLES'
10/07/2009;10/07/2009;'LA TORRE TERRASA';-9,00€;5.822,99 €;-476;-9,00;10.347,08 €;'sin fechas';10/07/2009;'TORRE';'Gastos_Ocio y transporte';'Restaurantes';'VARIABLES'
10/07/2009;10/07/2009;'MERCADONA';-41,12€;5.781,87 €;-475;-41,12;10.305,96 €;'sin fechas';10/07/2009;'MERCADONA';'Gastos_Compras';'Supermercado';'VARIABLES'
12/07/2009;12/07/2009;'NEW PARK';-23,70€;5.758,17 €;-474;-23,70;10.282,26 €;'sin fechas';12/07/2009;'NEW';'Gastos_Ocio y transporte';'Otros ocio';'VARIABLES'
13/07/2009;13/07/2009;'BRICOKING TERRASSA';-17,95€;5.740,22 €;-473;-17,95;10.264,31 €;'sin fechas';13/07/2009;'BRICOKING';'Gastos_Vivienda y vehiculo';'Mnto. hogar';'VARIABLES'
13/07/2009;13/07/2009;'MERCADONA';-6,58€;5.733,64 €;-472;-6,58;10.257,73 €;'sin fechas';13/07/2009;'MERCADONA';'Gastos_Compras';'Supermercado';'VARIABLES'
14/07/2009;14/07/2009;'ALCAMPO';-22,73€;5.710,91 €;-471;-22,73;10.235,00 €;'sin fechas';14/07/2009;'ALCAMPO';'Gastos_Compras';'Supermercado';'VARIABLES'
14/07/2009;14/07/2009;'PRIMARK';-43,00€;5.667,91 €;-470;-43,00;10.192,00 €;'sin fechas';14/07/2009;'PRIMARK';'Gastos_Compras';'Ropa';'VARIABLES'
14/07/2009;14/07/2009;'REINT.CAJERO';-60,00€;5.607,91 €;-469;-60,00;10.132,00 €;'sin fechas';14/07/2009;'REINTCAJERO';'Gastos_Gastos varios';'Efectivo';'VARIABLES'
15/07/2009;15/07/2009;'CAFET.C T PRAT';-2,40€;5.605,51 €;-468;-2,40;10.129,60 €;'sin fechas';15/07/2009;'CAFETC';'Gastos_Ocio y transporte';'Restaurantes';'VARIABLES'
15/07/2009;15/07/2009;'SEG.AM.HIPITEC';-31,15€;5.574,36 €;-467;-31,15;10.098,45 €;'sin fechas';15/07/2009;'SEGAMHIPITEC';'Gastos_Seguros';'Seguro vida';'FIJO'
16/07/2009;16/07/2009;'CAFET.C T PRAT';-3,15€;5.571,21 €;-466;-3,15;10.095,30 €;'sin fechas';16/07/2009;'CAFETC';'Gastos_Ocio y transporte';'Restaurantes';'VARIABLES'
16/07/2009;16/07/2009;'VIENA';-15,35€;5.555,86 €;-465;-15,35;10.079,95 €;'sin fechas';16/07/2009;'VIENA';'Gastos_Ocio y transporte';'Restaurantes';'VARIABLES'
17/07/2009;17/07/2009;'CAFET.C T PRAT';-2,45€;5.553,41 €;-464;-2,45;10.077,50 €;'sin fechas';17/07/2009;'CAFETC';'Gastos_Ocio y transporte';'Restaurantes';'VARIABLES'
17/07/2009;17/07/2009;'CARREFOUR-[comida]';-39,35€;5.514,06 €;-463;-39,35;10.038,15 €;'sin fechas';17/07/2009;'CARREFOURCOMIDA';'Gastos_Compras';'Supermercado';'VARIABLES'
18/07/2009;18/07/2009;'CAPRABO';-11,54€;5.502,52 €;-462;-11,54;10.026,61 €;'sin fechas';18/07/2009;'CAPRABO';'Gastos_Compras';'Supermercado';'VARIABLES'
18/07/2009;18/07/2009;'GASOLINA';-28,62€;5.473,90 €;-461;-28,62;9.997,99 €;'sin fechas';18/07/2009;'GASOLINA';'Gastos_Ocio y transporte';'Gasolina';'VARIABLES'
20/07/2009;24/07/2009;'COMPRA CON TARJETA';-4,51€;5.469,39 €;-460;-4,51;9.993,48 €;'sin fechas';24/07/2009;'COMPRA';'Gastos_Compras';'Supermercado';'VARIABLES'
20/07/2009;20/07/2009;'EROSKI-[COMIDA]';-52,42€;5.416,97 €;-459;-52,42;9.941,06 €;'sin fechas';20/07/2009;'EROSKICOMIDA';'Gastos_Compras';'Supermercado';'VARIABLES'
20/07/2009;17/07/2009;'INFORMACIO I TECNOLOGIA DE CAT';1.728,41€;7.145,38 €;-458;1.728,41;11.669,47 €;'sin fechas';17/07/2009;'INFORMACIO';'Ingresos';'Nomina';'FIJO'
20/07/2009;20/07/2009;'ONO';-82,22€;7.063,16 €;-457;-82,22;11.587,25 €;'sin fechas';20/07/2009;'ONO';'Gastos_Servicios tipicos';'Telecomunicaciones';'FIJO'
21/07/2009;21/07/2009;'FRANCE TELECOM';-36,96€;7.026,20 €;-456;-36,96;11.550,29 €;'sin fechas';21/07/2009;'FRANCE';'Gastos_Servicios tipicos';'Telecomunicaciones';'FIJO'
22/07/2009;22/07/2009;'CAFET.C T PRAT';-2,45€;7.023,75 €;-455;-2,45;11.547,84 €;'sin fechas';22/07/2009;'CAFETC';'Gastos_Ocio y transporte';'Restaurantes';'VARIABLES'
22/07/2009;22/07/2009;'FF.CC.GENERALITAT';-2,85€;7.020,90 €;-454;-2,85;11.544,99 €;'sin fechas';22/07/2009;'FFCCGENERALITAT';'Gastos_Ocio y transporte';'Transporte';'VARIABLES'
22/07/2009;22/07/2009;'FF.CC.GENERALITAT';-2,85€;7.018,05 €;-453;-2,85;11.542,14 €;'sin fechas';22/07/2009;'FFCCGENERALITAT';'Gastos_Ocio y transporte';'Transporte';'VARIABLES'
22/07/2009;22/07/2009;'LOLA VIDAL CABELL';-42,00€;6.976,05 €;-452;-42,00;11.500,14 €;'sin fechas';22/07/2009;'LOLA';'Gastos_Ocio y transporte';'Restaurantes';'VARIABLES'
22/07/2009;22/07/2009;'METRO';-1,35€;6.974,70 €;-451;-1,35;11.498,79 €;'sin fechas';22/07/2009;'METRO';'Gastos_Ocio y transporte';'Transporte';'VARIABLES'
22/07/2009;22/07/2009;'METRO';-1,35€;6.973,35 €;-450;-1,35;11.497,44 €;'sin fechas';22/07/2009;'METRO';'Gastos_Ocio y transporte';'Transporte';'VARIABLES'
22/07/2009;22/07/2009;'REINT.CAJERO';-60,00€;6.913,35 €;-449;-60,00;11.437,44 €;'sin fechas';22/07/2009;'REINTCAJERO';'Gastos_Gastos varios';'Efectivo';'VARIABLES'
23/07/2009;23/07/2009;'CAFET.C T PRAT';-2,45€;6.910,90 €;-448;-2,45;11.434,99 €;'sin fechas';23/07/2009;'CAFETC';'Gastos_Ocio y transporte';'Restaurantes';'VARIABLES'
23/07/2009;23/07/2009;'CENTRES AUTOEQUIP';-45,90€;6.865,00 €;-447;-45,90;11.389,09 €;'sin fechas';23/07/2009;'CENTRES';'Gastos_Vivienda y vehiculo';'Mnto. vehiculo';'VARIABLE'
23/07/2009;23/07/2009;'MARCO ALDANY';-9,99€;6.855,01 €;-446;-9,99;11.379,10 €;'sin fechas';23/07/2009;'MARCO';'Gastos_Salud, saber y deporte';'Belleza';'VARIABLES'
24/07/2009;24/07/2009;'CAFET.C T PRAT';-2,45€;6.852,56 €;-445;-2,45;11.376,65 €;'sin fechas';24/07/2009;'CAFETC';'Gastos_Ocio y transporte';'Restaurantes';'VARIABLES'
24/07/2009;28/07/2009;'COMPRA CON TARJETA';-5,25€;6.847,31 €;-444;-5,25;11.371,40 €;'sin fechas';28/07/2009;'COMPRA';'Gastos_Compras';'Supermercado';'VARIABLES'
24/07/2009;28/07/2009;'COMPRA CON TARJETA';-3,40€;6.843,91 €;-443;-3,40;11.368,00 €;'sin fechas';28/07/2009;'COMPRA';'Gastos_Compras';'Supermercado';'VARIABLES'
24/07/2009;03/08/2009;'COMPRA CON TARJETA';-5,80€;6.838,11 €;-442;-5,80;11.362,20 €;'sin fechas';03/08/2009;'COMPRA';'Gastos_Compras';'Supermercado';'VARIABLES'
24/07/2009;24/07/2009;'GASOLINA';-15,00€;6.823,11 €;-441;-15,00;11.347,20 €;'sin fechas';24/07/2009;'GASOLINA';'Gastos_Ocio y transporte';'Gasolina';'VARIABLES'
24/07/2009;24/07/2009;'SABECO TORTOSA';-67,93€;6.755,18 €;-440;-67,93;11.279,27 €;'sin fechas';24/07/2009;'SABECO';'Gastos_Compras';'Supermercado';'VARIABLES'
24/07/2009;24/07/2009;'SABECO TORTOSA';-11,49€;6.743,69 €;-439;-11,49;11.267,78 €;'sin fechas';24/07/2009;'SABECO';'Gastos_Compras';'Supermercado';'VARIABLES'
25/07/2009;25/07/2009;'CELLER CAL MENESCAL \\BOT';-20,90€;6.722,79 €;-438;-20,90;11.246,88 €;'sin fechas';25/07/2009;'CELLER';'Gastos_Ocio y transporte';'Restaurantes';'VARIABLES'
25/07/2009;25/07/2009;'SABECO TORTOSA';-17,20€;6.705,59 €;-437;-17,20;11.229,68 €;'sin fechas';25/07/2009;'SABECO';'Gastos_Compras';'Supermercado';'VARIABLES'
26/07/2009;26/07/2009;'AREA SERVICIO BAI\\ALDEA, L\''';-44,00€;6.661,59 €;-436;-44,00;11.185,68 €;'sin fechas';26/07/2009;'AREA';'Gastos_Ocio y transporte';'Gasolina';'VARIABLES'
26/07/2009;03/08/2009;'COMPRA CON TARJETA';-3,40€;6.658,19 €;-435;-3,40;11.182,28 €;'sin fechas';03/08/2009;'COMPRA';'Gastos_Compras';'Supermercado';'VARIABLES'
26/07/2009;03/08/2009;'COMPRA CON TARJETA';-5,25€;6.652,94 €;-434;-5,25;11.177,03 €;'sin fechas';03/08/2009;'COMPRA';'Gastos_Compras';'Supermercado';'VARIABLES'
26/07/2009;03/08/2009;'COMPRA CON TARJETA';-5,80€;6.647,14 €;-433;-5,80;11.171,23 €;'sin fechas';03/08/2009;'COMPRA';'Gastos_Compras';'Supermercado';'VARIABLES'
26/07/2009;26/07/2009;'GASOLINA';-30,00€;6.617,14 €;-432;-30,00;11.141,23 €;'sin fechas';26/07/2009;'GASOLINA';'Gastos_Ocio y transporte';'Gasolina';'VARIABLES'
27/07/2009;27/07/2009;'CAFET.C T PRAT';-3,00€;6.614,14 €;-431;-3,00;11.138,23 €;'sin fechas';27/07/2009;'CAFETC';'Gastos_Ocio y transporte';'Restaurantes';'VARIABLES'
27/07/2009;27/07/2009;'CENTRES AUTOEQUIP';-8,96€;6.605,18 €;-430;-8,96;11.129,27 €;'sin fechas';27/07/2009;'CENTRES';'Gastos_Vivienda y vehiculo';'Mnto. vehiculo';'VARIABLE'
27/07/2009;27/07/2009;'FRANCE TELECOM';-13,12€;6.592,06 €;-429;-13,12;11.116,15 €;'sin fechas';27/07/2009;'FRANCE';'Gastos_Servicios tipicos';'Telecomunicaciones';'FIJO'
27/07/2009;27/07/2009;'MERCADONA';-30,03€;6.562,03 €;-428;-30,03;11.086,12 €;'sin fechas';27/07/2009;'MERCADONA';'Gastos_Compras';'Supermercado';'VARIABLES'
29/07/2009;29/07/2009;'CAFET.C T PRAT';-2,45€;6.559,58 €;-427;-2,45;11.083,67 €;'sin fechas';29/07/2009;'CAFETC';'Gastos_Ocio y transporte';'Restaurantes';'VARIABLES'
29/07/2009;29/07/2009;'EROSKI-[COMIDA]';-348,90€;6.210,68 €;-426;-348,90;10.734,77 €;'sin fechas';29/07/2009;'EROSKICOMIDA';'Gastos_Compras';'Supermercado';'VARIABLES'
29/07/2009;29/07/2009;'EROSKI-[COMIDA]';-3,00€;6.207,68 €;-425;-3,00;10.731,77 €;'sin fechas';29/07/2009;'EROSKICOMIDA';'Gastos_Compras';'Supermercado';'VARIABLES'
29/07/2009;29/07/2009;'ULANKA';-56,83€;6.150,85 €;-424;-56,83;10.674,94 €;'sin fechas';29/07/2009;'ULANKA';'Gastos_Compras';'Ropa';'VARIABLES'
30/07/2009;30/07/2009;'AGBAR INSTALAC';-62,00€;6.088,85 €;-423;-62,00;10.612,94 €;'sin fechas';30/07/2009;'AGBAR';'Gastos_Servicios tipicos';'Agua';'FIJO'
30/07/2009;28/07/2009;'FOMENT DE TERRASSA, S.A. FOMEN';1.621,55€;7.710,40 €;-422;1.621,55;12.234,49 €;'sin fechas';28/07/2009;'FOMENT';'Ingresos';'Nomina';'FIJO'
30/07/2009;29/07/2009;'INFORMACIO I TECNOLOGIA DE CAT';1.652,31€;9.362,71 €;-421;1.652,31;13.886,80 €;'sin fechas';29/07/2009;'INFORMACIO';'Ingresos';'Nomina';'FIJO'
30/07/2009;30/07/2009;'M&S';-10,00€;9.352,71 €;-420;-10,00;13.876,80 €;'sin fechas';30/07/2009;'MS';'Gastos_Compras';'Ropa';'VARIABLES'
30/07/2009;30/07/2009;'MERCADONA';-24,48€;9.328,23 €;-419;-24,48;13.852,32 €;'sin fechas';30/07/2009;'MERCADONA';'Gastos_Compras';'Supermercado';'VARIABLES'
30/07/2009;30/07/2009;'REINT.CAJERO';-60,00€;9.268,23 €;-418;-60,00;13.792,32 €;'sin fechas';30/07/2009;'REINTCAJERO';'Gastos_Gastos varios';'Efectivo';'VARIABLES'
30/07/2009;30/07/2009;'TOYOTA ORIENT CARS';-285,07€;8.983,16 €;-417;-285,07;13.507,25 €;'sin fechas';30/07/2009;'TOYOTA';'Gastos_Vivienda y vehiculo';'Mnto. vehiculo';'VARIABLE'
31/07/2009;31/07/2009;'AMC PARC VALLES';-9,00€;8.974,16 €;-416;-9,00;13.498,25 €;'sin fechas';31/07/2009;'AMC';'Gastos_Ocio y transporte';'Espectáculos';'VARIABLES'
31/07/2009;31/07/2009;'CAPRABO';-11,33€;8.962,83 €;-415;-11,33;13.486,92 €;'sin fechas';31/07/2009;'CAPRABO';'Gastos_Compras';'Supermercado';'VARIABLES'
31/07/2009;31/07/2009;'RECIBO PTMOS. 3061-0960001518';-646,20€;8.316,63 €;-414;-646,20;12.840,72 €;'sin fechas';31/07/2009;'RECIBO';'Gastos_Banco y organismos';'Hipoteca';'FIJO'
31/07/2009;31/07/2009;'RECIBO PTMOS. 3061-0960004140';-177,24€;8.139,39 €;-413;-177,24;12.663,48 €;'sin fechas';31/07/2009;'RECIBO';'Gastos_Banco y organismos';'Hipoteca';'FIJO'
01/08/2009;01/08/2009;'DECATHLON';-56,55€;8.082,84 €;-412;-56,55;12.606,93 €;'sin fechas';01/08/2009;'DECATHLON';'Gastos_Compras';'Deportivo';'VARIABLES'
01/08/2009;01/08/2009;'EROSKI-[COMIDA]';-89,99€;7.992,85 €;-411;-89,99;12.516,94 €;'sin fechas';01/08/2009;'EROSKICOMIDA';'Gastos_Compras';'Supermercado';'VARIABLES'
01/08/2009;01/08/2009;'FARMACIA';-10,99€;7.981,86 €;-410;-10,99;12.505,95 €;'sin fechas';01/08/2009;'FARMACIA';'Gastos_Salud, saber y deporte';'Farmacia';'VARIABLES'
01/08/2009;01/08/2009;'MERCADONA';-9,41€;7.972,45 €;-409;-9,41;12.496,54 €;'sin fechas';01/08/2009;'MERCADONA';'Gastos_Compras';'Supermercado';'VARIABLES'
01/08/2009;01/08/2009;'MERCADONA';-65,23€;7.907,22 €;-408;-65,23;12.431,31 €;'sin fechas';01/08/2009;'MERCADONA';'Gastos_Compras';'Supermercado';'VARIABLES'
03/08/2009;03/08/2009;'AJUNTAMENT DE TERRASSA';-35,20€;7.872,02 €;-407;-35,20;12.396,11 €;'sin fechas';03/08/2009;'AJUNTAMENT';'Gastos_Banco y organismos';'Ayuntamiento';'FIJO'
03/08/2009;03/08/2009;'CIA. DE SEGUROS 006662671613';-33,90€;7.838,12 €;-406;-33,90;12.362,21 €;'sin fechas';03/08/2009;'CIA';'Ingresos';'Devoluciones';'VARIABLES'
03/08/2009;03/08/2009;'GASOLINA';-34,00€;7.804,12 €;-405;-34,00;12.328,21 €;'sin fechas';03/08/2009;'GASOLINA';'Gastos_Ocio y transporte';'Gasolina';'VARIABLES'
03/08/2009;03/08/2009;'MERCADONA';-20,52€;7.783,60 €;-404;-20,52;12.307,69 €;'sin fechas';03/08/2009;'MERCADONA';'Gastos_Compras';'Supermercado';'VARIABLES'
03/08/2009;03/08/2009;'Ordenador';-34,00€;7.749,60 €;-403;-34,00;12.273,69 €;'sin fechas';03/08/2009;'ORDENADOR';'Gastos_Compras';'Hobbys';'VARIABLES'
03/08/2009;03/08/2009;'Reserv. noches 30 y 31 de Agos';-30,00€;7.719,60 €;-402;-30,00;12.243,69 €;'sin fechas';03/08/2009;'RESERV';'Gastos_Ocio y transporte';'Vacaciones';'VARIABLES'
03/08/2009;03/08/2009;'Reserva noches 26 y 27 de Agos';-55,64€;7.663,96 €;-401;-55,64;12.188,05 €;'sin fechas';03/08/2009;'RESERVA';'Gastos_Ocio y transporte';'Vacaciones';'VARIABLES'
04/08/2009;04/08/2009;'VIRGIN ACTIVE';-59,00€;7.604,96 €;-400;-59,00;12.129,05 €;'sin fechas';04/08/2009;'VIRGIN';'Gastos_Salud, saber y deporte';'Deportes';'VARIABLES'
04/08/2009;04/08/2009;'VIRGIN ACTIVE';-59,00€;7.545,96 €;-399;-59,00;12.070,05 €;'sin fechas';04/08/2009;'VIRGIN';'Gastos_Salud, saber y deporte';'Deportes';'VARIABLES'
05/08/2009;05/08/2009;'CAFET.C T PRAT';-2,30€;7.543,66 €;-398;-2,30;12.067,75 €;'sin fechas';05/08/2009;'CAFETC';'Gastos_Ocio y transporte';'Restaurantes';'VARIABLES'
05/08/2009;05/08/2009;'CAPRABO';-5,19€;7.538,47 €;-397;-5,19;12.062,56 €;'sin fechas';05/08/2009;'CAPRABO';'Gastos_Compras';'Supermercado';'VARIABLES'
05/08/2009;05/08/2009;'CAPRABO';-11,50€;7.526,97 €;-396;-11,50;12.051,06 €;'sin fechas';05/08/2009;'CAPRABO';'Gastos_Compras';'Supermercado';'VARIABLES'
06/08/2009;06/08/2009;'CAFET.C T PRAT';-2,30€;7.524,67 €;-395;-2,30;12.048,76 €;'sin fechas';06/08/2009;'CAFETC';'Gastos_Ocio y transporte';'Restaurantes';'VARIABLES'
07/08/2009;07/08/2009;'AMC PARC VALLES';-9,00€;7.515,67 €;-394;-9,00;12.039,76 €;'sin fechas';07/08/2009;'AMC';'Gastos_Ocio y transporte';'Espectáculos';'VARIABLES'
07/08/2009;07/08/2009;'CAFET.C T PRAT';-3,15€;7.512,52 €;-393;-3,15;12.036,61 €;'sin fechas';07/08/2009;'CAFETC';'Gastos_Ocio y transporte';'Restaurantes';'VARIABLES'
07/08/2009;07/08/2009;'CAPRABO';-14,57€;7.497,95 €;-392;-14,57;12.022,04 €;'sin fechas';07/08/2009;'CAPRABO';'Gastos_Compras';'Supermercado';'VARIABLES'
08/08/2009;08/08/2009;'REINT.CAJERO';-60,00€;7.437,95 €;-391;-60,00;11.962,04 €;'sin fechas';08/08/2009;'REINTCAJERO';'Gastos_Gastos varios';'Efectivo';'VARIABLES'
08/08/2009;08/08/2009;'REINT.CAJERO';-60,00€;7.377,95 €;-390;-60,00;11.902,04 €;'sin fechas';08/08/2009;'REINTCAJERO';'Gastos_Gastos varios';'Efectivo';'VARIABLES'
08/08/2009;08/08/2009;'REINT.CAJERO';60,00€;7.437,95 €;-389;60,00;11.962,04 €;'sin fechas';08/08/2009;'REINTCAJERO';'Gastos_Gastos varios';'Efectivo';'VARIABLES'
09/08/2009;09/08/2009;'TUTANKAMON MUSEU';-42,00€;7.395,95 €;-388;-42,00;11.920,04 €;'sin fechas';09/08/2009;'TUTANKAMON';'Gastos_Ocio y transporte';'Espectáculos';'VARIABLES'
10/08/2009;10/08/2009;'CAFET.C T PRAT';-2,40€;7.393,55 €;-387;-2,40;11.917,64 €;'sin fechas';10/08/2009;'CAFETC';'Gastos_Ocio y transporte';'Restaurantes';'VARIABLES'
10/08/2009;10/08/2009;'GAS NATURAL';-190,79€;7.202,76 €;-386;-190,79;11.726,85 €;'sin fechas';10/08/2009;'GAS';'Gastos_Servicios tipicos';'Gas';'FIJO'
10/08/2009;10/08/2009;'MERCADONA';-18,36€;7.184,40 €;-385;-18,36;11.708,49 €;'sin fechas';10/08/2009;'MERCADONA';'Gastos_Compras';'Supermercado';'VARIABLES'
10/08/2009;10/08/2009;'METRO';-7,70€;7.176,70 €;-384;-7,70;11.700,79 €;'sin fechas';10/08/2009;'METRO';'Gastos_Ocio y transporte';'Transporte';'VARIABLES'
11/08/2009;11/08/2009;'CAFET.C T PRAT';-2,40€;7.174,30 €;-383;-2,40;11.698,39 €;'sin fechas';11/08/2009;'CAFETC';'Gastos_Ocio y transporte';'Restaurantes';'VARIABLES'
11/08/2009;11/08/2009;'CAFET.C T PRAT';-7,15€;7.167,15 €;-382;-7,15;11.691,24 €;'sin fechas';11/08/2009;'CAFETC';'Gastos_Ocio y transporte';'Restaurantes';'VARIABLES'
11/08/2009;11/08/2009;'ENDESA DISTRIB';-48,01€;7.119,14 €;-381;-48,01;11.643,23 €;'sin fechas';11/08/2009;'ENDESA';'Gastos_Servicios tipicos';'Electricidad';'FIJO'
11/08/2009;11/08/2009;'GASOLINA';-35,92€;7.083,22 €;-380;-35,92;11.607,31 €;'sin fechas';11/08/2009;'GASOLINA';'Gastos_Ocio y transporte';'Gasolina';'VARIABLES'
12/08/2009;12/08/2009;'MERCADONA';-20,93€;7.062,29 €;-379;-20,93;11.586,38 €;'sin fechas';12/08/2009;'MERCADONA';'Gastos_Compras';'Supermercado';'VARIABLES'
13/08/2009;13/08/2009;'CAFET.C T PRAT';-2,85€;7.059,44 €;-378;-2,85;11.583,53 €;'sin fechas';13/08/2009;'CAFETC';'Gastos_Ocio y transporte';'Restaurantes';'VARIABLES'
13/08/2009;13/08/2009;'MERCADONA';-10,22€;7.049,22 €;-377;-10,22;11.573,31 €;'sin fechas';13/08/2009;'MERCADONA';'Gastos_Compras';'Supermercado';'VARIABLES'
14/08/2009;14/08/2009;'CAFET.C T PRAT';-2,40€;7.046,82 €;-376;-2,40;11.570,91 €;'sin fechas';14/08/2009;'CAFETC';'Gastos_Ocio y transporte';'Restaurantes';'VARIABLES'
14/08/2009;14/08/2009;'SEG.AM.HIPITEC';-31,00€;7.015,82 €;-375;-31,00;11.539,91 €;'sin fechas';14/08/2009;'SEGAMHIPITEC';'Gastos_Seguros';'Seguro vida';'FIJO'
15/08/2009;15/08/2009;'REST.JAPONES YUTA';-93,52€;6.922,30 €;-374;-93,52;11.446,39 €;'sin fechas';15/08/2009;'RESTJAPONES';'Gastos_Ocio y transporte';'Restaurantes';'VARIABLES'
15/08/2009;15/08/2009;'TAKE';-68,85€;6.853,45 €;-373;-68,85;11.377,54 €;'sin fechas';15/08/2009;'TAKE';'Gastos_Ocio y transporte';'Restaurantes';'VARIABLES'
17/08/2009;17/08/2009;'AMC PARC VALLES';-9,00€;6.844,45 €;-372;-9,00;11.368,54 €;'sin fechas';17/08/2009;'AMC';'Gastos_Ocio y transporte';'Espectáculos';'VARIABLES'
17/08/2009;17/08/2009;'EROSKI-[COMIDA]';-13,74€;6.830,71 €;-371;-13,74;11.354,80 €;'sin fechas';17/08/2009;'EROSKICOMIDA';'Gastos_Compras';'Supermercado';'VARIABLES'
17/08/2009;17/08/2009;'GAME';-14,95€;6.815,76 €;-370;-14,95;11.339,85 €;'sin fechas';17/08/2009;'GAME';'Gastos_Compras';'Hobbys';'VARIABLES'
17/08/2009;17/08/2009;'REST.AROMA DE WASA';-25,04€;6.790,72 €;-369;-25,04;11.314,81 €;'sin fechas';17/08/2009;'RESTAROMA';'Gastos_Ocio y transporte';'Restaurantes';'VARIABLES'
18/08/2009;18/08/2009;'CENTRES AUTOEQUIP';-23,20€;6.767,52 €;-368;-23,20;11.291,61 €;'sin fechas';18/08/2009;'CENTRES';'Gastos_Vivienda y vehiculo';'Mnto. vehiculo';'VARIABLE'
18/08/2009;18/08/2009;'ENDESA DISTRIB';-37,38€;6.730,14 €;-367;-37,38;11.254,23 €;'sin fechas';18/08/2009;'ENDESA';'Gastos_Servicios tipicos';'Electricidad';'FIJO'
18/08/2009;18/08/2009;'ONO';-78,93€;6.651,21 €;-366;-78,93;11.175,30 €;'sin fechas';18/08/2009;'ONO';'Gastos_Servicios tipicos';'Telecomunicaciones';'FIJO'
19/08/2009;19/08/2009;'CAFET.C T PRAT';-3,70€;6.647,51 €;-365;-3,70;11.171,60 €;'sin fechas';19/08/2009;'CAFETC';'Gastos_Ocio y transporte';'Restaurantes';'VARIABLES'
20/08/2009;20/08/2009;'CAFET.C T PRAT';-2,55€;6.644,96 €;-364;-2,55;11.169,05 €;'sin fechas';20/08/2009;'CAFETC';'Gastos_Ocio y transporte';'Restaurantes';'VARIABLES'
20/08/2009;20/08/2009;'GASOLINA';-10,00€;6.634,96 €;-363;-10,00;11.159,05 €;'sin fechas';20/08/2009;'GASOLINA';'Gastos_Ocio y transporte';'Gasolina';'VARIABLES'
21/08/2009;21/08/2009;'CENTRES AUTOEQUIP';-153,89€;6.481,07 €;-362;-153,89;11.005,16 €;'sin fechas';21/08/2009;'CENTRES';'Gastos_Vivienda y vehiculo';'Mnto. vehiculo';'VARIABLE'
21/08/2009;21/08/2009;'EROSKI-[COMIDA]';-48,40€;6.432,67 €;-361;-48,40;10.956,76 €;'sin fechas';21/08/2009;'EROSKICOMIDA';'Gastos_Compras';'Supermercado';'VARIABLES'
21/08/2009;21/08/2009;'FRANCE TELECOM';-24,16€;6.408,51 €;-360;-24,16;10.932,60 €;'sin fechas';21/08/2009;'FRANCE';'Gastos_Servicios tipicos';'Telecomunicaciones';'FIJO'
21/08/2009;21/08/2009;'GASOLINA';-38,49€;6.370,02 €;-359;-38,49;10.894,11 €;'sin fechas';21/08/2009;'GASOLINA';'Gastos_Ocio y transporte';'Gasolina';'VARIABLES'
21/08/2009;21/08/2009;'GREENWICH PIEL, S.L';-32,49€;6.337,53 €;-358;-32,49;10.861,62 €;'sin fechas';21/08/2009;'GREENWICH';'Gastos_Compras';'Ropa';'VARIABLES'
21/08/2009;21/08/2009;'GUGGENHEIM BILBAO MU\\BILBAO';-39,00€;6.298,53 €;-357;-39,00;10.822,62 €;'sin fechas';21/08/2009;'GUGGENHEIM';'Gastos_Ocio y transporte';'Espectáculos';'VARIABLES'
21/08/2009;21/08/2009;'IMP-V.ENTRADAS - \\SANTANDER';-32,10€;6.266,43 €;-356;-32,10;10.790,52 €;'sin fechas';21/08/2009;'IMPVENTRADAS';'Gastos_Ocio y transporte';'Espectáculos';'VARIABLES'
21/08/2009;21/08/2009;'LA BRASA';-38,71€;6.227,72 €;-355;-38,71;10.751,81 €;'sin fechas';21/08/2009;'BRASA';'Gastos_Ocio y transporte';'Restaurantes';'VARIABLES'
21/08/2009;21/08/2009;'NAVIERA MAR DE ONS,S.L\\VIGO';-52,50€;6.175,22 €;-354;-52,50;10.699,31 €;'sin fechas';21/08/2009;'NAVIERA';'Gastos_Compras';'Ropa';'VARIABLES'
21/08/2009;21/08/2009;'ULANKA';-19,90€;6.155,32 €;-353;-19,90;10.679,41 €;'sin fechas';21/08/2009;'ULANKA';'Gastos_Compras';'Ropa';'VARIABLES'
22/08/2009;28/08/2009;'COMPRA CON TARJETA';-5,45€;6.149,87 €;-352;-5,45;10.673,96 €;'sin fechas';28/08/2009;'COMPRA';'Gastos_Compras';'Supermercado';'VARIABLES'
22/08/2009;31/08/2009;'COMPRA CON TARJETA';-2,45€;6.147,42 €;-351;-2,45;10.671,51 €;'sin fechas';31/08/2009;'COMPRA';'Gastos_Compras';'Supermercado';'VARIABLES'
22/08/2009;31/08/2009;'COMPRA CON TARJETA';-27,35€;6.120,07 €;-350;-27,35;10.644,16 €;'sin fechas';31/08/2009;'COMPRA';'Gastos_Compras';'Supermercado';'VARIABLES'
22/08/2009;22/08/2009;'GASOLINA';-7,60€;6.112,47 €;-349;-7,60;10.636,56 €;'sin fechas';22/08/2009;'GASOLINA';'Gastos_Ocio y transporte';'Gasolina';'VARIABLES'
23/08/2009;23/08/2009;'AREA DE SERV S\\VILABOA (RES';-5,30€;6.107,17 €;-348;-5,30;10.631,26 €;'sin fechas';23/08/2009;'AREA';'Gastos_Ocio y transporte';'Gasolina';'VARIABLES'
23/08/2009;28/08/2009;'COMPRA CON TARJETA';-1,05€;6.106,12 €;-347;-1,05;10.630,21 €;'sin fechas';28/08/2009;'COMPRA';'Gastos_Compras';'Supermercado';'VARIABLES'
23/08/2009;28/08/2009;'COMPRA CON TARJETA';-2,95€;6.103,17 €;-346;-2,95;10.627,26 €;'sin fechas';28/08/2009;'COMPRA';'Gastos_Compras';'Supermercado';'VARIABLES'
23/08/2009;23/08/2009;'FARMACIA';-12,80€;6.090,37 €;-345;-12,80;10.614,46 €;'sin fechas';23/08/2009;'FARMACIA';'Gastos_Salud, saber y deporte';'Farmacia';'VARIABLES'
23/08/2009;23/08/2009;'HOTEL HUSA ABAD SAN AN\\LEON';-6,00€;6.084,37 €;-344;-6,00;10.608,46 €;'sin fechas';23/08/2009;'HOTEL';'Gastos_Ocio y transporte';'Vacaciones';'VARIABLES'
23/08/2009;23/08/2009;'MARIA LORES ALVAREZ\\LA TOJA';-6,00€;6.078,37 €;-343;-6,00;10.602,46 €;'sin fechas';23/08/2009;'MARIA';'Gastos_Ocio y transporte';'Restaurantes';'VARIABLES'
23/08/2009;23/08/2009;'TERA VIDRIALES\\QUINTANILLA';-17,40€;6.060,97 €;-342;-17,40;10.585,06 €;'sin fechas';23/08/2009;'TERA';'Gastos_Ocio y transporte';'Restaurantes';'VARIABLES'
24/08/2009;24/08/2009;'A CASA DA LENA \\CAMBADOS';-59,50€;6.001,47 €;-341;-59,50;10.525,56 €;'sin fechas';24/08/2009;'CASA';'Gastos_Ocio y transporte';'Restaurantes';'VARIABLES'
24/08/2009;31/08/2009;'COMPRA CON TARJETA';-1,05€;6.000,42 €;-340;-1,05;10.524,51 €;'sin fechas';31/08/2009;'COMPRA';'Gastos_Compras';'Supermercado';'VARIABLES'
24/08/2009;31/08/2009;'COMPRA CON TARJETA';-2,95€;5.997,47 €;-339;-2,95;10.521,56 €;'sin fechas';31/08/2009;'COMPRA';'Gastos_Compras';'Supermercado';'VARIABLES'
24/08/2009;31/08/2009;'COMPRA CON TARJETA';-1,05€;5.996,42 €;-338;-1,05;10.520,51 €;'sin fechas';31/08/2009;'COMPRA';'Gastos_Compras';'Supermercado';'VARIABLES'
24/08/2009;31/08/2009;'COMPRA CON TARJETA';-2,95€;5.993,47 €;-337;-2,95;10.517,56 €;'sin fechas';31/08/2009;'COMPRA';'Gastos_Compras';'Supermercado';'VARIABLES'
24/08/2009;02/09/2009;'COMPRA CON TARJETA';-15,60€;5.977,87 €;-336;-15,60;10.501,96 €;'sin fechas';02/09/2009;'COMPRA';'Gastos_Compras';'Supermercado';'VARIABLES'
24/08/2009;24/08/2009;'GASOLINA';-36,24€;5.941,63 €;-335;-36,24;10.465,72 €;'sin fechas';24/08/2009;'GASOLINA';'Gastos_Ocio y transporte';'Gasolina';'VARIABLES'
25/08/2009;25/08/2009;'COMEST.O BEIRO\\SANTIAGO DE';-17,10€;5.924,53 €;-334;-17,10;10.448,62 €;'sin fechas';25/08/2009;'COMESTO';'Gastos_Ocio y transporte';'Restaurantes';'VARIABLES'
25/08/2009;01/09/2009;'COMPRA CON TARJETA';-3,85€;5.920,68 €;-333;-3,85;10.444,77 €;'sin fechas';01/09/2009;'COMPRA';'Gastos_Compras';'Supermercado';'VARIABLES'
25/08/2009;01/09/2009;'COMPRA CON TARJETA';-1,70€;5.918,98 €;-332;-1,70;10.443,07 €;'sin fechas';01/09/2009;'COMPRA';'Gastos_Compras';'Supermercado';'VARIABLES'
25/08/2009;25/08/2009;'EL PORTICO II \\SANTIAGO';-22,80€;5.896,18 €;-331;-22,80;10.420,27 €;'sin fechas';25/08/2009;'PORTICO';'Gastos_Ocio y transporte';'Restaurantes';'VARIABLES'
25/08/2009;25/08/2009;'GASOLINA';-17,00€;5.879,18 €;-330;-17,00;10.403,27 €;'sin fechas';25/08/2009;'GASOLINA';'Gastos_Ocio y transporte';'Gasolina';'VARIABLES'
25/08/2009;25/08/2009;'GASOLINA';-5,70€;5.873,48 €;-329;-5,70;10.397,57 €;'sin fechas';25/08/2009;'GASOLINA';'Gastos_Ocio y transporte';'Gasolina';'VARIABLES'
25/08/2009;25/08/2009;'REINT.CAJERO';-200,00€;5.673,48 €;-328;-200,00;10.197,57 €;'sin fechas';25/08/2009;'REINTCAJERO';'Gastos_Gastos varios';'Efectivo';'VARIABLES'
25/08/2009;25/08/2009;'REST.MARIA JOSE \\CAMBADOS';-75,50€;5.597,98 €;-327;-75,50;10.122,07 €;'sin fechas';25/08/2009;'RESTMARIA';'Gastos_Ocio y transporte';'Restaurantes';'VARIABLES'
26/08/2009;26/08/2009;'BAR AVENIDA \\COLUNGA';-48,70€;5.549,28 €;-326;-48,70;10.073,37 €;'sin fechas';26/08/2009;'BAR';'Gastos_Ocio y transporte';'Restaurantes';'VARIABLES'
26/08/2009;26/08/2009;'GASOLINA';-20,00€;5.529,28 €;-325;-20,00;10.053,37 €;'sin fechas';26/08/2009;'GASOLINA';'Gastos_Ocio y transporte';'Gasolina';'VARIABLES'
26/08/2009;26/08/2009;'HOTEL PROFONT 98 S\\VILALBA';-72,00€;5.457,28 €;-324;-72,00;9.981,37 €;'sin fechas';26/08/2009;'HOTEL';'Gastos_Ocio y transporte';'Vacaciones';'VARIABLES'
26/08/2009;26/08/2009;'RTE. LA TABERNA D\\CUDILLERO';-36,00€;5.421,28 €;-323;-36,00;9.945,37 €;'sin fechas';26/08/2009;'RTE';'Gastos_Ocio y transporte';'Restaurantes';'VARIABLES'
27/08/2009;27/08/2009;'FRANCE TELECOM';-43,08€;5.378,20 €;-322;-43,08;9.902,29 €;'sin fechas';27/08/2009;'FRANCE';'Gastos_Servicios tipicos';'Telecomunicaciones';'FIJO'
28/08/2009;28/08/2009;'EL OJANCANO \\SANTILLANA DE';-40,70€;5.337,50 €;-321;-40,70;9.861,59 €;'sin fechas';28/08/2009;'OJANCANO';'Gastos_Compras';'Supermercado';'VARIABLES'
28/08/2009;27/08/2009;'INFORMACIO I TECNOLOGIA DE CAT';1.578,97€;6.916,47 €;-320;1.578,97;11.440,56 €;'sin fechas';27/08/2009;'INFORMACIO';'Ingresos';'Nomina';'FIJO'
28/08/2009;28/08/2009;'LUPA EDIF.LAS CHIMEN\\REOCIN';-8,63€;6.907,84 €;-319;-8,63;11.431,93 €;'sin fechas';28/08/2009;'LUPA';'Gastos_Compras';'Ropa';'VARIABLES'
29/08/2009;29/08/2009;'REINT.CAJERO';-80,00€;6.827,84 €;-318;-80,00;11.351,93 €;'sin fechas';29/08/2009;'REINTCAJERO';'Gastos_Gastos varios';'Efectivo';'VARIABLES'
30/08/2009;03/09/2009;'COMPRA CON TARJETA';-3,75€;6.824,09 €;-317;-3,75;11.348,18 €;'sin fechas';03/09/2009;'COMPRA';'Gastos_Compras';'Supermercado';'VARIABLES'
30/08/2009;09/09/2009;'COMPRA CON TARJETA';-7,60€;6.816,49 €;-316;-7,60;11.340,58 €;'sin fechas';09/09/2009;'COMPRA';'Gastos_Compras';'Supermercado';'VARIABLES'
30/08/2009;30/08/2009;'GASOLINA';-22,59€;6.793,90 €;-315;-22,59;11.317,99 €;'sin fechas';30/08/2009;'GASOLINA';'Gastos_Ocio y transporte';'Gasolina';'VARIABLES'
30/08/2009;30/08/2009;'MESON SEGOVIAN\\CASTRO URDIA';-25,20€;6.768,70 €;-314;-25,20;11.292,79 €;'sin fechas';30/08/2009;'MESON';'Gastos_Ocio y transporte';'Restaurantes';'VARIABLES'
30/08/2009;30/08/2009;'REINT.CAJERO';-180,00€;6.588,70 €;-313;-180,00;11.112,79 €;'sin fechas';30/08/2009;'REINTCAJERO';'Gastos_Gastos varios';'Efectivo';'VARIABLES'
30/08/2009;30/08/2009;'REINT.CAJERO';-200,00€;6.388,70 €;-312;-200,00;10.912,79 €;'sin fechas';30/08/2009;'REINTCAJERO';'Gastos_Gastos varios';'Efectivo';'VARIABLES'
31/08/2009;04/09/2009;'COMPRA CON TARJETA';-5,35€;6.383,35 €;-311;-5,35;10.907,44 €;'sin fechas';04/09/2009;'COMPRA';'Gastos_Compras';'Supermercado';'VARIABLES'
31/08/2009;07/09/2009;'COMPRA CON TARJETA';-4,55€;6.378,80 €;-310;-4,55;10.902,89 €;'sin fechas';07/09/2009;'COMPRA';'Gastos_Compras';'Supermercado';'VARIABLES'
31/08/2009;31/08/2009;'EROSKI-[COMIDA]';-45,68€;6.333,12 €;-309;-45,68;10.857,21 €;'sin fechas';31/08/2009;'EROSKICOMIDA';'Gastos_Compras';'Supermercado';'VARIABLES'
31/08/2009;31/08/2009;'NATURA TERRASSA';-13,60€;6.319,52 €;-308;-13,60;10.843,61 €;'sin fechas';31/08/2009;'NATURA';'Gastos_Salud, saber y deporte';'Estudios';'VARIABLES'
31/08/2009;31/08/2009;'RECIBO PTMOS. 3061-0960001518';-646,20€;5.673,32 €;-307;-646,20;10.197,41 €;'sin fechas';31/08/2009;'RECIBO';'Gastos_Banco y organismos';'Hipoteca';'FIJO'
31/08/2009;31/08/2009;'RECIBO PTMOS. 3061-0960004140';-177,24€;5.496,08 €;-306;-177,24;10.020,17 €;'sin fechas';31/08/2009;'RECIBO';'Gastos_Banco y organismos';'Hipoteca';'FIJO'
01/09/2009;01/09/2009;'CIA. DE SEGUROS 006662671613';-33,90€;5.462,18 €;-305;-33,90;9.986,27 €;'sin fechas';01/09/2009;'CIA';'Ingresos';'Devoluciones';'VARIABLES'
01/09/2009;08/09/2009;'COMPRA CON TARJETA';-1,95€;5.460,23 €;-304;-1,95;9.984,32 €;'sin fechas';08/09/2009;'COMPRA';'Gastos_Compras';'Supermercado';'VARIABLES'
01/09/2009;08/09/2009;'COMPRA CON TARJETA';-10,25€;5.449,98 €;-303;-10,25;9.974,07 €;'sin fechas';08/09/2009;'COMPRA';'Gastos_Compras';'Supermercado';'VARIABLES'
01/09/2009;08/09/2009;'COMPRA CON TARJETA';-4,85€;5.445,13 €;-302;-4,85;9.969,22 €;'sin fechas';08/09/2009;'COMPRA';'Gastos_Compras';'Supermercado';'VARIABLES'
01/09/2009;08/09/2009;'COMPRA CON TARJETA';-1,90€;5.443,23 €;-301;-1,90;9.967,32 €;'sin fechas';08/09/2009;'COMPRA';'Gastos_Compras';'Supermercado';'VARIABLES'
01/09/2009;08/09/2009;'COMPRA CON TARJETA';-3,25€;5.439,98 €;-300;-3,25;9.964,07 €;'sin fechas';08/09/2009;'COMPRA';'Gastos_Compras';'Supermercado';'VARIABLES'
01/09/2009;09/09/2009;'COMPRA CON TARJETA';-7,65€;5.432,33 €;-299;-7,65;9.956,42 €;'sin fechas';09/09/2009;'COMPRA';'Gastos_Compras';'Supermercado';'VARIABLES'
01/09/2009;28/08/2009;'FOMENT DE TERRASSA, S.A. FOMEN';1.637,52€;7.069,85 €;-298;1.637,52;11.593,94 €;'sin fechas';28/08/2009;'FOMENT';'Ingresos';'Nomina';'FIJO'
01/09/2009;01/09/2009;'GASOLINA';-32,25€;7.037,60 €;-297;-32,25;11.561,69 €;'sin fechas';01/09/2009;'GASOLINA';'Gastos_Ocio y transporte';'Gasolina';'VARIABLES'
01/09/2009;01/09/2009;'PELUQUERIAS';-16,95€;7.020,65 €;-296;-16,95;11.544,74 €;'sin fechas';01/09/2009;'PELUQUERIAS';'Gastos_Salud, saber y deporte';'Belleza';'VARIABLES'
02/09/2009;02/09/2009;'VIRGIN ACTIVE';-59,00€;6.961,65 €;-295;-59,00;11.485,74 €;'sin fechas';02/09/2009;'VIRGIN';'Gastos_Salud, saber y deporte';'Deportes';'VARIABLES'
02/09/2009;02/09/2009;'VIRGIN ACTIVE';-59,00€;6.902,65 €;-294;-59,00;11.426,74 €;'sin fechas';02/09/2009;'VIRGIN';'Gastos_Salud, saber y deporte';'Deportes';'VARIABLES'
03/09/2009;08/09/2009;'COMPRA CON TARJETA';-3,40€;6.899,25 €;-293;-3,40;11.423,34 €;'sin fechas';08/09/2009;'COMPRA';'Gastos_Compras';'Supermercado';'VARIABLES'
03/09/2009;08/09/2009;'COMPRA CON TARJETA';-5,25€;6.894,00 €;-292;-5,25;11.418,09 €;'sin fechas';08/09/2009;'COMPRA';'Gastos_Compras';'Supermercado';'VARIABLES'
03/09/2009;08/09/2009;'COMPRA CON TARJETA';-5,80€;6.888,20 €;-291;-5,80;11.412,29 €;'sin fechas';08/09/2009;'COMPRA';'Gastos_Compras';'Supermercado';'VARIABLES'
03/09/2009;03/09/2009;'VIENA';-11,50€;6.876,70 €;-290;-11,50;11.400,79 €;'sin fechas';03/09/2009;'VIENA';'Gastos_Ocio y transporte';'Restaurantes';'VARIABLES'
05/09/2009;05/09/2009;'BIJOU BRIGITTE S';-17,40€;6.859,30 €;-289;-17,40;11.383,39 €;'sin fechas';05/09/2009;'BIJOU';'Gastos_Compras';'Ropa';'VARIABLES'
05/09/2009;05/09/2009;'EROSKI-[COMIDA]';-24,89€;6.834,41 €;-288;-24,89;11.358,50 €;'sin fechas';05/09/2009;'EROSKICOMIDA';'Gastos_Compras';'Supermercado';'VARIABLES'
05/09/2009;05/09/2009;'GASOLINA';-30,00€;6.804,41 €;-287;-30,00;11.328,50 €;'sin fechas';05/09/2009;'GASOLINA';'Gastos_Ocio y transporte';'Gasolina';'VARIABLES'
05/09/2009;05/09/2009;'NEOCINE \\BENICARLO';-23,60€;6.780,81 €;-286;-23,60;11.304,90 €;'sin fechas';05/09/2009;'NEOCINE';'Gastos_Ocio y transporte';'Espectáculos';'VARIABLES'
07/09/2009;07/09/2009;'FARMACIA';-10,34€;6.770,47 €;-285;-10,34;11.294,56 €;'sin fechas';07/09/2009;'FARMACIA';'Gastos_Salud, saber y deporte';'Farmacia';'VARIABLES'
09/09/2009;09/09/2009;'CINE';-10,00€;6.760,47 €;-284;-10,00;11.284,56 €;'sin fechas';09/09/2009;'CINE';'Gastos_Ocio y transporte';'Espectáculos';'VARIABLES'
11/09/2009;11/09/2009;'AMC PARC VALLES';-11,00€;6.749,47 €;-283;-11,00;11.273,56 €;'sin fechas';11/09/2009;'AMC';'Gastos_Ocio y transporte';'Espectáculos';'VARIABLES'
11/09/2009;16/09/2009;'COMPRA CON TARJETA';-3,40€;6.746,07 €;-282;-3,40;11.270,16 €;'sin fechas';16/09/2009;'COMPRA';'Gastos_Compras';'Supermercado';'VARIABLES'
11/09/2009;16/09/2009;'COMPRA CON TARJETA';-5,25€;6.740,82 €;-281;-5,25;11.264,91 €;'sin fechas';16/09/2009;'COMPRA';'Gastos_Compras';'Supermercado';'VARIABLES'
11/09/2009;21/09/2009;'COMPRA CON TARJETA';-5,80€;6.735,02 €;-280;-5,80;11.259,11 €;'sin fechas';21/09/2009;'COMPRA';'Gastos_Compras';'Supermercado';'VARIABLES'
11/09/2009;11/09/2009;'GASOLINA';-24,00€;6.711,02 €;-279;-24,00;11.235,11 €;'sin fechas';11/09/2009;'GASOLINA';'Gastos_Ocio y transporte';'Gasolina';'VARIABLES'
12/09/2009;12/09/2009;'CARREFOUR-[comida]';-25,60€;6.685,42 €;-278;-25,60;11.209,51 €;'sin fechas';12/09/2009;'CARREFOURCOMIDA';'Gastos_Compras';'Supermercado';'VARIABLES'
12/09/2009;12/09/2009;'GASOLINA';-12,95€;6.672,47 €;-277;-12,95;11.196,56 €;'sin fechas';12/09/2009;'GASOLINA';'Gastos_Ocio y transporte';'Gasolina';'VARIABLES'
12/09/2009;12/09/2009;'JIANHONG ZHOU S.L.';-26,22€;6.646,25 €;-276;-26,22;11.170,34 €;'sin fechas';12/09/2009;'JIANHONG';'Gastos_Ocio y transporte';'Restaurantes';'VARIABLES'
14/09/2009;14/09/2009;'MERCADONA';-29,14€;6.617,11 €;-275;-29,14;11.141,20 €;'sin fechas';14/09/2009;'MERCADONA';'Gastos_Compras';'Supermercado';'VARIABLES'
14/09/2009;14/09/2009;'MERCADONA';-63,36€;6.553,75 €;-274;-63,36;11.077,84 €;'sin fechas';14/09/2009;'MERCADONA';'Gastos_Compras';'Supermercado';'VARIABLES'
14/09/2009;14/09/2009;'RESTAURANT SAPPORO';-25,25€;6.528,50 €;-273;-25,25;11.052,59 €;'sin fechas';14/09/2009;'RESTAURANT';'Gastos_Ocio y transporte';'Restaurantes';'VARIABLES'
14/09/2009;14/09/2009;'SEG.AM.HIPITEC';-30,93€;6.497,57 €;-272;-30,93;11.021,66 €;'sin fechas';14/09/2009;'SEGAMHIPITEC';'Gastos_Seguros';'Seguro vida';'FIJO'
15/09/2009;15/09/2009;'CAFET.C T PRAT';-2,30€;6.495,27 €;-271;-2,30;11.019,36 €;'sin fechas';15/09/2009;'CAFETC';'Gastos_Ocio y transporte';'Restaurantes';'VARIABLES'
15/09/2009;15/09/2009;'ENDESA DISTRIB';-44,65€;6.450,62 €;-270;-44,65;10.974,71 €;'sin fechas';15/09/2009;'ENDESA';'Gastos_Servicios tipicos';'Electricidad';'FIJO'
16/09/2009;16/09/2009;'CAFET.C T PRAT';-3,15€;6.447,47 €;-269;-3,15;10.971,56 €;'sin fechas';16/09/2009;'CAFETC';'Gastos_Ocio y transporte';'Restaurantes';'VARIABLES'
17/09/2009;17/09/2009;'MINA PUBLICA DE LA CIUTAT';-24,87€;6.422,60 €;-268;-24,87;10.946,69 €;'sin fechas';17/09/2009;'MINA';'Gastos_Servicios tipicos';'Agua';'FIJO'
18/09/2009;18/09/2009;'BON AREA';-28,98€;6.393,62 €;-267;-28,98;10.917,71 €;'sin fechas';18/09/2009;'BON';'Gastos_Compras';'Supermercado';'VARIABLES'
18/09/2009;18/09/2009;'CAFET.C T PRAT';-1,85€;6.391,77 €;-266;-1,85;10.915,86 €;'sin fechas';18/09/2009;'CAFETC';'Gastos_Ocio y transporte';'Restaurantes';'VARIABLES'
18/09/2009;18/09/2009;'GASOLINA';-31,59€;6.360,18 €;-265;-31,59;10.884,27 €;'sin fechas';18/09/2009;'GASOLINA';'Gastos_Ocio y transporte';'Gasolina';'VARIABLES'
18/09/2009;18/09/2009;'ONO';-79,83€;6.280,35 €;-264;-79,83;10.804,44 €;'sin fechas';18/09/2009;'ONO';'Gastos_Servicios tipicos';'Telecomunicaciones';'FIJO'
18/09/2009;18/09/2009;'VIENA';-18,50€;6.261,85 €;-263;-18,50;10.785,94 €;'sin fechas';18/09/2009;'VIENA';'Gastos_Ocio y transporte';'Restaurantes';'VARIABLES'
19/09/2009;19/09/2009;'IKEA';-189,09€;6.072,76 €;-262;-189,09;10.596,85 €;'sin fechas';19/09/2009;'IKEA';'Gastos_Vivienda y vehiculo';'Mnto. hogar';'VARIABLES'
21/09/2009;21/09/2009;'CAFET.C T PRAT';-3,25€;6.069,51 €;-261;-3,25;10.593,60 €;'sin fechas';21/09/2009;'CAFETC';'Gastos_Ocio y transporte';'Restaurantes';'VARIABLES'
22/09/2009;22/09/2009;'CAFET.C T PRAT';-2,40€;6.067,11 €;-260;-2,40;10.591,20 €;'sin fechas';22/09/2009;'CAFETC';'Gastos_Ocio y transporte';'Restaurantes';'VARIABLES'
22/09/2009;22/09/2009;'FRANCE TELECOM';-52,56€;6.014,55 €;-259;-52,56;10.538,64 €;'sin fechas';22/09/2009;'FRANCE';'Gastos_Servicios tipicos';'Telecomunicaciones';'FIJO'
22/09/2009;22/09/2009;'MERCADONA';-21,97€;5.992,58 €;-258;-21,97;10.516,67 €;'sin fechas';22/09/2009;'MERCADONA';'Gastos_Compras';'Supermercado';'VARIABLES'
23/09/2009;23/09/2009;'CAFET.C T PRAT';-3,25€;5.989,33 €;-257;-3,25;10.513,42 €;'sin fechas';23/09/2009;'CAFETC';'Gastos_Ocio y transporte';'Restaurantes';'VARIABLES'
24/09/2009;24/09/2009;'MARCO ALDANY';-9,99€;5.979,34 €;-256;-9,99;10.503,43 €;'sin fechas';24/09/2009;'MARCO';'Gastos_Salud, saber y deporte';'Belleza';'VARIABLES'
24/09/2009;24/09/2009;'MERCADONA';-47,57€;5.931,77 €;-255;-47,57;10.455,86 €;'sin fechas';24/09/2009;'MERCADONA';'Gastos_Compras';'Supermercado';'VARIABLES'
24/09/2009;24/09/2009;'OCEAN TECNOLOGIC S';-49,94€;5.881,83 €;-254;-49,94;10.405,92 €;'sin fechas';24/09/2009;'OCEAN';'Gastos_Compras';'Hogar';'VARIABLES'
24/09/2009;24/09/2009;'REST.AROMA DE WASA';-25,04€;5.856,79 €;-253;-25,04;10.380,88 €;'sin fechas';24/09/2009;'RESTAROMA';'Gastos_Ocio y transporte';'Restaurantes';'VARIABLES'
25/09/2009;25/09/2009;'FRANCE TELECOM';-50,48€;5.806,31 €;-252;-50,48;10.330,40 €;'sin fechas';25/09/2009;'FRANCE';'Gastos_Servicios tipicos';'Telecomunicaciones';'FIJO'
26/09/2009;26/09/2009;'AMC PARC VALLES';-11,00€;5.795,31 €;-251;-11,00;10.319,40 €;'sin fechas';26/09/2009;'AMC';'Gastos_Ocio y transporte';'Espectáculos';'VARIABLES'
26/09/2009;26/09/2009;'BRICOKING TERRASSA';-40,40€;5.754,91 €;-250;-40,40;10.279,00 €;'sin fechas';26/09/2009;'BRICOKING';'Gastos_Vivienda y vehiculo';'Mnto. hogar';'VARIABLES'
26/09/2009;26/09/2009;'GIFI';-18,25€;5.736,66 €;-249;-18,25;10.260,75 €;'sin fechas';26/09/2009;'GIFI';'Gastos_Compras';'Hogar';'VARIABLES'
26/09/2009;26/09/2009;'IKEA';-159,00€;5.577,66 €;-248;-159,00;10.101,75 €;'sin fechas';26/09/2009;'IKEA';'Gastos_Vivienda y vehiculo';'Mnto. hogar';'VARIABLES'
26/09/2009;26/09/2009;'VIENA';-11,30€;5.566,36 €;-247;-11,30;10.090,45 €;'sin fechas';26/09/2009;'VIENA';'Gastos_Ocio y transporte';'Restaurantes';'VARIABLES'
28/09/2009;28/09/2009;'CAFET.C T PRAT';-2,55€;5.563,81 €;-246;-2,55;10.087,90 €;'sin fechas';28/09/2009;'CAFETC';'Gastos_Ocio y transporte';'Restaurantes';'VARIABLES'
28/09/2009;28/09/2009;'FARMACIA';-12,82€;5.550,99 €;-245;-12,82;10.075,08 €;'sin fechas';28/09/2009;'FARMACIA';'Gastos_Salud, saber y deporte';'Farmacia';'VARIABLES'
29/09/2009;29/09/2009;'CAFET.C T PRAT';-2,45€;5.548,54 €;-244;-2,45;10.072,63 €;'sin fechas';29/09/2009;'CAFETC';'Gastos_Ocio y transporte';'Restaurantes';'VARIABLES'
29/09/2009;29/09/2009;'MERCADONA';-38,39€;5.510,15 €;-243;-38,39;10.034,24 €;'sin fechas';29/09/2009;'MERCADONA';'Gastos_Compras';'Supermercado';'VARIABLES'
29/09/2009;29/09/2009;'MERCADONA';-9,05€;5.501,10 €;-242;-9,05;10.025,19 €;'sin fechas';29/09/2009;'MERCADONA';'Gastos_Compras';'Supermercado';'VARIABLES'
29/09/2009;29/09/2009;'REINT.CAJERO';-100,00€;5.401,10 €;-241;-100,00;9.925,19 €;'sin fechas';29/09/2009;'REINTCAJERO';'Gastos_Gastos varios';'Efectivo';'VARIABLES'
30/09/2009;26/09/2009;'FOMENT DE TERRASSA, S.A. FOMEN';1.621,55€;7.022,65 €;-240;1.621,55;11.546,74 €;'sin fechas';26/09/2009;'FOMENT';'Ingresos';'Nomina';'FIJO'
30/09/2009;30/09/2009;'GASOLINA';-34,16€;6.988,49 €;-239;-34,16;11.512,58 €;'sin fechas';30/09/2009;'GASOLINA';'Gastos_Ocio y transporte';'Gasolina';'VARIABLES'
30/09/2009;29/09/2009;'INFORMACIO I TECNOLOGIA DE CAT';1.626,98€;8.615,47 €;-238;1.626,98;13.139,56 €;'sin fechas';29/09/2009;'INFORMACIO';'Ingresos';'Nomina';'FIJO'
30/09/2009;30/09/2009;'RECIBO PTMOS. 3061-0960001518';-646,20€;7.969,27 €;-237;-646,20;12.493,36 €;'sin fechas';30/09/2009;'RECIBO';'Gastos_Banco y organismos';'Hipoteca';'FIJO'
30/09/2009;30/09/2009;'RECIBO PTMOS. 3061-0960004140';-177,24€;7.792,03 €;-236;-177,24;12.316,12 €;'sin fechas';30/09/2009;'RECIBO';'Gastos_Banco y organismos';'Hipoteca';'FIJO'
01/10/2009;01/10/2009;'AJUNTAMENT DE TERRASSA';-36,81€;7.755,22 €;-235;-36,81;12.279,31 €;'sin fechas';01/10/2009;'AJUNTAMENT';'Gastos_Banco y organismos';'Ayuntamiento';'FIJO'
01/10/2009;01/10/2009;'CAFET.C T PRAT';-3,55€;7.751,67 €;-234;-3,55;12.275,76 €;'sin fechas';01/10/2009;'CAFETC';'Gastos_Ocio y transporte';'Restaurantes';'VARIABLES'
01/10/2009;01/10/2009;'CIA. DE SEGUROS 006662671613';-33,90€;7.717,77 €;-233;-33,90;12.241,86 €;'sin fechas';01/10/2009;'CIA';'Ingresos';'Devoluciones';'VARIABLES'
01/10/2009;01/10/2009;'MERCADONA';-13,79€;7.703,98 €;-232;-13,79;12.228,07 €;'sin fechas';01/10/2009;'MERCADONA';'Gastos_Compras';'Supermercado';'VARIABLES'
01/10/2009;01/10/2009;'Ordenador';-34,00€;7.669,98 €;-231;-34,00;12.194,07 €;'sin fechas';01/10/2009;'ORDENADOR';'Gastos_Compras';'Hobbys';'VARIABLES'
01/10/2009;01/10/2009;'Parking Octubre, Noviembre, Di';-160,00€;7.509,98 €;-230;-160,00;12.034,07 €;'sin fechas';01/10/2009;'PARKING';'Gastos_Ocio y transporte';'Parking y peaje';'VARIABLES'
02/10/2009;02/10/2009;'CAFET.C T PRAT';-3,25€;7.506,73 €;-229;-3,25;12.030,82 €;'sin fechas';02/10/2009;'CAFETC';'Gastos_Ocio y transporte';'Restaurantes';'VARIABLES'
02/10/2009;02/10/2009;'MERCADONA';-24,22€;7.482,51 €;-228;-24,22;12.006,60 €;'sin fechas';02/10/2009;'MERCADONA';'Gastos_Compras';'Supermercado';'VARIABLES'
02/10/2009;02/10/2009;'VIRGIN ACTIVE';-59,00€;7.423,51 €;-227;-59,00;11.947,60 €;'sin fechas';02/10/2009;'VIRGIN';'Gastos_Salud, saber y deporte';'Deportes';'VARIABLES'
02/10/2009;02/10/2009;'VIRGIN ACTIVE';-59,00€;7.364,51 €;-226;-59,00;11.888,60 €;'sin fechas';02/10/2009;'VIRGIN';'Gastos_Salud, saber y deporte';'Deportes';'VARIABLES'
03/10/2009;09/10/2009;'COMPRA CON TARJETA';-3,05€;7.361,46 €;-225;-3,05;11.885,55 €;'sin fechas';09/10/2009;'COMPRA';'Gastos_Compras';'Supermercado';'VARIABLES'
03/10/2009;09/10/2009;'COMPRA CON TARJETA';-3,05€;7.358,41 €;-224;-3,05;11.882,50 €;'sin fechas';09/10/2009;'COMPRA';'Gastos_Compras';'Supermercado';'VARIABLES'
05/10/2009;02/10/2009;'COM. MANT. ACTIVAS DE LIQ.';-14,92€;7.343,49 €;-223;-14,92;11.867,58 €;'sin fechas';02/10/2009;'COM';'Gastos_Banco y organismos';'Cargos banco';'FIJO'
05/10/2009;02/10/2009;'IMPUESTOS RETENIDOS A CUENTA';-0,07€;7.343,42 €;-222;-0,07;11.867,51 €;'sin fechas';02/10/2009;'IMPUESTOS';'Gastos_Banco y organismos';'Impuestos';'FIJO'
05/10/2009;02/10/2009;'INTERESES';0,40€;7.343,82 €;-221;0,40;11.867,91 €;'sin fechas';02/10/2009;'INTERESES';'Ingresos';'Rendimientos';
05/10/2009;05/10/2009;'SEGS. CATALANA';-318,42€;7.025,40 €;-220;-318,42;11.549,49 €;'sin fechas';05/10/2009;'SEGS';'Gastos_Seguros';'Seguro auto';'FIJO'
09/10/2009;09/10/2009;'BATA SA \\S BOI LLOBREG';-79,90€;6.945,50 €;-219;-79,90;11.469,59 €;'sin fechas';09/10/2009;'BATA';'Gastos_Ocio y transporte';'Restaurantes';'VARIABLES'
09/10/2009;09/10/2009;'CAFET.C T PRAT';-3,40€;6.942,10 €;-218;-3,40;11.466,19 €;'sin fechas';09/10/2009;'CAFETC';'Gastos_Ocio y transporte';'Restaurantes';'VARIABLES'
09/10/2009;08/10/2009;'DEV.TRIBUTARIA';1.151,51€;8.093,61 €;-217;1.151,51;12.617,70 €;'sin fechas';08/10/2009;'DEVTRIBUTARIA';'Ingresos';'Devoluciones';'VARIABLES'
09/10/2009;08/10/2009;'DEV.TRIBUTARIA';995,53€;9.089,14 €;-216;995,53;13.613,23 €;'sin fechas';08/10/2009;'DEVTRIBUTARIA';'Ingresos';'Devoluciones';'VARIABLES'
09/10/2009;09/10/2009;'GAME';-52,90€;9.036,24 €;-215;-52,90;13.560,33 €;'sin fechas';09/10/2009;'GAME';'Gastos_Compras';'Hobbys';'VARIABLES'
09/10/2009;09/10/2009;'GASOLINA';-30,00€;9.006,24 €;-214;-30,00;13.530,33 €;'sin fechas';09/10/2009;'GASOLINA';'Gastos_Ocio y transporte';'Gasolina';'VARIABLES'
09/10/2009;09/10/2009;'IKEA';159,00€;9.165,24 €;-213;159,00;13.689,33 €;'sin fechas';09/10/2009;'IKEA';'Gastos_Vivienda y vehiculo';'Mnto. hogar';'VARIABLES'
09/10/2009;09/10/2009;'KIABI SANT BOI';-14,98€;9.150,26 €;-212;-14,98;13.674,35 €;'sin fechas';09/10/2009;'KIABI';'Gastos_Compras';'Ropa';'VARIABLES'
09/10/2009;09/10/2009;'RINCON GLORIA';-10,20€;9.140,06 €;-211;-10,20;13.664,15 €;'sin fechas';09/10/2009;'RINCON';'Gastos_Ocio y transporte';'Restaurantes';'VARIABLES'
10/10/2009;10/10/2009;'GRINZING';-5,60€;9.134,46 €;-210;-5,60;13.658,55 €;'sin fechas';10/10/2009;'GRINZING';'Gastos_Ocio y transporte';'Restaurantes';'VARIABLES'
10/10/2009;10/10/2009;'MERCADONA';-43,36€;9.091,10 €;-209;-43,36;13.615,19 €;'sin fechas';10/10/2009;'MERCADONA';'Gastos_Compras';'Supermercado';'VARIABLES'
10/10/2009;10/10/2009;'REST.JAPONES KIYOT';-39,27€;9.051,83 €;-208;-39,27;13.575,92 €;'sin fechas';10/10/2009;'RESTJAPONES';'Gastos_Ocio y transporte';'Restaurantes';'VARIABLES'
13/10/2009;13/10/2009;'CAFET.C T PRAT';-3,25€;9.048,58 €;-207;-3,25;13.572,67 €;'sin fechas';13/10/2009;'CAFETC';'Gastos_Ocio y transporte';'Restaurantes';'VARIABLES'
13/10/2009;13/10/2009;'CAFET.C T PRAT';-4,25€;9.044,33 €;-206;-4,25;13.568,42 €;'sin fechas';13/10/2009;'CAFETC';'Gastos_Ocio y transporte';'Restaurantes';'VARIABLES'
14/10/2009;14/10/2009;'GAS NATURAL';-103,83€;8.940,50 €;-205;-103,83;13.464,59 €;'sin fechas';14/10/2009;'GAS';'Gastos_Servicios tipicos';'Gas';'FIJO'
14/10/2009;14/10/2009;'REST.AROMA DE WASA';-31,57€;8.908,93 €;-204;-31,57;13.433,02 €;'sin fechas';14/10/2009;'RESTAROMA';'Gastos_Ocio y transporte';'Restaurantes';'VARIABLES'
15/10/2009;15/10/2009;'CAFET.C T PRAT';-1,65€;8.907,28 €;-203;-1,65;13.431,37 €;'sin fechas';15/10/2009;'CAFETC';'Gastos_Ocio y transporte';'Restaurantes';'VARIABLES'
15/10/2009;16/10/2009;'ENDESA DISTRIB';-53,66€;8.853,62 €;-202;-53,66;13.377,71 €;'sin fechas';16/10/2009;'ENDESA';'Gastos_Servicios tipicos';'Electricidad';'FIJO'
15/10/2009;15/10/2009;'MERCADONA';-51,30€;8.802,32 €;-201;-51,30;13.326,41 €;'sin fechas';15/10/2009;'MERCADONA';'Gastos_Compras';'Supermercado';'VARIABLES'
15/10/2009;15/10/2009;'SEG.AM.HIPITEC';-30,85€;8.771,47 €;-200;-30,85;13.295,56 €;'sin fechas';15/10/2009;'SEGAMHIPITEC';'Gastos_Seguros';'Seguro vida';'FIJO'
17/10/2009;17/10/2009;'GASOLINA';-28,64€;8.742,83 €;-199;-28,64;13.266,92 €;'sin fechas';17/10/2009;'GASOLINA';'Gastos_Ocio y transporte';'Gasolina';'VARIABLES'
17/10/2009;17/10/2009;'KIKO';-20,10€;8.722,73 €;-198;-20,10;13.246,82 €;'sin fechas';17/10/2009;'KIKO';'Gastos_Salud, saber y deporte';'Belleza';'VARIABLES'
17/10/2009;17/10/2009;'M&S';-37,98€;8.684,75 €;-197;-37,98;13.208,84 €;'sin fechas';17/10/2009;'MS';'Gastos_Compras';'Ropa';'VARIABLES'
17/10/2009;17/10/2009;'MISAKO';-30,00€;8.654,75 €;-196;-30,00;13.178,84 €;'sin fechas';17/10/2009;'MISAKO';'Gastos_Compras';'Ropa';'VARIABLES'
18/10/2009;18/10/2009;'LA BRASA';-16,43€;8.638,32 €;-195;-16,43;13.162,41 €;'sin fechas';18/10/2009;'BRASA';'Gastos_Ocio y transporte';'Restaurantes';'VARIABLES'
19/10/2009;19/10/2009;'CAFET.C T PRAT';-3,40 €;8.634,92 €;-194;-3,40;13.159,01 €;'sin fechas';19/10/2009;'CAFETC';'Gastos_Ocio y transporte';'Restaurantes';'VARIABLES'
19/10/2009;19/10/2009;'CAFET.C T PRAT';-3,25 €;8.631,67 €;-193;-3,25;13.155,76 €;'sin fechas';19/10/2009;'CAFETC';'Gastos_Ocio y transporte';'Restaurantes';'VARIABLES'
20/10/2009;20/10/2009;'CAFET.C T PRAT';-3,10 €;8.628,57 €;-192;-3,10;13.152,66 €;'sin fechas';20/10/2009;'CAFETC';'Gastos_Ocio y transporte';'Restaurantes';'VARIABLES'
20/10/2009;20/10/2009;'COMISIONES';-0,30 €;8.628,27 €;-191;-0,30;13.152,36 €;'sin fechas';20/10/2009;'COMISIONES';'Gastos_Banco y organismos';'Cargos banco';'FIJO'
20/10/2009;20/10/2009;'METRO';-7,70 €;8.620,57 €;-190;-7,70;13.144,66 €;'sin fechas';20/10/2009;'METRO';'Gastos_Ocio y transporte';'Transporte';'VARIABLES'
20/10/2009;20/10/2009;'METRO';-21,00 €;8.599,57 €;-189;-21,00;13.123,66 €;'sin fechas';20/10/2009;'METRO';'Gastos_Ocio y transporte';'Transporte';'VARIABLES'
20/10/2009;20/10/2009;'NOSTRUM';-12,25 €;8.587,32 €;-188;-12,25;13.111,41 €;'sin fechas';20/10/2009;'NOSTRUM';'Gastos_Ocio y transporte';'Restaurantes';'VARIABLES'
20/10/2009;20/10/2009;'ONO';-88,81 €;8.498,51 €;-187;-88,81;13.022,60 €;'sin fechas';20/10/2009;'ONO';'Gastos_Servicios tipicos';'Telecomunicaciones';'FIJO'
20/10/2009;20/10/2009;'PANSGLORIAS';-8,55 €;8.489,96 €;-186;-8,55;13.014,05 €;'sin fechas';20/10/2009;'PANSGLORIAS';'Gastos_Ocio y transporte';'Restaurantes';'VARIABLES'
21/10/2009;21/10/2009;'CAFET.C T PRAT';-3,10 €;8.486,86 €;-185;-3,10;13.010,95 €;'sin fechas';21/10/2009;'CAFETC';'Gastos_Ocio y transporte';'Restaurantes';'VARIABLES'
21/10/2009;21/10/2009;'COMISIONES';-0,30 €;8.486,56 €;-184;-0,30;13.010,65 €;'sin fechas';21/10/2009;'COMISIONES';'Gastos_Banco y organismos';'Cargos banco';'FIJO'
21/10/2009;21/10/2009;'REINT.CAJERO';-150,00 €;8.336,56 €;-183;-150,00;12.860,65 €;'sin fechas';21/10/2009;'REINTCAJERO';'Gastos_Gastos varios';'Efectivo';'VARIABLES'
22/10/2009;22/10/2009;'CAFET.C T PRAT';-3,85 €;8.332,71 €;-182;-3,85;12.856,80 €;'sin fechas';22/10/2009;'CAFETC';'Gastos_Ocio y transporte';'Restaurantes';'VARIABLES'
23/10/2009;23/10/2009;'AMC PARC VALLES';-9,00 €;8.323,71 €;-181;-9,00;12.847,80 €;'sin fechas';23/10/2009;'AMC';'Gastos_Ocio y transporte';'Espectáculos';'VARIABLES'
23/10/2009;23/10/2009;'COMISIONES';14,92 €;8.338,63 €;-180;14,92;12.862,72 €;'sin fechas';23/10/2009;'COMISIONES';'Gastos_Banco y organismos';'Cargos banco';'FIJO'
23/10/2009;23/10/2009;'FRANCE TELECOM';-10,44 €;8.328,19 €;-179;-10,44;12.852,28 €;'sin fechas';23/10/2009;'FRANCE';'Gastos_Servicios tipicos';'Telecomunicaciones';'FIJO'
23/10/2009;23/10/2009;'MCDONALDS SANT';-15,15 €;8.313,04 €;-178;-15,15;12.837,13 €;'sin fechas';23/10/2009;'MCDONALDS';'Gastos_Ocio y transporte';'Restaurantes';'VARIABLES'
24/10/2009;24/10/2009;'CAPRABO';-33,21 €;8.279,83 €;-177;-33,21;12.803,92 €;'sin fechas';24/10/2009;'CAPRABO';'Gastos_Compras';'Supermercado';'VARIABLES'
24/10/2009;24/10/2009;'CELIO TERRASSA';-99,99 €;8.179,84 €;-176;-99,99;12.703,93 €;'sin fechas';24/10/2009;'CELIO';'Gastos_Compras';'Ropa';'VARIABLES'
24/10/2009;24/10/2009;'H&M';-79,90 €;8.099,94 €;-175;-79,90;12.624,03 €;'sin fechas';24/10/2009;'HM';'Gastos_Compras';'Ropa';'VARIABLES'
24/10/2009;24/10/2009;'TAPASBAR';-30,00 €;8.069,94 €;-174;-30,00;12.594,03 €;'sin fechas';24/10/2009;'TAPASBAR';'Gastos_Ocio y transporte';'Restaurantes';'VARIABLES'
24/10/2009;24/10/2009;'VIENA';-6,75 €;8.063,19 €;-173;-6,75;12.587,28 €;'sin fechas';24/10/2009;'VIENA';'Gastos_Ocio y transporte';'Restaurantes';'VARIABLES'
26/10/2009;26/10/2009;'MERCADONA';-20,33 €;8.042,86 €;-172;-20,33;12.566,95 €;'sin fechas';26/10/2009;'MERCADONA';'Gastos_Compras';'Supermercado';'VARIABLES'
27/10/2009;27/10/2009;'CAFET.C T PRAT';-3,25 €;8.039,61 €;-171;-3,25;12.563,70 €;'sin fechas';27/10/2009;'CAFETC';'Gastos_Ocio y transporte';'Restaurantes';'VARIABLES'
27/10/2009;27/10/2009;'FRANCE TELECOM';-19,20 €;8.020,41 €;-170;-19,20;12.544,50 €;'sin fechas';27/10/2009;'FRANCE';'Gastos_Servicios tipicos';'Telecomunicaciones';'FIJO'
27/10/2009;27/10/2009;'FRUITES I VERDURES';-5,64 €;8.014,77 €;-169;-5,64;12.538,86 €;'sin fechas';27/10/2009;'FRUITES';'Gastos_Compras';'Supermercado';'VARIABLES'
27/10/2009;27/10/2009;'RENFE';-15,40 €;7.999,37 €;-168;-15,40;12.523,46 €;'sin fechas';27/10/2009;'RENFE';'Gastos_Ocio y transporte';'Transporte';'VARIABLES'
28/10/2009;28/10/2009;'CAFET.C T PRAT';-3,25 €;7.996,12 €;-167;-3,25;12.520,21 €;'sin fechas';28/10/2009;'CAFETC';'Gastos_Ocio y transporte';'Restaurantes';'VARIABLES'
28/10/2009;28/10/2009;'CARREFOUR-[comida]';-19,80 €;7.976,32 €;-166;-19,80;12.500,41 €;'sin fechas';28/10/2009;'CARREFOURCOMIDA';'Gastos_Compras';'Supermercado';'VARIABLES'
28/10/2009;28/10/2009;'GASOLINA';-29,28 €;7.947,04 €;-165;-29,28;12.471,13 €;'sin fechas';28/10/2009;'GASOLINA';'Gastos_Ocio y transporte';'Gasolina';'VARIABLES'
28/10/2009;28/10/2009;'MERCADONA';-144,83 €;7.802,21 €;-164;-144,83;12.326,30 €;'sin fechas';28/10/2009;'MERCADONA';'Gastos_Compras';'Supermercado';'VARIABLES'
29/10/2009;28/10/2009;'ajuste vacaciones';-72,00 €;7.730,21 €;-163;-72,00;12.254,30 €;'sin fechas';28/10/2009;'AJUSTE';'No computable';'Inicializacion';
29/10/2009;29/10/2009;'CAFET.C T PRAT';-3,25 €;7.726,96 €;-162;-3,25;12.251,05 €;'sin fechas';29/10/2009;'CAFETC';'Gastos_Ocio y transporte';'Restaurantes';'VARIABLES'
29/10/2009;28/10/2009;'INFORMACIO I TECNOLOGIA DE CAT';1.698,77 €;9.425,73 €;-161;1.698,77;13.949,82 €;'sin fechas';28/10/2009;'INFORMACIO';'Ingresos';'Nomina';'FIJO'
29/10/2009;28/10/2009;'Ordenador';-68,00 €;9.357,73 €;-160;-68,00;13.881,82 €;'sin fechas';28/10/2009;'ORDENADOR';'Gastos_Compras';'Hobbys';'VARIABLES'
29/10/2009;29/10/2009;'REINT.CAJERO';-60,00 €;9.297,73 €;-159;-60,00;13.821,82 €;'sin fechas';29/10/2009;'REINTCAJERO';'Gastos_Gastos varios';'Efectivo';'VARIABLES'
29/10/2009;29/10/2009;'REINT.CAJERO';-60,00 €;9.237,73 €;-158;-60,00;13.761,82 €;'sin fechas';29/10/2009;'REINTCAJERO';'Gastos_Gastos varios';'Efectivo';'VARIABLES'
29/10/2009;29/10/2009;'REINT.CAJERO';60,00 €;9.297,73 €;-157;60,00;13.821,82 €;'sin fechas';29/10/2009;'REINTCAJERO';'Gastos_Gastos varios';'Efectivo';'VARIABLES'
30/10/2009;30/10/2009;'C&A';-130,95 €;9.166,78 €;-156;-130,95;13.690,87 €;'sin fechas';30/10/2009;'CA';'Gastos_Compras';'Ropa';'VARIABLES'
30/10/2009;30/10/2009;'CAFET.C T PRAT';-3,50 €;9.163,28 €;-155;-3,50;13.687,37 €;'sin fechas';30/10/2009;'CAFETC';'Gastos_Ocio y transporte';'Restaurantes';'VARIABLES'
30/10/2009;28/10/2009;'FOMENT DE TERRASSA, S.A. FOMEN';1.632,20 €;10.795,48 €;-154;1.632,20;15.319,57 €;'sin fechas';28/10/2009;'FOMENT';'Ingresos';'Nomina';'FIJO'
30/10/2009;30/10/2009;'GAME';-39,90 €;10.755,58 €;-153;-39,90;15.279,67 €;'sin fechas';30/10/2009;'GAME';'Gastos_Compras';'Hobbys';'VARIABLES'
30/10/2009;30/10/2009;'KANAK BARCELONA S';-49,90 €;10.705,68 €;-152;-49,90;15.229,77 €;'sin fechas';30/10/2009;'KANAK';'Gastos_Compras';'Ropa';'VARIABLES'
30/10/2009;30/10/2009;'KUROKAI';-27,99 €;10.677,69 €;-151;-27,99;15.201,78 €;'sin fechas';30/10/2009;'KUROKAI';'Gastos_Compras';'Ropa';'VARIABLES'
30/10/2009;30/10/2009;'KUROKAI';-89,99 €;10.587,70 €;-150;-89,99;15.111,79 €;'sin fechas';30/10/2009;'KUROKAI';'Gastos_Compras';'Ropa';'VARIABLES'
30/10/2009;30/10/2009;'STARBUCKS COFFEE';-6,85 €;10.580,85 €;-149;-6,85;15.104,94 €;'sin fechas';30/10/2009;'STARBUCKS';'Gastos_Ocio y transporte';'Restaurantes';'VARIABLES'
31/10/2009;31/10/2009;'EROSKI-[COMIDA]';-70,54 €;10.510,31 €;-148;-70,54;15.034,40 €;'sin fechas';31/10/2009;'EROSKICOMIDA';'Gastos_Compras';'Supermercado';'VARIABLES'
31/10/2009;31/10/2009;'GRAN SIGLO';-28,15 €;10.482,16 €;-147;-28,15;15.006,25 €;'sin fechas';31/10/2009;'GRAN';'Gastos_Ocio y transporte';'Restaurantes';'VARIABLES'
31/10/2009;28/10/2009;'RECIBO PTMOS. 3061-0960001518';-646,20 €;9.835,96 €;-146;-646,20;14.360,05 €;'sin fechas';28/10/2009;'RECIBO';'Gastos_Banco y organismos';'Hipoteca';'FIJO'
31/10/2009;28/10/2009;'RECIBO PTMOS. 3061-0960004140';-177,24 €;9.658,72 €;-145;-177,24;14.182,81 €;'sin fechas';28/10/2009;'RECIBO';'Gastos_Banco y organismos';'Hipoteca';'FIJO'
02/11/2009;02/11/2009;'CAFET.C T PRAT';-3,25 €;9.655,47 €;-144;-3,25;14.179,56 €;'sin fechas';02/11/2009;'CAFETC';'Gastos_Ocio y transporte';'Restaurantes';'VARIABLES'
02/11/2009;02/11/2009;'MERCADONA';-3,70 €;9.651,77 €;-143;-3,70;14.175,86 €;'sin fechas';02/11/2009;'MERCADONA';'Gastos_Compras';'Supermercado';'VARIABLES'
03/11/2009;03/11/2009;'CAFET.C T PRAT';-3,40 €;9.648,37 €;-142;-3,40;14.172,46 €;'sin fechas';03/11/2009;'CAFETC';'Gastos_Ocio y transporte';'Restaurantes';'VARIABLES'
04/11/2009;04/11/2009;'CAFET.C T PRAT';-3,40 €;9.644,97 €;-141;-3,40;14.169,06 €;'sin fechas';04/11/2009;'CAFETC';'Gastos_Ocio y transporte';'Restaurantes';'VARIABLES'
04/11/2009;04/11/2009;'VIRGIN ACTIVE';-59,00 €;9.585,97 €;-140;-59,00;14.110,06 €;'sin fechas';04/11/2009;'VIRGIN';'Gastos_Salud, saber y deporte';'Deportes';'VARIABLES'
04/11/2009;04/11/2009;'VIRGIN ACTIVE';-59,00 €;9.526,97 €;-139;-59,00;14.051,06 €;'sin fechas';04/11/2009;'VIRGIN';'Gastos_Salud, saber y deporte';'Deportes';'VARIABLES'
05/11/2009;05/11/2009;'CAFET.C T PRAT';-3,25 €;9.523,72 €;-138;-3,25;14.047,81 €;'sin fechas';05/11/2009;'CAFETC';'Gastos_Ocio y transporte';'Restaurantes';'VARIABLES'
05/11/2009;05/11/2009;'MERCADONA';-13,05 €;9.510,67 €;-137;-13,05;14.034,76 €;'sin fechas';05/11/2009;'MERCADONA';'Gastos_Compras';'Supermercado';'VARIABLES'
06/11/2009;06/11/2009;'CAFET.C T PRAT';-3,25 €;9.507,42 €;-136;-3,25;14.031,51 €;'sin fechas';06/11/2009;'CAFETC';'Gastos_Ocio y transporte';'Restaurantes';'VARIABLES'
06/11/2009;06/11/2009;'GASOLINA';-30,02 €;9.477,40 €;-135;-30,02;14.001,49 €;'sin fechas';06/11/2009;'GASOLINA';'Gastos_Ocio y transporte';'Gasolina';'VARIABLES'
06/11/2009;06/11/2009;'WOKGU';-17,50 €;9.459,90 €;-134;-17,50;13.983,99 €;'sin fechas';06/11/2009;'WOKGU';'Gastos_Ocio y transporte';'Restaurantes';'VARIABLES'
07/11/2009;07/11/2009;'ALCAMPO';-63,88 €;9.396,02 €;-133;-63,88;13.920,11 €;'sin fechas';07/11/2009;'ALCAMPO';'Gastos_Compras';'Supermercado';'VARIABLES'
07/11/2009;07/11/2009;'CAPRABO';-39,35 €;9.356,67 €;-132;-39,35;13.880,76 €;'sin fechas';07/11/2009;'CAPRABO';'Gastos_Compras';'Supermercado';'VARIABLES'
07/11/2009;07/11/2009;'LEROY MERLIN';-41,45 €;9.315,22 €;-131;-41,45;13.839,31 €;'sin fechas';07/11/2009;'LEROY';'Gastos_Vivienda y vehiculo';'Mnto. hogar';'VARIABLES'
07/11/2009;07/11/2009;'VIENA';-10,10 €;9.305,12 €;-130;-10,10;13.829,21 €;'sin fechas';07/11/2009;'VIENA';'Gastos_Ocio y transporte';'Restaurantes';'VARIABLES'
08/11/2009;16/11/2009;'COMPRA CON TARJETA';-0,90 €;9.304,22 €;-129;-0,90;13.828,31 €;'sin fechas';16/11/2009;'COMPRA';'Gastos_Compras';'Supermercado';'VARIABLES'
08/11/2009;08/11/2009;'FARMACIA';-7,50 €;9.296,72 €;-128;-7,50;13.820,81 €;'sin fechas';08/11/2009;'FARMACIA';'Gastos_Salud, saber y deporte';'Farmacia';'VARIABLES'
08/11/2009;08/11/2009;'REINT.CAJERO';-120,00 €;9.176,72 €;-127;-120,00;13.700,81 €;'sin fechas';08/11/2009;'REINTCAJERO';'Gastos_Gastos varios';'Efectivo';'VARIABLES'
09/11/2009;09/11/2009;'CAFET.C T PRAT';-3,25 €;9.173,47 €;-126;-3,25;13.697,56 €;'sin fechas';09/11/2009;'CAFETC';'Gastos_Ocio y transporte';'Restaurantes';'VARIABLES'
09/11/2009;09/11/2009;'CIA. DE SEGUROS 006662671613';-33,90 €;9.139,57 €;-125;-33,90;13.663,66 €;'sin fechas';09/11/2009;'CIA';'Ingresos';'Devoluciones';'VARIABLES'
11/11/2009;11/11/2009;'CAFET.C T PRAT';-3,25 €;9.136,32 €;-124;-3,25;13.660,41 €;'sin fechas';11/11/2009;'CAFETC';'Gastos_Ocio y transporte';'Restaurantes';'VARIABLES'
12/11/2009;12/11/2009;'CAFET.C T PRAT';-3,15 €;9.133,17 €;-123;-3,15;13.657,26 €;'sin fechas';12/11/2009;'CAFETC';'Gastos_Ocio y transporte';'Restaurantes';'VARIABLES'
13/11/2009;13/11/2009;'CAFET.C T PRAT';-2,55 €;9.130,62 €;-122;-2,55;13.654,71 €;'sin fechas';13/11/2009;'CAFETC';'Gastos_Ocio y transporte';'Restaurantes';'VARIABLES'
13/11/2009;17/11/2009;'COMPRA CON TARJETA';-4,05 €;9.126,57 €;-121;-4,05;13.650,66 €;'sin fechas';17/11/2009;'COMPRA';'Gastos_Compras';'Supermercado';'VARIABLES'
13/11/2009;17/11/2009;'COMPRA CON TARJETA';-5,30 €;9.121,27 €;-120;-5,30;13.645,36 €;'sin fechas';17/11/2009;'COMPRA';'Gastos_Compras';'Supermercado';'VARIABLES'
13/11/2009;17/11/2009;'COMPRA CON TARJETA';-3,11 €;9.118,16 €;-119;-3,11;13.642,25 €;'sin fechas';17/11/2009;'COMPRA';'Gastos_Compras';'Supermercado';'VARIABLES'
13/11/2009;20/11/2009;'COMPRA CON TARJETA';-5,80 €;9.112,36 €;-118;-5,80;13.636,45 €;'sin fechas';20/11/2009;'COMPRA';'Gastos_Compras';'Supermercado';'VARIABLES'
13/11/2009;13/11/2009;'GASOLINA';-20,00 €;9.092,36 €;-117;-20,00;13.616,45 €;'sin fechas';13/11/2009;'GASOLINA';'Gastos_Ocio y transporte';'Gasolina';'VARIABLES'
14/11/2009;14/11/2009;'VIENA';-4,85 €;9.087,51 €;-116;-4,85;13.611,60 €;'sin fechas';14/11/2009;'VIENA';'Gastos_Ocio y transporte';'Restaurantes';'VARIABLES'
15/11/2009;20/11/2009;'COMPRA CON TARJETA';-5,25 €;9.082,26 €;-115;-5,25;13.606,35 €;'sin fechas';20/11/2009;'COMPRA';'Gastos_Compras';'Supermercado';'VARIABLES'
15/11/2009;20/11/2009;'COMPRA CON TARJETA';-3,40 €;9.078,86 €;-114;-3,40;13.602,95 €;'sin fechas';20/11/2009;'COMPRA';'Gastos_Compras';'Supermercado';'VARIABLES'
15/11/2009;20/11/2009;'COMPRA CON TARJETA';-5,80 €;9.073,06 €;-113;-5,80;13.597,15 €;'sin fechas';20/11/2009;'COMPRA';'Gastos_Compras';'Supermercado';'VARIABLES'
16/11/2009;16/11/2009;'CAFET.C T PRAT';-1,40 €;9.071,66 €;-112;-1,40;13.595,75 €;'sin fechas';16/11/2009;'CAFETC';'Gastos_Ocio y transporte';'Restaurantes';'VARIABLES'
16/11/2009;16/11/2009;'SEG.AM.HIPITEC';-30,79 €;9.040,87 €;-111;-30,79;13.564,96 €;'sin fechas';16/11/2009;'SEGAMHIPITEC';'Gastos_Seguros';'Seguro vida';'FIJO'
17/11/2009;17/11/2009;'CAFET.C T PRAT';-3,30 €;9.037,57 €;-110;-3,30;13.561,66 €;'sin fechas';17/11/2009;'CAFETC';'Gastos_Ocio y transporte';'Restaurantes';'VARIABLES'
17/11/2009;17/11/2009;'GASOLINA';-30,00 €;9.007,57 €;-109;-30,00;13.531,66 €;'sin fechas';17/11/2009;'GASOLINA';'Gastos_Ocio y transporte';'Gasolina';'VARIABLES'
17/11/2009;17/11/2009;'ONO';-90,44 €;8.917,13 €;-108;-90,44;13.441,22 €;'sin fechas';17/11/2009;'ONO';'Gastos_Servicios tipicos';'Telecomunicaciones';'FIJO'
17/11/2009;17/11/2009;'REINT.CAJERO';-100,00 €;8.817,13 €;-107;-100,00;13.341,22 €;'sin fechas';17/11/2009;'REINTCAJERO';'Gastos_Gastos varios';'Efectivo';'VARIABLES'
18/11/2009;18/11/2009;'CAFET.C T PRAT';-3,70 €;8.813,43 €;-106;-3,70;13.337,52 €;'sin fechas';18/11/2009;'CAFETC';'Gastos_Ocio y transporte';'Restaurantes';'VARIABLES'
18/11/2009;18/11/2009;'ENDESA DISTRIB';-54,36 €;8.759,07 €;-105;-54,36;13.283,16 €;'sin fechas';18/11/2009;'ENDESA';'Gastos_Servicios tipicos';'Electricidad';'FIJO'
18/11/2009;18/11/2009;'TOYOTA ORIENT CARS';-419,48 €;8.339,59 €;-104;-419,48;12.863,68 €;'sin fechas';18/11/2009;'TOYOTA';'Gastos_Vivienda y vehiculo';'Mnto. vehiculo';'VARIABLE'
19/11/2009;19/11/2009;'CAFET.C T PRAT';-3,80 €;8.335,79 €;-103;-3,80;12.859,88 €;'sin fechas';19/11/2009;'CAFETC';'Gastos_Ocio y transporte';'Restaurantes';'VARIABLES'
19/11/2009;19/11/2009;'MERCADONA';-186,48 €;8.149,31 €;-102;-186,48;12.673,40 €;'sin fechas';19/11/2009;'MERCADONA';'Gastos_Compras';'Supermercado';'VARIABLES'
20/11/2009;20/11/2009;'CAFET.C T PRAT';-3,10 €;8.146,21 €;-101;-3,10;12.670,30 €;'sin fechas';20/11/2009;'CAFETC';'Gastos_Ocio y transporte';'Restaurantes';'VARIABLES'
20/11/2009;20/11/2009;'REINT.CAJERO';-250,00 €;7.896,21 €;-100;-250,00;12.420,30 €;'sin fechas';20/11/2009;'REINTCAJERO';'Gastos_Gastos varios';'Efectivo';'VARIABLES'
23/11/2009;23/11/2009;'CAFET.C T PRAT';-2,10 €;7.894,11 €;-99;-2,10;12.418,20 €;'sin fechas';23/11/2009;'CAFETC';'Gastos_Ocio y transporte';'Restaurantes';'VARIABLES'
23/11/2009;23/11/2009;'FRANCE TELECOM';-14,64 €;7.879,47 €;-98;-14,64;12.403,56 €;'sin fechas';23/11/2009;'FRANCE';'Gastos_Servicios tipicos';'Telecomunicaciones';'FIJO'
24/11/2009;24/11/2009;'CAFET.C T PRAT';-2,45 €;7.877,02 €;-97;-2,45;12.401,11 €;'sin fechas';24/11/2009;'CAFETC';'Gastos_Ocio y transporte';'Restaurantes';'VARIABLES'
25/11/2009;25/11/2009;'CAFET.C T PRAT';-2,45 €;7.874,57 €;-96;-2,45;12.398,66 €;'sin fechas';25/11/2009;'CAFETC';'Gastos_Ocio y transporte';'Restaurantes';'VARIABLES'
25/11/2009;25/11/2009;'FARMACIA';-6,00 €;7.868,57 €;-95;-6,00;12.392,66 €;'sin fechas';25/11/2009;'FARMACIA';'Gastos_Salud, saber y deporte';'Farmacia';'VARIABLES'
26/11/2009;26/11/2009;'CAFET.C T PRAT';-3,25 €;7.865,32 €;-94;-3,25;12.389,41 €;'sin fechas';26/11/2009;'CAFETC';'Gastos_Ocio y transporte';'Restaurantes';'VARIABLES'
26/11/2009;26/11/2009;'GASOLINA';-30,00 €;7.835,32 €;-93;-30,00;12.359,41 €;'sin fechas';26/11/2009;'GASOLINA';'Gastos_Ocio y transporte';'Gasolina';'VARIABLES'
26/11/2009;26/11/2009;'REINT.CAJERO';-100,00 €;7.735,32 €;-92;-100,00;12.259,41 €;'sin fechas';26/11/2009;'REINTCAJERO';'Gastos_Gastos varios';'Efectivo';'VARIABLES'
27/11/2009;27/11/2009;'CAFET.C T PRAT';-3,55 €;7.731,77 €;-91;-3,55;12.255,86 €;'sin fechas';27/11/2009;'CAFETC';'Gastos_Ocio y transporte';'Restaurantes';'VARIABLES'
27/11/2009;01/12/2009;'COMPRA CON TARJETA';-0,65 €;7.731,12 €;-90;-0,65;12.255,21 €;'sin fechas';01/12/2009;'COMPRA';'Gastos_Compras';'Supermercado';'VARIABLES'
27/11/2009;27/11/2009;'FRANCE TELECOM';-24,64 €;7.706,48 €;-89;-24,64;12.230,57 €;'sin fechas';27/11/2009;'FRANCE';'Gastos_Servicios tipicos';'Telecomunicaciones';'FIJO'
27/11/2009;27/11/2009;'KURZ AND GUT MATARO \\MATARO';-6,90 €;7.699,58 €;-88;-6,90;12.223,67 €;'sin fechas';27/11/2009;'KURZ';'Gastos_Ocio y transporte';'Restaurantes';'VARIABLES'
28/11/2009;04/12/2009;'COMPRA CON TARJETA';-1,10 €;7.698,48 €;-87;-1,10;12.222,57 €;'sin fechas';04/12/2009;'COMPRA';'Gastos_Compras';'Supermercado';'VARIABLES'
28/11/2009;04/12/2009;'COMPRA CON TARJETA';-0,65 €;7.697,83 €;-86;-0,65;12.221,92 €;'sin fechas';04/12/2009;'COMPRA';'Gastos_Compras';'Supermercado';'VARIABLES'
28/11/2009;28/11/2009;'FARMACIA';-13,00 €;7.684,83 €;-85;-13,00;12.208,92 €;'sin fechas';28/11/2009;'FARMACIA';'Gastos_Salud, saber y deporte';'Farmacia';'VARIABLES'
28/11/2009;28/11/2009;'REST.YUTAKA II';-89,99 €;7.594,84 €;-84;-89,99;12.118,93 €;'sin fechas';28/11/2009;'RESTYUTAKA';'Gastos_Seguros';'Seguro vida';'FIJO'
28/11/2009;28/11/2009;'VIENA';-9,40 €;7.585,44 €;-83;-9,40;12.109,53 €;'sin fechas';28/11/2009;'VIENA';'Gastos_Ocio y transporte';'Restaurantes';'VARIABLES'
29/11/2009;29/11/2009;'AMC PARC VALLES';-11,00 €;7.574,44 €;-82;-11,00;12.098,53 €;'sin fechas';29/11/2009;'AMC';'Gastos_Ocio y transporte';'Espectáculos';'VARIABLES'
29/11/2009;29/11/2009;'VIENA';-6,95 €;7.567,49 €;-81;-6,95;12.091,58 €;'sin fechas';29/11/2009;'VIENA';'Gastos_Ocio y transporte';'Restaurantes';'VARIABLES'
30/11/2009;30/11/2009;'CAPRABO';-8,07 €;7.559,42 €;-80;-8,07;12.083,51 €;'sin fechas';30/11/2009;'CAPRABO';'Gastos_Compras';'Supermercado';'VARIABLES'
30/11/2009;27/11/2009;'INFORMACIO I TECNOLOGIA DE CAT';1.626,77 €;9.186,19 €;-79;1.626,77;13.710,28 €;'sin fechas';27/11/2009;'INFORMACIO';'Ingresos';'Nomina';'FIJO'
30/11/2009;30/11/2009;'KANAK BARCELONA S';-51,90 €;9.134,29 €;-78;-51,90;13.658,38 €;'sin fechas';30/11/2009;'KANAK';'Gastos_Compras';'Ropa';'VARIABLES'
30/11/2009;30/11/2009;'M&S';-60,98 €;9.073,31 €;-77;-60,98;13.597,40 €;'sin fechas';30/11/2009;'MS';'Gastos_Compras';'Ropa';'VARIABLES'
30/11/2009;30/11/2009;'RECIBO PTMOS. 3061-0960001518';-646,20 €;8.427,11 €;-76;-646,20;12.951,20 €;'sin fechas';30/11/2009;'RECIBO';'Gastos_Banco y organismos';'Hipoteca';'FIJO'
30/11/2009;30/11/2009;'RECIBO PTMOS. 3061-0960004140';-177,24 €;8.249,87 €;-75;-177,24;12.773,96 €;'sin fechas';30/11/2009;'RECIBO';'Gastos_Banco y organismos';'Hipoteca';'FIJO'
30/11/2009;30/11/2009;'VIENA';-9,85 €;8.240,02 €;-74;-9,85;12.764,11 €;'sin fechas';30/11/2009;'VIENA';'Gastos_Ocio y transporte';'Restaurantes';'VARIABLES'
01/12/2009;01/12/2009;'AJUNTAMENT DE TERRASSA';-36,83 €;8.203,19 €;-73;-36,83;12.727,28 €;'sin fechas';01/12/2009;'AJUNTAMENT';'Gastos_Banco y organismos';'Ayuntamiento';'FIJO'
01/12/2009;30/11/2009;'AMORTIZ.PTMOS. SEA1-SEGUROS';-21,20 €;8.181,99 €;-72;-21,20;12.706,08 €;'sin fechas';30/11/2009;'AMORTIZPTMOS';'Gastos_Banco y organismos';'Hipoteca';'FIJO'
01/12/2009;01/12/2009;'CAFET.C T PRAT';-7,75 €;8.174,24 €;-71;-7,75;12.698,33 €;'sin fechas';01/12/2009;'CAFETC';'Gastos_Ocio y transporte';'Restaurantes';'VARIABLES'
01/12/2009;27/11/2009;'FOMENT DE TERRASSA, S.A. FOMEN';1.574,20 €;9.748,44 €;-70;1.574,20;14.272,53 €;'sin fechas';27/11/2009;'FOMENT';'Ingresos';'Nomina';'FIJO'
01/12/2009;01/12/2009;'REINT.CAJERO';-100,00 €;9.648,44 €;-69;-100,00;14.172,53 €;'sin fechas';01/12/2009;'REINTCAJERO';'Gastos_Gastos varios';'Efectivo';'VARIABLES'
02/12/2009;02/12/2009;'CAFET.C T PRAT';-4,45 €;9.643,99 €;-68;-4,45;14.168,08 €;'sin fechas';02/12/2009;'CAFETC';'Gastos_Ocio y transporte';'Restaurantes';'VARIABLES'
02/12/2009;03/12/2009;'CIA. DE SEGUROS 006662671613';-33,90 €;9.610,09 €;-67;-33,90;14.134,18 €;'sin fechas';03/12/2009;'CIA';'Ingresos';'Devoluciones';'VARIABLES'
02/12/2009;02/12/2009;'DECATHLON';-179,00 €;9.431,09 €;-66;-179,00;13.955,18 €;'sin fechas';02/12/2009;'DECATHLON';'Gastos_Compras';'Deportivo';'VARIABLES'
02/12/2009;02/12/2009;'GASOLINA';-42,40 €;9.388,69 €;-65;-42,40;13.912,78 €;'sin fechas';02/12/2009;'GASOLINA';'Gastos_Ocio y transporte';'Gasolina';'VARIABLES'
03/12/2009;03/12/2009;'CAFET.C T PRAT';-3,55 €;9.385,14 €;-64;-3,55;13.909,23 €;'sin fechas';03/12/2009;'CAFETC';'Gastos_Ocio y transporte';'Restaurantes';'VARIABLES'
03/12/2009;03/12/2009;'DHR TRADE SL';-15,10 €;9.370,04 €;-63;-15,10;13.894,13 €;'sin fechas';03/12/2009;'DHR';'Gastos_Ocio y transporte';'Gasolina';'VARIABLES'
03/12/2009;03/12/2009;'EROSKI-[COMIDA]';-74,89 €;9.295,15 €;-62;-74,89;13.819,24 €;'sin fechas';03/12/2009;'EROSKICOMIDA';'Gastos_Compras';'Supermercado';'VARIABLES'
03/12/2009;03/12/2009;'MERCADONA';-9,47 €;9.285,68 €;-61;-9,47;13.809,77 €;'sin fechas';03/12/2009;'MERCADONA';'Gastos_Compras';'Supermercado';'VARIABLES'
04/12/2009;04/12/2009;'AMC PARC VALLES';-15,00 €;9.270,68 €;-60;-15,00;13.794,77 €;'sin fechas';04/12/2009;'AMC';'Gastos_Ocio y transporte';'Espectáculos';'VARIABLES'
04/12/2009;04/12/2009;'CAFET.C T PRAT';-2,35 €;9.268,33 €;-59;-2,35;13.792,42 €;'sin fechas';04/12/2009;'CAFETC';'Gastos_Ocio y transporte';'Restaurantes';'VARIABLES'
06/12/2009;06/12/2009;'AMC PARC VALLES';-11,00 €;9.257,33 €;-58;-11,00;13.781,42 €;'sin fechas';06/12/2009;'AMC';'Gastos_Ocio y transporte';'Espectáculos';'VARIABLES'
06/12/2009;06/12/2009;'EROSKI-[COMIDA]';-49,92 €;9.207,41 €;-57;-49,92;13.731,50 €;'sin fechas';06/12/2009;'EROSKICOMIDA';'Gastos_Compras';'Supermercado';'VARIABLES'
06/12/2009;06/12/2009;'VIENA';-10,80 €;9.196,61 €;-56;-10,80;13.720,70 €;'sin fechas';06/12/2009;'VIENA';'Gastos_Ocio y transporte';'Restaurantes';'VARIABLES'
07/12/2009;07/12/2009;'CAFET.C T PRAT';-3,65 €;9.192,96 €;-55;-3,65;13.717,05 €;'sin fechas';07/12/2009;'CAFETC';'Gastos_Ocio y transporte';'Restaurantes';'VARIABLES'
09/12/2009;09/12/2009;'CAFET.C T PRAT';-2,70 €;9.190,26 €;-54;-2,70;13.714,35 €;'sin fechas';09/12/2009;'CAFETC';'Gastos_Ocio y transporte';'Restaurantes';'VARIABLES'
10/12/2009;10/12/2009;'CAFET.C T PRAT';-3,85 €;9.186,41 €;-53;-3,85;13.710,50 €;'sin fechas';10/12/2009;'CAFETC';'Gastos_Ocio y transporte';'Restaurantes';'VARIABLES'
10/12/2009;10/12/2009;'FRUITES I VERDURES';-5,50 €;9.180,91 €;-52;-5,50;13.705,00 €;'sin fechas';10/12/2009;'FRUITES';'Gastos_Compras';'Supermercado';'VARIABLES'
10/12/2009;10/12/2009;'MERCADONA';-89,98 €;9.090,93 €;-51;-89,98;13.615,02 €;'sin fechas';10/12/2009;'MERCADONA';'Gastos_Compras';'Supermercado';'VARIABLES'
11/12/2009;11/12/2009;'CAFET.C T PRAT';-4,30 €;9.086,63 €;-50;-4,30;13.610,72 €;'sin fechas';11/12/2009;'CAFETC';'Gastos_Ocio y transporte';'Restaurantes';'VARIABLES'
12/12/2009;12/12/2009;'VIENA';-10,80 €;9.075,83 €;-49;-10,80;13.599,92 €;'sin fechas';12/12/2009;'VIENA';'Gastos_Ocio y transporte';'Restaurantes';'VARIABLES'
14/12/2009;14/12/2009;'BON AREA';-19,88 €;9.055,95 €;-48;-19,88;13.580,04 €;'sin fechas';14/12/2009;'BON';'Gastos_Compras';'Supermercado';'VARIABLES'
14/12/2009;14/12/2009;'GAS NATURAL';-90,44 €;8.965,51 €;-47;-90,44;13.489,60 €;'sin fechas';14/12/2009;'GAS';'Gastos_Servicios tipicos';'Gas';'FIJO'
14/12/2009;14/12/2009;'H&M';-27,90 €;8.937,61 €;-46;-27,90;13.461,70 €;'sin fechas';14/12/2009;'HM';'Gastos_Compras';'Ropa';'VARIABLES'
14/12/2009;14/12/2009;'IKEA';-3,95 €;8.933,66 €;-45;-3,95;13.457,75 €;'sin fechas';14/12/2009;'IKEA';'Gastos_Vivienda y vehiculo';'Mnto. hogar';'VARIABLES'
14/12/2009;14/12/2009;'LET\''S WOK';-45,40 €;8.888,26 €;-44;-45,40;13.412,35 €;'sin fechas';14/12/2009;'LETS';'Gastos_Ocio y transporte';'Restaurantes';'VARIABLES'
14/12/2009;14/12/2009;'REINT.CAJERO';-60,00 €;8.828,26 €;-43;-60,00;13.352,35 €;'sin fechas';14/12/2009;'REINTCAJERO';'Gastos_Gastos varios';'Efectivo';'VARIABLES'
14/12/2009;14/12/2009;'VIENA';-9,90 €;8.818,36 €;-42;-9,90;13.342,45 €;'sin fechas';14/12/2009;'VIENA';'Gastos_Ocio y transporte';'Restaurantes';'VARIABLES'
15/12/2009;15/12/2009;'CAFET.C T PRAT';-3,55 €;8.814,81 €;-41;-3,55;13.338,90 €;'sin fechas';15/12/2009;'CAFETC';'Gastos_Ocio y transporte';'Restaurantes';'VARIABLES'
15/12/2009;15/12/2009;'CAFET.C T PRAT';-7,15 €;8.807,66 €;-40;-7,15;13.331,75 €;'sin fechas';15/12/2009;'CAFETC';'Gastos_Ocio y transporte';'Restaurantes';'VARIABLES'
15/12/2009;15/12/2009;'ENDESA DISTRIB';-44,10 €;8.763,56 €;-39;-44,10;13.287,65 €;'sin fechas';15/12/2009;'ENDESA';'Gastos_Servicios tipicos';'Electricidad';'FIJO'
15/12/2009;15/12/2009;'GASOLINA';-30,00 €;8.733,56 €;-38;-30,00;13.257,65 €;'sin fechas';15/12/2009;'GASOLINA';'Gastos_Ocio y transporte';'Gasolina';'VARIABLES'
15/12/2009;15/12/2009;'SEG.AM.HIPITEC';-30,72 €;8.702,84 €;-37;-30,72;13.226,93 €;'sin fechas';15/12/2009;'SEGAMHIPITEC';'Gastos_Seguros';'Seguro vida';'FIJO'
16/12/2009;16/12/2009;'CAFET.C T PRAT';-3,60 €;8.699,24 €;-36;-3,60;13.223,33 €;'sin fechas';16/12/2009;'CAFETC';'Gastos_Ocio y transporte';'Restaurantes';'VARIABLES'
16/12/2009;16/12/2009;'CAFET.C T PRAT';-7,15 €;8.692,09 €;-35;-7,15;13.216,18 €;'sin fechas';16/12/2009;'CAFETC';'Gastos_Ocio y transporte';'Restaurantes';'VARIABLES'
17/12/2009;17/12/2009;'CAFET.C T PRAT';-2,20 €;8.689,89 €;-34;-2,20;13.213,98 €;'sin fechas';17/12/2009;'CAFETC';'Gastos_Ocio y transporte';'Restaurantes';'VARIABLES'
17/12/2009;17/12/2009;'CAFET.C T PRAT';-7,15 €;8.682,74 €;-33;-7,15;13.206,83 €;'sin fechas';17/12/2009;'CAFETC';'Gastos_Ocio y transporte';'Restaurantes';'VARIABLES'
17/12/2009;17/12/2009;'INFORMACIO I TECNOLOGIA DE CAT';1.779,43 €;10.462,17 €;-32;1.779,43;14.986,26 €;'sin fechas';17/12/2009;'INFORMACIO';'Ingresos';'Nomina';'FIJO'
18/12/2009;18/12/2009;'CAFET.C T PRAT';-3,50 €;10.458,67 €;-31;-3,50;14.982,76 €;'sin fechas';18/12/2009;'CAFETC';'Gastos_Ocio y transporte';'Restaurantes';'VARIABLES'
18/12/2009;18/12/2009;'MINA PUBLICA DE LA CIUTAT';-26,56 €;10.432,11 €;-30;-26,56;14.956,20 €;'sin fechas';18/12/2009;'MINA';'Gastos_Servicios tipicos';'Agua';'FIJO'
18/12/2009;18/12/2009;'ONO';-84,97 €;10.347,14 €;-29;-84,97;14.871,23 €;'sin fechas';18/12/2009;'ONO';'Gastos_Servicios tipicos';'Telecomunicaciones';'FIJO'
19/12/2009;19/12/2009;'LOLA VIDAL CABELL';-25,00 €;10.322,14 €;-28;-25,00;14.846,23 €;'sin fechas';19/12/2009;'LOLA';'Gastos_Ocio y transporte';'Restaurantes';'VARIABLES'
19/12/2009;19/12/2009;'VIENA';-11,20 €;10.310,94 €;-27;-11,20;14.835,03 €;'sin fechas';19/12/2009;'VIENA';'Gastos_Ocio y transporte';'Restaurantes';'VARIABLES'
20/12/2009;20/12/2009;'EROSKI-[COMIDA]';-88,49 €;10.222,45 €;-26;-88,49;14.746,54 €;'sin fechas';20/12/2009;'EROSKICOMIDA';'Gastos_Compras';'Supermercado';'VARIABLES'
20/12/2009;20/12/2009;'VIENA';-10,80 €;10.211,65 €;-25;-10,80;14.735,74 €;'sin fechas';20/12/2009;'VIENA';'Gastos_Ocio y transporte';'Restaurantes';'VARIABLES'
21/12/2009;21/12/2009;'CAFET.C T PRAT';-2,65 €;10.209,00 €;-24;-2,65;14.733,09 €;'sin fechas';21/12/2009;'CAFETC';'Gastos_Ocio y transporte';'Restaurantes';'VARIABLES'
21/12/2009;21/12/2009;'CAFET.C T PRAT';-7,15 €;10.201,85 €;-23;-7,15;14.725,94 €;'sin fechas';21/12/2009;'CAFETC';'Gastos_Ocio y transporte';'Restaurantes';'VARIABLES'
21/12/2009;21/12/2009;'FOMENT DE TERRASSA, S.A. FOMEN';3.008,90 €;13.210,75 €;-22;3.008,90;17.734,84 €;'sin fechas';21/12/2009;'FOMENT';'Ingresos';'Nomina';'FIJO'
22/12/2009;22/12/2009;'CAFET.C T PRAT';-3,55 €;13.207,20 €;-21;-3,55;17.731,29 €;'sin fechas';22/12/2009;'CAFETC';'Gastos_Ocio y transporte';'Restaurantes';'VARIABLES'
22/12/2009;22/12/2009;'FARMACIA';-18,05 €;13.189,15 €;-20;-18,05;17.713,24 €;'sin fechas';22/12/2009;'FARMACIA';'Gastos_Salud, saber y deporte';'Farmacia';'VARIABLES'
22/12/2009;22/12/2009;'FRANCE TELECOM';-21,46 €;13.167,69 €;-19;-21,46;17.691,78 €;'sin fechas';22/12/2009;'FRANCE';'Gastos_Servicios tipicos';'Telecomunicaciones';'FIJO'
23/12/2009;23/12/2009;'CAFET.C T PRAT';-2,65 €;13.165,04 €;-18;-2,65;17.689,13 €;'sin fechas';23/12/2009;'CAFETC';'Gastos_Ocio y transporte';'Restaurantes';'VARIABLES'
23/12/2009;23/12/2009;'CAFET.C T PRAT';-7,15 €;13.157,89 €;-17;-7,15;17.681,98 €;'sin fechas';23/12/2009;'CAFETC';'Gastos_Ocio y transporte';'Restaurantes';'VARIABLES'
23/12/2009;23/12/2009;'CARREFOUR-[comida]';-32,33 €;13.125,56 €;-16;-32,33;17.649,65 €;'sin fechas';23/12/2009;'CARREFOURCOMIDA';'Gastos_Compras';'Supermercado';'VARIABLES'
23/12/2009;23/12/2009;'GASOLINA';-35,67 €;13.089,89 €;-15;-35,67;17.613,98 €;'sin fechas';23/12/2009;'GASOLINA';'Gastos_Ocio y transporte';'Gasolina';'VARIABLES'
23/12/2009;23/12/2009;'REINT.CAJERO';-50,00 €;13.039,89 €;-14;-50,00;17.563,98 €;'sin fechas';23/12/2009;'REINTCAJERO';'Gastos_Gastos varios';'Efectivo';'VARIABLES'
24/12/2009;24/12/2009;'MERCADONA';-22,75 €;13.017,14 €;-13;-22,75;17.541,23 €;'sin fechas';24/12/2009;'MERCADONA';'Gastos_Compras';'Supermercado';'VARIABLES'
28/12/2009;28/12/2009;'FRANCE TELECOM';-17,88 €;12.999,26 €;-12;-17,88;17.523,35 €;'sin fechas';28/12/2009;'FRANCE';'Gastos_Servicios tipicos';'Telecomunicaciones';'FIJO'
29/12/2009;29/12/2009;'INFORMACIO I TECNOLOGIA DE CAT';1.626,77 €;14.626,03 €;-11;1.626,77;19.150,12 €;'sin fechas';29/12/2009;'INFORMACIO';'Ingresos';'Nomina';'FIJO'
30/12/2009;30/12/2009;'AJUNTAMENT DE TERRASSA';-35,21 €;14.590,82 €;-10;-35,21;19.114,91 €;'sin fechas';30/12/2009;'AJUNTAMENT';'Gastos_Banco y organismos';'Ayuntamiento';'FIJO'
30/12/2009;30/12/2009;'CASER HOGAR';-266,21 €;14.324,61 €;-9;-266,21;18.848,70 €;'sin fechas';30/12/2009;'CASER';'Ingresos';'Transferencias';'VARIABLES'
30/12/2009;30/12/2009;'EROSKI-[COMIDA]';-16,94 €;14.307,67 €;-8;-16,94;18.831,76 €;'sin fechas';30/12/2009;'EROSKICOMIDA';'Gastos_Compras';'Supermercado';'VARIABLES'
31/12/2009;31/12/2009;'MARCO ALDANY';-9,99 €;14.297,68 €;-7;-9,99;18.821,77 €;'sin fechas';31/12/2009;'MARCO';'Gastos_Salud, saber y deporte';'Belleza';'VARIABLES'
31/12/2009;31/12/2009;'Ordenador dic, ene, feb';-102,00 €;14.195,68 €;-6;-102,00;18.719,77 €;'sin fechas';31/12/2009;'ORDENADOR';'Gastos_Compras';'Hobbys';'VARIABLES'
31/12/2009;31/12/2009;'COMUNIDAD Pago 4-3 de dif. abril y junio';-9,00 €;14.186,68 €;-5;-9,00;18.710,77 €;'sin fechas';31/12/2009;'COMUNIDAD';'Gastos_Vivienda y vehiculo';'Comunidad';'FIJO'
31/12/2009;31/12/2009;'COMUNIDAD Pago 4-3 de Julio a Diciembre';-120,00 €;14.066,68 €;-4;-120,00;18.590,77 €;'sin fechas';31/12/2009;'COMUNIDAD';'Gastos_Vivienda y vehiculo';'Comunidad';'FIJO'
31/12/2009;31/12/2009;'RECIBO PTMOS. 3061-0960001518';-646,20 €;13.420,48 €;-3;-646,20;17.944,57 €;'sin fechas';31/12/2009;'RECIBO';'Gastos_Banco y organismos';'Hipoteca';'FIJO'
31/12/2009;31/12/2009;'RECIBO PTMOS. 3061-0960004140';-177,24 €;13.243,24 €;-2;-177,24;17.767,33 €;'sin fechas';31/12/2009;'RECIBO';'Gastos_Banco y organismos';'Hipoteca';'FIJO'
31/12/2009;31/12/2009;'REINT.CAJERO';-60,00 €;13.183,24 €;-1;-60,00;17.707,33 €;'sin fechas';31/12/2009;'REINTCAJERO';'Gastos_Gastos varios';'Efectivo';'VARIABLES'
31/12/2009;31/12/2009;'REINT.CAJERO';-60,00 €;13.123,24 €;0;-60,00;17.647,33 €;'sin fechas';31/12/2009;'REINTCAJERO';'Gastos_Gastos varios';'Efectivo';'VARIABLES'
31/12/2009;31/12/2009;'REINT.CAJERO';60,00 €;13.183,24 €;1;60,00;17.707,33 €;'sin fechas';31/12/2009;'REINTCAJERO';'Gastos_Gastos varios';'Efectivo';'VARIABLES'
01/01/2010;01/01/2010;'INTERESES';0,01 €;13.183,25 €;2;0,01;17.707,34 €;'sin fechas';01/01/2010;'INTERESES';'Ingresos';'Rendimientos';
01/01/2010;01/01/2010;'MANTENIMIENTO';-1,00 €;13.182,25 €;3;-1,00;17.706,34 €;'sin fechas';01/01/2010;'MANTENIMIENTO';'Gastos_Banco y organismos';'Cargos banco';'FIJO'
03/01/2010;03/01/2010;'AMC PARC VALLES';-17,00 €;13.165,25 €;4;-17,00;17.689,34 €;'sin fechas';03/01/2010;'AMC';'Gastos_Ocio y transporte';'Espectáculos';'VARIABLES'
03/01/2010;03/01/2010;'VIENA';-10,30 €;13.154,95 €;5;-10,30;17.679,04 €;'sin fechas';03/01/2010;'VIENA';'Gastos_Ocio y transporte';'Restaurantes';'VARIABLES'
04/01/2010;27/12/2009;'AUTOPISTA TERR';-1,92 €;13.153,03 €;6;-1,92;17.677,12 €;'sin fechas';27/12/2009;'AUTOPISTA';'Gastos_Ocio y transporte';'Parking y peaje';'VARIABLES'
04/01/2010;27/12/2009;'AUTOPISTA TERR';-0,65 €;13.152,38 €;7;-0,65;17.676,47 €;'sin fechas';27/12/2009;'AUTOPISTA';'Gastos_Ocio y transporte';'Parking y peaje';'VARIABLES'
04/01/2010;27/12/2009;'AUTOPISTA TERR';-1,92 €;13.150,46 €;8;-1,92;17.674,55 €;'sin fechas';27/12/2009;'AUTOPISTA';'Gastos_Ocio y transporte';'Parking y peaje';'VARIABLES'
04/01/2010;27/12/2009;'AUTOPISTA TERR';-0,65 €;13.149,81 €;9;-0,65;17.673,90 €;'sin fechas';27/12/2009;'AUTOPISTA';'Gastos_Ocio y transporte';'Parking y peaje';'VARIABLES'
04/01/2010;04/01/2010;'CAFET.C T PRAT';-3,60 €;13.146,21 €;10;-3,60;17.670,30 €;'sin fechas';04/01/2010;'CAFETC';'Gastos_Ocio y transporte';'Restaurantes';'VARIABLES'
04/01/2010;04/01/2010;'MERCADONA';-19,60 €;13.126,61 €;11;-19,60;17.650,70 €;'sin fechas';04/01/2010;'MERCADONA';'Gastos_Compras';'Supermercado';'VARIABLES'
05/01/2010;05/01/2010;'FF.CC.GENERALITAT';-2,10 €;13.124,51 €;12;-2,10;17.648,60 €;'sin fechas';05/01/2010;'FFCCGENERALITAT';'Gastos_Ocio y transporte';'Transporte';'VARIABLES'
07/01/2010;07/01/2010;'E.S. MOLINS \\MOLINS DE REY';-30,00 €;13.094,51 €;13;-30,00;17.618,60 €;'sin fechas';07/01/2010;'MOLINS';'Gastos_Ocio y transporte';'Gasolina';'VARIABLES'
08/01/2010;08/01/2010;'CAFET.C T PRAT';-3,55 €;13.090,96 €;14;-3,55;17.615,05 €;'sin fechas';08/01/2010;'CAFETC';'Gastos_Ocio y transporte';'Restaurantes';'VARIABLES'
08/01/2010;08/01/2010;'MERCADONA';-127,32 €;12.963,64 €;15;-127,32;17.487,73 €;'sin fechas';08/01/2010;'MERCADONA';'Gastos_Compras';'Supermercado';'VARIABLES'
09/01/2010;09/01/2010;'BRICOKING TERRASSA';-16,00 €;12.947,64 €;16;-16,00;17.471,73 €;'sin fechas';09/01/2010;'BRICOKING';'Gastos_Vivienda y vehiculo';'Mnto. hogar';'VARIABLES'
09/01/2010;09/01/2010;'CAPRABO';-38,55 €;12.909,09 €;17;-38,55;17.433,18 €;'sin fechas';09/01/2010;'CAPRABO';'Gastos_Compras';'Supermercado';'VARIABLES'
09/01/2010;09/01/2010;'FRESH AND READY \\HOSPITALET';-10,75 €;12.898,34 €;18;-10,75;17.422,43 €;'sin fechas';09/01/2010;'FRESH';'Gastos_Ocio y transporte';'Restaurantes';'VARIABLES'
11/01/2010;11/01/2010;'CAFET.C T PRAT';-3,70 €;12.894,64 €;19;-3,70;17.418,73 €;'sin fechas';11/01/2010;'CAFETC';'Gastos_Ocio y transporte';'Restaurantes';'VARIABLES'
11/01/2010;11/01/2010;'FARMACIA';-17,58 €;12.877,06 €;20;-17,58;17.401,15 €;'sin fechas';11/01/2010;'FARMACIA';'Gastos_Salud, saber y deporte';'Farmacia';'VARIABLES'
13/01/2010;13/01/2010;'CAFET.C T PRAT';-3,40 €;12.873,66 €;21;-3,40;17.397,75 €;'sin fechas';13/01/2010;'CAFETC';'Gastos_Ocio y transporte';'Restaurantes';'VARIABLES'
14/01/2010;04/01/2010;'CATALANA DIAG.I CIRUR';-5,35 €;12.868,31 €;22;-5,35;17.392,40 €;'sin fechas';04/01/2010;'CATALANA';'Gastos_Ocio y transporte';'Parking y peaje';'VARIABLES'
15/01/2010;15/01/2010;'CAFET.C T PRAT';-3,00 €;12.865,31 €;23;-3,00;17.389,40 €;'sin fechas';15/01/2010;'CAFETC';'Gastos_Ocio y transporte';'Restaurantes';'VARIABLES'
15/01/2010;15/01/2010;'CCM VIDA Y P SEGURO PRESTAMO';-20,82 €;12.844,49 €;24;-20,82;17.368,58 €;'sin fechas';15/01/2010;'CCM';'Gastos_Seguros';'Seguro vida';'FIJO'
15/01/2010;15/01/2010;'SEG.AM.HIPITEC 440925/00026232';-30,65 €;12.813,84 €;25;-30,65;17.337,93 €;'sin fechas';15/01/2010;'SEGAMHIPITEC';'Gastos_Seguros';'Seguro vida';'FIJO'
16/01/2010;16/01/2010;'AMC PARC VALLES';-11,00 €;12.802,84 €;26;-11,00;17.326,93 €;'sin fechas';16/01/2010;'AMC';'Gastos_Ocio y transporte';'Espectáculos';'VARIABLES'
16/01/2010;16/01/2010;'CAPRABO';-17,96 €;12.784,88 €;27;-17,96;17.308,97 €;'sin fechas';16/01/2010;'CAPRABO';'Gastos_Compras';'Supermercado';'VARIABLES'
16/01/2010;16/01/2010;'ES STA. MARGARITA';-38,11 €;12.746,77 €;28;-38,11;17.270,86 €;'sin fechas';16/01/2010;'STA';'Gastos_Ocio y transporte';'Gasolina';'VARIABLES'
16/01/2010;16/01/2010;'FASHION KANAK \\BADALONA';-53,85 €;12.692,92 €;29;-53,85;17.217,01 €;'sin fechas';16/01/2010;'FASHION';'Gastos_Compras';'Ropa';'VARIABLES'
16/01/2010;16/01/2010;'KIKO';-12,50 €;12.680,42 €;30;-12,50;17.204,51 €;'sin fechas';16/01/2010;'KIKO';'Gastos_Salud, saber y deporte';'Belleza';'VARIABLES'
16/01/2010;16/01/2010;'LA BRASA';-40,02 €;12.640,40 €;31;-40,02;17.164,49 €;'sin fechas';16/01/2010;'BRASA';'Gastos_Ocio y transporte';'Restaurantes';'VARIABLES'
16/01/2010;16/01/2010;'M&S';-32,00 €;12.608,40 €;32;-32,00;17.132,49 €;'sin fechas';16/01/2010;'MS';'Gastos_Compras';'Ropa';'VARIABLES'
16/01/2010;16/01/2010;'VIENA';-10,25 €;12.598,15 €;33;-10,25;17.122,24 €;'sin fechas';16/01/2010;'VIENA';'Gastos_Ocio y transporte';'Restaurantes';'VARIABLES'
18/01/2010;18/01/2010;'FF.CC.GENERALITAT';-2,10 €;12.596,05 €;34;-2,10;17.120,14 €;'sin fechas';18/01/2010;'FFCCGENERALITAT';'Gastos_Ocio y transporte';'Transporte';'VARIABLES'
18/01/2010;18/01/2010;'NOSTRUM';-6,35 €;12.589,70 €;35;-6,35;17.113,79 €;'sin fechas';18/01/2010;'NOSTRUM';'Gastos_Ocio y transporte';'Restaurantes';'VARIABLES'
19/01/2010;19/01/2010;'ONO';-83,05 €;12.506,65 €;36;-83,05;17.030,74 €;'sin fechas';19/01/2010;'ONO';'Gastos_Servicios tipicos';'Telecomunicaciones';'FIJO'
20/01/2010;20/01/2010;'CAFET.C T PRAT';-5,35 €;12.501,30 €;37;-5,35;17.025,39 €;'sin fechas';20/01/2010;'CAFETC';'Gastos_Ocio y transporte';'Restaurantes';'VARIABLES'
20/01/2010;20/01/2010;'MERCADONA';-25,96 €;12.475,34 €;38;-25,96;16.999,43 €;'sin fechas';20/01/2010;'MERCADONA';'Gastos_Compras';'Supermercado';'VARIABLES'
22/01/2010;19/01/2010;'DEVOLUCION COMPRA';20,00 €;12.495,34 €;39;20,00;17.019,43 €;'sin fechas';19/01/2010;'DEVOLUCION';'Ingresos';'Devoluciones';'VARIABLES'
22/01/2010;19/01/2010;'DEVOLUCION COMPRA';3,22 €;12.498,56 €;40;3,22;17.022,65 €;'sin fechas';19/01/2010;'DEVOLUCION';'Ingresos';'Devoluciones';'VARIABLES'
22/01/2010;22/01/2010;'TAKE';-64,96 €;12.433,60 €;41;-64,96;16.957,69 €;'sin fechas';22/01/2010;'TAKE';'Gastos_Ocio y transporte';'Restaurantes';'VARIABLES'
23/01/2010;23/01/2010;'REINT.CAJERO';-50,00 €;12.383,60 €;42;-50,00;16.907,69 €;'sin fechas';23/01/2010;'REINTCAJERO';'Gastos_Gastos varios';'Efectivo';'VARIABLES'
25/01/2010;25/01/2010;'ENDESA ENERGI 464558/0000012P2';-76,49 €;12.307,11 €;43;-76,49;16.831,20 €;'sin fechas';25/01/2010;'ENDESA';'Gastos_Servicios tipicos';'Electricidad';'FIJO'
25/01/2010;25/01/2010;'EROSKI-[COMIDA]';-37,97 €;12.269,14 €;44;-37,97;16.793,23 €;'sin fechas';25/01/2010;'EROSKICOMIDA';'Gastos_Compras';'Supermercado';'VARIABLES'
25/01/2010;25/01/2010;'EROSKI-[COMIDA]';-39,89 €;12.229,25 €;45;-39,89;16.753,34 €;'sin fechas';25/01/2010;'EROSKICOMIDA';'Gastos_Compras';'Supermercado';'VARIABLES'
25/01/2010;25/01/2010;'FARMACIA';-7,87 €;12.221,38 €;46;-7,87;16.745,47 €;'sin fechas';25/01/2010;'FARMACIA';'Gastos_Salud, saber y deporte';'Farmacia';'VARIABLES'
25/01/2010;25/01/2010;'FF.CC.GENERALITAT';-7,85 €;12.213,53 €;47;-7,85;16.737,62 €;'sin fechas';25/01/2010;'FFCCGENERALITAT';'Gastos_Ocio y transporte';'Transporte';'VARIABLES'
25/01/2010;25/01/2010;'FF.CC.GENERALITAT';-2,10 €;12.211,43 €;48;-2,10;16.735,52 €;'sin fechas';25/01/2010;'FFCCGENERALITAT';'Gastos_Ocio y transporte';'Transporte';'VARIABLES'
25/01/2010;25/01/2010;'FRANCE TELEC ORANGE MOVIL 0211';-28,81 €;12.182,62 €;49;-28,81;16.706,71 €;'sin fechas';25/01/2010;'FRANCE';'Gastos_Servicios tipicos';'Telecomunicaciones';'FIJO'
25/01/2010;25/01/2010;'REINT.CAJERO';-100,00 €;12.082,62 €;50;-100,00;16.606,71 €;'sin fechas';25/01/2010;'REINTCAJERO';'Gastos_Gastos varios';'Efectivo';'VARIABLES'
26/01/2010;26/01/2010;'ES STA. MARGARITA';-40,18 €;12.042,44 €;51;-40,18;16.566,53 €;'sin fechas';26/01/2010;'STA';'Gastos_Ocio y transporte';'Gasolina';'VARIABLES'
27/01/2010;27/01/2010;'CAFET.C T PRAT';-3,40 €;12.039,04 €;52;-3,40;16.563,13 €;'sin fechas';27/01/2010;'CAFETC';'Gastos_Ocio y transporte';'Restaurantes';'VARIABLES'
27/01/2010;27/01/2010;'EROSKI-[COMIDA]';-45,98 €;11.993,06 €;53;-45,98;16.517,15 €;'sin fechas';27/01/2010;'EROSKICOMIDA';'Gastos_Compras';'Supermercado';'VARIABLES'
27/01/2010;27/01/2010;'FRANCE TELEC ORANGE MOVIL 0211';-14,70 €;11.978,36 €;54;-14,70;16.502,45 €;'sin fechas';27/01/2010;'FRANCE';'Gastos_Servicios tipicos';'Telecomunicaciones';'FIJO'
27/01/2010;27/01/2010;'ONO';-89,00 €;11.889,36 €;55;-89,00;16.413,45 €;'sin fechas';27/01/2010;'ONO';'Gastos_Servicios tipicos';'Telecomunicaciones';'FIJO'
28/01/2010;28/01/2010;'CAFET.C T PRAT';-1,50 €;11.887,86 €;56;-1,50;16.411,95 €;'sin fechas';28/01/2010;'CAFETC';'Gastos_Ocio y transporte';'Restaurantes';'VARIABLES'
28/01/2010;28/01/2010;'FOMENT DE TERRASSA, S.A. FOMEN';1.595,42 €;13.483,28 €;57;1.595,42;18.007,37 €;'sin fechas';28/01/2010;'FOMENT';'Ingresos';'Nomina';'FIJO'
28/01/2010;28/01/2010;'INFORMACIO I TECNOLOGIA DE CAT';1.599,16 €;15.082,44 €;58;1.599,16;19.606,53 €;'sin fechas';28/01/2010;'INFORMACIO';'Ingresos';'Nomina';'FIJO'
29/01/2010;29/01/2010;'MERCADONA';-135,72 €;14.946,72 €;59;-135,72;19.470,81 €;'sin fechas';29/01/2010;'MERCADONA';'Gastos_Compras';'Supermercado';'VARIABLES'
30/01/2010;30/01/2010;'TOCINERIES VENTURA';-21,77 €;14.924,95 €;60;-21,77;19.449,04 €;'sin fechas';30/01/2010;'TOCINERIES';'Gastos_Compras';'Supermercado';'VARIABLES'
01/02/2010;23/01/2010;'AUTOPISTA TERR';-3,40 €;14.921,55 €;61;-3,40;19.445,64 €;'sin fechas';23/01/2010;'AUTOPISTA';'Gastos_Ocio y transporte';'Parking y peaje';'VARIABLES'
01/02/2010;23/01/2010;'AUTOPISTA TERR';-3,40 €;14.918,15 €;62;-3,40;19.442,24 €;'sin fechas';23/01/2010;'AUTOPISTA';'Gastos_Ocio y transporte';'Parking y peaje';'VARIABLES'
01/02/2010;01/02/2010;'CAFET.C T PRAT';-2,95 €;14.915,20 €;63;-2,95;19.439,29 €;'sin fechas';01/02/2010;'CAFETC';'Gastos_Ocio y transporte';'Restaurantes';'VARIABLES'
01/02/2010;01/02/2010;'CIA.DE SEGUROS AD 006662671613';-34,17 €;14.881,03 €;64;-34,17;19.405,12 €;'sin fechas';01/02/2010;'CIADE';'Gastos_Salud, saber y deporte';'Medico';'VARIABLES'
01/02/2010;01/02/2010;'CIA.DE SEGUROS AD 006662671613';-34,17 €;14.846,86 €;65;-34,17;19.370,95 €;'sin fechas';01/02/2010;'CIADE';'Gastos_Salud, saber y deporte';'Medico';'VARIABLES'
01/02/2010;01/02/2010;'FARMACIA';-18,05 €;14.828,81 €;66;-18,05;19.352,90 €;'sin fechas';01/02/2010;'FARMACIA';'Gastos_Salud, saber y deporte';'Farmacia';'VARIABLES'
01/02/2010;01/02/2010;'MANTENIMIENTO';-1,25 €;14.827,56 €;67;-1,25;19.351,65 €;'sin fechas';01/02/2010;'MANTENIMIENTO';'Gastos_Banco y organismos';'Cargos banco';'FIJO'
01/02/2010;31/01/2010;'RECIBO PTMOS. 3061-0960001518';-646,20 €;14.181,36 €;68;-646,20;18.705,45 €;'sin fechas';31/01/2010;'RECIBO';'Gastos_Banco y organismos';'Hipoteca';'FIJO'
01/02/2010;31/01/2010;'RECIBO PTMOS. 3061-0960004140';-177,24 €;14.004,12 €;69;-177,24;18.528,21 €;'sin fechas';31/01/2010;'RECIBO';'Gastos_Banco y organismos';'Hipoteca';'FIJO'
02/02/2010;02/02/2010;'CAFET.C T PRAT';-2,45 €;14.001,67 €;70;-2,45;18.525,76 €;'sin fechas';02/02/2010;'CAFETC';'Gastos_Ocio y transporte';'Restaurantes';'VARIABLES'
03/02/2010;03/02/2010;'CAFET.C T PRAT';-2,60 €;13.999,07 €;71;-2,60;18.523,16 €;'sin fechas';03/02/2010;'CAFETC';'Gastos_Ocio y transporte';'Restaurantes';'VARIABLES'
03/02/2010;03/02/2010;'CARREFOUR-[COMIDA]';-24,40 €;13.974,67 €;72;-24,40;18.498,76 €;'sin fechas';03/02/2010;'CARREFOURCOMIDA';'Gastos_Compras';'Supermercado';'VARIABLES'
04/02/2010;04/02/2010;'CAFET.C T PRAT';-3,15 €;13.971,52 €;73;-3,15;18.495,61 €;'sin fechas';04/02/2010;'CAFETC';'Gastos_Ocio y transporte';'Restaurantes';'VARIABLES'
04/02/2010;04/02/2010;'RESTAURANTES';-45,36 €;13.926,16 €;74;-45,36;18.450,25 €;'sin fechas';04/02/2010;'RESTAURANTES';'Gastos_Ocio y transporte';'Restaurantes';'VARIABLES'
05/02/2010;05/02/2010;'CAFET.C T PRAT';-3,30 €;13.922,86 €;75;-3,30;18.446,95 €;'sin fechas';05/02/2010;'CAFETC';'Gastos_Ocio y transporte';'Restaurantes';'VARIABLES'
05/02/2010;05/02/2010;'TOYOTA ORIENT CARS';-157,15 €;13.765,71 €;76;-157,15;18.289,80 €;'sin fechas';05/02/2010;'TOYOTA';'Gastos_Vivienda y vehiculo';'Mnto. vehiculo';'VARIABLE'
06/02/2010;06/02/2010;'C&A';-66,95 €;13.698,76 €;77;-66,95;18.222,85 €;'sin fechas';06/02/2010;'CA';'Gastos_Compras';'Ropa';'VARIABLES'
06/02/2010;06/02/2010;'ES STA. MARGARITA';-32,00 €;13.666,76 €;78;-32,00;18.190,85 €;'sin fechas';06/02/2010;'STA';'Gastos_Ocio y transporte';'Gasolina';'VARIABLES'
06/02/2010;06/02/2010;'MERCADONA';-36,36 €;13.630,40 €;79;-36,36;18.154,49 €;'sin fechas';06/02/2010;'MERCADONA';'Gastos_Compras';'Supermercado';'VARIABLES'
06/02/2010;06/02/2010;'STARBUCKS';-11,15 €;13.619,25 €;80;-11,15;18.143,34 €;'sin fechas';06/02/2010;'STARBUCKS';'Gastos_Ocio y transporte';'Restaurantes';'VARIABLES'
08/02/2010;08/02/2010;'MERCADONA';-16,96 €;13.602,29 €;81;-16,96;18.126,38 €;'sin fechas';08/02/2010;'MERCADONA';'Gastos_Compras';'Supermercado';'VARIABLES'
09/02/2010;03/02/2010;'AUTOPISTA TERR';-3,53 €;13.598,76 €;82;-3,53;18.122,85 €;'sin fechas';03/02/2010;'AUTOPISTA';'Gastos_Ocio y transporte';'Parking y peaje';'VARIABLES'
09/02/2010;03/02/2010;'AUTOPISTA TERR';-2,60 €;13.596,16 €;83;-2,60;18.120,25 €;'sin fechas';03/02/2010;'AUTOPISTA';'Gastos_Ocio y transporte';'Parking y peaje';'VARIABLES'
09/02/2010;09/02/2010;'CAFET.C T PRAT';-4,75 €;13.591,41 €;84;-4,75;18.115,50 €;'sin fechas';09/02/2010;'CAFETC';'Gastos_Ocio y transporte';'Restaurantes';'VARIABLES'
09/02/2010;09/02/2010;'GAS NATURAL';-77,60 €;13.513,81 €;85;-77,60;18.037,90 €;'sin fechas';09/02/2010;'GAS';'Gastos_Servicios tipicos';'Gas';'FIJO'
09/02/2010;09/02/2010;'Parking Enero, Febrero y Marzo';-180,00 €;13.333,81 €;86;-180,00;17.857,90 €;'sin fechas';09/02/2010;'PARKING';'Gastos_Ocio y transporte';'Parking y peaje';'VARIABLES'
09/02/2010;09/02/2010;'TRANSCARGO';-95,00 €;13.238,81 €;87;-95,00;17.762,90 €;'sin fechas';09/02/2010;'TRANSCARGO';'Gastos_Gastos varios';'Transferencias';'VARIABLES'
10/02/2010;10/02/2010;'CAFET.C T PRAT';-3,15 €;13.235,66 €;88;-3,15;17.759,75 €;'sin fechas';10/02/2010;'CAFETC';'Gastos_Ocio y transporte';'Restaurantes';'VARIABLES'
11/02/2010;11/02/2010;'LA BRASA';-25,81 €;13.209,85 €;89;-25,81;17.733,94 €;'sin fechas';11/02/2010;'BRASA';'Gastos_Ocio y transporte';'Restaurantes';'VARIABLES'
13/02/2010;13/02/2010;'BON AREA';-20,42 €;13.189,43 €;90;-20,42;17.713,52 €;'sin fechas';13/02/2010;'BON';'Gastos_Compras';'Supermercado';'VARIABLES'
13/02/2010;13/02/2010;'CARREFOUR-[COMIDA]';-76,80 €;13.112,63 €;91;-76,80;17.636,72 €;'sin fechas';13/02/2010;'CARREFOURCOMIDA';'Gastos_Compras';'Supermercado';'VARIABLES'
13/02/2010;13/02/2010;'NOVA EULALIA S L';-800,00 €;12.312,63 €;92;-800,00;16.836,72 €;'sin fechas';13/02/2010;'NOVA';'Gastos_Compras';'Gastos_Compras';'Gastos_Compras'
13/02/2010;13/02/2010;'TOCINERIES VENTURA';-18,30 €;12.294,33 €;93;-18,30;16.818,42 €;'sin fechas';13/02/2010;'TOCINERIES';'Gastos_Compras';'Supermercado';'VARIABLES'
13/02/2010;13/02/2010;'VIENA';-10,20 €;12.284,13 €;94;-10,20;16.808,22 €;'sin fechas';13/02/2010;'VIENA';'Gastos_Ocio y transporte';'Restaurantes';'VARIABLES'
15/02/2010;15/02/2010;'CCM VIDA Y P SEGURO PRESTAMO';-20,79 €;12.263,34 €;95;-20,79;16.787,43 €;'sin fechas';15/02/2010;'CCM';'Gastos_Seguros';'Seguro vida';'FIJO'
15/02/2010;15/02/2010;'SEG.AM.HIPITEC 572041/00026582';-30,58 €;12.232,76 €;96;-30,58;16.756,85 €;'sin fechas';15/02/2010;'SEGAMHIPITEC';'Gastos_Seguros';'Seguro vida';'FIJO'
16/02/2010;16/02/2010;'CAFET.C T PRAT';-1,65 €;12.231,11 €;97;-1,65;16.755,20 €;'sin fechas';16/02/2010;'CAFETC';'Gastos_Ocio y transporte';'Restaurantes';'VARIABLES'
17/02/2010;17/02/2010;'CAFET.C T PRAT';-1,65 €;12.229,46 €;98;-1,65;16.753,55 €;'sin fechas';17/02/2010;'CAFETC';'Gastos_Ocio y transporte';'Restaurantes';'VARIABLES'
17/02/2010;17/02/2010;'E.S. RUBI E 9';-30,00 €;12.199,46 €;99;-30,00;16.723,55 €;'sin fechas';17/02/2010;'RUBI';'Gastos_Ocio y transporte';'Gasolina';'VARIABLES'
17/02/2010;17/02/2010;'ENDESA ENERGI 578393/0000016P2';-43,64 €;12.155,82 €;100;-43,64;16.679,91 €;'sin fechas';17/02/2010;'ENDESA';'Gastos_Servicios tipicos';'Electricidad';'FIJO'
18/02/2010;18/02/2010;'ONO';-82,65 €;12.073,17 €;101;-82,65;16.597,26 €;'sin fechas';18/02/2010;'ONO';'Gastos_Servicios tipicos';'Telecomunicaciones';'FIJO'
20/02/2010;20/02/2010;'EROSKI-[COMIDA]';-56,70 €;12.016,47 €;102;-56,70;16.540,56 €;'sin fechas';20/02/2010;'EROSKICOMIDA';'Gastos_Compras';'Supermercado';'VARIABLES'
20/02/2010;20/02/2010;'VIENA';-9,70 €;12.006,77 €;103;-9,70;16.530,86 €;'sin fechas';20/02/2010;'VIENA';'Gastos_Ocio y transporte';'Restaurantes';'VARIABLES'
22/02/2010;22/02/2010;'FRANCE TELEC ORANGE MOVIL 0211';-10,44 €;11.996,33 €;104;-10,44;16.520,42 €;'sin fechas';22/02/2010;'FRANCE';'Gastos_Servicios tipicos';'Telecomunicaciones';'FIJO'
23/02/2010;23/02/2010;'CAFET.C T PRAT';-1,65 €;11.994,68 €;105;-1,65;16.518,77 €;'sin fechas';23/02/2010;'CAFETC';'Gastos_Ocio y transporte';'Restaurantes';'VARIABLES'
23/02/2010;23/02/2010;'FF.CC.GENERALITAT';-2,10 €;11.992,58 €;106;-2,10;16.516,67 €;'sin fechas';23/02/2010;'FFCCGENERALITAT';'Gastos_Ocio y transporte';'Transporte';'VARIABLES'
23/02/2010;23/02/2010;'REINT.CAJERO';-100,00 €;11.892,58 €;107;-100,00;16.416,67 €;'sin fechas';23/02/2010;'REINTCAJERO';'Gastos_Gastos varios';'Efectivo';'VARIABLES'
24/02/2010;24/02/2010;'DECATHLON';-96,80 €;11.795,78 €;108;-96,80;16.319,87 €;'sin fechas';24/02/2010;'DECATHLON';'Gastos_Compras';'Deportivo';'VARIABLES'
24/02/2010;24/02/2010;'FRANCE TELEC ORANGE MOVIL 0211';-36,31 €;11.759,47 €;109;-36,31;16.283,56 €;'sin fechas';24/02/2010;'FRANCE';'Gastos_Servicios tipicos';'Telecomunicaciones';'FIJO'
24/02/2010;24/02/2010;'MERCADONA';-15,35 €;11.744,12 €;110;-15,35;16.268,21 €;'sin fechas';24/02/2010;'MERCADONA';'Gastos_Compras';'Supermercado';'VARIABLES'
25/02/2010;25/02/2010;'CAFET.C T PRAT';-1,50 €;11.742,62 €;111;-1,50;16.266,71 €;'sin fechas';25/02/2010;'CAFETC';'Gastos_Ocio y transporte';'Restaurantes';'VARIABLES'
25/02/2010;25/02/2010;'DECATHLON';-12,95 €;11.729,67 €;112;-12,95;16.253,76 €;'sin fechas';25/02/2010;'DECATHLON';'Gastos_Compras';'Deportivo';'VARIABLES'
26/02/2010;26/02/2010;'CAFET.C T PRAT';-3,15 €;11.726,52 €;113;-3,15;16.250,61 €;'sin fechas';26/02/2010;'CAFETC';'Gastos_Ocio y transporte';'Restaurantes';'VARIABLES'
26/02/2010;26/02/2010;'FOMENT DE TERRASSA, S.A. FOMEN';1.606,05 €;13.332,57 €;114;1.606,05;17.856,66 €;'sin fechas';26/02/2010;'FOMENT';'Ingresos';'Nomina';'FIJO'
26/02/2010;26/02/2010;'INFORMACIO I TECNOLOGIA DE CAT';1.598,74 €;14.931,31 €;115;1.598,74;19.455,40 €;'sin fechas';26/02/2010;'INFORMACIO';'Ingresos';'Nomina';'FIJO'
27/02/2010;27/02/2010;'CATALA GRANADOS SL';-40,96 €;14.890,35 €;116;-40,96;19.414,44 €;'sin fechas';27/02/2010;'CATALA';'Gastos_Ocio y transporte';'Gasolina';'VARIABLES'
27/02/2010;27/02/2010;'KIKU CHAN';-63,08 €;14.827,27 €;117;-63,08;19.351,36 €;'sin fechas';27/02/2010;'KIKU';'Gastos_Ocio y transporte';'Restaurantes';'VARIABLES'
28/02/2010;28/02/2010;'REINT.CAJERO';-200,00 €;14.627,27 €;118;-200,00;19.151,36 €;'sin fechas';28/02/2010;'REINTCAJERO';'Gastos_Gastos varios';'Efectivo';'VARIABLES'
01/03/2010;01/03/2010;'AJUNTAMENT DE 616659/0000002P1';-37,18 €;14.590,09 €;119;-37,18;19.114,18 €;'sin fechas';01/03/2010;'AJUNTAMENT';'Gastos_Banco y organismos';'Ayuntamiento';'FIJO'
01/03/2010;01/03/2010;'BON AREA';-16,43 €;14.573,66 €;120;-16,43;19.097,75 €;'sin fechas';01/03/2010;'BON';'Gastos_Compras';'Supermercado';'VARIABLES'
01/03/2010;01/03/2010;'CIA.DE SEGUROS AD 006662671613';-34,17 €;14.539,49 €;121;-34,17;19.063,58 €;'sin fechas';01/03/2010;'CIADE';'Gastos_Salud, saber y deporte';'Medico';'VARIABLES'
01/03/2010;01/03/2010;'LA BRASA';-54,01 €;14.485,48 €;122;-54,01;19.009,57 €;'sin fechas';01/03/2010;'BRASA';'Gastos_Ocio y transporte';'Restaurantes';'VARIABLES'
01/03/2010;01/03/2010;'MANTENIMIENTO';-1,25 €;14.484,23 €;123;-1,25;19.008,32 €;'sin fechas';01/03/2010;'MANTENIMIENTO';'Gastos_Banco y organismos';'Cargos banco';'FIJO'
01/03/2010;01/03/2010;'MARCO ALDANY';-9,99 €;14.474,24 €;124;-9,99;18.998,33 €;'sin fechas';01/03/2010;'MARCO';'Gastos_Salud, saber y deporte';'Belleza';'VARIABLES'
01/03/2010;28/02/2010;'RECIBO PTMOS. 3061-0960001518';-646,20 €;13.828,04 €;125;-646,20;18.352,13 €;'sin fechas';28/02/2010;'RECIBO';'Gastos_Banco y organismos';'Hipoteca';'FIJO'
01/03/2010;28/02/2010;'RECIBO PTMOS. 3061-0960004140';-177,24 €;13.650,80 €;126;-177,24;18.174,89 €;'sin fechas';28/02/2010;'RECIBO';'Gastos_Banco y organismos';'Hipoteca';'FIJO'
01/03/2010;01/03/2010;'VIENA';-4,80 €;13.646,00 €;127;-4,80;18.170,09 €;'sin fechas';01/03/2010;'VIENA';'Gastos_Ocio y transporte';'Restaurantes';'VARIABLES'
03/03/2010;03/03/2010;'CAFET.C T PRAT';-3,15 €;13.642,85 €;128;-3,15;18.166,94 €;'sin fechas';03/03/2010;'CAFETC';'Gastos_Ocio y transporte';'Restaurantes';'VARIABLES'
04/03/2010;04/03/2010;'FF.CC.GENERALITAT';-21,40 €;13.621,45 €;129;-21,40;18.145,54 €;'sin fechas';04/03/2010;'FFCCGENERALITAT';'Gastos_Ocio y transporte';'Transporte';'VARIABLES'
05/03/2010;05/03/2010;'AMC PARC VALLES';-9,00 €;13.612,45 €;130;-9,00;18.136,54 €;'sin fechas';05/03/2010;'AMC';'Gastos_Ocio y transporte';'Espectáculos';'VARIABLES'
05/03/2010;05/03/2010;'BURGUER KING';-13,40 €;13.599,05 €;131;-13,40;18.123,14 €;'sin fechas';05/03/2010;'BURGUER';'Gastos_Ocio y transporte';'Restaurantes';'VARIABLES'
06/03/2010;06/03/2010;'CA N\''AYXELA \\STA MARGARITA';-132,68 €;13.466,37 €;132;-132,68;17.990,46 €;'sin fechas';06/03/2010;'NAYXELA';'Gastos_Ocio y transporte';'Restaurantes';'VARIABLES'
06/03/2010;06/03/2010;'CAPRABO';-18,05 €;13.448,32 €;133;-18,05;17.972,41 €;'sin fechas';06/03/2010;'CAPRABO';'Gastos_Compras';'Supermercado';'VARIABLES'
06/03/2010;06/03/2010;'TOCINERIES VENTURA';-17,62 €;13.430,70 €;134;-17,62;17.954,79 €;'sin fechas';06/03/2010;'TOCINERIES';'Gastos_Compras';'Supermercado';'VARIABLES'
08/03/2010;08/03/2010;'CAFET.C T PRAT';-17,45 €;13.413,25 €;135;-17,45;17.937,34 €;'sin fechas';08/03/2010;'CAFETC';'Gastos_Ocio y transporte';'Restaurantes';'VARIABLES'
08/03/2010;08/03/2010;'CAFET.C T PRAT';-2,60 €;13.410,65 €;136;-2,60;17.934,74 €;'sin fechas';08/03/2010;'CAFETC';'Gastos_Ocio y transporte';'Restaurantes';'VARIABLES'
08/03/2010;08/03/2010;'CAFET.C T PRAT';-2,20 €;13.408,45 €;137;-2,20;17.932,54 €;'sin fechas';08/03/2010;'CAFETC';'Gastos_Ocio y transporte';'Restaurantes';'VARIABLES'
09/03/2010;09/03/2010;'CARREFOUR-[COMIDA]';-44,57 €;13.363,88 €;138;-44,57;17.887,97 €;'sin fechas';09/03/2010;'CARREFOURCOMIDA';'Gastos_Compras';'Supermercado';'VARIABLES'
09/03/2010;09/03/2010;'FARMACIA';-18,05 €;13.345,83 €;139;-18,05;17.869,92 €;'sin fechas';09/03/2010;'FARMACIA';'Gastos_Salud, saber y deporte';'Farmacia';'VARIABLES'
10/03/2010;10/03/2010;'E.S. MOLINS \\MOLINS DE REY';-30,00 €;13.315,83 €;140;-30,00;17.839,92 €;'sin fechas';10/03/2010;'MOLINS';'Gastos_Ocio y transporte';'Gasolina';'VARIABLES'
11/03/2010;11/03/2010;'CAFET.C T PRAT';-0,30 €;13.315,53 €;141;-0,30;17.839,62 €;'sin fechas';11/03/2010;'CAFETC';'Gastos_Ocio y transporte';'Restaurantes';'VARIABLES'
12/03/2010;06/03/2010;'AUTOPISTA TERR';-3,40 €;13.312,13 €;142;-3,40;17.836,22 €;'sin fechas';06/03/2010;'AUTOPISTA';'Gastos_Ocio y transporte';'Parking y peaje';'VARIABLES'
12/03/2010;06/03/2010;'AUTOPISTA TERR';-3,40 €;13.308,73 €;143;-3,40;17.832,82 €;'sin fechas';06/03/2010;'AUTOPISTA';'Gastos_Ocio y transporte';'Parking y peaje';'VARIABLES'
12/03/2010;12/03/2010;'CAFET.C T PRAT';-3,70 €;13.305,03 €;144;-3,70;17.829,12 €;'sin fechas';12/03/2010;'CAFETC';'Gastos_Ocio y transporte';'Restaurantes';'VARIABLES'
12/03/2010;12/03/2010;'EROSKI-[COMIDA]';-22,38 €;13.282,65 €;145;-22,38;17.806,74 €;'sin fechas';12/03/2010;'EROSKICOMIDA';'Gastos_Compras';'Supermercado';'VARIABLES'
12/03/2010;12/03/2010;'GREENWICH PIEL, S.L\\TARRASA';-29,99 €;13.252,66 €;146;-29,99;17.776,75 €;'sin fechas';12/03/2010;'GREENWICH';'Gastos_Compras';'Ropa';'VARIABLES'
13/03/2010;13/03/2010;'METRO BILBAO \\BILBAO';-5,00 €;13.247,66 €;147;-5,00;17.771,75 €;'sin fechas';13/03/2010;'METRO';'Gastos_Ocio y transporte';'Transporte';'VARIABLES'
13/03/2010;13/03/2010;'METRO BILBAO \\BILBAO';-5,00 €;13.242,66 €;148;-5,00;17.766,75 €;'sin fechas';13/03/2010;'METRO';'Gastos_Ocio y transporte';'Transporte';'VARIABLES'
14/03/2010;14/03/2010;'METRO BILBAO \\BILBAO';-5,00 €;13.237,66 €;149;-5,00;17.761,75 €;'sin fechas';14/03/2010;'METRO';'Gastos_Ocio y transporte';'Transporte';'VARIABLES'
14/03/2010;14/03/2010;'RESTAURANTES';-45,15 €;13.192,51 €;150;-45,15;17.716,60 €;'sin fechas';14/03/2010;'RESTAURANTES';'Gastos_Ocio y transporte';'Restaurantes';'VARIABLES'
14/03/2010;14/03/2010;'SHANGHAI HOSTELEROS \\BILBAO';-34,99 €;13.157,52 €;151;-34,99;17.681,61 €;'sin fechas';14/03/2010;'SHANGHAI';'Gastos_Ocio y transporte';'Vacaciones';'VARIABLES'
15/03/2010;15/03/2010;'CCM VIDA Y P SEGURO PRESTAMO';-20,74 €;13.136,78 €;152;-20,74;17.660,87 €;'sin fechas';15/03/2010;'CCM';'Gastos_Seguros';'Seguro vida';'FIJO'
15/03/2010;15/03/2010;'KUKUXUMUSU \\BILBAO';-34,00 €;13.102,78 €;153;-34,00;17.626,87 €;'sin fechas';15/03/2010;'KUKUXUMUSU';'Gastos_Compras';'Ropa';'VARIABLES'
15/03/2010;15/03/2010;'METRO BILBAO \\BILBAO';-5,00 €;13.097,78 €;154;-5,00;17.621,87 €;'sin fechas';15/03/2010;'METRO';'Gastos_Ocio y transporte';'Transporte';'VARIABLES'
15/03/2010;15/03/2010;'RESTAURANTES';-27,21 €;13.070,57 €;155;-27,21;17.594,66 €;'sin fechas';15/03/2010;'RESTAURANTES';'Gastos_Ocio y transporte';'Restaurantes';'VARIABLES'
15/03/2010;15/03/2010;'SEG.AM.HIPITEC 712674/00033982';-30,52 €;13.040,05 €;156;-30,52;17.564,14 €;'sin fechas';15/03/2010;'SEGAMHIPITEC';'Gastos_Seguros';'Seguro vida';'FIJO'
16/03/2010;16/03/2010;'CAFET.C T PRAT';-3,15 €;13.036,90 €;157;-3,15;17.560,99 €;'sin fechas';16/03/2010;'CAFETC';'Gastos_Ocio y transporte';'Restaurantes';'VARIABLES'
17/03/2010;17/03/2010;'MERCADONA';-16,01 €;13.020,89 €;158;-16,01;17.544,98 €;'sin fechas';17/03/2010;'MERCADONA';'Gastos_Compras';'Supermercado';'VARIABLES'
18/03/2010;18/03/2010;'ONO';-84,23 €;12.936,66 €;159;-84,23;17.460,75 €;'sin fechas';18/03/2010;'ONO';'Gastos_Servicios tipicos';'Telecomunicaciones';'FIJO'
19/03/2010;19/03/2010;'FARMACIA';-14,25 €;12.922,41 €;160;-14,25;17.446,50 €;'sin fechas';19/03/2010;'FARMACIA';'Gastos_Salud, saber y deporte';'Farmacia';'VARIABLES'
20/03/2010;20/03/2010;'EROSKI-[COMIDA]';-43,11 €;12.879,30 €;161;-43,11;17.403,39 €;'sin fechas';20/03/2010;'EROSKICOMIDA';'Gastos_Compras';'Supermercado';'VARIABLES'
20/03/2010;20/03/2010;'MERCADONA';-63,31 €;12.815,99 €;162;-63,31;17.340,08 €;'sin fechas';20/03/2010;'MERCADONA';'Gastos_Compras';'Supermercado';'VARIABLES'
20/03/2010;20/03/2010;'NATURCENTER';-7,10 €;12.808,89 €;163;-7,10;17.332,98 €;'sin fechas';20/03/2010;'NATURCENTER';'Gastos_Salud, saber y deporte';'Farmacia';'VARIABLES'
22/03/2010;15/03/2010;'AUTOPISTA TERR';-1,18 €;12.807,71 €;164;-1,18;17.331,80 €;'sin fechas';15/03/2010;'AUTOPISTA';'Gastos_Ocio y transporte';'Parking y peaje';'VARIABLES'
22/03/2010;15/03/2010;'AUTOPISTA TERR';-0,60 €;12.807,11 €;165;-0,60;17.331,20 €;'sin fechas';15/03/2010;'AUTOPISTA';'Gastos_Ocio y transporte';'Parking y peaje';'VARIABLES'
22/03/2010;22/03/2010;'CAFET.C T PRAT';-2,25 €;12.804,86 €;166;-2,25;17.328,95 €;'sin fechas';22/03/2010;'CAFETC';'Gastos_Ocio y transporte';'Restaurantes';'VARIABLES'
22/03/2010;22/03/2010;'CAPRABO';-34,50 €;12.770,36 €;167;-34,50;17.294,45 €;'sin fechas';22/03/2010;'CAPRABO';'Gastos_Compras';'Supermercado';'VARIABLES'
22/03/2010;22/03/2010;'ES STA. MARGARITA';-40,00 €;12.730,36 €;168;-40,00;17.254,45 €;'sin fechas';22/03/2010;'STA';'Gastos_Ocio y transporte';'Gasolina';'VARIABLES'
22/03/2010;22/03/2010;'FRANCE TELEC ORANGE MOVIL 0211';-22,48 €;12.707,88 €;169;-22,48;17.231,97 €;'sin fechas';22/03/2010;'FRANCE';'Gastos_Servicios tipicos';'Telecomunicaciones';'FIJO'
23/03/2010;23/03/2010;'REINT.CAJERO';-100,00 €;12.607,88 €;170;-100,00;17.131,97 €;'sin fechas';23/03/2010;'REINTCAJERO';'Gastos_Gastos varios';'Efectivo';'VARIABLES'
24/03/2010;19/03/2010;'AUTOPISTA TERR';-1,55 €;12.606,33 €;171;-1,55;17.130,42 €;'sin fechas';19/03/2010;'AUTOPISTA';'Gastos_Ocio y transporte';'Parking y peaje';'VARIABLES'
24/03/2010;24/03/2010;'CAFET.C T PRAT';-1,05 €;12.605,28 €;172;-1,05;17.129,37 €;'sin fechas';24/03/2010;'CAFETC';'Gastos_Ocio y transporte';'Restaurantes';'VARIABLES'
25/03/2010;25/03/2010;'CAFET.C T PRAT';-1,55 €;12.603,73 €;173;-1,55;17.127,82 €;'sin fechas';25/03/2010;'CAFETC';'Gastos_Ocio y transporte';'Restaurantes';'VARIABLES'
25/03/2010;25/03/2010;'MINA PUBLICA 738582/0000001P2';-31,41 €;12.572,32 €;174;-31,41;17.096,41 €;'sin fechas';25/03/2010;'MINA';'Gastos_Servicios tipicos';'Agua';'FIJO'
26/03/2010;26/03/2010;'AMC PARC VALLES';-15,00 €;12.557,32 €;175;-15,00;17.081,41 €;'sin fechas';26/03/2010;'AMC';'Gastos_Ocio y transporte';'Espectáculos';'VARIABLES'
26/03/2010;26/03/2010;'CAFET.C T PRAT';-3,75 €;12.553,57 €;176;-3,75;17.077,66 €;'sin fechas';26/03/2010;'CAFETC';'Gastos_Ocio y transporte';'Restaurantes';'VARIABLES'
26/03/2010;26/03/2010;'CAPRABO';-19,30 €;12.534,27 €;177;-19,30;17.058,36 €;'sin fechas';26/03/2010;'CAPRABO';'Gastos_Compras';'Supermercado';'VARIABLES'
26/03/2010;26/03/2010;'ENDESA ENERGI 744667/0000025P2';-62,47 €;12.471,80 €;178;-62,47;16.995,89 €;'sin fechas';26/03/2010;'ENDESA';'Gastos_Servicios tipicos';'Electricidad';'FIJO'
26/03/2010;26/03/2010;'FOMENT DE TERRASSA, S.A. FOMEN';1.606,05 €;14.077,85 €;179;1.606,05;18.601,94 €;'sin fechas';26/03/2010;'FOMENT';'Ingresos';'Nomina';'FIJO'
27/03/2010;29/03/2010;'INFORMACIO I TECNOLOGIA DE CAT';1.598,95 €;15.676,80 €;180;1.598,95;20.200,89 €;'sin fechas';29/03/2010;'INFORMACIO';'Ingresos';'Nomina';'FIJO'
27/03/2010;27/03/2010;'JUGUETILANDIA TERR';-18,95 €;15.657,85 €;181;-18,95;20.181,94 €;'sin fechas';27/03/2010;'JUGUETILANDIA';'Gastos_Compras';'Niños';'VARIABLES'
29/03/2010;29/03/2010;'CAFET.C T PRAT';-2,95 €;15.654,90 €;182;-2,95;20.178,99 €;'sin fechas';29/03/2010;'CAFETC';'Gastos_Ocio y transporte';'Restaurantes';'VARIABLES'
29/03/2010;29/03/2010;'FARMACIA';-4,65 €;15.650,25 €;183;-4,65;20.174,34 €;'sin fechas';29/03/2010;'FARMACIA';'Gastos_Salud, saber y deporte';'Farmacia';'VARIABLES'
29/03/2010;29/03/2010;'FARMACIA';-4,65 €;15.645,60 €;184;-4,65;20.169,69 €;'sin fechas';29/03/2010;'FARMACIA';'Gastos_Salud, saber y deporte';'Farmacia';'VARIABLES'
29/03/2010;29/03/2010;'FARMACIA';-4,65 €;15.640,95 €;185;-4,65;20.165,04 €;'sin fechas';29/03/2010;'FARMACIA';'Gastos_Salud, saber y deporte';'Farmacia';'VARIABLES'
29/03/2010;29/03/2010;'FARMACIA';-4,65 €;15.636,30 €;186;-4,65;20.160,39 €;'sin fechas';29/03/2010;'FARMACIA';'Gastos_Salud, saber y deporte';'Farmacia';'VARIABLES'
29/03/2010;29/03/2010;'FARMACIA';-4,65 €;15.631,65 €;187;-4,65;20.155,74 €;'sin fechas';29/03/2010;'FARMACIA';'Gastos_Salud, saber y deporte';'Farmacia';'VARIABLES'
29/03/2010;29/03/2010;'FARMACIA';-4,65 €;15.627,00 €;188;-4,65;20.151,09 €;'sin fechas';29/03/2010;'FARMACIA';'Gastos_Salud, saber y deporte';'Farmacia';'VARIABLES'
29/03/2010;29/03/2010;'FARMACIA';-4,65 €;15.622,35 €;189;-4,65;20.146,44 €;'sin fechas';29/03/2010;'FARMACIA';'Gastos_Salud, saber y deporte';'Farmacia';'VARIABLES'
29/03/2010;29/03/2010;'FRANCE TELEC ORANGE MOVIL 0211';-38,40 €;15.583,95 €;190;-38,40;20.108,04 €;'sin fechas';29/03/2010;'FRANCE';'Gastos_Servicios tipicos';'Telecomunicaciones';'FIJO'
29/03/2010;29/03/2010;'MERCADONA';-18,07 €;15.565,88 €;191;-18,07;20.089,97 €;'sin fechas';29/03/2010;'MERCADONA';'Gastos_Compras';'Supermercado';'VARIABLES'
30/03/2010;30/03/2010;'CAFET.C T PRAT';-1,25 €;15.564,63 €;192;-1,25;20.088,72 €;'sin fechas';30/03/2010;'CAFETC';'Gastos_Ocio y transporte';'Restaurantes';'VARIABLES'
30/03/2010;30/03/2010;'FARMACIA';-4,10 €;15.560,53 €;193;-4,10;20.084,62 €;'sin fechas';30/03/2010;'FARMACIA';'Gastos_Salud, saber y deporte';'Farmacia';'VARIABLES'
30/03/2010;30/03/2010;'LA TORRE TERRASA';-69,15 €;15.491,38 €;194;-69,15;20.015,47 €;'sin fechas';30/03/2010;'TORRE';'Gastos_Ocio y transporte';'Restaurantes';'VARIABLES'
31/03/2010;31/03/2010;'CAFET.C T PRAT';-1,55 €;15.489,83 €;195;-1,55;20.013,92 €;'sin fechas';31/03/2010;'CAFETC';'Gastos_Ocio y transporte';'Restaurantes';'VARIABLES'
31/03/2010;31/03/2010;'DUIT\''S C.B. \\EL PRAT DE LL';-14,50 €;15.475,33 €;196;-14,50;19.999,42 €;'sin fechas';31/03/2010;'DUITS';'Gastos_Ocio y transporte';'Restaurantes';'VARIABLES'
31/03/2010;31/03/2010;'RECIBO PTMOS. 3061-0960001518';-646,20 €;14.829,13 €;197;-646,20;19.353,22 €;'sin fechas';31/03/2010;'RECIBO';'Gastos_Banco y organismos';'Hipoteca';'FIJO'
31/03/2010;31/03/2010;'RECIBO PTMOS. 3061-0960004140';-177,24 €;14.651,89 €;198;-177,24;19.175,98 €;'sin fechas';31/03/2010;'RECIBO';'Gastos_Banco y organismos';'Hipoteca';'FIJO'
01/04/2010;01/04/2010;'AJUNTAMENT DE 770858/0000001P1';-37,18 €;14.614,71 €;199;-37,18;19.138,80 €;'sin fechas';01/04/2010;'AJUNTAMENT';'Gastos_Banco y organismos';'Ayuntamiento';'FIJO'
01/04/2010;01/04/2010;'CAFET.C T PRAT';-2,95 €;14.611,76 €;200;-2,95;19.135,85 €;'sin fechas';01/04/2010;'CAFETC';'Gastos_Ocio y transporte';'Restaurantes';'VARIABLES'
01/04/2010;22/03/2010;'CATALANA DIAG.I CIRUR';-6,85 €;14.604,91 €;201;-6,85;19.129,00 €;'sin fechas';22/03/2010;'CATALANA';'Gastos_Ocio y transporte';'Parking y peaje';'VARIABLES'
01/04/2010;01/04/2010;'MANTENIMIENTO';-1,25 €;14.603,66 €;202;-1,25;19.127,75 €;'sin fechas';01/04/2010;'MANTENIMIENTO';'Gastos_Banco y organismos';'Cargos banco';'FIJO'
02/04/2010;02/04/2010;'ES STA. MARGARITA';-40,75 €;14.562,91 €;203;-40,75;19.087,00 €;'sin fechas';02/04/2010;'STA';'Gastos_Ocio y transporte';'Gasolina';'VARIABLES'
02/04/2010;02/04/2010;'FF.CC.GENERALITAT';-64,30 €;14.498,61 €;204;-64,30;19.022,70 €;'sin fechas';02/04/2010;'FFCCGENERALITAT';'Gastos_Ocio y transporte';'Transporte';'VARIABLES'
03/04/2010;03/04/2010;'EROSKI-[COMIDA]';-42,29 €;14.456,32 €;205;-42,29;18.980,41 €;'sin fechas';03/04/2010;'EROSKICOMIDA';'Gastos_Compras';'Supermercado';'VARIABLES'
06/04/2010;30/03/2010;'AUTOPISTA TERR';-3,80 €;14.452,52 €;206;-3,80;18.976,61 €;'sin fechas';30/03/2010;'AUTOPISTA';'Gastos_Ocio y transporte';'Parking y peaje';'VARIABLES'
06/04/2010;06/04/2010;'EROSKI-[COMIDA]';-49,89 €;14.402,63 €;207;-49,89;18.926,72 €;'sin fechas';06/04/2010;'EROSKICOMIDA';'Gastos_Compras';'Supermercado';'VARIABLES'
06/04/2010;06/04/2010;'GENERAL DE PINTURAS';-121,83 €;14.280,80 €;208;-121,83;18.804,89 €;'sin fechas';06/04/2010;'GENERAL';'Gastos_Vivienda y vehiculo';'Mnto. hogar';'VARIABLES'
06/04/2010;06/04/2010;'ONO';-9,95 €;14.270,85 €;209;-9,95;18.794,94 €;'sin fechas';06/04/2010;'ONO';'Gastos_Servicios tipicos';'Telecomunicaciones';'FIJO'
06/04/2010;06/04/2010;'RESTAURANTES';-50,34 €;14.220,51 €;210;-50,34;18.744,60 €;'sin fechas';06/04/2010;'RESTAURANTES';'Gastos_Ocio y transporte';'Restaurantes';'VARIABLES'
06/04/2010;06/04/2010;'SEGUROS CATALANA';-287,19 €;13.933,32 €;211;-287,19;18.457,41 €;'sin fechas';06/04/2010;'CATALANA';'Gastos_Ocio y transporte';'Parking y peaje';'VARIABLES'
06/04/2010;06/04/2010;'TOYS R US IBER';-45,99 €;13.887,33 €;212;-45,99;18.411,42 €;'sin fechas';06/04/2010;'TOYS';'Gastos_Compras';'Niños';'VARIABLES'
06/04/2010;06/04/2010;'VIENA';-10,50 €;13.876,83 €;213;-10,50;18.400,92 €;'sin fechas';06/04/2010;'VIENA';'Gastos_Ocio y transporte';'Restaurantes';'VARIABLES'
07/04/2010;07/04/2010;'AMC PARC VALLES';-15,00 €;13.861,83 €;214;-15,00;18.385,92 €;'sin fechas';07/04/2010;'AMC';'Gastos_Ocio y transporte';'Espectáculos';'VARIABLES'
07/04/2010;07/04/2010;'CIA.DE SEGUROS AD 006662671613';-34,17 €;13.827,66 €;215;-34,17;18.351,75 €;'sin fechas';07/04/2010;'CIADE';'Gastos_Salud, saber y deporte';'Medico';'VARIABLES'
07/04/2010;07/04/2010;'VIENA';-11,40 €;13.816,26 €;216;-11,40;18.340,35 €;'sin fechas';07/04/2010;'VIENA';'Gastos_Ocio y transporte';'Restaurantes';'VARIABLES'
08/04/2010;08/04/2010;'DHR TRADE SL';-29,71 €;13.786,55 €;217;-29,71;18.310,64 €;'sin fechas';08/04/2010;'DHR';'Gastos_Ocio y transporte';'Gasolina';'VARIABLES'
08/04/2010;08/04/2010;'EROSKI-[COMIDA]';-2,94 €;13.783,61 €;218;-2,94;18.307,70 €;'sin fechas';08/04/2010;'EROSKICOMIDA';'Gastos_Compras';'Supermercado';'VARIABLES'
08/04/2010;08/04/2010;'FNAC';-31,00 €;13.752,61 €;219;-31,00;18.276,70 €;'sin fechas';08/04/2010;'FNAC';'Gastos_Compras';'Supermercado';'VARIABLES'
08/04/2010;08/04/2010;'GENERAL DE PINTURAS';-25,33 €;13.727,28 €;220;-25,33;18.251,37 €;'sin fechas';08/04/2010;'GENERAL';'Gastos_Vivienda y vehiculo';'Mnto. hogar';'VARIABLES'
10/04/2010;10/04/2010;'BUENAS MIGAS';-8,68 €;13.718,60 €;221;-8,68;18.242,69 €;'sin fechas';10/04/2010;'BUENAS';'Gastos_Ocio y transporte';'Restaurantes';'VARIABLES'
10/04/2010;10/04/2010;'GAME';-64,90 €;13.653,70 €;222;-64,90;18.177,79 €;'sin fechas';10/04/2010;'GAME';'Gastos_Compras';'Hobbys';'VARIABLES'
10/04/2010;10/04/2010;'JIANHONG ZHOU S.L.';-26,22 €;13.627,48 €;223;-26,22;18.151,57 €;'sin fechas';10/04/2010;'JIANHONG';'Gastos_Ocio y transporte';'Restaurantes';'VARIABLES'
10/04/2010;10/04/2010;'MERCADONA';-40,09 €;13.587,39 €;224;-40,09;18.111,48 €;'sin fechas';10/04/2010;'MERCADONA';'Gastos_Compras';'Supermercado';'VARIABLES'
10/04/2010;10/04/2010;'NOVA EULALIA S L';-856,63 €;12.730,76 €;225;-856,63;17.254,85 €;'sin fechas';10/04/2010;'NOVA';'Gastos_Compras';'Gastos_Compras';'Gastos_Compras'
12/04/2010;12/04/2010;'CAFET.C T PRAT';-2,60 €;12.728,16 €;226;-2,60;17.252,25 €;'sin fechas';12/04/2010;'CAFETC';'Gastos_Ocio y transporte';'Restaurantes';'VARIABLES'
13/04/2010;08/04/2010;'AUTOPISTA TERR';-6,20 €;12.721,96 €;227;-6,20;17.246,05 €;'sin fechas';08/04/2010;'AUTOPISTA';'Gastos_Ocio y transporte';'Parking y peaje';'VARIABLES'
13/04/2010;13/04/2010;'CAFET.C T PRAT';-3,15 €;12.718,81 €;228;-3,15;17.242,90 €;'sin fechas';13/04/2010;'CAFETC';'Gastos_Ocio y transporte';'Restaurantes';'VARIABLES'
13/04/2010;13/04/2010;'FORNERIA';-3,52 €;12.715,29 €;229;-3,52;17.239,38 €;'sin fechas';13/04/2010;'FORNERIA';'Gastos_Compras';'Supermercado';'VARIABLES'
13/04/2010;13/04/2010;'GAS NATURAL';-86,87 €;12.628,42 €;230;-86,87;17.152,51 €;'sin fechas';13/04/2010;'GAS';'Gastos_Servicios tipicos';'Gas';'FIJO'
14/04/2010;14/04/2010;'CAFET.C T PRAT';-1,80 €;12.626,62 €;231;-1,80;17.150,71 €;'sin fechas';14/04/2010;'CAFETC';'Gastos_Ocio y transporte';'Restaurantes';'VARIABLES'
15/04/2010;15/04/2010;'CCM VIDA Y P SEGURO PRESTAMO';-20,69 €;12.605,93 €;232;-20,69;17.130,02 €;'sin fechas';15/04/2010;'CCM';'Gastos_Seguros';'Seguro vida';'FIJO'
15/04/2010;15/04/2010;'RESTAURANTES';-31,57 €;12.574,36 €;233;-31,57;17.098,45 €;'sin fechas';15/04/2010;'RESTAURANTES';'Gastos_Ocio y transporte';'Restaurantes';'VARIABLES'
15/04/2010;15/04/2010;'SEG.AM.HIPITEC 848898/00028122';-30,44 €;12.543,92 €;234;-30,44;17.068,01 €;'sin fechas';15/04/2010;'SEGAMHIPITEC';'Gastos_Seguros';'Seguro vida';'FIJO'
16/04/2010;16/04/2010;'ES STA. MARGARITA';-30,00 €;12.513,92 €;235;-30,00;17.038,01 €;'sin fechas';16/04/2010;'STA';'Gastos_Ocio y transporte';'Gasolina';'VARIABLES'
16/04/2010;16/04/2010;'TOCINERIES VENTURA';-12,92 €;12.501,00 €;236;-12,92;17.025,09 €;'sin fechas';16/04/2010;'TOCINERIES';'Gastos_Compras';'Supermercado';'VARIABLES'
17/04/2010;17/04/2010;'EROSKI-[COMIDA]';-59,82 €;12.441,18 €;237;-59,82;16.965,27 €;'sin fechas';17/04/2010;'EROSKICOMIDA';'Gastos_Compras';'Supermercado';'VARIABLES'
17/04/2010;17/04/2010;'RINCON GLORIA \\SANT BOI DE';-17,15 €;12.424,03 €;238;-17,15;16.948,12 €;'sin fechas';17/04/2010;'RINCON';'Gastos_Ocio y transporte';'Restaurantes';'VARIABLES'
19/04/2010;19/04/2010;'CAFET.C T PRAT';-2,15 €;12.421,88 €;239;-2,15;16.945,97 €;'sin fechas';19/04/2010;'CAFETC';'Gastos_Ocio y transporte';'Restaurantes';'VARIABLES'
19/04/2010;19/04/2010;'ENDESA ENERGI 856913/0000005P2';-46,49 €;12.375,39 €;240;-46,49;16.899,48 €;'sin fechas';19/04/2010;'ENDESA';'Gastos_Servicios tipicos';'Electricidad';'FIJO'
20/04/2010;13/04/2010;'AUTOPISTA TERR';-2,40 €;12.372,99 €;241;-2,40;16.897,08 €;'sin fechas';13/04/2010;'AUTOPISTA';'Gastos_Ocio y transporte';'Parking y peaje';'VARIABLES'
20/04/2010;20/04/2010;'CAFET.C T PRAT';-3,40 €;12.369,59 €;242;-3,40;16.893,68 €;'sin fechas';20/04/2010;'CAFETC';'Gastos_Ocio y transporte';'Restaurantes';'VARIABLES'
20/04/2010;20/04/2010;'FF.CC.GENERALITAT';-21,40 €;12.348,19 €;243;-21,40;16.872,28 €;'sin fechas';20/04/2010;'FFCCGENERALITAT';'Gastos_Ocio y transporte';'Transporte';'VARIABLES'
20/04/2010;20/04/2010;'ONO';-84,60 €;12.263,59 €;244;-84,60;16.787,68 €;'sin fechas';20/04/2010;'ONO';'Gastos_Servicios tipicos';'Telecomunicaciones';'FIJO'
20/04/2010;20/04/2010;'REINT.CAJERO';-50,00 €;12.213,59 €;245;-50,00;16.737,68 €;'sin fechas';20/04/2010;'REINTCAJERO';'Gastos_Gastos varios';'Efectivo';'VARIABLES'
21/04/2010;15/04/2010;'AUTOPISTA TERR';-1,90 €;12.211,69 €;246;-1,90;16.735,78 €;'sin fechas';15/04/2010;'AUTOPISTA';'Gastos_Ocio y transporte';'Parking y peaje';'VARIABLES'
21/04/2010;21/04/2010;'FARMACIA';-18,05 €;12.193,64 €;247;-18,05;16.717,73 €;'sin fechas';21/04/2010;'FARMACIA';'Gastos_Salud, saber y deporte';'Farmacia';'VARIABLES'
21/04/2010;21/04/2010;'TRANSF.CIT 865637/0000059';375,47 €;12.569,11 €;248;375,47;17.093,20 €;'sin fechas';21/04/2010;'TRANSFCIT';'Ingresos';'Transferencias';'VARIABLES'
22/04/2010;22/04/2010;'BON AREA';-17,36 €;12.551,75 €;249;-17,36;17.075,84 €;'sin fechas';22/04/2010;'BON';'Gastos_Compras';'Supermercado';'VARIABLES'
22/04/2010;22/04/2010;'CAFET.C T PRAT';-3,15 €;12.548,60 €;250;-3,15;17.072,69 €;'sin fechas';22/04/2010;'CAFETC';'Gastos_Ocio y transporte';'Restaurantes';'VARIABLES'
23/04/2010;23/04/2010;'CAPIO SANIDAD \\SANT CUGAT D';-129,63 €;12.418,97 €;251;-129,63;16.943,06 €;'sin fechas';23/04/2010;'CAPIO';'Gastos_Salud, saber y deporte';'Medico';'VARIABLES'
23/04/2010;23/04/2010;'FRANCE TELEC ORANGE MOVIL 0211';-24,12 €;12.394,85 €;252;-24,12;16.918,94 €;'sin fechas';23/04/2010;'FRANCE';'Gastos_Servicios tipicos';'Telecomunicaciones';'FIJO'
23/04/2010;23/04/2010;'SODEXO-HOSPITA\\SANT CUGAT D';-11,05 €;12.383,80 €;253;-11,05;16.907,89 €;'sin fechas';23/04/2010;'SODEXOHOSPITASANT';'Gastos_Ocio y transporte';'Restaurantes';'VARIABLES'
24/04/2010;24/04/2010;'CAPRABO';-40,70 €;12.343,10 €;254;-40,70;16.867,19 €;'sin fechas';24/04/2010;'CAPRABO';'Gastos_Compras';'Supermercado';'VARIABLES'
24/04/2010;24/04/2010;'E.S. RUBI II';-39,35 €;12.303,75 €;255;-39,35;16.827,84 €;'sin fechas';24/04/2010;'RUBI';'Gastos_Ocio y transporte';'Gasolina';'VARIABLES'
24/04/2010;24/04/2010;'EL CORTE INGLES';-98,00 €;12.205,75 €;256;-98,00;16.729,84 €;'sin fechas';24/04/2010;'CORTE';'Gastos_Compras';'Supermercado';'VARIABLES'
24/04/2010;24/04/2010;'FRANCK PROVOST LA';-18,50 €;12.187,25 €;257;-18,50;16.711,34 €;'sin fechas';24/04/2010;'FRANCK';'Gastos_Salud, saber y deporte';'Belleza';'VARIABLES'
25/04/2010;25/04/2010;'C&A';-72,00 €;12.115,25 €;258;-72,00;16.639,34 €;'sin fechas';25/04/2010;'CA';'Gastos_Compras';'Ropa';'VARIABLES'
25/04/2010;25/04/2010;'TERIOSA TIME,';-28,00 €;12.087,25 €;259;-28,00;16.611,34 €;'sin fechas';25/04/2010;'TERIOSA';'No computable';'No computable';'No computable'
26/04/2010;26/04/2010;'CAFET.C T PRAT';-3,40 €;12.083,85 €;260;-3,40;16.607,94 €;'sin fechas';26/04/2010;'CAFETC';'Gastos_Ocio y transporte';'Restaurantes';'VARIABLES'
26/04/2010;26/04/2010;'FRANCE TELEC ORANGE MOVIL 0211';-34,16 €;12.049,69 €;261;-34,16;16.573,78 €;'sin fechas';26/04/2010;'FRANCE';'Gastos_Servicios tipicos';'Telecomunicaciones';'FIJO'
27/04/2010;27/04/2010;'CAFET.C T PRAT';-3,15 €;12.046,54 €;262;-3,15;16.570,63 €;'sin fechas';27/04/2010;'CAFETC';'Gastos_Ocio y transporte';'Restaurantes';'VARIABLES'
27/04/2010;27/04/2010;'FOMENT DE TERRASSA, S.A. FOMEN';1.606,05 €;13.652,59 €;263;1.606,05;18.176,68 €;'sin fechas';27/04/2010;'FOMENT';'Ingresos';'Nomina';'FIJO'
28/04/2010;28/04/2010;'CAFET.C T PRAT';-2,95 €;13.649,64 €;264;-2,95;18.173,73 €;'sin fechas';28/04/2010;'CAFETC';'Gastos_Ocio y transporte';'Restaurantes';'VARIABLES'
28/04/2010;28/04/2010;'INFORMACIO I TECNOLOGIA DE CAT';1.598,95 €;15.248,59 €;265;1.598,95;19.772,68 €;'sin fechas';28/04/2010;'INFORMACIO';'Ingresos';'Nomina';'FIJO'
28/04/2010;28/04/2010;'MERCADONA';-63,50 €;15.185,09 €;266;-63,50;19.709,18 €;'sin fechas';28/04/2010;'MERCADONA';'Gastos_Compras';'Supermercado';'VARIABLES'
29/04/2010;29/04/2010;'CAFET.C T PRAT';-3,15 €;15.181,94 €;267;-3,15;19.706,03 €;'sin fechas';29/04/2010;'CAFETC';'Gastos_Ocio y transporte';'Restaurantes';'VARIABLES'
29/04/2010;23/04/2010;'CATALANA DIAG.I CIRUR';-4,10 €;15.177,84 €;268;-4,10;19.701,93 €;'sin fechas';23/04/2010;'CATALANA';'Gastos_Ocio y transporte';'Parking y peaje';'VARIABLES'
30/04/2010;30/04/2010;'CAFET.C T PRAT';-2,90 €;15.174,94 €;269;-2,90;19.699,03 €;'sin fechas';30/04/2010;'CAFETC';'Gastos_Ocio y transporte';'Restaurantes';'VARIABLES'
30/04/2010;30/04/2010;'ES STA. MARGARITA';-36,15 €;15.138,79 €;270;-36,15;19.662,88 €;'sin fechas';30/04/2010;'STA';'Gastos_Ocio y transporte';'Gasolina';'VARIABLES'
30/04/2010;30/04/2010;'RECIBO PTMOS. 3061-0960001518';-646,20 €;14.492,59 €;271;-646,20;19.016,68 €;'sin fechas';30/04/2010;'RECIBO';'Gastos_Banco y organismos';'Hipoteca';'FIJO'
30/04/2010;30/04/2010;'RECIBO PTMOS. 3061-0960004140';-177,24 €;14.315,35 €;272;-177,24;18.839,44 €;'sin fechas';30/04/2010;'RECIBO';'Gastos_Banco y organismos';'Hipoteca';'FIJO'
01/05/2010;01/05/2010;'MANTENIMIENTO';-1,25 €;14.314,10 €;273;-1,25;18.838,19 €;'sin fechas';01/05/2010;'MANTENIMIENTO';'Gastos_Banco y organismos';'Cargos banco';'FIJO'
02/05/2010;02/05/2010;'AREA SERVICIO BAI\\ALDEA, L\''';-12,30 €;14.301,80 €;274;-12,30;18.825,89 €;'sin fechas';02/05/2010;'AREA';'Gastos_Ocio y transporte';'Gasolina';'VARIABLES'
03/05/2010;03/05/2010;'AJUNTAMENT BA 904897/0000032P1';-68,15 €;14.233,65 €;275;-68,15;18.757,74 €;'sin fechas';03/05/2010;'AJUNTAMENT';'Gastos_Banco y organismos';'Ayuntamiento';'FIJO'
03/05/2010;03/05/2010;'AJUNTAMENT DE 897481/0000001P1';-37,18 €;14.196,47 €;276;-37,18;18.720,56 €;'sin fechas';03/05/2010;'AJUNTAMENT';'Gastos_Banco y organismos';'Ayuntamiento';'FIJO'
03/05/2010;03/05/2010;'CAFET.C T PRAT';-3,15 €;14.193,32 €;277;-3,15;18.717,41 €;'sin fechas';03/05/2010;'CAFETC';'Gastos_Ocio y transporte';'Restaurantes';'VARIABLES'
03/05/2010;03/05/2010;'CIA.DE SEGUROS AD 006662671613';-34,17 €;14.159,15 €;278;-34,17;18.683,24 €;'sin fechas';03/05/2010;'CIADE';'Gastos_Salud, saber y deporte';'Medico';'VARIABLES'
04/05/2010;30/04/2010;'AUTOPISTA TERR';-5,25 €;14.153,90 €;279;-5,25;18.677,99 €;'sin fechas';30/04/2010;'AUTOPISTA';'Gastos_Ocio y transporte';'Parking y peaje';'VARIABLES'
04/05/2010;30/04/2010;'AUTOPISTA TERR';-3,40 €;14.150,50 €;280;-3,40;18.674,59 €;'sin fechas';30/04/2010;'AUTOPISTA';'Gastos_Ocio y transporte';'Parking y peaje';'VARIABLES'
04/05/2010;04/05/2010;'CAFET.C T PRAT';-3,40 €;14.147,10 €;281;-3,40;18.671,19 €;'sin fechas';04/05/2010;'CAFETC';'Gastos_Ocio y transporte';'Restaurantes';'VARIABLES'
04/05/2010;04/05/2010;'ENTREGA PTMO. 3061-0960004140';-2.000,00 €;12.147,10 €;282;-2.000,00;16.671,19 €;'sin fechas';04/05/2010;'ENTREGA';'Gastos_Banco y organismos';'Hipoteca';'FIJO'
05/05/2010;05/05/2010;'CAFET.C T PRAT';-3,40 €;12.143,70 €;283;-3,40;16.667,79 €;'sin fechas';05/05/2010;'CAFETC';'Gastos_Ocio y transporte';'Restaurantes';'VARIABLES'
05/05/2010;05/05/2010;'ES STA. MARGARITA';-42,01 €;12.101,69 €;284;-42,01;16.625,78 €;'sin fechas';05/05/2010;'STA';'Gastos_Ocio y transporte';'Gasolina';'VARIABLES'
06/05/2010;06/05/2010;'CAFET.C T PRAT';-0,80 €;12.100,89 €;285;-0,80;16.624,98 €;'sin fechas';06/05/2010;'CAFETC';'Gastos_Ocio y transporte';'Restaurantes';'VARIABLES'
06/05/2010;06/05/2010;'EROSKI-[COMIDA]';-46,66 €;12.054,23 €;286;-46,66;16.578,32 €;'sin fechas';06/05/2010;'EROSKICOMIDA';'Gastos_Compras';'Supermercado';'VARIABLES'
06/05/2010;06/05/2010;'REINT.CAJERO';-50,00 €;12.004,23 €;287;-50,00;16.528,32 €;'sin fechas';06/05/2010;'REINTCAJERO';'Gastos_Gastos varios';'Efectivo';'VARIABLES'
07/05/2010;30/04/2010;'AUTOPISTA TERR';-5,80 €;11.998,43 €;288;-5,80;16.522,52 €;'sin fechas';30/04/2010;'AUTOPISTA';'Gastos_Ocio y transporte';'Parking y peaje';'VARIABLES'
07/05/2010;07/05/2010;'CAFET.C T PRAT';-3,80 €;11.994,63 €;289;-3,80;16.518,72 €;'sin fechas';07/05/2010;'CAFETC';'Gastos_Ocio y transporte';'Restaurantes';'VARIABLES'
08/05/2010;08/05/2010;'CAPRABO';-49,54 €;11.945,09 €;290;-49,54;16.469,18 €;'sin fechas';08/05/2010;'CAPRABO';'Gastos_Compras';'Supermercado';'VARIABLES'
08/05/2010;08/05/2010;'H&M';-44,75 €;11.900,34 €;291;-44,75;16.424,43 €;'sin fechas';08/05/2010;'HM';'Gastos_Compras';'Ropa';'VARIABLES'
08/05/2010;08/05/2010;'IKEA';-13,45 €;11.886,89 €;292;-13,45;16.410,98 €;'sin fechas';08/05/2010;'IKEA';'Gastos_Vivienda y vehiculo';'Mnto. hogar';'VARIABLES'
08/05/2010;08/05/2010;'IKEA';-12,97 €;11.873,92 €;293;-12,97;16.398,01 €;'sin fechas';08/05/2010;'IKEA';'Gastos_Vivienda y vehiculo';'Mnto. hogar';'VARIABLES'
08/05/2010;08/05/2010;'STARBUCKS';-4,30 €;11.869,62 €;294;-4,30;16.393,71 €;'sin fechas';08/05/2010;'STARBUCKS';'Gastos_Ocio y transporte';'Restaurantes';'VARIABLES'
10/05/2010;02/05/2010;'AUTOPISTA TERR';-5,25 €;11.864,37 €;295;-5,25;16.388,46 €;'sin fechas';02/05/2010;'AUTOPISTA';'Gastos_Ocio y transporte';'Parking y peaje';'VARIABLES'
10/05/2010;02/05/2010;'AUTOPISTA TERR';-3,40 €;11.860,97 €;296;-3,40;16.385,06 €;'sin fechas';02/05/2010;'AUTOPISTA';'Gastos_Ocio y transporte';'Parking y peaje';'VARIABLES'
10/05/2010;02/05/2010;'AUTOPISTA TERR';-5,80 €;11.855,17 €;297;-5,80;16.379,26 €;'sin fechas';02/05/2010;'AUTOPISTA';'Gastos_Ocio y transporte';'Parking y peaje';'VARIABLES'
10/05/2010;10/05/2010;'CAFET.C T PRAT';-2,85 €;11.852,32 €;298;-2,85;16.376,41 €;'sin fechas';10/05/2010;'CAFETC';'Gastos_Ocio y transporte';'Restaurantes';'VARIABLES'
10/05/2010;10/05/2010;'CAFET.C T PRAT';-7,25 €;11.845,07 €;299;-7,25;16.369,16 €;'sin fechas';10/05/2010;'CAFETC';'Gastos_Ocio y transporte';'Restaurantes';'VARIABLES'
10/05/2010;10/05/2010;'REINT.CAJERO';-50,00 €;11.795,07 €;300;-50,00;16.319,16 €;'sin fechas';10/05/2010;'REINTCAJERO';'Gastos_Gastos varios';'Efectivo';'VARIABLES'
11/05/2010;11/05/2010;'CAFET.C T PRAT';-3,30 €;11.791,77 €;301;-3,30;16.315,86 €;'sin fechas';11/05/2010;'CAFETC';'Gastos_Ocio y transporte';'Restaurantes';'VARIABLES'
12/05/2010;12/05/2010;'CAFET.C T PRAT';-3,40 €;11.788,37 €;302;-3,40;16.312,46 €;'sin fechas';12/05/2010;'CAFETC';'Gastos_Ocio y transporte';'Restaurantes';'VARIABLES'
13/05/2010;13/05/2010;'CAFET.C T PRAT';-2,75 €;11.785,62 €;303;-2,75;16.309,71 €;'sin fechas';13/05/2010;'CAFETC';'Gastos_Ocio y transporte';'Restaurantes';'VARIABLES'
14/05/2010;14/05/2010;'CAFET.C T PRAT';-3,70 €;11.781,92 €;304;-3,70;16.306,01 €;'sin fechas';14/05/2010;'CAFETC';'Gastos_Ocio y transporte';'Restaurantes';'VARIABLES'
14/05/2010;14/05/2010;'CCM VIDA Y P SEGURO PRESTAMO';-20,64 €;11.761,28 €;305;-20,64;16.285,37 €;'sin fechas';14/05/2010;'CCM';'Gastos_Seguros';'Seguro vida';'FIJO'
14/05/2010;14/05/2010;'SEG.AM.HIPITEC 959296/00027732';-30,37 €;11.730,91 €;306;-30,37;16.255,00 €;'sin fechas';14/05/2010;'SEGAMHIPITEC';'Gastos_Seguros';'Seguro vida';'FIJO'
15/05/2010;15/05/2010;'C&A';-42,00 €;11.688,91 €;307;-42,00;16.213,00 €;'sin fechas';15/05/2010;'CA';'Gastos_Compras';'Ropa';'VARIABLES'
15/05/2010;15/05/2010;'ES STA. MARGARITA';-37,50 €;11.651,41 €;308;-37,50;16.175,50 €;'sin fechas';15/05/2010;'STA';'Gastos_Ocio y transporte';'Gasolina';'VARIABLES'
15/05/2010;15/05/2010;'REINT.CAJERO';-50,00 €;11.601,41 €;309;-50,00;16.125,50 €;'sin fechas';15/05/2010;'REINTCAJERO';'Gastos_Gastos varios';'Efectivo';'VARIABLES'
16/05/2010;16/05/2010;'VIENA';-10,25 €;11.591,16 €;310;-10,25;16.115,25 €;'sin fechas';16/05/2010;'VIENA';'Gastos_Ocio y transporte';'Restaurantes';'VARIABLES'
17/05/2010;17/05/2010;'CAFET.C T PRAT';-2,75 €;11.588,41 €;311;-2,75;16.112,50 €;'sin fechas';17/05/2010;'CAFETC';'Gastos_Ocio y transporte';'Restaurantes';'VARIABLES'
17/05/2010;17/05/2010;'CARNS JONICS SL';-8,95 €;11.579,46 €;312;-8,95;16.103,55 €;'sin fechas';17/05/2010;'CARNS';'Gastos_Compras';'Supermercado';'VARIABLES'
17/05/2010;17/05/2010;'ONO';-81,92 €;11.497,54 €;313;-81,92;16.021,63 €;'sin fechas';17/05/2010;'ONO';'Gastos_Servicios tipicos';'Telecomunicaciones';'FIJO'
18/05/2010;18/05/2010;'CAFET.C T PRAT';-2,95 €;11.494,59 €;314;-2,95;16.018,68 €;'sin fechas';18/05/2010;'CAFETC';'Gastos_Ocio y transporte';'Restaurantes';'VARIABLES'
18/05/2010;18/05/2010;'REINT.CAJERO';-100,00 €;11.394,59 €;315;-100,00;15.918,68 €;'sin fechas';18/05/2010;'REINTCAJERO';'Gastos_Gastos varios';'Efectivo';'VARIABLES'
19/05/2010;19/05/2010;'CAFET.C T PRAT';-2,90 €;11.391,69 €;316;-2,90;15.915,78 €;'sin fechas';19/05/2010;'CAFETC';'Gastos_Ocio y transporte';'Restaurantes';'VARIABLES'
19/05/2010;19/05/2010;'FARMACIA';-22,70 €;11.368,99 €;317;-22,70;15.893,08 €;'sin fechas';19/05/2010;'FARMACIA';'Gastos_Salud, saber y deporte';'Farmacia';'VARIABLES'
19/05/2010;19/05/2010;'FF.CC.GENERALITAT';-15,70 €;11.353,29 €;318;-15,70;15.877,38 €;'sin fechas';19/05/2010;'FFCCGENERALITAT';'Gastos_Ocio y transporte';'Transporte';'VARIABLES'
19/05/2010;19/05/2010;'H&M';-26,85 €;11.326,44 €;319;-26,85;15.850,53 €;'sin fechas';19/05/2010;'HM';'Gastos_Compras';'Ropa';'VARIABLES'
19/05/2010;19/05/2010;'MUERDE LA PAST\\CORNELLA LLO';-21,80 €;11.304,64 €;320;-21,80;15.828,73 €;'sin fechas';19/05/2010;'MUERDE';'Gastos_Ocio y transporte';'Restaurantes';'VARIABLES'
19/05/2010;19/05/2010;'PRIMARK';-39,50 €;11.265,14 €;321;-39,50;15.789,23 €;'sin fechas';19/05/2010;'PRIMARK';'Gastos_Compras';'Ropa';'VARIABLES'
20/05/2010;20/05/2010;'AMC PARC VALLES';-9,00 €;11.256,14 €;322;-9,00;15.780,23 €;'sin fechas';20/05/2010;'AMC';'Gastos_Ocio y transporte';'Espectáculos';'VARIABLES'
20/05/2010;20/05/2010;'CAFET.C T PRAT';-4,10 €;11.252,04 €;323;-4,10;15.776,13 €;'sin fechas';20/05/2010;'CAFETC';'Gastos_Ocio y transporte';'Restaurantes';'VARIABLES'
20/05/2010;20/05/2010;'CHUMI CHURRI';-16,49 €;11.235,55 €;324;-16,49;15.759,64 €;'sin fechas';20/05/2010;'CHUMI';'Gastos_Ocio y transporte';'Restaurantes';'VARIABLES'
20/05/2010;20/05/2010;'MERCADONA';-171,64 €;11.063,91 €;325;-171,64;15.588,00 €;'sin fechas';20/05/2010;'MERCADONA';'Gastos_Compras';'Supermercado';'VARIABLES'
21/05/2010;14/05/2010;'AUTOPISTA TERR';-3,53 €;11.060,38 €;326;-3,53;15.584,47 €;'sin fechas';14/05/2010;'AUTOPISTA';'Gastos_Ocio y transporte';'Parking y peaje';'VARIABLES'
21/05/2010;21/05/2010;'ENDESA ENERGI 978594/0000024P2';-63,86 €;10.996,52 €;327;-63,86;15.520,61 €;'sin fechas';21/05/2010;'ENDESA';'Gastos_Servicios tipicos';'Electricidad';'FIJO'
21/05/2010;21/05/2010;'FRANCE TELEC ORANGE MOVIL 0211';-20,47 €;10.976,05 €;328;-20,47;15.500,14 €;'sin fechas';21/05/2010;'FRANCE';'Gastos_Servicios tipicos';'Telecomunicaciones';'FIJO'
22/05/2010;22/05/2010;'EROSKI-[COMIDA]';-38,82 €;10.937,23 €;329;-38,82;15.461,32 €;'sin fechas';22/05/2010;'EROSKICOMIDA';'Gastos_Compras';'Supermercado';'VARIABLES'
22/05/2010;22/05/2010;'ES STA. MARGARITA';-38,36 €;10.898,87 €;330;-38,36;15.422,96 €;'sin fechas';22/05/2010;'STA';'Gastos_Ocio y transporte';'Gasolina';'VARIABLES'
22/05/2010;22/05/2010;'KIABI';-63,94 €;10.834,93 €;331;-63,94;15.359,02 €;'sin fechas';22/05/2010;'KIABI';'Gastos_Compras';'Ropa';'VARIABLES'
22/05/2010;22/05/2010;'RESTAURANTES';-26,22 €;10.808,71 €;332;-26,22;15.332,80 €;'sin fechas';22/05/2010;'RESTAURANTES';'Gastos_Ocio y transporte';'Restaurantes';'VARIABLES'
24/05/2010;24/05/2010;'RESTAURANTES';-25,04 €;10.783,67 €;333;-25,04;15.307,76 €;'sin fechas';24/05/2010;'RESTAURANTES';'Gastos_Ocio y transporte';'Restaurantes';'VARIABLES'
25/05/2010;15/05/2010;'AUTOPISTA TERR';-1,65 €;10.782,02 €;334;-1,65;15.306,11 €;'sin fechas';15/05/2010;'AUTOPISTA';'Gastos_Ocio y transporte';'Parking y peaje';'VARIABLES'
25/05/2010;25/05/2010;'BON AREA';-21,25 €;10.760,77 €;335;-21,25;15.284,86 €;'sin fechas';25/05/2010;'BON';'Gastos_Compras';'Supermercado';'VARIABLES'
25/05/2010;25/05/2010;'CAFET.C T PRAT';-3,15 €;10.757,62 €;336;-3,15;15.281,71 €;'sin fechas';25/05/2010;'CAFETC';'Gastos_Ocio y transporte';'Restaurantes';'VARIABLES'
25/05/2010;25/05/2010;'CAPIO SANIDAD \\SANT CUGAT D';-41,67 €;10.715,95 €;337;-41,67;15.240,04 €;'sin fechas';25/05/2010;'CAPIO';'Gastos_Salud, saber y deporte';'Medico';'VARIABLES'
25/05/2010;25/05/2010;'FRANCE TELEC ORANGE MOVIL 0211';-31,16 €;10.684,79 €;338;-31,16;15.208,88 €;'sin fechas';25/05/2010;'FRANCE';'Gastos_Servicios tipicos';'Telecomunicaciones';'FIJO'
26/05/2010;26/05/2010;'CAFET.C T PRAT';-2,95 €;10.681,84 €;339;-2,95;15.205,93 €;'sin fechas';26/05/2010;'CAFETC';'Gastos_Ocio y transporte';'Restaurantes';'VARIABLES'
27/05/2010;27/05/2010;'CAFET.C T PRAT';-1,85 €;10.679,99 €;340;-1,85;15.204,08 €;'sin fechas';27/05/2010;'CAFETC';'Gastos_Ocio y transporte';'Restaurantes';'VARIABLES'
27/05/2010;27/05/2010;'FARMACIA';-43,59 €;10.636,40 €;341;-43,59;15.160,49 €;'sin fechas';27/05/2010;'FARMACIA';'Gastos_Salud, saber y deporte';'Farmacia';'VARIABLES'
27/05/2010;27/05/2010;'FOMENT DE TERRASSA, S.A. FOMEN';1.600,80 €;12.237,20 €;342;1.600,80;16.761,29 €;'sin fechas';27/05/2010;'FOMENT';'Ingresos';'Nomina';'FIJO'
28/05/2010;28/05/2010;'INFORMACIO I TECNOLOGIA DE CAT';1.598,95 €;13.836,15 €;343;1.598,95;18.360,24 €;'sin fechas';28/05/2010;'INFORMACIO';'Ingresos';'Nomina';'FIJO'
28/05/2010;28/05/2010;'TOCINERIES VENTURA';-24,41 €;13.811,74 €;344;-24,41;18.335,83 €;'sin fechas';28/05/2010;'TOCINERIES';'Gastos_Compras';'Supermercado';'VARIABLES'
31/05/2010;31/05/2010;'CAFET.C T PRAT';-2,95 €;13.808,79 €;345;-2,95;18.332,88 €;'sin fechas';31/05/2010;'CAFETC';'Gastos_Ocio y transporte';'Restaurantes';'VARIABLES'
31/05/2010;31/05/2010;'RECIBO PTMOS. 3061-0960001518';-646,20 €;13.162,59 €;346;-646,20;17.686,68 €;'sin fechas';31/05/2010;'RECIBO';'Gastos_Banco y organismos';'Hipoteca';'FIJO'
31/05/2010;31/05/2010;'RECIBO PTMOS. 3061-0960004140';-137,10 €;13.025,49 €;347;-137,10;17.549,58 €;'sin fechas';31/05/2010;'RECIBO';'Gastos_Banco y organismos';'Hipoteca';'FIJO'
01/06/2010;01/06/2010;'CAFET.C T PRAT';-3,40 €;13.022,09 €;348;-3,40;17.546,18 €;'sin fechas';01/06/2010;'CAFETC';'Gastos_Ocio y transporte';'Restaurantes';'VARIABLES'
01/06/2010;01/06/2010;'CIA.DE SEGUROS AD 006662671613';-34,17 €;12.987,92 €;349;-34,17;17.512,01 €;'sin fechas';01/06/2010;'CIADE';'Gastos_Salud, saber y deporte';'Medico';'VARIABLES'
01/06/2010;01/06/2010;'MANTENIMIENTO';-1,25 €;12.986,67 €;350;-1,25;17.510,76 €;'sin fechas';01/06/2010;'MANTENIMIENTO';'Gastos_Banco y organismos';'Cargos banco';'FIJO'
02/06/2010;02/06/2010;'CAFET.C T PRAT';-1,85 €;12.984,82 €;351;-1,85;17.508,91 €;'sin fechas';02/06/2010;'CAFETC';'Gastos_Ocio y transporte';'Restaurantes';'VARIABLES'
02/06/2010;02/06/2010;'CAFET.C T PRAT';-7,25 €;12.977,57 €;352;-7,25;17.501,66 €;'sin fechas';02/06/2010;'CAFETC';'Gastos_Ocio y transporte';'Restaurantes';'VARIABLES'
03/06/2010;03/06/2010;'CAFET.C T PRAT';-2,90 €;12.974,67 €;353;-2,90;17.498,76 €;'sin fechas';03/06/2010;'CAFETC';'Gastos_Ocio y transporte';'Restaurantes';'VARIABLES'
03/06/2010;03/06/2010;'ES STA. MARGARITA';-41,27 €;12.933,40 €;354;-41,27;17.457,49 €;'sin fechas';03/06/2010;'STA';'Gastos_Ocio y transporte';'Gasolina';'VARIABLES'
04/06/2010;04/06/2010;'CAFET.C T PRAT';-3,70 €;12.929,70 €;355;-3,70;17.453,79 €;'sin fechas';04/06/2010;'CAFETC';'Gastos_Ocio y transporte';'Restaurantes';'VARIABLES'
04/06/2010;04/06/2010;'TOCINERIES VENTURA';-20,57 €;12.909,13 €;356;-20,57;17.433,22 €;'sin fechas';04/06/2010;'TOCINERIES';'Gastos_Compras';'Supermercado';'VARIABLES'
05/06/2010;05/06/2010;'EROSKI-[COMIDA]';-73,39 €;12.835,74 €;357;-73,39;17.359,83 €;'sin fechas';05/06/2010;'EROSKICOMIDA';'Gastos_Compras';'Supermercado';'VARIABLES'
07/06/2010;07/06/2010;'CAFET.C T PRAT';-1,90 €;12.833,84 €;358;-1,90;17.357,93 €;'sin fechas';07/06/2010;'CAFETC';'Gastos_Ocio y transporte';'Restaurantes';'VARIABLES'
07/06/2010;07/06/2010;'CAFET.C T PRAT';-1,50 €;12.832,34 €;359;-1,50;17.356,43 €;'sin fechas';07/06/2010;'CAFETC';'Gastos_Ocio y transporte';'Restaurantes';'VARIABLES'
07/06/2010;07/06/2010;'CAFET.C T PRAT';-0,25 €;12.832,09 €;360;-0,25;17.356,18 €;'sin fechas';07/06/2010;'CAFETC';'Gastos_Ocio y transporte';'Restaurantes';'VARIABLES'
07/06/2010;07/06/2010;'CARREFOUR-[COMIDA]';-14,95 €;12.817,14 €;361;-14,95;17.341,23 €;'sin fechas';07/06/2010;'CARREFOURCOMIDA';'Gastos_Compras';'Supermercado';'VARIABLES'
07/06/2010;07/06/2010;'GAME';-15,95 €;12.801,19 €;362;-15,95;17.325,28 €;'sin fechas';07/06/2010;'GAME';'Gastos_Compras';'Hobbys';'VARIABLES'
07/06/2010;07/06/2010;'REINT.CAJERO';-50,00 €;12.751,19 €;363;-50,00;17.275,28 €;'sin fechas';07/06/2010;'REINTCAJERO';'Gastos_Gastos varios';'Efectivo';'VARIABLES'
08/06/2010;08/06/2010;'CAFET.C T PRAT';-3,70 €;12.747,49 €;364;-3,70;17.271,58 €;'sin fechas';08/06/2010;'CAFETC';'Gastos_Ocio y transporte';'Restaurantes';'VARIABLES'
09/06/2010;04/06/2010;'AUTOPISTA TERR';-2,60 €;12.744,89 €;365;-2,60;17.268,98 €;'sin fechas';04/06/2010;'AUTOPISTA';'Gastos_Ocio y transporte';'Parking y peaje';'VARIABLES'
09/06/2010;09/06/2010;'CAFET.C T PRAT';-0,25 €;12.744,64 €;366;-0,25;17.268,73 €;'sin fechas';09/06/2010;'CAFETC';'Gastos_Ocio y transporte';'Restaurantes';'VARIABLES'
10/06/2010;10/06/2010;'CAFET.C T PRAT';-2,95 €;12.741,69 €;367;-2,95;17.265,78 €;'sin fechas';10/06/2010;'CAFETC';'Gastos_Ocio y transporte';'Restaurantes';'VARIABLES'
10/06/2010;10/06/2010;'GAS NATURAL';-102,04 €;12.639,65 €;368;-102,04;17.163,74 €;'sin fechas';10/06/2010;'GAS';'Gastos_Servicios tipicos';'Gas';'FIJO'
11/06/2010;11/06/2010;'CAFET.C T PRAT';-3,30 €;12.636,35 €;369;-3,30;17.160,44 €;'sin fechas';11/06/2010;'CAFETC';'Gastos_Ocio y transporte';'Restaurantes';'VARIABLES'
11/06/2010;11/06/2010;'TOCINERIES VENTURA';-18,85 €;12.617,50 €;370;-18,85;17.141,59 €;'sin fechas';11/06/2010;'TOCINERIES';'Gastos_Compras';'Supermercado';'VARIABLES'
12/06/2010;12/06/2010;'BON AREA';-21,41 €;12.596,09 €;371;-21,41;17.120,18 €;'sin fechas';12/06/2010;'BON';'Gastos_Compras';'Supermercado';'VARIABLES'
12/06/2010;12/06/2010;'ES STA. MARGARITA';-26,01 €;12.570,08 €;372;-26,01;17.094,17 €;'sin fechas';12/06/2010;'STA';'Gastos_Ocio y transporte';'Gasolina';'VARIABLES'
12/06/2010;14/06/2010;'Fabregues - Gabriel';-1.071,60 €;11.498,48 €;373;-1.071,60;16.022,57 €;'sin fechas';14/06/2010;'FABREGUES';'Gastos_Compras';'Niños';'VARIABLES'
12/06/2010;12/06/2010;'FARMACIA';-48,24 €;11.450,24 €;374;-48,24;15.974,33 €;'sin fechas';12/06/2010;'FARMACIA';'Gastos_Salud, saber y deporte';'Farmacia';'VARIABLES'
15/06/2010;15/06/2010;'CAFET.C T PRAT';-2,85 €;11.447,39 €;375;-2,85;15.971,48 €;'sin fechas';15/06/2010;'CAFETC';'Gastos_Ocio y transporte';'Restaurantes';'VARIABLES'
15/06/2010;15/06/2010;'CAFET.C T PRAT';-0,25 €;11.447,14 €;376;-0,25;15.971,23 €;'sin fechas';15/06/2010;'CAFETC';'Gastos_Ocio y transporte';'Restaurantes';'VARIABLES'
15/06/2010;15/06/2010;'CCM VIDA Y P SEGURO PRESTAMO';-20,59 €;11.426,55 €;377;-20,59;15.950,64 €;'sin fechas';15/06/2010;'CCM';'Gastos_Seguros';'Seguro vida';'FIJO'
15/06/2010;15/06/2010;'EROSKI-[COMIDA]';-36,08 €;11.390,47 €;378;-36,08;15.914,56 €;'sin fechas';15/06/2010;'EROSKICOMIDA';'Gastos_Compras';'Supermercado';'VARIABLES'
15/06/2010;15/06/2010;'ES STA. MARGARITA';-31,05 €;11.359,42 €;379;-31,05;15.883,51 €;'sin fechas';15/06/2010;'STA';'Gastos_Ocio y transporte';'Gasolina';'VARIABLES'
15/06/2010;15/06/2010;'SEG.AM.HIPITEC 023179/00026102';-30,30 €;11.329,12 €;380;-30,30;15.853,21 €;'sin fechas';15/06/2010;'SEGAMHIPITEC';'Gastos_Seguros';'Seguro vida';'FIJO'
15/06/2010;15/06/2010;'ULANKA';-30,00 €;11.299,12 €;381;-30,00;15.823,21 €;'sin fechas';15/06/2010;'ULANKA';'Gastos_Compras';'Ropa';'VARIABLES'
16/06/2010;16/06/2010;'CAFET.C T PRAT';-2,35 €;11.296,77 €;382;-2,35;15.820,86 €;'sin fechas';16/06/2010;'CAFETC';'Gastos_Ocio y transporte';'Restaurantes';'VARIABLES'
16/06/2010;16/06/2010;'ENDESA ENERGI 023853/0000006P2';-38,89 €;11.257,88 €;383;-38,89;15.781,97 €;'sin fechas';16/06/2010;'ENDESA';'Gastos_Servicios tipicos';'Electricidad';'FIJO'
17/06/2010;17/06/2010;'CARREFOUR-[COMIDA]';-128,68 €;11.129,20 €;384;-128,68;15.653,29 €;'sin fechas';17/06/2010;'CARREFOURCOMIDA';'Gastos_Compras';'Supermercado';'VARIABLES'
17/06/2010;17/06/2010;'MC DONALDS';-3,80 €;11.125,40 €;385;-3,80;15.649,49 €;'sin fechas';17/06/2010;'DONALDS';'Gastos_Ocio y transporte';'Restaurantes';'VARIABLES'
17/06/2010;17/06/2010;'TOCINERIES VENTURA';-12,35 €;11.113,05 €;386;-12,35;15.637,14 €;'sin fechas';17/06/2010;'TOCINERIES';'Gastos_Compras';'Supermercado';'VARIABLES'
18/06/2010;12/06/2010;'AUTOPISTA TERR';-5,80 €;11.107,25 €;387;-5,80;15.631,34 €;'sin fechas';12/06/2010;'AUTOPISTA';'Gastos_Ocio y transporte';'Parking y peaje';'VARIABLES'
18/06/2010;12/06/2010;'AUTOPISTA TERR';-5,80 €;11.101,45 €;388;-5,80;15.625,54 €;'sin fechas';12/06/2010;'AUTOPISTA';'Gastos_Ocio y transporte';'Parking y peaje';'VARIABLES'
18/06/2010;18/06/2010;'CAFET.C T PRAT';-3,65 €;11.097,80 €;389;-3,65;15.621,89 €;'sin fechas';18/06/2010;'CAFETC';'Gastos_Ocio y transporte';'Restaurantes';'VARIABLES'
18/06/2010;18/06/2010;'ONO';-84,18 €;11.013,62 €;390;-84,18;15.537,71 €;'sin fechas';18/06/2010;'ONO';'Gastos_Servicios tipicos';'Telecomunicaciones';'FIJO'
19/06/2010;19/06/2010;'IKEA';-907,29 €;10.106,33 €;391;-907,29;14.630,42 €;'sin fechas';19/06/2010;'IKEA';'Gastos_Vivienda y vehiculo';'Mnto. hogar';'VARIABLES'
19/06/2010;19/06/2010;'REINT.CAJERO';-40,00 €;10.066,33 €;392;-40,00;14.590,42 €;'sin fechas';19/06/2010;'REINTCAJERO';'Gastos_Gastos varios';'Efectivo';'VARIABLES'
19/06/2010;19/06/2010;'SAMA LOGISTICA\\SANT ANDREU';-84,00 €;9.982,33 €;393;-84,00;14.506,42 €;'sin fechas';19/06/2010;'SAMA';'No computable';'No computable';'No computable'
21/06/2010;21/06/2010;'COMISIONES';-1,50 €;9.980,83 €;394;-1,50;14.504,92 €;'sin fechas';21/06/2010;'COMISIONES';'Gastos_Banco y organismos';'Cargos banco';'FIJO'
21/06/2010;12/06/2010;'AUTOPISTA TERR';-5,25 €;9.975,58 €;395;-5,25;14.499,67 €;'sin fechas';12/06/2010;'AUTOPISTA';'Gastos_Ocio y transporte';'Parking y peaje';'VARIABLES'
21/06/2010;12/06/2010;'AUTOPISTA TERR';-5,25 €;9.970,33 €;396;-5,25;14.494,42 €;'sin fechas';12/06/2010;'AUTOPISTA';'Gastos_Ocio y transporte';'Parking y peaje';'VARIABLES'
21/06/2010;12/06/2010;'AUTOPISTA TERR';-3,40 €;9.966,93 €;397;-3,40;14.491,02 €;'sin fechas';12/06/2010;'AUTOPISTA';'Gastos_Ocio y transporte';'Parking y peaje';'VARIABLES'
21/06/2010;12/06/2010;'AUTOPISTA TERR';-3,40 €;9.963,53 €;398;-3,40;14.487,62 €;'sin fechas';12/06/2010;'AUTOPISTA';'Gastos_Ocio y transporte';'Parking y peaje';'VARIABLES'
21/06/2010;21/06/2010;'CAFET.C T PRAT';-3,15 €;9.960,38 €;399;-3,15;14.484,47 €;'sin fechas';21/06/2010;'CAFETC';'Gastos_Ocio y transporte';'Restaurantes';'VARIABLES'
21/06/2010;21/06/2010;'CAFET.C T PRAT';-0,25 €;9.960,13 €;400;-0,25;14.484,22 €;'sin fechas';21/06/2010;'CAFETC';'Gastos_Ocio y transporte';'Restaurantes';'VARIABLES'
21/06/2010;21/06/2010;'FOMENT DE TERRASSA, S.A. FOMEN';3.267,86 €;13.227,99 €;401;3.267,86;17.752,08 €;'sin fechas';21/06/2010;'FOMENT';'Ingresos';'Nomina';'FIJO'
21/06/2010;21/06/2010;'REINT.CAJERO';-50,00 €;13.177,99 €;402;-50,00;17.702,08 €;'sin fechas';21/06/2010;'REINTCAJERO';'Gastos_Gastos varios';'Efectivo';'VARIABLES'
22/06/2010;22/06/2010;'FRANCE TELEC ORANGE MOVIL 0211';-13,39 €;13.164,60 €;403;-13,39;17.688,69 €;'sin fechas';22/06/2010;'FRANCE';'Gastos_Servicios tipicos';'Telecomunicaciones';'FIJO'
23/06/2010;23/06/2010;'CAPRABO';-36,00 €;13.128,60 €;404;-36,00;17.652,69 €;'sin fechas';23/06/2010;'CAPRABO';'Gastos_Compras';'Supermercado';'VARIABLES'
23/06/2010;23/06/2010;'GENERAL DE PINTURAS';-45,61 €;13.082,99 €;405;-45,61;17.607,08 €;'sin fechas';23/06/2010;'GENERAL';'Gastos_Vivienda y vehiculo';'Mnto. hogar';'VARIABLES'
24/06/2010;17/06/2010;'CATALANA DIAG.I CIRUR';-4,30 €;13.078,69 €;406;-4,30;17.602,78 €;'sin fechas';17/06/2010;'CATALANA';'Gastos_Ocio y transporte';'Parking y peaje';'VARIABLES'
24/06/2010;24/06/2010;'MINA PIBLICA AIGUES T.01A75789';-28,56 €;13.050,13 €;407;-28,56;17.574,22 €;'sin fechas';24/06/2010;'MINA';'Gastos_Servicios tipicos';'Agua';'FIJO'
25/06/2010;25/06/2010;'GENERAL DE PINTURAS';-24,43 €;13.025,70 €;408;-24,43;17.549,79 €;'sin fechas';25/06/2010;'GENERAL';'Gastos_Vivienda y vehiculo';'Mnto. hogar';'VARIABLES'
26/06/2010;26/06/2010;'BRICOKING TERRASSA';-22,05 €;13.003,65 €;409;-22,05;17.527,74 €;'sin fechas';26/06/2010;'BRICOKING';'Gastos_Vivienda y vehiculo';'Mnto. hogar';'VARIABLES'
26/06/2010;26/06/2010;'CAPRABO';-35,77 €;12.967,88 €;410;-35,77;17.491,97 €;'sin fechas';26/06/2010;'CAPRABO';'Gastos_Compras';'Supermercado';'VARIABLES'
26/06/2010;26/06/2010;'GENERAL DE PINTURAS';-24,49 €;12.943,39 €;411;-24,49;17.467,48 €;'sin fechas';26/06/2010;'GENERAL';'Gastos_Vivienda y vehiculo';'Mnto. hogar';'VARIABLES'
27/06/2010;27/06/2010;'LA BRASA';-58,06 €;12.885,33 €;412;-58,06;17.409,42 €;'sin fechas';27/06/2010;'BRASA';'Gastos_Ocio y transporte';'Restaurantes';'VARIABLES'
28/06/2010;28/06/2010;'BON AREA';-2,37 €;12.882,96 €;413;-2,37;17.407,05 €;'sin fechas';28/06/2010;'BON';'Gastos_Compras';'Supermercado';'VARIABLES'
28/06/2010;28/06/2010;'E.S. RUBI E 9';-30,00 €;12.852,96 €;414;-30,00;17.377,05 €;'sin fechas';28/06/2010;'RUBI';'Gastos_Ocio y transporte';'Gasolina';'VARIABLES'
28/06/2010;28/06/2010;'FRANCE TELEC ORANGE MOVIL 0211';-21,34 €;12.831,62 €;415;-21,34;17.355,71 €;'sin fechas';28/06/2010;'FRANCE';'Gastos_Servicios tipicos';'Telecomunicaciones';'FIJO'
28/06/2010;29/06/2010;'INFORMACIO I TECNOLOGIA DE CAT';1.598,95 €;14.430,57 €;416;1.598,95;18.954,66 €;'sin fechas';29/06/2010;'INFORMACIO';'Ingresos';'Nomina';'FIJO'
29/06/2010;18/06/2010;'AUTOPISTA TERR';-1,30 €;14.429,27 €;417;-1,30;18.953,36 €;'sin fechas';18/06/2010;'AUTOPISTA';'Gastos_Ocio y transporte';'Parking y peaje';'VARIABLES'
29/06/2010;29/06/2010;'CAFET.C T PRAT';-3,30 €;14.425,97 €;418;-3,30;18.950,06 €;'sin fechas';29/06/2010;'CAFETC';'Gastos_Ocio y transporte';'Restaurantes';'VARIABLES'
29/06/2010;29/06/2010;'CAFET.C T PRAT';-0,25 €;14.425,72 €;419;-0,25;18.949,81 €;'sin fechas';29/06/2010;'CAFETC';'Gastos_Ocio y transporte';'Restaurantes';'VARIABLES'
29/06/2010;29/06/2010;'RODELAS PERRUQUERS';-20,50 €;14.405,22 €;420;-20,50;18.929,31 €;'sin fechas';29/06/2010;'RODELAS';'Gastos_Salud, saber y deporte';'Belleza';'VARIABLES'
30/06/2010;30/06/2010;'CAPIO SANIDAD \\SANT CUGAT D';-50,00 €;14.355,22 €;421;-50,00;18.879,31 €;'sin fechas';30/06/2010;'CAPIO';'Gastos_Salud, saber y deporte';'Medico';'VARIABLES'
30/06/2010;30/06/2010;'RECIBO PTMOS. 3061-0960001518';-646,20 €;13.709,02 €;422;-646,20;18.233,11 €;'sin fechas';30/06/2010;'RECIBO';'Gastos_Banco y organismos';'Hipoteca';'FIJO'
30/06/2010;30/06/2010;'RECIBO PTMOS. 3061-0960004140';-137,10 €;13.571,92 €;423;-137,10;18.096,01 €;'sin fechas';30/06/2010;'RECIBO';'Gastos_Banco y organismos';'Hipoteca';'FIJO'
01/07/2010;01/07/2010;'AJUNTAMENT DE TER 010000520716';-37,18 €;13.534,74 €;424;-37,18;18.058,83 €;'sin fechas';01/07/2010;'AJUNTAMENT';'Gastos_Banco y organismos';'Ayuntamiento';'FIJO'
01/07/2010;01/07/2010;'HOSPITAL GRAL \\SANT CUGAT D';-12,05 €;13.522,69 €;425;-12,05;18.046,78 €;'sin fechas';01/07/2010;'HOSPITAL';'Gastos_Salud, saber y deporte';'Medico';'VARIABLES'
01/07/2010;01/07/2010;'MANTENIMIENTO';-1,25 €;13.521,44 €;426;-1,25;18.045,53 €;'sin fechas';01/07/2010;'MANTENIMIENTO';'Gastos_Banco y organismos';'Cargos banco';'FIJO'
02/07/2010;02/07/2010;'CATALANA DE PA\\SANT CUGAT D';-31,00 €;13.490,44 €;427;-31,00;18.014,53 €;'sin fechas';02/07/2010;'CATALANA';'Gastos_Ocio y transporte';'Parking y peaje';'VARIABLES'
02/07/2010;02/07/2010;'CIA.DE SEGUROS AD 006662671613';-34,17 €;13.456,27 €;428;-34,17;17.980,36 €;'sin fechas';02/07/2010;'CIADE';'Gastos_Salud, saber y deporte';'Medico';'VARIABLES'
02/07/2010;02/07/2010;'HOSPITAL GRAL \\SANT CUGAT D';-12,05 €;13.444,22 €;429;-12,05;17.968,31 €;'sin fechas';02/07/2010;'HOSPITAL';'Gastos_Salud, saber y deporte';'Medico';'VARIABLES'
03/07/2010;03/07/2010;'AUTOPISTA TERR';-1,18 €;13.443,04 €;430;-1,18;17.967,13 €;'sin fechas';03/07/2010;'AUTOPISTA';'Gastos_Ocio y transporte';'Parking y peaje';'VARIABLES'
03/07/2010;03/07/2010;'HOSPITAL GRAL \\SANT CUGAT D';-12,05 €;13.430,99 €;431;-12,05;17.955,08 €;'sin fechas';03/07/2010;'HOSPITAL';'Gastos_Salud, saber y deporte';'Medico';'VARIABLES'
04/07/2010;04/07/2010;'HOSPITAL GRAL \\SANT CUGAT D';-12,05 €;13.418,94 €;432;-12,05;17.943,03 €;'sin fechas';04/07/2010;'HOSPITAL';'Gastos_Salud, saber y deporte';'Medico';'VARIABLES'
05/07/2010;28/06/2010;'AUTOPISTA TERR';-1,20 €;13.417,74 €;433;-1,20;17.941,83 €;'sin fechas';28/06/2010;'AUTOPISTA';'Gastos_Ocio y transporte';'Parking y peaje';'VARIABLES'
05/07/2010;05/07/2010;'CAPIO SANIDAD \\SANT CUGAT D';-22,57 €;13.395,17 €;434;-22,57;17.919,26 €;'sin fechas';05/07/2010;'CAPIO';'Gastos_Salud, saber y deporte';'Medico';'VARIABLES'
05/07/2010;05/07/2010;'FARMACIA';-20,67 €;13.374,50 €;435;-20,67;17.898,59 €;'sin fechas';05/07/2010;'FARMACIA';'Gastos_Salud, saber y deporte';'Farmacia';'VARIABLES'
07/07/2010;07/07/2010;'FARMACIA';-36,20 €;13.338,30 €;436;-36,20;17.862,39 €;'sin fechas';07/07/2010;'FARMACIA';'Gastos_Salud, saber y deporte';'Farmacia';'VARIABLES'
07/07/2010;07/07/2010;'FARMACIA';-10,72 €;13.327,58 €;437;-10,72;17.851,67 €;'sin fechas';07/07/2010;'FARMACIA';'Gastos_Salud, saber y deporte';'Farmacia';'VARIABLES'
08/07/2010;04/07/2010;'AUTOPISTA TERR';-2,19 €;13.325,39 €;438;-2,19;17.849,48 €;'sin fechas';04/07/2010;'AUTOPISTA';'Gastos_Ocio y transporte';'Parking y peaje';'VARIABLES'
08/07/2010;28/06/2010;'CATALANA DIAG.I CIRUR';-5,55 €;13.319,84 €;439;-5,55;17.843,93 €;'sin fechas';28/06/2010;'CATALANA';'Gastos_Ocio y transporte';'Parking y peaje';'VARIABLES'
09/07/2010;09/07/2010;'DROGUERIA PLUMED';-39,00 €;13.280,84 €;440;-39,00;17.804,93 €;'sin fechas';09/07/2010;'DROGUERIA';'Gastos_Compras';'Supermercado';'VARIABLES'
09/07/2010;09/07/2010;'FARMACIA';-21,15 €;13.259,69 €;441;-21,15;17.783,78 €;'sin fechas';09/07/2010;'FARMACIA';'Gastos_Salud, saber y deporte';'Farmacia';'VARIABLES'
10/07/2010;10/07/2010;'COMISIONES';-1,50 €;13.258,19 €;442;-1,50;17.782,28 €;'sin fechas';10/07/2010;'COMISIONES';'Gastos_Banco y organismos';'Cargos banco';'FIJO'
10/07/2010;10/07/2010;'REINT.CAJERO';-100,00 €;13.158,19 €;443;-100,00;17.682,28 €;'sin fechas';10/07/2010;'REINTCAJERO';'Gastos_Gastos varios';'Efectivo';'VARIABLES'
12/07/2010;12/07/2010;'C&A';-40,00 €;13.118,19 €;444;-40,00;17.642,28 €;'sin fechas';12/07/2010;'CA';'Gastos_Compras';'Ropa';'VARIABLES'
12/07/2010;12/07/2010;'EL CORTE INGLES';-225,00 €;12.893,19 €;445;-225,00;17.417,28 €;'sin fechas';12/07/2010;'CORTE';'Gastos_Compras';'Supermercado';'VARIABLES'
12/07/2010;12/07/2010;'ES STA. MARGARITA';-38,00 €;12.855,19 €;446;-38,00;17.379,28 €;'sin fechas';12/07/2010;'STA';'Gastos_Ocio y transporte';'Gasolina';'VARIABLES'
12/07/2010;12/07/2010;'H&M';-84,90 €;12.770,29 €;447;-84,90;17.294,38 €;'sin fechas';12/07/2010;'HM';'Gastos_Compras';'Ropa';'VARIABLES'
12/07/2010;12/07/2010;'STARBUCKS';-10,45 €;12.759,84 €;448;-10,45;17.283,93 €;'sin fechas';12/07/2010;'STARBUCKS';'Gastos_Ocio y transporte';'Restaurantes';'VARIABLES'
13/07/2010;13/07/2010;'BUENAS MIGAS';-11,80 €;12.748,04 €;449;-11,80;17.272,13 €;'sin fechas';13/07/2010;'BUENAS';'Gastos_Ocio y transporte';'Restaurantes';'VARIABLES'
13/07/2010;13/07/2010;'PRIMARK';-32,00 €;12.716,04 €;450;-32,00;17.240,13 €;'sin fechas';13/07/2010;'PRIMARK';'Gastos_Compras';'Ropa';'VARIABLES'
14/07/2010;14/07/2010;'CAPRABO';-19,12 €;12.696,92 €;451;-19,12;17.221,01 €;'sin fechas';14/07/2010;'CAPRABO';'Gastos_Compras';'Supermercado';'VARIABLES'
14/07/2010;14/07/2010;'FASHION KANAK \\BADALONA';-43,85 €;12.653,07 €;452;-43,85;17.177,16 €;'sin fechas';14/07/2010;'FASHION';'Gastos_Compras';'Ropa';'VARIABLES'
14/07/2010;14/07/2010;'LIZARRAN';-10,00 €;12.643,07 €;453;-10,00;17.167,16 €;'sin fechas';14/07/2010;'LIZARRAN';'Gastos_Ocio y transporte';'Restaurantes';'VARIABLES'
15/07/2010;15/07/2010;'CCM VIDA Y P SEGURO PRESTAMO';-20,54 €;12.622,53 €;454;-20,54;17.146,62 €;'sin fechas';15/07/2010;'CCM';'Gastos_Seguros';'Seguro vida';'FIJO'
15/07/2010;15/07/2010;'EROSKI-[COMIDA]';-114,84 €;12.507,69 €;455;-114,84;17.031,78 €;'sin fechas';15/07/2010;'EROSKICOMIDA';'Gastos_Compras';'Supermercado';'VARIABLES'
15/07/2010;15/07/2010;'SEG.AM.HIPITEC 043225/00029352';-30,42 €;12.477,27 €;456;-30,42;17.001,36 €;'sin fechas';15/07/2010;'SEGAMHIPITEC';'Gastos_Seguros';'Seguro vida';'FIJO'
16/07/2010;07/07/2010;'CATALANA DIAG.I CIRUR';-6,40 €;12.470,87 €;457;-6,40;16.994,96 €;'sin fechas';07/07/2010;'CATALANA';'Gastos_Ocio y transporte';'Parking y peaje';'VARIABLES'
16/07/2010;16/07/2010;'RESTAURANTES';-48,75 €;12.422,12 €;458;-48,75;16.946,21 €;'sin fechas';16/07/2010;'RESTAURANTES';'Gastos_Ocio y transporte';'Restaurantes';'VARIABLES'
17/07/2010;17/07/2010;'EL CORTE INGLES';-19,99 €;12.402,13 €;459;-19,99;16.926,22 €;'sin fechas';17/07/2010;'CORTE';'Gastos_Compras';'Supermercado';'VARIABLES'
17/07/2010;17/07/2010;'FARMACIA';-26,00 €;12.376,13 €;460;-26,00;16.900,22 €;'sin fechas';17/07/2010;'FARMACIA';'Gastos_Salud, saber y deporte';'Farmacia';'VARIABLES'
19/07/2010;19/07/2010;'EROSKI-[COMIDA]';-74,05 €;12.302,08 €;461;-74,05;16.826,17 €;'sin fechas';19/07/2010;'EROSKICOMIDA';'Gastos_Compras';'Supermercado';'VARIABLES'
19/07/2010;19/07/2010;'ES STA. MARGARITA';-7,20 €;12.294,88 €;462;-7,20;16.818,97 €;'sin fechas';19/07/2010;'STA';'Gastos_Ocio y transporte';'Gasolina';'VARIABLES'
19/07/2010;19/07/2010;'GRINZING';-8,30 €;12.286,58 €;463;-8,30;16.810,67 €;'sin fechas';19/07/2010;'GRINZING';'Gastos_Ocio y transporte';'Restaurantes';'VARIABLES'
19/07/2010;19/07/2010;'H&M';-12,95 €;12.273,63 €;464;-12,95;16.797,72 €;'sin fechas';19/07/2010;'HM';'Gastos_Compras';'Ropa';'VARIABLES'
19/07/2010;19/07/2010;'INTERKITS';-39,95 €;12.233,68 €;465;-39,95;16.757,77 €;'sin fechas';19/07/2010;'INTERKITS';'Gastos_Compras';'Niños';'VARIABLES'
20/07/2010;20/07/2010;'DIRECCION PROVINCIAL INSS BARC';975,66 €;13.209,34 €;466;975,66;17.733,43 €;'sin fechas';20/07/2010;'DIRECCION';'Ingresos';'Nomina';'FIJO'
20/07/2010;20/07/2010;'DIRECCION PROVINCIAL INSS BARC';75,97 €;13.285,31 €;467;75,97;17.809,40 €;'sin fechas';20/07/2010;'DIRECCION';'Ingresos';'Nomina';'FIJO'
20/07/2010;21/07/2010;'INFORMACIO I TECNOLOGIA DE CAT';1.823,12 €;15.108,43 €;468;1.823,12;19.632,52 €;'sin fechas';21/07/2010;'INFORMACIO';'Ingresos';'Nomina';'FIJO'
20/07/2010;20/07/2010;'MERCADONA';-134,09 €;14.974,34 €;469;-134,09;19.498,43 €;'sin fechas';20/07/2010;'MERCADONA';'Gastos_Compras';'Supermercado';'VARIABLES'
20/07/2010;20/07/2010;'ONO';-105,22 €;14.869,12 €;470;-105,22;19.393,21 €;'sin fechas';20/07/2010;'ONO';'Gastos_Servicios tipicos';'Telecomunicaciones';'FIJO'
21/07/2010;21/07/2010;'CAPRABO';-15,68 €;14.853,44 €;471;-15,68;19.377,53 €;'sin fechas';21/07/2010;'CAPRABO';'Gastos_Compras';'Supermercado';'VARIABLES'
21/07/2010;21/07/2010;'VIENA';-12,25 €;14.841,19 €;472;-12,25;19.365,28 €;'sin fechas';21/07/2010;'VIENA';'Gastos_Ocio y transporte';'Restaurantes';'VARIABLES'
22/07/2010;22/07/2010;'CROISSANTERIA \\SANT BOI DE';-9,21 €;14.831,98 €;473;-9,21;19.356,07 €;'sin fechas';22/07/2010;'CROISSANTERIA';'Gastos_Ocio y transporte';'Restaurantes';'VARIABLES'
22/07/2010;22/07/2010;'KIABI';-12,99 €;14.818,99 €;474;-12,99;19.343,08 €;'sin fechas';22/07/2010;'KIABI';'Gastos_Compras';'Ropa';'VARIABLES'
23/07/2010;23/07/2010;'FARMACIA';-19,93 €;14.799,06 €;475;-19,93;19.323,15 €;'sin fechas';23/07/2010;'FARMACIA';'Gastos_Salud, saber y deporte';'Farmacia';'VARIABLES'
23/07/2010;23/07/2010;'FRANCE TELEC ORANGE MOVIL 0211';-97,05 €;14.702,01 €;476;-97,05;19.226,10 €;'sin fechas';23/07/2010;'FRANCE';'Gastos_Servicios tipicos';'Telecomunicaciones';'FIJO'
23/07/2010;23/07/2010;'TOCINERIES VENTURA';-33,32 €;14.668,69 €;477;-33,32;19.192,78 €;'sin fechas';23/07/2010;'TOCINERIES';'Gastos_Compras';'Supermercado';'VARIABLES'
23/07/2010;23/07/2010;'TOCINERIES VENTURA';-39,94 €;14.628,75 €;478;-39,94;19.152,84 €;'sin fechas';23/07/2010;'TOCINERIES';'Gastos_Compras';'Supermercado';'VARIABLES'
26/07/2010;26/07/2010;'BLANCO CAL`ATS';-24,00 €;14.604,75 €;479;-24,00;19.128,84 €;'sin fechas';26/07/2010;'BLANCO';'Gastos_Compras';'Ropa';'VARIABLES'
26/07/2010;26/07/2010;'EL CORTE INGLES';-50,00 €;14.554,75 €;480;-50,00;19.078,84 €;'sin fechas';26/07/2010;'CORTE';'Gastos_Compras';'Supermercado';'VARIABLES'
26/07/2010;26/07/2010;'EL CORTE INGLES';-11,50 €;14.543,25 €;481;-11,50;19.067,34 €;'sin fechas';26/07/2010;'CORTE';'Gastos_Compras';'Supermercado';'VARIABLES'
26/07/2010;26/07/2010;'ENDESA ENERG EE_XXI40025545678';-58,42 €;14.484,83 €;482;-58,42;19.008,92 €;'sin fechas';26/07/2010;'ENDESA';'Gastos_Servicios tipicos';'Electricidad';'FIJO'
26/07/2010;26/07/2010;'FARMACIA';-8,48 €;14.476,35 €;483;-8,48;19.000,44 €;'sin fechas';26/07/2010;'FARMACIA';'Gastos_Salud, saber y deporte';'Farmacia';'VARIABLES'
26/07/2010;26/07/2010;'PRIMARK';-52,50 €;14.423,85 €;484;-52,50;18.947,94 €;'sin fechas';26/07/2010;'PRIMARK';'Gastos_Compras';'Ropa';'VARIABLES'
27/07/2010;19/07/2010;'AUTOPISTA TERR';-5,05 €;14.418,80 €;485;-5,05;18.942,89 €;'sin fechas';19/07/2010;'AUTOPISTA';'Gastos_Ocio y transporte';'Parking y peaje';'VARIABLES'
27/07/2010;27/07/2010;'FARMACIA';-39,86 €;14.378,94 €;486;-39,86;18.903,03 €;'sin fechas';27/07/2010;'FARMACIA';'Gastos_Salud, saber y deporte';'Farmacia';'VARIABLES'
27/07/2010;28/07/2010;'INFORMACIO I TECNOLOGIA DE CAT';1.670,46 €;16.049,40 €;487;1.670,46;20.573,49 €;'sin fechas';28/07/2010;'INFORMACIO';'Ingresos';'Nomina';'FIJO'
27/07/2010;27/07/2010;'QUEVIURES MANUEL S';-23,15 €;16.026,25 €;488;-23,15;20.550,34 €;'sin fechas';27/07/2010;'QUEVIURES';'Gastos_Compras';'Supermercado';'VARIABLES'
28/07/2010;12/07/2010;'AUTOPISTA TERR';-1,20 €;16.025,05 €;489;-1,20;20.549,14 €;'sin fechas';12/07/2010;'AUTOPISTA';'Gastos_Ocio y transporte';'Parking y peaje';'VARIABLES'
28/07/2010;28/07/2010;'CAPRABO';-8,54 €;16.016,51 €;490;-8,54;20.540,60 €;'sin fechas';28/07/2010;'CAPRABO';'Gastos_Compras';'Supermercado';'VARIABLES'
28/07/2010;28/07/2010;'FRANCE TELEC ORANGE MOVIL 0211';-87,69 €;15.928,82 €;491;-87,69;20.452,91 €;'sin fechas';28/07/2010;'FRANCE';'Gastos_Servicios tipicos';'Telecomunicaciones';'FIJO'
29/07/2010;22/07/2010;'AUTOPISTA TERR';-1,00 €;15.927,82 €;492;-1,00;20.451,91 €;'sin fechas';22/07/2010;'AUTOPISTA';'Gastos_Ocio y transporte';'Parking y peaje';'VARIABLES'
29/07/2010;29/07/2010;'DIRECCION PROVINCIAL INSS BARC';2.360,13 €;18.287,95 €;493;2.360,13;22.812,04 €;'sin fechas';29/07/2010;'DIRECCION';'Ingresos';'Nomina';'FIJO'
30/07/2010;30/07/2010;'CEDIPSA HOSPIT\\HOSPITALET I';-33,36 €;18.254,59 €;494;-33,36;22.778,68 €;'sin fechas';30/07/2010;'CEDIPSA';'Gastos_Ocio y transporte';'Gasolina';'VARIABLES'
31/07/2010;31/07/2010;'COMISIONES';-0,34 €;18.254,25 €;495;-0,34;22.778,34 €;'sin fechas';31/07/2010;'COMISIONES';'Gastos_Banco y organismos';'Cargos banco';'FIJO'
01/08/2010;01/08/2010;'MANTENIMIENTO';-1,25 €;18.253,00 €;496;-1,25;22.777,09 €;'sin fechas';01/08/2010;'MANTENIMIENTO';'Gastos_Banco y organismos';'Cargos banco';'FIJO'
02/08/2010;02/08/2010;'AGBAR INSTALACIONES, S 1038842';-66,08 €;18.186,92 €;497;-66,08;22.711,01 €;'sin fechas';02/08/2010;'AGBAR';'Gastos_Servicios tipicos';'Agua';'FIJO'
02/08/2010;02/08/2010;'AJUNTAMENT DE TER 850000031046';-36,18 €;18.150,74 €;498;-36,18;22.674,83 €;'sin fechas';02/08/2010;'AJUNTAMENT';'Gastos_Banco y organismos';'Ayuntamiento';'FIJO'
02/08/2010;02/08/2010;'CIA.DE SEGUROS AD 006662671613';-34,17 €;18.116,57 €;499;-34,17;22.640,66 €;'sin fechas';02/08/2010;'CIADE';'Gastos_Salud, saber y deporte';'Medico';'VARIABLES'
02/08/2010;31/07/2010;'RECIBO PTMOS. 3061-0960001518';-646,19 €;17.470,38 €;500;-646,19;21.994,47 €;'sin fechas';31/07/2010;'RECIBO';'Gastos_Banco y organismos';'Hipoteca';'FIJO'
02/08/2010;31/07/2010;'RECIBO PTMOS. 3061-0960004140';-137,10 €;17.333,28 €;501;-137,10;21.857,37 €;'sin fechas';31/07/2010;'RECIBO';'Gastos_Banco y organismos';'Hipoteca';'FIJO'
03/08/2010;26/07/2010;'AUTOPISTA TERR';-2,75 €;17.330,53 €;502;-2,75;21.854,62 €;'sin fechas';26/07/2010;'AUTOPISTA';'Gastos_Ocio y transporte';'Parking y peaje';'VARIABLES'
03/08/2010;30/07/2010;'AUTOPISTA TERR';-5,30 €;17.325,23 €;503;-5,30;21.849,32 €;'sin fechas';30/07/2010;'AUTOPISTA';'Gastos_Ocio y transporte';'Parking y peaje';'VARIABLES'
03/08/2010;30/07/2010;'AUTOPISTA TERR';-3,50 €;17.321,73 €;504;-3,50;21.845,82 €;'sin fechas';30/07/2010;'AUTOPISTA';'Gastos_Ocio y transporte';'Parking y peaje';'VARIABLES'
03/08/2010;03/08/2010;'HOTEL MIRALLES\\HORTA DE SAN';-106,20 €;17.215,53 €;505;-106,20;21.739,62 €;'sin fechas';03/08/2010;'HOTEL';'Gastos_Ocio y transporte';'Vacaciones';'VARIABLES'
05/08/2010;05/08/2010;'CELLER CAL MENESCAL \\BOT';-28,65 €;17.186,88 €;506;-28,65;21.710,97 €;'sin fechas';05/08/2010;'CELLER';'Gastos_Ocio y transporte';'Restaurantes';'VARIABLES'
07/08/2010;07/08/2010;'CAPRABO';-22,89 €;17.163,99 €;507;-22,89;21.688,08 €;'sin fechas';07/08/2010;'CAPRABO';'Gastos_Compras';'Supermercado';'VARIABLES'
09/08/2010;30/07/2010;'AUTOPISTA TERR';-5,90 €;17.158,09 €;508;-5,90;21.682,18 €;'sin fechas';30/07/2010;'AUTOPISTA';'Gastos_Ocio y transporte';'Parking y peaje';'VARIABLES'
09/08/2010;09/08/2010;'CAFET.C T PRAT';-1,95 €;17.156,14 €;509;-1,95;21.680,23 €;'sin fechas';09/08/2010;'CAFETC';'Gastos_Ocio y transporte';'Restaurantes';'VARIABLES'
09/08/2010;09/08/2010;'E.S. RUBI II';-20,00 €;17.136,14 €;510;-20,00;21.660,23 €;'sin fechas';09/08/2010;'RUBI';'Gastos_Ocio y transporte';'Gasolina';'VARIABLES'
10/08/2010;10/08/2010;'AG.TRIBUT GABRIEL';2.500,00 €;19.636,14 €;511;2.500,00;24.160,23 €;'sin fechas';10/08/2010;'AGTRIBUT';'Ingresos';'Subvenciones';
10/08/2010;10/08/2010;'FARMACIA';-39,86 €;19.596,28 €;512;-39,86;24.120,37 €;'sin fechas';10/08/2010;'FARMACIA';'Gastos_Salud, saber y deporte';'Farmacia';'VARIABLES'
11/08/2010;11/08/2010;'AKI 104 - TERRASSA';-29,95 €;19.566,33 €;513;-29,95;24.090,42 €;'sin fechas';11/08/2010;'AKI';'Gastos_Vivienda y vehiculo';'Mnto. hogar';'VARIABLES'
11/08/2010;11/08/2010;'CAFET.C T PRAT';-1,65 €;19.564,68 €;514;-1,65;24.088,77 €;'sin fechas';11/08/2010;'CAFETC';'Gastos_Ocio y transporte';'Restaurantes';'VARIABLES'
11/08/2010;11/08/2010;'QUEVIURES MANUEL S';-18,95 €;19.545,73 €;515;-18,95;24.069,82 €;'sin fechas';11/08/2010;'QUEVIURES';'Gastos_Compras';'Supermercado';'VARIABLES'
12/08/2010;12/08/2010;'CAFET.C T PRAT';-2,75 €;19.542,98 €;516;-2,75;24.067,07 €;'sin fechas';12/08/2010;'CAFETC';'Gastos_Ocio y transporte';'Restaurantes';'VARIABLES'
12/08/2010;12/08/2010;'DIVAN RESTAURANT T';-24,70 €;19.518,28 €;517;-24,70;24.042,37 €;'sin fechas';12/08/2010;'DIVAN';'Gastos_Ocio y transporte';'Restaurantes';'VARIABLES'
12/08/2010;12/08/2010;'ES STA. MARGARITA';-42,00 €;19.476,28 €;518;-42,00;24.000,37 €;'sin fechas';12/08/2010;'STA';'Gastos_Ocio y transporte';'Gasolina';'VARIABLES'
12/08/2010;12/08/2010;'GAS NATURAL';-124,60 €;19.351,68 €;519;-124,60;23.875,77 €;'sin fechas';12/08/2010;'GAS';'Gastos_Servicios tipicos';'Gas';'FIJO'
12/08/2010;12/08/2010;'MERCADONA';-18,33 €;19.333,35 €;520;-18,33;23.857,44 €;'sin fechas';12/08/2010;'MERCADONA';'Gastos_Compras';'Supermercado';'VARIABLES'
12/08/2010;12/08/2010;'MERCADONA';-156,75 €;19.176,60 €;521;-156,75;23.700,69 €;'sin fechas';12/08/2010;'MERCADONA';'Gastos_Compras';'Supermercado';'VARIABLES'
13/08/2010;06/08/2010;'AUTOPISTA TERR';-3,50 €;19.173,10 €;522;-3,50;23.697,19 €;'sin fechas';06/08/2010;'AUTOPISTA';'Gastos_Ocio y transporte';'Parking y peaje';'VARIABLES'
13/08/2010;06/08/2010;'AUTOPISTA TERR';-5,30 €;19.167,80 €;523;-5,30;23.691,89 €;'sin fechas';06/08/2010;'AUTOPISTA';'Gastos_Ocio y transporte';'Parking y peaje';'VARIABLES'
13/08/2010;13/08/2010;'BRICOKING TERRASSA';-27,20 €;19.140,60 €;524;-27,20;23.664,69 €;'sin fechas';13/08/2010;'BRICOKING';'Gastos_Vivienda y vehiculo';'Mnto. hogar';'VARIABLES'
13/08/2010;13/08/2010;'CAFET.C T PRAT';-4,30 €;19.136,30 €;525;-4,30;23.660,39 €;'sin fechas';13/08/2010;'CAFETC';'Gastos_Ocio y transporte';'Restaurantes';'VARIABLES'
14/08/2010;14/08/2010;'CARREFOUR-[COMIDA]';-31,26 €;19.105,04 €;526;-31,26;23.629,13 €;'sin fechas';14/08/2010;'CARREFOURCOMIDA';'Gastos_Compras';'Supermercado';'VARIABLES'
16/08/2010;06/08/2010;'AUTOPISTA TERR';-5,90 €;19.099,14 €;527;-5,90;23.623,23 €;'sin fechas';06/08/2010;'AUTOPISTA';'Gastos_Ocio y transporte';'Parking y peaje';'VARIABLES'
16/08/2010;16/08/2010;'CAFET.C T PRAT';-2,25 €;19.096,89 €;528;-2,25;23.620,98 €;'sin fechas';16/08/2010;'CAFETC';'Gastos_Ocio y transporte';'Restaurantes';'VARIABLES'
16/08/2010;16/08/2010;'CCM VIDA Y P SEGURO PRESTAMO';-30,34 €;19.066,55 €;529;-30,34;23.590,64 €;'sin fechas';16/08/2010;'CCM';'Gastos_Seguros';'Seguro vida';'FIJO'
16/08/2010;16/08/2010;'CCM VIDA Y PENSIO 000000493358';-20,49 €;19.046,06 €;530;-20,49;23.570,15 €;'sin fechas';16/08/2010;'CCM';'Gastos_Seguros';'Seguro vida';'FIJO'
16/08/2010;16/08/2010;'ENDESA ENERG EE_XXI40025545678';-33,59 €;19.012,47 €;531;-33,59;23.536,56 €;'sin fechas';16/08/2010;'ENDESA';'Gastos_Servicios tipicos';'Electricidad';'FIJO'
17/08/2010;17/08/2010;'CAFET.C T PRAT';-3,35 €;19.009,12 €;532;-3,35;23.533,21 €;'sin fechas';17/08/2010;'CAFETC';'Gastos_Ocio y transporte';'Restaurantes';'VARIABLES'
17/08/2010;17/08/2010;'VIENA';-20,20 €;18.988,92 €;533;-20,20;23.513,01 €;'sin fechas';17/08/2010;'VIENA';'Gastos_Ocio y transporte';'Restaurantes';'VARIABLES'
18/08/2010;18/08/2010;'BOLIN SHIJIA, SCP';-28,10 €;18.960,82 €;534;-28,10;23.484,91 €;'sin fechas';18/08/2010;'BOLIN';'Gastos_Ocio y transporte';'Restaurantes';'VARIABLES'
18/08/2010;18/08/2010;'ONO';-92,86 €;18.867,96 €;535;-92,86;23.392,05 €;'sin fechas';18/08/2010;'ONO';'Gastos_Servicios tipicos';'Telecomunicaciones';'FIJO'
19/08/2010;19/08/2010;'CAFET.C T PRAT';-1,95 €;18.866,01 €;536;-1,95;23.390,10 €;'sin fechas';19/08/2010;'CAFETC';'Gastos_Ocio y transporte';'Restaurantes';'VARIABLES'
19/08/2010;19/08/2010;'CARREFOUR-[COMIDA]';-33,50 €;18.832,51 €;537;-33,50;23.356,60 €;'sin fechas';19/08/2010;'CARREFOURCOMIDA';'Gastos_Compras';'Supermercado';'VARIABLES'
19/08/2010;19/08/2010;'CARREFOUR-[COMIDA]';-57,50 €;18.775,01 €;538;-57,50;23.299,10 €;'sin fechas';19/08/2010;'CARREFOURCOMIDA';'Gastos_Compras';'Supermercado';'VARIABLES'
19/08/2010;19/08/2010;'JOHN\''S ITALIAN CAF';-30,67 €;18.744,34 €;539;-30,67;23.268,43 €;'sin fechas';19/08/2010;'JOHNS';'Gastos_Ocio y transporte';'Restaurantes';'VARIABLES'
20/08/2010;20/08/2010;'AG.TRIBUT GABRIEL';100,00 €;18.844,34 €;540;100,00;23.368,43 €;'sin fechas';20/08/2010;'AGTRIBUT';'Ingresos';'Subvenciones';
20/08/2010;20/08/2010;'AG.TRIBUT GABRIEL';100,00 €;18.944,34 €;541;100,00;23.468,43 €;'sin fechas';20/08/2010;'AGTRIBUT';'Ingresos';'Subvenciones';
20/08/2010;20/08/2010;'CAFET.C T PRAT';-3,35 €;18.940,99 €;542;-3,35;23.465,08 €;'sin fechas';20/08/2010;'CAFETC';'Gastos_Ocio y transporte';'Restaurantes';'VARIABLES'
20/08/2010;12/08/2010;'CATALANA DIAG.I CIRUR';-2,45 €;18.938,54 €;543;-2,45;23.462,63 €;'sin fechas';12/08/2010;'CATALANA';'Gastos_Ocio y transporte';'Parking y peaje';'VARIABLES'
20/08/2010;20/08/2010;'FRANCE TELEC ORANGE MOVIL 0211';-46,42 €;18.892,12 €;544;-46,42;23.416,21 €;'sin fechas';20/08/2010;'FRANCE';'Gastos_Servicios tipicos';'Telecomunicaciones';'FIJO'
21/08/2010;21/08/2010;'EROSKI-[COMIDA]';-118,85 €;18.773,27 €;545;-118,85;23.297,36 €;'sin fechas';21/08/2010;'EROSKICOMIDA';'Gastos_Compras';'Supermercado';'VARIABLES'
21/08/2010;21/08/2010;'FARMACIA';-47,61 €;18.725,66 €;546;-47,61;23.249,75 €;'sin fechas';21/08/2010;'FARMACIA';'Gastos_Salud, saber y deporte';'Farmacia';'VARIABLES'
23/08/2010;23/08/2010;'CAFET.C T PRAT';-3,50 €;18.722,16 €;547;-3,50;23.246,25 €;'sin fechas';23/08/2010;'CAFETC';'Gastos_Ocio y transporte';'Restaurantes';'VARIABLES'
23/08/2010;23/08/2010;'CAFET.C T PRAT';-2,55 €;18.719,61 €;548;-2,55;23.243,70 €;'sin fechas';23/08/2010;'CAFETC';'Gastos_Ocio y transporte';'Restaurantes';'VARIABLES'
24/08/2010;24/08/2010;'CAFET.C T PRAT';-3,00 €;18.716,61 €;549;-3,00;23.240,70 €;'sin fechas';24/08/2010;'CAFETC';'Gastos_Ocio y transporte';'Restaurantes';'VARIABLES'
24/08/2010;24/08/2010;'FRANCE TELEC ORANGE MOVIL 0211';-72,67 €;18.643,94 €;550;-72,67;23.168,03 €;'sin fechas';24/08/2010;'FRANCE';'Gastos_Servicios tipicos';'Telecomunicaciones';'FIJO'
25/08/2010;25/08/2010;'CAFET.C T PRAT';-3,00 €;18.640,94 €;551;-3,00;23.165,03 €;'sin fechas';25/08/2010;'CAFETC';'Gastos_Ocio y transporte';'Restaurantes';'VARIABLES'
25/08/2010;25/08/2010;'EROSKI-[COMIDA]';-147,69 €;18.493,25 €;552;-147,69;23.017,34 €;'sin fechas';25/08/2010;'EROSKICOMIDA';'Gastos_Compras';'Supermercado';'VARIABLES'
25/08/2010;25/08/2010;'ES STA. MARGARITA';-42,24 €;18.451,01 €;553;-42,24;22.975,10 €;'sin fechas';25/08/2010;'STA';'Gastos_Ocio y transporte';'Gasolina';'VARIABLES'
26/08/2010;26/08/2010;'C&A';-13,00 €;18.438,01 €;554;-13,00;22.962,10 €;'sin fechas';26/08/2010;'CA';'Gastos_Compras';'Ropa';'VARIABLES'
26/08/2010;26/08/2010;'CAFET.C T PRAT';-4,25 €;18.433,76 €;555;-4,25;22.957,85 €;'sin fechas';26/08/2010;'CAFETC';'Gastos_Ocio y transporte';'Restaurantes';'VARIABLES'
26/08/2010;26/08/2010;'CAFET.C T PRAT';-1,95 €;18.431,81 €;556;-1,95;22.955,90 €;'sin fechas';26/08/2010;'CAFETC';'Gastos_Ocio y transporte';'Restaurantes';'VARIABLES'
26/08/2010;26/08/2010;'DEICHMANN CALZ\\CORNELLA DE';-30,80 €;18.401,01 €;557;-30,80;22.925,10 €;'sin fechas';26/08/2010;'DEICHMANN';'Gastos_Compras';'Ropa';'VARIABLES'
26/08/2010;26/08/2010;'FF.CC.GENERALITAT';-21,60 €;18.379,41 €;558;-21,60;22.903,50 €;'sin fechas';26/08/2010;'FFCCGENERALITAT';'Gastos_Ocio y transporte';'Transporte';'VARIABLES'
26/08/2010;26/08/2010;'KIKO';-4,90 €;18.374,51 €;559;-4,90;22.898,60 €;'sin fechas';26/08/2010;'KIKO';'Gastos_Salud, saber y deporte';'Belleza';'VARIABLES'
26/08/2010;26/08/2010;'MERCADONA';-150,67 €;18.223,84 €;560;-150,67;22.747,93 €;'sin fechas';26/08/2010;'MERCADONA';'Gastos_Compras';'Supermercado';'VARIABLES'
26/08/2010;26/08/2010;'MUERDE LA PAST\\CORNELLA LLO';-35,65 €;18.188,19 €;561;-35,65;22.712,28 €;'sin fechas';26/08/2010;'MUERDE';'Gastos_Ocio y transporte';'Restaurantes';'VARIABLES'
26/08/2010;26/08/2010;'SPRINGFIELD \\RONDA';-19,95 €;18.168,24 €;562;-19,95;22.692,33 €;'sin fechas';26/08/2010;'SPRINGFIELD';'Gastos_Compras';'Ropa';'VARIABLES'
27/08/2010;27/08/2010;'CAFET.C T PRAT';-2,05 €;18.166,19 €;563;-2,05;22.690,28 €;'sin fechas';27/08/2010;'CAFETC';'Gastos_Ocio y transporte';'Restaurantes';'VARIABLES'
27/08/2010;27/08/2010;'FARMACIA';-14,82 €;18.151,37 €;564;-14,82;22.675,46 €;'sin fechas';27/08/2010;'FARMACIA';'Gastos_Salud, saber y deporte';'Farmacia';'VARIABLES'
27/08/2010;27/08/2010;'FARMACIA';-3,90 €;18.147,47 €;565;-3,90;22.671,56 €;'sin fechas';27/08/2010;'FARMACIA';'Gastos_Salud, saber y deporte';'Farmacia';'VARIABLES'
27/08/2010;27/08/2010;'FOMENT DE TERRASSA, S.A. FOMEN';633,27 €;18.780,74 €;566;633,27;23.304,83 €;'sin fechas';27/08/2010;'FOMENT';'Ingresos';'Nomina';'FIJO'
27/08/2010;30/08/2010;'INFORMACIO I TECNOLOGIA DE CAT';944,86 €;19.725,60 €;567;944,86;24.249,69 €;'sin fechas';30/08/2010;'INFORMACIO';'Ingresos';'Nomina';'FIJO'
27/08/2010;27/08/2010;'REINT.CAJERO';-60,00 €;19.665,60 €;568;-60,00;24.189,69 €;'sin fechas';27/08/2010;'REINTCAJERO';'Gastos_Gastos varios';'Efectivo';'VARIABLES'
27/08/2010;27/08/2010;'TALLER TERRASSA';-19,95 €;19.645,65 €;569;-19,95;24.169,74 €;'sin fechas';27/08/2010;'TALLER';'Gastos_Ocio y transporte';'Espectáculos';'VARIABLES'
27/08/2010;27/08/2010;'VIENA';-5,40 €;19.640,25 €;570;-5,40;24.164,34 €;'sin fechas';27/08/2010;'VIENA';'Gastos_Ocio y transporte';'Restaurantes';'VARIABLES'
28/08/2010;30/08/2010;'DIRECCION PROVINCIAL INSS BARC';2.360,13 €;22.000,38 €;571;2.360,13;26.524,47 €;'sin fechas';30/08/2010;'DIRECCION';'Ingresos';'Nomina';'FIJO'
30/08/2010;30/08/2010;'FARMACIA';-31,80 €;21.968,58 €;572;-31,80;26.492,67 €;'sin fechas';30/08/2010;'FARMACIA';'Gastos_Salud, saber y deporte';'Farmacia';'VARIABLES'
31/08/2010;31/08/2010;'RECIBO PTMOS. 3061-0960001518';-646,19 €;21.322,39 €;573;-646,19;25.846,48 €;'sin fechas';31/08/2010;'RECIBO';'Gastos_Banco y organismos';'Hipoteca';'FIJO'
31/08/2010;31/08/2010;'RECIBO PTMOS. 3061-0960004140';-137,10 €;21.185,29 €;574;-137,10;25.709,38 €;'sin fechas';31/08/2010;'RECIBO';'Gastos_Banco y organismos';'Hipoteca';'FIJO'
01/09/2010;01/09/2010;'BON AREA';-20,59 €;21.164,70 €;575;-20,59;25.688,79 €;'sin fechas';01/09/2010;'BON';'Gastos_Compras';'Supermercado';'VARIABLES'
01/09/2010;01/09/2010;'CIA.DE SEGUROS AD 006662671613';-136,68 €;21.028,02 €;576;-136,68;25.552,11 €;'sin fechas';01/09/2010;'CIADE';'Gastos_Salud, saber y deporte';'Medico';'VARIABLES'
01/09/2010;01/09/2010;'MANTENIMIENTO';-1,25 €;21.026,77 €;577;-1,25;25.550,86 €;'sin fechas';01/09/2010;'MANTENIMIENTO';'Gastos_Banco y organismos';'Cargos banco';'FIJO'
02/09/2010;02/09/2010;'CAFET.C T PRAT';-2,20 €;21.024,57 €;578;-2,20;25.548,66 €;'sin fechas';02/09/2010;'CAFETC';'Gastos_Ocio y transporte';'Restaurantes';'VARIABLES'
02/09/2010;02/09/2010;'FARMACIA';-24,68 €;20.999,89 €;579;-24,68;25.523,98 €;'sin fechas';02/09/2010;'FARMACIA';'Gastos_Salud, saber y deporte';'Farmacia';'VARIABLES'
03/09/2010;12/08/2010;'AUTOPISTA TERR';-0,15 €;20.999,74 €;580;-0,15;25.523,83 €;'sin fechas';12/08/2010;'AUTOPISTA';'Gastos_Ocio y transporte';'Parking y peaje';'VARIABLES'
03/09/2010;03/09/2010;'CAFET.C T PRAT';-3,20 €;20.996,54 €;581;-3,20;25.520,63 €;'sin fechas';03/09/2010;'CAFETC';'Gastos_Ocio y transporte';'Restaurantes';'VARIABLES'
04/09/2010;04/09/2010;'EROSKI-[COMIDA]';-44,81 €;20.951,73 €;582;-44,81;25.475,82 €;'sin fechas';04/09/2010;'EROSKICOMIDA';'Gastos_Compras';'Supermercado';'VARIABLES'
06/09/2010;06/09/2010;'CAFET.C T PRAT';-2,25 €;20.949,48 €;583;-2,25;25.473,57 €;'sin fechas';06/09/2010;'CAFETC';'Gastos_Ocio y transporte';'Restaurantes';'VARIABLES'
06/09/2010;06/09/2010;'CARREFOUR-[COMIDA]';-50,10 €;20.899,38 €;584;-50,10;25.423,47 €;'sin fechas';06/09/2010;'CARREFOURCOMIDA';'Gastos_Compras';'Supermercado';'VARIABLES'
07/09/2010;07/09/2010;'CAFET.C T PRAT';-3,35 €;20.896,03 €;585;-3,35;25.420,12 €;'sin fechas';07/09/2010;'CAFETC';'Gastos_Ocio y transporte';'Restaurantes';'VARIABLES'
07/09/2010;07/09/2010;'REINT.CAJERO';-60,00 €;20.836,03 €;586;-60,00;25.360,12 €;'sin fechas';07/09/2010;'REINTCAJERO';'Gastos_Gastos varios';'Efectivo';'VARIABLES'
08/09/2010;08/09/2010;'CAFET.C T PRAT';-3,35 €;20.832,68 €;587;-3,35;25.356,77 €;'sin fechas';08/09/2010;'CAFETC';'Gastos_Ocio y transporte';'Restaurantes';'VARIABLES'
08/09/2010;08/09/2010;'ES STA. MARGARITA';-46,08 €;20.786,60 €;588;-46,08;25.310,69 €;'sin fechas';08/09/2010;'STA';'Gastos_Ocio y transporte';'Gasolina';'VARIABLES'
08/09/2010;08/09/2010;'FARMACIA';-15,58 €;20.771,02 €;589;-15,58;25.295,11 €;'sin fechas';08/09/2010;'FARMACIA';'Gastos_Salud, saber y deporte';'Farmacia';'VARIABLES'
09/09/2010;09/09/2010;'FARMACIA';-40,49 €;20.730,53 €;590;-40,49;25.254,62 €;'sin fechas';09/09/2010;'FARMACIA';'Gastos_Salud, saber y deporte';'Farmacia';'VARIABLES'
10/09/2010;10/09/2010;'CAFET.C T PRAT';-3,00 €;20.727,53 €;591;-3,00;25.251,62 €;'sin fechas';10/09/2010;'CAFETC';'Gastos_Ocio y transporte';'Restaurantes';'VARIABLES'
10/09/2010;10/09/2010;'CAFET.C T PRAT';-2,80 €;20.724,73 €;592;-2,80;25.248,82 €;'sin fechas';10/09/2010;'CAFETC';'Gastos_Ocio y transporte';'Restaurantes';'VARIABLES'
13/09/2010;13/09/2010;'BON AREA';-12,68 €;20.712,05 €;593;-12,68;25.236,14 €;'sin fechas';13/09/2010;'BON';'Gastos_Compras';'Supermercado';'VARIABLES'
13/09/2010;13/09/2010;'CAFET.C T PRAT';-10,15 €;20.701,90 €;594;-10,15;25.225,99 €;'sin fechas';13/09/2010;'CAFETC';'Gastos_Ocio y transporte';'Restaurantes';'VARIABLES'
13/09/2010;13/09/2010;'FARMACIA';-13,04 €;20.688,86 €;595;-13,04;25.212,95 €;'sin fechas';13/09/2010;'FARMACIA';'Gastos_Salud, saber y deporte';'Farmacia';'VARIABLES'
14/09/2010;14/09/2010;'CAFET.C T PRAT';-1,65 €;20.687,21 €;596;-1,65;25.211,30 €;'sin fechas';14/09/2010;'CAFETC';'Gastos_Ocio y transporte';'Restaurantes';'VARIABLES'
14/09/2010;14/09/2010;'MERCADONA';-129,95 €;20.557,26 €;597;-129,95;25.081,35 €;'sin fechas';14/09/2010;'MERCADONA';'Gastos_Compras';'Supermercado';'VARIABLES'
15/09/2010;15/09/2010;'CAFET.C T PRAT';-1,90 €;20.555,36 €;598;-1,90;25.079,45 €;'sin fechas';15/09/2010;'CAFETC';'Gastos_Ocio y transporte';'Restaurantes';'VARIABLES'
15/09/2010;15/09/2010;'CCM VIDA Y P SEGURO PRESTAMO';-30,27 €;20.525,09 €;599;-30,27;25.049,18 €;'sin fechas';15/09/2010;'CCM';'Gastos_Seguros';'Seguro vida';'FIJO'
15/09/2010;15/09/2010;'CCM VIDA Y PENSIO 000000493358';-20,45 €;20.504,64 €;600;-20,45;25.028,73 €;'sin fechas';15/09/2010;'CCM';'Gastos_Seguros';'Seguro vida';'FIJO'
16/09/2010;16/09/2010;'AG.TRIBUT GABRIEL';100,00 €;20.604,64 €;601;100,00;25.128,73 €;'sin fechas';16/09/2010;'AGTRIBUT';'Ingresos';'Subvenciones';
16/09/2010;16/09/2010;'CAFET.C T PRAT';-3,35 €;20.601,29 €;602;-3,35;25.125,38 €;'sin fechas';16/09/2010;'CAFETC';'Gastos_Ocio y transporte';'Restaurantes';'VARIABLES'
17/09/2010;17/09/2010;'CAFET.C T PRAT';-2,35 €;20.598,94 €;603;-2,35;25.123,03 €;'sin fechas';17/09/2010;'CAFETC';'Gastos_Ocio y transporte';'Restaurantes';'VARIABLES'
18/09/2010;18/09/2010;'C&A';-115,00 €;20.483,94 €;604;-115,00;25.008,03 €;'sin fechas';18/09/2010;'CA';'Gastos_Compras';'Ropa';'VARIABLES'
20/09/2010;20/09/2010;'CAFET.C T PRAT';-11,00 €;20.472,94 €;605;-11,00;24.997,03 €;'sin fechas';20/09/2010;'CAFETC';'Gastos_Ocio y transporte';'Restaurantes';'VARIABLES'
20/09/2010;20/09/2010;'E.S. ESTEVE \\SUBIRANS';-15,00 €;20.457,94 €;606;-15,00;24.982,03 €;'sin fechas';20/09/2010;'ESTEVE';'Gastos_Ocio y transporte';'Gasolina';'VARIABLES'
20/09/2010;20/09/2010;'EROSKI-[COMIDA]';-70,30 €;20.387,64 €;607;-70,30;24.911,73 €;'sin fechas';20/09/2010;'EROSKICOMIDA';'Gastos_Compras';'Supermercado';'VARIABLES'
20/09/2010;20/09/2010;'ONO';-113,53 €;20.274,11 €;608;-113,53;24.798,20 €;'sin fechas';20/09/2010;'ONO';'Gastos_Servicios tipicos';'Telecomunicaciones';'FIJO'
21/09/2010;21/09/2010;'A.E.A.T. DEVOLUCIONES TRIBUTAR';1.031,78 €;21.305,89 €;609;1.031,78;25.829,98 €;'sin fechas';21/09/2010;'AEAT';'Ingresos';'Devoluciones';'VARIABLES'
21/09/2010;21/09/2010;'A.E.A.T. DEVOLUCIONES TRIBUTAR';492,35 €;21.798,24 €;610;492,35;26.322,33 €;'sin fechas';21/09/2010;'AEAT';'Ingresos';'Devoluciones';'VARIABLES'
21/09/2010;21/09/2010;'CAFET.C T PRAT';-1,65 €;21.796,59 €;611;-1,65;26.320,68 €;'sin fechas';21/09/2010;'CAFETC';'Gastos_Ocio y transporte';'Restaurantes';'VARIABLES'
21/09/2010;21/09/2010;'ENDESA ENERG EE_XXI40025545678';-82,26 €;21.714,33 €;612;-82,26;26.238,42 €;'sin fechas';21/09/2010;'ENDESA';'Gastos_Servicios tipicos';'Electricidad';'FIJO'
21/09/2010;21/09/2010;'FRANCE TELEC ORANGE MOVIL 0211';-16,93 €;21.697,40 €;613;-16,93;26.221,49 €;'sin fechas';21/09/2010;'FRANCE';'Gastos_Servicios tipicos';'Telecomunicaciones';'FIJO'
22/09/2010;22/09/2010;'CAFET.C T PRAT';-3,85 €;21.693,55 €;614;-3,85;26.217,64 €;'sin fechas';22/09/2010;'CAFETC';'Gastos_Ocio y transporte';'Restaurantes';'VARIABLES'
22/09/2010;22/09/2010;'ES STA. MARGARITA';-40,10 €;21.653,45 €;615;-40,10;26.177,54 €;'sin fechas';22/09/2010;'STA';'Gastos_Ocio y transporte';'Gasolina';'VARIABLES'
22/09/2010;22/09/2010;'H&M';-57,70 €;21.595,75 €;616;-57,70;26.119,84 €;'sin fechas';22/09/2010;'HM';'Gastos_Compras';'Ropa';'VARIABLES'
22/09/2010;22/09/2010;'INSIDE TARRASA \\TARRASA';-14,98 €;21.580,77 €;617;-14,98;26.104,86 €;'sin fechas';22/09/2010;'INSIDE';'Gastos_Compras';'Ropa';'VARIABLES'
22/09/2010;22/09/2010;'Z TERRASSA';-87,27 €;21.493,50 €;618;-87,27;26.017,59 €;'sin fechas';22/09/2010;'ZTERASSA';'Gastos_Compras';'Ropa';'VARIABLES'
23/09/2010;23/09/2010;'BURGUER KING';-15,00 €;21.478,50 €;619;-15,00;26.002,59 €;'sin fechas';23/09/2010;'BURGUER';'Gastos_Ocio y transporte';'Restaurantes';'VARIABLES'
23/09/2010;23/09/2010;'CAFET.C T PRAT';-2,05 €;21.476,45 €;620;-2,05;26.000,54 €;'sin fechas';23/09/2010;'CAFETC';'Gastos_Ocio y transporte';'Restaurantes';'VARIABLES'
23/09/2010;23/09/2010;'GRINZING';-13,90 €;21.462,55 €;621;-13,90;25.986,64 €;'sin fechas';23/09/2010;'GRINZING';'Gastos_Ocio y transporte';'Restaurantes';'VARIABLES'
23/09/2010;23/09/2010;'MINA PIBLICA AIGUES T.01A75789';-31,36 €;21.431,19 €;622;-31,36;25.955,28 €;'sin fechas';23/09/2010;'MINA';'Gastos_Servicios tipicos';'Agua';'FIJO'
24/09/2010;24/09/2010;'LIFECOLOR NASTA S.\\BADALONA';-309,50 €;21.121,69 €;623;-309,50;25.645,78 €;'sin fechas';24/09/2010;'LIFECOLOR';'Gastos_Compras';'Regalos';'VARIABLES'
24/09/2010;24/09/2010;'VIENA';-15,95 €;21.105,74 €;624;-15,95;25.629,83 €;'sin fechas';24/09/2010;'VIENA';'Gastos_Ocio y transporte';'Restaurantes';'VARIABLES'
24/09/2010;24/09/2010;'VIENA';-15,95 €;21.089,79 €;625;-15,95;25.613,88 €;'sin fechas';24/09/2010;'VIENA';'Gastos_Ocio y transporte';'Restaurantes';'VARIABLES'
24/09/2010;24/09/2010;'VIENA';-11,85 €;21.077,94 €;626;-11,85;25.602,03 €;'sin fechas';24/09/2010;'VIENA';'Gastos_Ocio y transporte';'Restaurantes';'VARIABLES'
25/09/2010;25/09/2010;'EROSKI-[COMIDA]';-16,70 €;21.061,24 €;627;-16,70;25.585,33 €;'sin fechas';25/09/2010;'EROSKICOMIDA';'Gastos_Compras';'Supermercado';'VARIABLES'
25/09/2010;25/09/2010;'EROSKI-[COMIDA]';-61,86 €;20.999,38 €;628;-61,86;25.523,47 €;'sin fechas';25/09/2010;'EROSKICOMIDA';'Gastos_Compras';'Supermercado';'VARIABLES'
25/09/2010;25/09/2010;'GRAN SIGLO -TERRAS';-28,15 €;20.971,23 €;629;-28,15;25.495,32 €;'sin fechas';25/09/2010;'GRAN';'Gastos_Ocio y transporte';'Restaurantes';'VARIABLES'
27/09/2010;27/09/2010;'CAFET.C T PRAT';-2,20 €;20.969,03 €;630;-2,20;25.493,12 €;'sin fechas';27/09/2010;'CAFETC';'Gastos_Ocio y transporte';'Restaurantes';'VARIABLES'
27/09/2010;27/09/2010;'FRANCE TELEC ORANGE MOVIL 0211';-73,17 €;20.895,86 €;631;-73,17;25.419,95 €;'sin fechas';27/09/2010;'FRANCE';'Gastos_Servicios tipicos';'Telecomunicaciones';'FIJO'
28/09/2010;28/09/2010;'CAFET.C T PRAT';-1,65 €;20.894,21 €;632;-1,65;25.418,30 €;'sin fechas';28/09/2010;'CAFETC';'Gastos_Ocio y transporte';'Restaurantes';'VARIABLES'
28/09/2010;28/09/2010;'DIVAN RESTAURANT T';-20,60 €;20.873,61 €;633;-20,60;25.397,70 €;'sin fechas';28/09/2010;'DIVAN';'Gastos_Ocio y transporte';'Restaurantes';'VARIABLES'
28/09/2010;28/09/2010;'H&M';-41,70 €;20.831,91 €;634;-41,70;25.356,00 €;'sin fechas';28/09/2010;'HM';'Gastos_Compras';'Ropa';'VARIABLES'
28/09/2010;29/09/2010;'INFORMACIO I TECNOLOGIA DE CAT';1.699,93 €;22.531,84 €;635;1.699,93;27.055,93 €;'sin fechas';29/09/2010;'INFORMACIO';'Ingresos';'Nomina';'FIJO'
28/09/2010;28/09/2010;'MERCADONA';-42,00 €;22.489,84 €;636;-42,00;27.013,93 €;'sin fechas';28/09/2010;'MERCADONA';'Gastos_Compras';'Supermercado';'VARIABLES'
29/09/2010;29/09/2010;'DIRECCION PROVINCIAL INSS BARC';2.278,97 €;24.768,81 €;637;2.278,97;29.292,90 €;'sin fechas';29/09/2010;'DIRECCION';'Ingresos';'Nomina';'FIJO'
30/09/2010;30/09/2010;'CAFET.C T PRAT';-3,35 €;24.765,46 €;638;-3,35;29.289,55 €;'sin fechas';30/09/2010;'CAFETC';'Gastos_Ocio y transporte';'Restaurantes';'VARIABLES'
30/09/2010;30/09/2010;'RECIBO PTMOS. 3061-0960001518';-646,19 €;24.119,27 €;639;-646,19;28.643,36 €;'sin fechas';30/09/2010;'RECIBO';'Gastos_Banco y organismos';'Hipoteca';'FIJO'
30/09/2010;30/09/2010;'RECIBO PTMOS. 3061-0960004140';-137,10 €;23.982,17 €;640;-137,10;28.506,26 €;'sin fechas';30/09/2010;'RECIBO';'Gastos_Banco y organismos';'Hipoteca';'FIJO'
01/10/2010;01/10/2010;'AJUNTAMENT DE TER 010000520716';-37,18 €;23.944,99 €;641;-37,18;28.469,08 €;'sin fechas';01/10/2010;'AJUNTAMENT';'Gastos_Banco y organismos';'Ayuntamiento';'FIJO'
01/10/2010;01/10/2010;'CAFET.C T PRAT';-2,35 €;23.942,64 €;642;-2,35;28.466,73 €;'sin fechas';01/10/2010;'CAFETC';'Gastos_Ocio y transporte';'Restaurantes';'VARIABLES'
01/10/2010;01/10/2010;'CIA.DE SEGUROS AD 006662671613';-68,34 €;23.874,30 €;643;-68,34;28.398,39 €;'sin fechas';01/10/2010;'CIADE';'Gastos_Salud, saber y deporte';'Medico';'VARIABLES'
01/10/2010;01/10/2010;'LET\''S WOK';-20,85 €;23.853,45 €;644;-20,85;28.377,54 €;'sin fechas';01/10/2010;'LETS';'Gastos_Ocio y transporte';'Restaurantes';'VARIABLES'
01/10/2010;01/10/2010;'MANTENIMIENTO';-1,25 €;23.852,20 €;645;-1,25;28.376,29 €;'sin fechas';01/10/2010;'MANTENIMIENTO';'Gastos_Banco y organismos';'Cargos banco';'FIJO'
04/10/2010;04/10/2010;'CAFET.C T PRAT';-3,30 €;23.848,90 €;646;-3,30;28.372,99 €;'sin fechas';04/10/2010;'CAFETC';'Gastos_Ocio y transporte';'Restaurantes';'VARIABLES'
05/10/2010;28/09/2010;'AUTOPISTA TERR';-1,95 €;23.846,95 €;647;-1,95;28.371,04 €;'sin fechas';28/09/2010;'AUTOPISTA';'Gastos_Ocio y transporte';'Parking y peaje';'VARIABLES'
05/10/2010;05/10/2010;'BON AREA';-24,35 €;23.822,60 €;648;-24,35;28.346,69 €;'sin fechas';05/10/2010;'BON';'Gastos_Compras';'Supermercado';'VARIABLES'
05/10/2010;05/10/2010;'CAFET.C T PRAT';-3,45 €;23.819,15 €;649;-3,45;28.343,24 €;'sin fechas';05/10/2010;'CAFETC';'Gastos_Ocio y transporte';'Restaurantes';'VARIABLES'
05/10/2010;05/10/2010;'COM. MANT. ACTIVAS DE LIQ.';-15,00 €;23.804,15 €;650;-15,00;28.328,24 €;'sin fechas';05/10/2010;'COM';'Gastos_Banco y organismos';'Cargos banco';'FIJO'
05/10/2010;05/10/2010;'IMP.RET.A CTA';-0,25 €;23.803,90 €;651;-0,25;28.327,99 €;'sin fechas';05/10/2010;'IMPRETA';'Gastos_Banco y organismos';'Impuestos';'FIJO'
05/10/2010;05/10/2010;'INTERESES';1,29 €;23.805,19 €;652;1,29;28.329,28 €;'sin fechas';05/10/2010;'INTERESES';'Ingresos';'Rendimientos';
05/10/2010;05/10/2010;'RODELAS PERRUQUERS';-13,50 €;23.791,69 €;653;-13,50;28.315,78 €;'sin fechas';05/10/2010;'RODELAS';'Gastos_Salud, saber y deporte';'Belleza';'VARIABLES'
05/10/2010;05/10/2010;'SEGUROS CATALANA';-287,22 €;23.504,47 €;654;-287,22;28.028,56 €;'sin fechas';05/10/2010;'CATALANA';'Gastos_Ocio y transporte';'Parking y peaje';'VARIABLES'
06/10/2010;06/10/2010;'CAFET.C T PRAT';-10,15 €;23.494,32 €;655;-10,15;28.018,41 €;'sin fechas';06/10/2010;'CAFETC';'Gastos_Ocio y transporte';'Restaurantes';'VARIABLES'
06/10/2010;06/10/2010;'FARMACIA';-30,97 €;23.463,35 €;656;-30,97;27.987,44 €;'sin fechas';06/10/2010;'FARMACIA';'Gastos_Salud, saber y deporte';'Farmacia';'VARIABLES'
06/10/2010;07/10/2010;'COMUNIDAD Pago 4-3 de Enero a Diciembre';-240,00 €;23.223,35 €;657;-240,00;27.747,44 €;'sin fechas';07/10/2010;'COMUNIDAD';'Gastos_Vivienda y vehiculo';'Comunidad';'FIJO'
06/10/2010;07/10/2010;'Parking Abr,May,Jun,Jul,Ago y';-360,00 €;22.863,35 €;658;-360,00;27.387,44 €;'sin fechas';07/10/2010;'PARKING';'Gastos_Ocio y transporte';'Parking y peaje';'VARIABLES'
07/10/2010;07/10/2010;'TRANSCARGO 3061.1990014513 00001';-19.000,00 €;3.863,35 €;659;-19.000,00;8.387,44 €;'sin fechas';07/10/2010;'TRANSCARGO';'Gastos_Gastos varios';'Transferencias';'VARIABLES'
07/10/2010;07/10/2010;'CAFET.C T PRAT';-1,65 €;3.861,70 €;660;-1,65;8.385,79 €;'sin fechas';07/10/2010;'CAFETC';'Gastos_Ocio y transporte';'Restaurantes';'VARIABLES'
07/10/2010;07/10/2010;'DIETISTA';-88,00 €;3.773,70 €;661;-88,00;8.297,79 €;'sin fechas';07/10/2010;'DIETISTA';'Gastos_Salud, saber y deporte';'Otros Salud';'VARIABLES'
07/10/2010;07/10/2010;'ES STA. MARGARITA';-43,33 €;3.730,37 €;662;-43,33;8.254,46 €;'sin fechas';07/10/2010;'STA';'Gastos_Ocio y transporte';'Gasolina';'VARIABLES'
07/10/2010;07/10/2010;'MESON EL CORTI\\EL PRAT DE L';-10,50 €;3.719,87 €;663;-10,50;8.243,96 €;'sin fechas';07/10/2010;'MESON';'Gastos_Ocio y transporte';'Restaurantes';'VARIABLES'
07/10/2010;07/10/2010;'REINT.CAJERO';-12,00 €;3.707,87 €;664;-12,00;8.231,96 €;'sin fechas';07/10/2010;'REINTCAJERO';'Gastos_Gastos varios';'Efectivo';'VARIABLES'
08/10/2010;08/10/2010;'CAFET.C T PRAT';-1,10 €;3.706,77 €;665;-1,10;8.230,86 €;'sin fechas';08/10/2010;'CAFETC';'Gastos_Ocio y transporte';'Restaurantes';'VARIABLES'
08/10/2010;08/10/2010;'EROSKI-[COMIDA]';-79,40 €;3.627,37 €;666;-79,40;8.151,46 €;'sin fechas';08/10/2010;'EROSKICOMIDA';'Gastos_Compras';'Supermercado';'VARIABLES'
11/10/2010;11/10/2010;'GAS NATURAL';-131,20 €;3.496,17 €;667;-131,20;8.020,26 €;'sin fechas';11/10/2010;'GAS';'Gastos_Servicios tipicos';'Gas';'FIJO'
11/10/2010;11/10/2010;'MEDIA MARKT';-99,00 €;3.397,17 €;668;-99,00;7.921,26 €;'sin fechas';11/10/2010;'MEDIA';'Gastos_Compras';'Hobbys';'VARIABLES'
11/10/2010;11/10/2010;'MERCADONA';-8,75 €;3.388,42 €;669;-8,75;7.912,51 €;'sin fechas';11/10/2010;'MERCADONA';'Gastos_Compras';'Supermercado';'VARIABLES'
11/10/2010;11/10/2010;'RESTAURANTES';-34,66 €;3.353,76 €;670;-34,66;7.877,85 €;'sin fechas';11/10/2010;'RESTAURANTES';'Gastos_Ocio y transporte';'Restaurantes';'VARIABLES'
13/10/2010;13/10/2010;'ALCAMPO';-71,96 €;3.281,80 €;671;-71,96;7.805,89 €;'sin fechas';13/10/2010;'ALCAMPO';'Gastos_Compras';'Supermercado';'VARIABLES'
13/10/2010;13/10/2010;'ALCAMPO';-77,69 €;3.204,11 €;672;-77,69;7.728,20 €;'sin fechas';13/10/2010;'ALCAMPO';'Gastos_Compras';'Supermercado';'VARIABLES'
13/10/2010;13/10/2010;'CAFET.C T PRAT';-2,35 €;3.201,76 €;673;-2,35;7.725,85 €;'sin fechas';13/10/2010;'CAFETC';'Gastos_Ocio y transporte';'Restaurantes';'VARIABLES'
13/10/2010;13/10/2010;'FLUNCH';-23,55 €;3.178,21 €;674;-23,55;7.702,30 €;'sin fechas';13/10/2010;'FLUNCH';'Gastos_Ocio y transporte';'Restaurantes';'VARIABLES'
14/10/2010;14/10/2010;'CAFET.C T PRAT';-1,10 €;3.177,11 €;675;-1,10;7.701,20 €;'sin fechas';14/10/2010;'CAFETC';'Gastos_Ocio y transporte';'Restaurantes';'VARIABLES'
14/10/2010;13/10/2010;'COMISIONES';-15,00 €;3.162,11 €;676;-15,00;7.686,20 €;'sin fechas';13/10/2010;'COMISIONES';'Gastos_Banco y organismos';'Cargos banco';'FIJO'
15/10/2010;15/10/2010;'BON AREA';-25,60 €;3.136,51 €;677;-25,60;7.660,60 €;'sin fechas';15/10/2010;'BON';'Gastos_Compras';'Supermercado';'VARIABLES'
15/10/2010;15/10/2010;'CAFET.C T PRAT';-3,65 €;3.132,86 €;678;-3,65;7.656,95 €;'sin fechas';15/10/2010;'CAFETC';'Gastos_Ocio y transporte';'Restaurantes';'VARIABLES'
15/10/2010;15/10/2010;'CCM VIDA Y P SEGURO PRESTAMO';-30,19 €;3.102,67 €;679;-30,19;7.626,76 €;'sin fechas';15/10/2010;'CCM';'Gastos_Seguros';'Seguro vida';'FIJO'
15/10/2010;15/10/2010;'CCM VIDA Y PENSIO 000000493358';-20,40 €;3.082,27 €;680;-20,40;7.606,36 €;'sin fechas';15/10/2010;'CCM';'Gastos_Seguros';'Seguro vida';'FIJO'
16/10/2010;16/10/2010;'ALCAMPO';-24,01 €;3.058,26 €;681;-24,01;7.582,35 €;'sin fechas';16/10/2010;'ALCAMPO';'Gastos_Compras';'Supermercado';'VARIABLES'
16/10/2010;16/10/2010;'KIABI';-71,44 €;2.986,82 €;682;-71,44;7.510,91 €;'sin fechas';16/10/2010;'KIABI';'Gastos_Compras';'Ropa';'VARIABLES'
16/10/2010;16/10/2010;'KIDDY S CLASS\\SANT BOI DE L';-17,85 €;2.968,97 €;683;-17,85;7.493,06 €;'sin fechas';16/10/2010;'KIDDY';'Gastos_Compras';'Ropa';'VARIABLES'
17/10/2010;17/10/2010;'ES STA. MARGARITA';-32,19 €;2.936,78 €;684;-32,19;7.460,87 €;'sin fechas';17/10/2010;'STA';'Gastos_Ocio y transporte';'Gasolina';'VARIABLES'
17/10/2010;17/10/2010;'REINT.CAJERO';-100,00 €;2.836,78 €;685;-100,00;7.360,87 €;'sin fechas';17/10/2010;'REINTCAJERO';'Gastos_Gastos varios';'Efectivo';'VARIABLES'
18/10/2010;18/10/2010;'CAFET.C T PRAT';-6,15 €;2.830,63 €;686;-6,15;7.354,72 €;'sin fechas';18/10/2010;'CAFETC';'Gastos_Ocio y transporte';'Restaurantes';'VARIABLES'
18/10/2010;18/10/2010;'TOYOTA ORIENT CARS';-222,97 €;2.607,66 €;687;-222,97;7.131,75 €;'sin fechas';18/10/2010;'TOYOTA';'Gastos_Vivienda y vehiculo';'Mnto. vehiculo';'VARIABLE'
19/10/2010;11/10/2010;'AUTOPISTA TERR';-2,00 €;2.605,66 €;688;-2,00;7.129,75 €;'sin fechas';11/10/2010;'AUTOPISTA';'Gastos_Ocio y transporte';'Parking y peaje';'VARIABLES'
19/10/2010;19/10/2010;'ONO';-111,04 €;2.494,62 €;689;-111,04;7.018,71 €;'sin fechas';19/10/2010;'ONO';'Gastos_Servicios tipicos';'Telecomunicaciones';'FIJO'
20/10/2010;20/10/2010;'FARMACIA';-10,54 €;2.484,08 €;690;-10,54;7.008,17 €;'sin fechas';20/10/2010;'FARMACIA';'Gastos_Salud, saber y deporte';'Farmacia';'VARIABLES'
20/10/2010;20/10/2010;'REINT.CAJERO';-100,00 €;2.384,08 €;691;-100,00;6.908,17 €;'sin fechas';20/10/2010;'REINTCAJERO';'Gastos_Gastos varios';'Efectivo';'VARIABLES'
21/10/2010;21/10/2010;'CAFET.C T PRAT';-3,50 €;2.380,58 €;692;-3,50;6.904,67 €;'sin fechas';21/10/2010;'CAFETC';'Gastos_Ocio y transporte';'Restaurantes';'VARIABLES'
21/10/2010;21/10/2010;'CAPRABO';-61,18 €;2.319,40 €;693;-61,18;6.843,49 €;'sin fechas';21/10/2010;'CAPRABO';'Gastos_Compras';'Supermercado';'VARIABLES'
22/10/2010;22/10/2010;'AG.TRIBUT GABRIEL';100,00 €;2.419,40 €;694;100,00;6.943,49 €;'sin fechas';22/10/2010;'AGTRIBUT';'Ingresos';'Subvenciones';
22/10/2010;22/10/2010;'BON AREA';-23,27 €;2.396,13 €;695;-23,27;6.920,22 €;'sin fechas';22/10/2010;'BON';'Gastos_Compras';'Supermercado';'VARIABLES'
22/10/2010;22/10/2010;'CAFET.C T PRAT';-3,65 €;2.392,48 €;696;-3,65;6.916,57 €;'sin fechas';22/10/2010;'CAFETC';'Gastos_Ocio y transporte';'Restaurantes';'VARIABLES'
22/10/2010;22/10/2010;'ENDESA ENERG EE_XXI40025545678';-42,54 €;2.349,94 €;697;-42,54;6.874,03 €;'sin fechas';22/10/2010;'ENDESA';'Gastos_Servicios tipicos';'Electricidad';'FIJO'
22/10/2010;22/10/2010;'FRANCE TELEC ORANGE MOVIL 0211';-25,50 €;2.324,44 €;698;-25,50;6.848,53 €;'sin fechas';22/10/2010;'FRANCE';'Gastos_Servicios tipicos';'Telecomunicaciones';'FIJO'
25/10/2010;25/10/2010;'CAFET.C T PRAT';-1,90 €;2.322,54 €;699;-1,90;6.846,63 €;'sin fechas';25/10/2010;'CAFETC';'Gastos_Ocio y transporte';'Restaurantes';'VARIABLES'
25/10/2010;25/10/2010;'DIETISTA';-60,00 €;2.262,54 €;700;-60,00;6.786,63 €;'sin fechas';25/10/2010;'DIETISTA';'Gastos_Salud, saber y deporte';'Otros Salud';'VARIABLES'
25/10/2010;25/10/2010;'METRO BARCELONA';-7,95 €;2.254,59 €;701;-7,95;6.778,68 €;'sin fechas';25/10/2010;'METRO';'Gastos_Ocio y transporte';'Transporte';'VARIABLES'
25/10/2010;25/10/2010;'REINT.CAJERO';-40,00 €;2.214,59 €;702;-40,00;6.738,68 €;'sin fechas';25/10/2010;'REINTCAJERO';'Gastos_Gastos varios';'Efectivo';'VARIABLES'
26/10/2010;11/10/2010;'AUTOPISTA TERR';-2,10 €;2.212,49 €;703;-2,10;6.736,58 €;'sin fechas';11/10/2010;'AUTOPISTA';'Gastos_Ocio y transporte';'Parking y peaje';'VARIABLES'
26/10/2010;26/10/2010;'CAFET.C T PRAT';-2,55 €;2.209,94 €;704;-2,55;6.734,03 €;'sin fechas';26/10/2010;'CAFETC';'Gastos_Ocio y transporte';'Restaurantes';'VARIABLES'
26/10/2010;26/10/2010;'IKEA';-86,04 €;2.123,90 €;705;-86,04;6.647,99 €;'sin fechas';26/10/2010;'IKEA';'Gastos_Vivienda y vehiculo';'Mnto. hogar';'VARIABLES'
27/10/2010;27/10/2010;'CAFET.C T PRAT';-3,50 €;2.120,40 €;706;-3,50;6.644,49 €;'sin fechas';27/10/2010;'CAFETC';'Gastos_Ocio y transporte';'Restaurantes';'VARIABLES'
27/10/2010;27/10/2010;'CAFET.C T PRAT';-1,20 €;2.119,20 €;707;-1,20;6.643,29 €;'sin fechas';27/10/2010;'CAFETC';'Gastos_Ocio y transporte';'Restaurantes';'VARIABLES'
27/10/2010;28/10/2010;'INFORMACIO I TECNOLOGIA DE CAT';1.539,58 €;3.658,78 €;708;1.539,58;8.182,87 €;'sin fechas';28/10/2010;'INFORMACIO';'Ingresos';'Nomina';'FIJO'
27/10/2010;27/10/2010;'MERCADONA';-179,27 €;3.479,51 €;709;-179,27;8.003,60 €;'sin fechas';27/10/2010;'MERCADONA';'Gastos_Compras';'Supermercado';'VARIABLES'
28/10/2010;28/10/2010;'BABAK INK';-14,90 €;3.464,61 €;710;-14,90;7.988,70 €;'sin fechas';28/10/2010;'BABAK';'Gastos_Compras';'Ropa';'VARIABLES'
28/10/2010;28/10/2010;'CAFET.C T PRAT';-1,15 €;3.463,46 €;711;-1,15;7.987,55 €;'sin fechas';28/10/2010;'CAFETC';'Gastos_Ocio y transporte';'Restaurantes';'VARIABLES'
28/10/2010;28/10/2010;'EROSKI-[COMIDA]';-58,61 €;3.404,85 €;712;-58,61;7.928,94 €;'sin fechas';28/10/2010;'EROSKICOMIDA';'Gastos_Compras';'Supermercado';'VARIABLES'
28/10/2010;28/10/2010;'ES STA. MARGARITA';-46,40 €;3.358,45 €;713;-46,40;7.882,54 €;'sin fechas';28/10/2010;'STA';'Gastos_Ocio y transporte';'Gasolina';'VARIABLES'
28/10/2010;28/10/2010;'FOMENT DE TERRASSA, S.A. FOMEN';518,64 €;3.877,09 €;714;518,64;8.401,18 €;'sin fechas';28/10/2010;'FOMENT';'Ingresos';'Nomina';'FIJO'
28/10/2010;28/10/2010;'FRANCE TELEC ORANGE MOVIL 0211';-18,00 €;3.859,09 €;715;-18,00;8.383,18 €;'sin fechas';28/10/2010;'FRANCE';'Gastos_Servicios tipicos';'Telecomunicaciones';'FIJO'
29/10/2010;29/10/2010;'CAFET.C T PRAT';-1,45 €;3.857,64 €;716;-1,45;8.381,73 €;'sin fechas';29/10/2010;'CAFETC';'Gastos_Ocio y transporte';'Restaurantes';'VARIABLES'
29/10/2010;29/10/2010;'DIRECCION PROVINCIAL INSS BARC';1.443,35 €;5.300,99 €;717;1.443,35;9.825,08 €;'sin fechas';29/10/2010;'DIRECCION';'Ingresos';'Nomina';'FIJO'
30/10/2010;30/10/2010;'ALCAMPO';-24,86 €;5.276,13 €;718;-24,86;9.800,22 €;'sin fechas';30/10/2010;'ALCAMPO';'Gastos_Compras';'Supermercado';'VARIABLES'
30/10/2010;30/10/2010;'FARMACIA';-15,67 €;5.260,46 €;719;-15,67;9.784,55 €;'sin fechas';30/10/2010;'FARMACIA';'Gastos_Salud, saber y deporte';'Farmacia';'VARIABLES'
30/10/2010;30/10/2010;'FARMACIA';-22,56 €;5.237,90 €;720;-22,56;9.761,99 €;'sin fechas';30/10/2010;'FARMACIA';'Gastos_Salud, saber y deporte';'Farmacia';'VARIABLES'
30/10/2010;30/10/2010;'IT STYLE DIAGONAL';-17,90 €;5.220,00 €;721;-17,90;9.744,09 €;'sin fechas';30/10/2010;'STYLE';'Gastos_Compras';'Ropa';'VARIABLES'
30/10/2010;30/10/2010;'PEIXOS POVILL \\MONISTROL DE';-68,98 €;5.151,02 €;722;-68,98;9.675,11 €;'sin fechas';30/10/2010;'PEIXOS';'Gastos_Compras';'Supermercado';'VARIABLES'
30/10/2010;30/10/2010;'RESTAURANTES';-38,44 €;5.112,58 €;723;-38,44;9.636,67 €;'sin fechas';30/10/2010;'RESTAURANTES';'Gastos_Ocio y transporte';'Restaurantes';'VARIABLES'
01/11/2010;01/11/2010;'MANTENIMIENTO';-1,25 €;5.111,33 €;724;-1,25;9.635,42 €;'sin fechas';01/11/2010;'MANTENIMIENTO';'Gastos_Banco y organismos';'Cargos banco';'FIJO'
02/11/2010;02/11/2010;'CAFET.C T PRAT';-4,25 €;5.107,08 €;725;-4,25;9.631,17 €;'sin fechas';02/11/2010;'CAFETC';'Gastos_Ocio y transporte';'Restaurantes';'VARIABLES'
02/11/2010;02/11/2010;'CAFET.C T PRAT';-1,20 €;5.105,88 €;726;-1,20;9.629,97 €;'sin fechas';02/11/2010;'CAFETC';'Gastos_Ocio y transporte';'Restaurantes';'VARIABLES'
02/11/2010;02/11/2010;'CIA.DE SEGUROS AD 006662671613';-68,34 €;5.037,54 €;727;-68,34;9.561,63 €;'sin fechas';02/11/2010;'CIADE';'Gastos_Salud, saber y deporte';'Medico';'VARIABLES'
02/11/2010;31/10/2010;'RECIBO PTMOS. 3061-0960001518';-646,19 €;4.391,35 €;728;-646,19;8.915,44 €;'sin fechas';31/10/2010;'RECIBO';'Gastos_Banco y organismos';'Hipoteca';'FIJO'
02/11/2010;31/10/2010;'RECIBO PTMOS. 3061-0960004140';-137,10 €;4.254,25 €;729;-137,10;8.778,34 €;'sin fechas';31/10/2010;'RECIBO';'Gastos_Banco y organismos';'Hipoteca';'FIJO'
03/11/2010;28/10/2010;'AUTOPISTA TERR';-1,80 €;4.252,45 €;730;-1,80;8.776,54 €;'sin fechas';28/10/2010;'AUTOPISTA';'Gastos_Ocio y transporte';'Parking y peaje';'VARIABLES'
03/11/2010;03/11/2010;'CAFET.C T PRAT';-1,45 €;4.251,00 €;731;-1,45;8.775,09 €;'sin fechas';03/11/2010;'CAFETC';'Gastos_Ocio y transporte';'Restaurantes';'VARIABLES'
04/11/2010;04/11/2010;'DIETISTA';-60,00 €;4.191,00 €;732;-60,00;8.715,09 €;'sin fechas';04/11/2010;'DIETISTA';'Gastos_Salud, saber y deporte';'Otros Salud';'VARIABLES'
04/11/2010;04/11/2010;'FF.CC.GENERALITAT';-21,60 €;4.169,40 €;733;-21,60;8.693,49 €;'sin fechas';04/11/2010;'FFCCGENERALITAT';'Gastos_Ocio y transporte';'Transporte';'VARIABLES'
04/11/2010;04/11/2010;'REINT.CAJERO';-40,00 €;4.129,40 €;734;-40,00;8.653,49 €;'sin fechas';04/11/2010;'REINTCAJERO';'Gastos_Gastos varios';'Efectivo';'VARIABLES'
05/11/2010;05/11/2010;'CAFET.C T PRAT';-1,15 €;4.128,25 €;735;-1,15;8.652,34 €;'sin fechas';05/11/2010;'CAFETC';'Gastos_Ocio y transporte';'Restaurantes';'VARIABLES'
06/11/2010;06/11/2010;'EROSKI-[COMIDA]';-33,29 €;4.094,96 €;736;-33,29;8.619,05 €;'sin fechas';06/11/2010;'EROSKICOMIDA';'Gastos_Compras';'Supermercado';'VARIABLES'
06/11/2010;06/11/2010;'EROSKI-[COMIDA]';-78,97 €;4.015,99 €;737;-78,97;8.540,08 €;'sin fechas';06/11/2010;'EROSKICOMIDA';'Gastos_Compras';'Supermercado';'VARIABLES'
06/11/2010;06/11/2010;'FARMACIA';-23,42 €;3.992,57 €;738;-23,42;8.516,66 €;'sin fechas';06/11/2010;'FARMACIA';'Gastos_Salud, saber y deporte';'Farmacia';'VARIABLES'
08/11/2010;08/11/2010;'CAFET.C T PRAT';-4,95 €;3.987,62 €;739;-4,95;8.511,71 €;'sin fechas';08/11/2010;'CAFETC';'Gastos_Ocio y transporte';'Restaurantes';'VARIABLES'
09/11/2010;31/10/2010;'AUTOPISTA TERR';-3,50 €;3.984,12 €;740;-3,50;8.508,21 €;'sin fechas';31/10/2010;'AUTOPISTA';'Gastos_Ocio y transporte';'Parking y peaje';'VARIABLES'
09/11/2010;31/10/2010;'AUTOPISTA TERR';-3,50 €;3.980,62 €;741;-3,50;8.504,71 €;'sin fechas';31/10/2010;'AUTOPISTA';'Gastos_Ocio y transporte';'Parking y peaje';'VARIABLES'
09/11/2010;09/11/2010;'CAFET.C T PRAT';-1,45 €;3.979,17 €;742;-1,45;8.503,26 €;'sin fechas';09/11/2010;'CAFETC';'Gastos_Ocio y transporte';'Restaurantes';'VARIABLES'
10/11/2010;10/11/2010;'CAFET.C T PRAT';-1,15 €;3.978,02 €;743;-1,15;8.502,11 €;'sin fechas';10/11/2010;'CAFETC';'Gastos_Ocio y transporte';'Restaurantes';'VARIABLES'
10/11/2010;10/11/2010;'E.S. RUBI II';-35,00 €;3.943,02 €;744;-35,00;8.467,11 €;'sin fechas';10/11/2010;'RUBI';'Gastos_Ocio y transporte';'Gasolina';'VARIABLES'
11/11/2010;11/11/2010;'CAFET.C T PRAT';-4,95 €;3.938,07 €;745;-4,95;8.462,16 €;'sin fechas';11/11/2010;'CAFETC';'Gastos_Ocio y transporte';'Restaurantes';'VARIABLES'
11/11/2010;11/11/2010;'DIETISTA';-60,00 €;3.878,07 €;746;-60,00;8.402,16 €;'sin fechas';11/11/2010;'DIETISTA';'Gastos_Salud, saber y deporte';'Otros Salud';'VARIABLES'
11/11/2010;11/11/2010;'REINT.CAJERO';-40,00 €;3.838,07 €;747;-40,00;8.362,16 €;'sin fechas';11/11/2010;'REINTCAJERO';'Gastos_Gastos varios';'Efectivo';'VARIABLES'
11/11/2010;11/11/2010;'TRANSFAVOR';180,00 €;4.018,07 €;748;180,00;8.542,16 €;'sin fechas';11/11/2010;'TRANSFAVOR';'Ingresos';'Transferencias';'VARIABLES'
12/11/2010;12/11/2010;'CAFET.C T PRAT';-1,45 €;4.016,62 €;749;-1,45;8.540,71 €;'sin fechas';12/11/2010;'CAFETC';'Gastos_Ocio y transporte';'Restaurantes';'VARIABLES'
13/11/2010;13/11/2010;'BON AREA';-12,72 €;4.003,90 €;750;-12,72;8.527,99 €;'sin fechas';13/11/2010;'BON';'Gastos_Compras';'Supermercado';'VARIABLES'
13/11/2010;13/11/2010;'FRUITES I VERDURES';-15,63 €;3.988,27 €;751;-15,63;8.512,36 €;'sin fechas';13/11/2010;'FRUITES';'Gastos_Compras';'Supermercado';'VARIABLES'
13/11/2010;13/11/2010;'RESTAURANTES';-122,55 €;3.865,72 €;752;-122,55;8.389,81 €;'sin fechas';13/11/2010;'RESTAURANTES';'Gastos_Ocio y transporte';'Restaurantes';'VARIABLES'
15/11/2010;15/11/2010;'CAFET.C T PRAT';-1,45 €;3.864,27 €;753;-1,45;8.388,36 €;'sin fechas';15/11/2010;'CAFETC';'Gastos_Ocio y transporte';'Restaurantes';'VARIABLES'
15/11/2010;15/11/2010;'CCM VIDA Y P SEGURO PRESTAMO';-30,12 €;3.834,15 €;754;-30,12;8.358,24 €;'sin fechas';15/11/2010;'CCM';'Gastos_Seguros';'Seguro vida';'FIJO'
15/11/2010;15/11/2010;'CCM VIDA Y PENSIO 000000493358';-20,35 €;3.813,80 €;755;-20,35;8.337,89 €;'sin fechas';15/11/2010;'CCM';'Gastos_Seguros';'Seguro vida';'FIJO'
16/11/2010;16/11/2010;'CAFET.C T PRAT';-1,90 €;3.811,90 €;756;-1,90;8.335,99 €;'sin fechas';16/11/2010;'CAFETC';'Gastos_Ocio y transporte';'Restaurantes';'VARIABLES'
17/11/2010;17/11/2010;'AG.TRIBUT GABRIEL';100,00 €;3.911,90 €;757;100,00;8.435,99 €;'sin fechas';17/11/2010;'AGTRIBUT';'Ingresos';'Subvenciones';
17/11/2010;17/11/2010;'CAFET.C T PRAT';-1,20 €;3.910,70 €;758;-1,20;8.434,79 €;'sin fechas';17/11/2010;'CAFETC';'Gastos_Ocio y transporte';'Restaurantes';'VARIABLES'
18/11/2010;18/11/2010;'CAFET.C T PRAT';-0,60 €;3.910,10 €;759;-0,60;8.434,19 €;'sin fechas';18/11/2010;'CAFETC';'Gastos_Ocio y transporte';'Restaurantes';'VARIABLES'
18/11/2010;18/11/2010;'EROSKI-[COMIDA]';-97,04 €;3.813,06 €;760;-97,04;8.337,15 €;'sin fechas';18/11/2010;'EROSKICOMIDA';'Gastos_Compras';'Supermercado';'VARIABLES'
18/11/2010;18/11/2010;'ONO';-105,61 €;3.707,45 €;761;-105,61;8.231,54 €;'sin fechas';18/11/2010;'ONO';'Gastos_Servicios tipicos';'Telecomunicaciones';'FIJO'
18/11/2010;18/11/2010;'RESTAURANTES';-38,90 €;3.668,55 €;762;-38,90;8.192,64 €;'sin fechas';18/11/2010;'RESTAURANTES';'Gastos_Ocio y transporte';'Restaurantes';'VARIABLES'
19/11/2010;19/11/2010;'CAFET.C T PRAT';-1,20 €;3.667,35 €;763;-1,20;8.191,44 €;'sin fechas';19/11/2010;'CAFETC';'Gastos_Ocio y transporte';'Restaurantes';'VARIABLES'
19/11/2010;19/11/2010;'DIETISTA';-60,00 €;3.607,35 €;764;-60,00;8.131,44 €;'sin fechas';19/11/2010;'DIETISTA';'Gastos_Salud, saber y deporte';'Otros Salud';'VARIABLES'
19/11/2010;19/11/2010;'E.S. RUBI E 9';-30,00 €;3.577,35 €;765;-30,00;8.101,44 €;'sin fechas';19/11/2010;'RUBI';'Gastos_Ocio y transporte';'Gasolina';'VARIABLES'
19/11/2010;19/11/2010;'ENDESA ENERG EE_XXI40025545678';-103,47 €;3.473,88 €;766;-103,47;7.997,97 €;'sin fechas';19/11/2010;'ENDESA';'Gastos_Servicios tipicos';'Electricidad';'FIJO'
19/11/2010;19/11/2010;'ERCAR SL';-19,88 €;3.454,00 €;767;-19,88;7.978,09 €;'sin fechas';19/11/2010;'ERCAR';'No computable';'No computable';'No computable'
19/11/2010;19/11/2010;'FARMACIA';-39,40 €;3.414,60 €;768;-39,40;7.938,69 €;'sin fechas';19/11/2010;'FARMACIA';'Gastos_Salud, saber y deporte';'Farmacia';'VARIABLES'
19/11/2010;19/11/2010;'FRANCE TELEC ORANGE MOVIL 0211';-15,91 €;3.398,69 €;769;-15,91;7.922,78 €;'sin fechas';19/11/2010;'FRANCE';'Gastos_Servicios tipicos';'Telecomunicaciones';'FIJO'
20/11/2010;20/11/2010;'CAPRABO';-39,40 €;3.359,29 €;770;-39,40;7.883,38 €;'sin fechas';20/11/2010;'CAPRABO';'Gastos_Compras';'Supermercado';'VARIABLES'
20/11/2010;20/11/2010;'VIENA';-6,00 €;3.353,29 €;771;-6,00;7.877,38 €;'sin fechas';20/11/2010;'VIENA';'Gastos_Ocio y transporte';'Restaurantes';'VARIABLES'
22/11/2010;22/11/2010;'CAFET.C T PRAT';-4,25 €;3.349,04 €;772;-4,25;7.873,13 €;'sin fechas';22/11/2010;'CAFETC';'Gastos_Ocio y transporte';'Restaurantes';'VARIABLES'
22/11/2010;22/11/2010;'CAFET.C T PRAT';-1,45 €;3.347,59 €;773;-1,45;7.871,68 €;'sin fechas';22/11/2010;'CAFETC';'Gastos_Ocio y transporte';'Restaurantes';'VARIABLES'
22/11/2010;22/11/2010;'CELIO TERRASSA';-19,99 €;3.327,60 €;774;-19,99;7.851,69 €;'sin fechas';22/11/2010;'CELIO';'Gastos_Compras';'Ropa';'VARIABLES'
24/11/2010;24/11/2010;'CAFET.C T PRAT';-4,95 €;3.322,65 €;775;-4,95;7.846,74 €;'sin fechas';24/11/2010;'CAFETC';'Gastos_Ocio y transporte';'Restaurantes';'VARIABLES'
25/11/2010;25/11/2010;'CAFET.C T PRAT';-1,95 €;3.320,70 €;776;-1,95;7.844,79 €;'sin fechas';25/11/2010;'CAFETC';'Gastos_Ocio y transporte';'Restaurantes';'VARIABLES'
25/11/2010;25/11/2010;'CAPRABO';-101,93 €;3.218,77 €;777;-101,93;7.742,86 €;'sin fechas';25/11/2010;'CAPRABO';'Gastos_Compras';'Supermercado';'VARIABLES'
26/11/2010;26/11/2010;'TRANSFAVOR 3061.1990014513 00001';10.000,00 €;13.218,77 €;778;10.000,00;17.742,86 €;'sin fechas';26/11/2010;'TRANSFAVOR';'Ingresos';'Transferencias';'VARIABLES'
26/11/2010;26/11/2010;'CAFET.C T PRAT';-2,40 €;13.216,37 €;779;-2,40;17.740,46 €;'sin fechas';26/11/2010;'CAFETC';'Gastos_Ocio y transporte';'Restaurantes';'VARIABLES'
26/11/2010;26/11/2010;'COMISIONES';-40,64 €;13.175,73 €;780;-40,64;17.699,82 €;'sin fechas';26/11/2010;'COMISIONES';'Gastos_Banco y organismos';'Cargos banco';'FIJO'
26/11/2010;26/11/2010;'ENTREGA PTMO. 3061-0960001518';-10.000,00 €;3.175,73 €;781;-10.000,00;7.699,82 €;'sin fechas';26/11/2010;'ENTREGA';'Gastos_Banco y organismos';'Hipoteca';'FIJO'
26/11/2010;26/11/2010;'FOMENT DE TERRASSA, S.A. FOMEN';1.555,44 €;4.731,17 €;782;1.555,44;9.255,26 €;'sin fechas';26/11/2010;'FOMENT';'Ingresos';'Nomina';'FIJO'
26/11/2010;26/11/2010;'FRANCE TELEC ORANGE MOVIL 0211';-15,68 €;4.715,49 €;783;-15,68;9.239,58 €;'sin fechas';26/11/2010;'FRANCE';'Gastos_Servicios tipicos';'Telecomunicaciones';'FIJO'
26/11/2010;26/11/2010;'IMPUESTOS RETENIDOS A CUENTA';-7,72 €;4.707,77 €;784;-7,72;9.231,86 €;'sin fechas';26/11/2010;'IMPUESTOS';'Gastos_Banco y organismos';'Impuestos';'FIJO'
26/11/2010;29/11/2010;'INFORMACIO I TECNOLOGIA DE CAT';1.540,02 €;6.247,79 €;785;1.540,02;10.771,88 €;'sin fechas';29/11/2010;'INFORMACIO';'Ingresos';'Nomina';'FIJO'
26/11/2010;26/11/2010;'INTERESES CUENTA AHORRO PLAZO 3061.1990014513 00002';40,64 €;6.288,43 €;786;40,64;10.812,52 €;'sin fechas';26/11/2010;'INTERESES';'Ingresos';'Rendimientos';
27/11/2010;27/11/2010;'CAPRABO';-19,84 €;6.268,59 €;787;-19,84;10.792,68 €;'sin fechas';27/11/2010;'CAPRABO';'Gastos_Compras';'Supermercado';'VARIABLES'
27/11/2010;27/11/2010;'ES STA. MARGARITA';-38,92 €;6.229,67 €;788;-38,92;10.753,76 €;'sin fechas';27/11/2010;'STA';'Gastos_Ocio y transporte';'Gasolina';'VARIABLES'
27/11/2010;27/11/2010;'FRANKFURT LA T\\CORNELLA LLO';-24,80 €;6.204,87 €;789;-24,80;10.728,96 €;'sin fechas';27/11/2010;'FRANKFURT';'Gastos_Ocio y transporte';'Restaurantes';'VARIABLES'
27/11/2010;27/11/2010;'PRIMARK';-29,00 €;6.175,87 €;790;-29,00;10.699,96 €;'sin fechas';27/11/2010;'PRIMARK';'Gastos_Compras';'Ropa';'VARIABLES'
28/11/2010;28/11/2010;'BOLIN SHIJIA, SCP';-30,20 €;6.145,67 €;791;-30,20;10.669,76 €;'sin fechas';28/11/2010;'BOLIN';'Gastos_Ocio y transporte';'Restaurantes';'VARIABLES'
29/11/2010;29/11/2010;'CAFET.C T PRAT';-2,20 €;6.143,47 €;792;-2,20;10.667,56 €;'sin fechas';29/11/2010;'CAFETC';'Gastos_Ocio y transporte';'Restaurantes';'VARIABLES'
30/11/2010;30/11/2010;'CAFET.C T PRAT';-6,75 €;6.136,72 €;793;-6,75;10.660,81 €;'sin fechas';30/11/2010;'CAFETC';'Gastos_Ocio y transporte';'Restaurantes';'VARIABLES'
30/11/2010;30/11/2010;'DIETISTA';-60,00 €;6.076,72 €;794;-60,00;10.600,81 €;'sin fechas';30/11/2010;'DIETISTA';'Gastos_Salud, saber y deporte';'Otros Salud';'VARIABLES'
30/11/2010;30/11/2010;'RECIBO PTMOS. 3061-0960001518';-598,03 €;5.478,69 €;795;-598,03;10.002,78 €;'sin fechas';30/11/2010;'RECIBO';'Gastos_Banco y organismos';'Hipoteca';'FIJO'
30/11/2010;30/11/2010;'RECIBO PTMOS. 3061-0960004140';-137,10 €;5.341,59 €;796;-137,10;9.865,68 €;'sin fechas';30/11/2010;'RECIBO';'Gastos_Banco y organismos';'Hipoteca';'FIJO'
30/11/2010;30/11/2010;'REINT.CAJERO';-20,00 €;5.321,59 €;797;-20,00;9.845,68 €;'sin fechas';30/11/2010;'REINTCAJERO';'Gastos_Gastos varios';'Efectivo';'VARIABLES'
01/12/2010;01/12/2010;'AJUNTAMENT DE TER 010000520716';-37,19 €;5.284,40 €;798;-37,19;9.808,49 €;'sin fechas';01/12/2010;'AJUNTAMENT';'Gastos_Banco y organismos';'Ayuntamiento';'FIJO'
01/12/2010;01/12/2010;'CAFET.C T PRAT';-2,20 €;5.282,20 €;799;-2,20;9.806,29 €;'sin fechas';01/12/2010;'CAFETC';'Gastos_Ocio y transporte';'Restaurantes';'VARIABLES'
01/12/2010;01/12/2010;'CIA.DE SEGUROS AD 006662671613';-68,34 €;5.213,86 €;800;-68,34;9.737,95 €;'sin fechas';01/12/2010;'CIADE';'Gastos_Salud, saber y deporte';'Medico';'VARIABLES'
01/12/2010;01/12/2010;'MANTENIMIENTO';-1,25 €;5.212,61 €;801;-1,25;9.736,70 €;'sin fechas';01/12/2010;'MANTENIMIENTO';'Gastos_Banco y organismos';'Cargos banco';'FIJO'
01/12/2010;01/12/2010;'MANTENIMIENTO';-1,25 €;5.211,36 €;802;-1,25;9.735,45 €;'sin fechas';01/12/2010;'MANTENIMIENTO';'Gastos_Banco y organismos';'Cargos banco';'FIJO'
02/12/2010;02/12/2010;'CAFET.C T PRAT';-2,00 €;5.209,36 €;803;-2,00;9.733,45 €;'sin fechas';02/12/2010;'CAFETC';'Gastos_Ocio y transporte';'Restaurantes';'VARIABLES'
02/12/2010;02/12/2010;'FARMACIA';-54,71 €;5.154,65 €;804;-54,71;9.678,74 €;'sin fechas';02/12/2010;'FARMACIA';'Gastos_Salud, saber y deporte';'Farmacia';'VARIABLES'
03/12/2010;03/12/2010;'CAFET.C T PRAT';-1,90 €;5.152,75 €;805;-1,90;9.676,84 €;'sin fechas';03/12/2010;'CAFETC';'Gastos_Ocio y transporte';'Restaurantes';'VARIABLES'
03/12/2010;03/12/2010;'EROSKI-[COMIDA]';-193,40 €;4.959,35 €;806;-193,40;9.483,44 €;'sin fechas';03/12/2010;'EROSKICOMIDA';'Gastos_Compras';'Supermercado';'VARIABLES'
03/12/2010;03/12/2010;'EROSKI-[COMIDA]';-14,00 €;4.945,35 €;807;-14,00;9.469,44 €;'sin fechas';03/12/2010;'EROSKICOMIDA';'Gastos_Compras';'Supermercado';'VARIABLES'
03/12/2010;03/12/2010;'FARMACIA';-26,89 €;4.918,46 €;808;-26,89;9.442,55 €;'sin fechas';03/12/2010;'FARMACIA';'Gastos_Salud, saber y deporte';'Farmacia';'VARIABLES'
03/12/2010;03/12/2010;'VIENA';-14,90 €;4.903,56 €;809;-14,90;9.427,65 €;'sin fechas';03/12/2010;'VIENA';'Gastos_Ocio y transporte';'Restaurantes';'VARIABLES'
04/12/2010;04/12/2010;'FARMACIA';-11,05 €;4.892,51 €;810;-11,05;9.416,60 €;'sin fechas';04/12/2010;'FARMACIA';'Gastos_Salud, saber y deporte';'Farmacia';'VARIABLES'
04/12/2010;04/12/2010;'REINT.CAJERO';-92,00 €;4.800,51 €;811;-92,00;9.324,60 €;'sin fechas';04/12/2010;'REINTCAJERO';'Gastos_Gastos varios';'Efectivo';'VARIABLES'
04/12/2010;04/12/2010;'RESTAURANTES';-46,00 €;4.754,51 €;812;-46,00;9.278,60 €;'sin fechas';04/12/2010;'RESTAURANTES';'Gastos_Ocio y transporte';'Restaurantes';'VARIABLES'
06/12/2010;06/12/2010;'ES STA. MARGARITA';-35,01 €;4.719,50 €;813;-35,01;9.243,59 €;'sin fechas';06/12/2010;'STA';'Gastos_Ocio y transporte';'Gasolina';'VARIABLES'
06/12/2010;06/12/2010;'KIABI';-53,94 €;4.665,56 €;814;-53,94;9.189,65 €;'sin fechas';06/12/2010;'KIABI';'Gastos_Compras';'Ropa';'VARIABLES'
06/12/2010;06/12/2010;'SMART PHARMACY\\SANT BOI DE';-21,10 €;4.644,46 €;815;-21,10;9.168,55 €;'sin fechas';06/12/2010;'SMART';'Gastos_Salud, saber y deporte';'Farmacia';'VARIABLES'
07/12/2010;07/12/2010;'ALCAMPO';-122,10 €;4.522,36 €;816;-122,10;9.046,45 €;'sin fechas';07/12/2010;'ALCAMPO';'Gastos_Compras';'Supermercado';'VARIABLES'
07/12/2010;29/11/2010;'AUTOPISTA TERR';-6,20 €;4.516,16 €;817;-6,20;9.040,25 €;'sin fechas';29/11/2010;'AUTOPISTA';'Gastos_Ocio y transporte';'Parking y peaje';'VARIABLES'
07/12/2010;07/12/2010;'CAFET.C T PRAT';-1,50 €;4.514,66 €;818;-1,50;9.038,75 €;'sin fechas';07/12/2010;'CAFETC';'Gastos_Ocio y transporte';'Restaurantes';'VARIABLES'
07/12/2010;07/12/2010;'REINT.CAJERO';-179,00 €;4.335,66 €;819;-179,00;8.859,75 €;'sin fechas';07/12/2010;'REINTCAJERO';'Gastos_Gastos varios';'Efectivo';'VARIABLES'
09/12/2010;09/12/2010;'BON AREA';-23,67 €;4.311,99 €;820;-23,67;8.836,08 €;'sin fechas';09/12/2010;'BON';'Gastos_Compras';'Supermercado';'VARIABLES'
09/12/2010;09/12/2010;'CAPRABO';-18,70 €;4.293,29 €;821;-18,70;8.817,38 €;'sin fechas';09/12/2010;'CAPRABO';'Gastos_Compras';'Supermercado';'VARIABLES'
09/12/2010;09/12/2010;'FARMACIA';-20,10 €;4.273,19 €;822;-20,10;8.797,28 €;'sin fechas';09/12/2010;'FARMACIA';'Gastos_Salud, saber y deporte';'Farmacia';'VARIABLES'
09/12/2010;09/12/2010;'LA TORRE TERRASA';-17,35 €;4.255,84 €;823;-17,35;8.779,93 €;'sin fechas';09/12/2010;'TORRE';'Gastos_Ocio y transporte';'Restaurantes';'VARIABLES'
10/12/2010;10/12/2010;'DIETISTA';-60,00 €;4.195,84 €;824;-60,00;8.719,93 €;'sin fechas';10/12/2010;'DIETISTA';'Gastos_Salud, saber y deporte';'Otros Salud';'VARIABLES'
10/12/2010;10/12/2010;'GAS NATURAL';-215,71 €;3.980,13 €;825;-215,71;8.504,22 €;'sin fechas';10/12/2010;'GAS';'Gastos_Servicios tipicos';'Gas';'FIJO'
10/12/2010;10/12/2010;'METRO BARCELONA';-7,95 €;3.972,18 €;826;-7,95;8.496,27 €;'sin fechas';10/12/2010;'METRO';'Gastos_Ocio y transporte';'Transporte';'VARIABLES'
11/12/2010;11/12/2010;'FNAC';-64,90 €;3.907,28 €;827;-64,90;8.431,37 €;'sin fechas';11/12/2010;'FNAC';'Gastos_Compras';'Supermercado';'VARIABLES'
11/12/2010;11/12/2010;'REINT.CAJERO';-65,00 €;3.842,28 €;828;-65,00;8.366,37 €;'sin fechas';11/12/2010;'REINTCAJERO';'Gastos_Gastos varios';'Efectivo';'VARIABLES'
13/12/2010;13/12/2010;'CAFET.C T PRAT';-1,20 €;3.841,08 €;829;-1,20;8.365,17 €;'sin fechas';13/12/2010;'CAFETC';'Gastos_Ocio y transporte';'Restaurantes';'VARIABLES'
13/12/2010;13/12/2010;'QUOTA T. Visa Ele';-23,00 €;3.818,08 €;830;-23,00;8.342,17 €;'sin fechas';13/12/2010;'QUOTA';'Gastos_Banco y organismos';'Cargos banco';'FIJO'
14/12/2010;14/12/2010;'EROSKI-[COMIDA]';-33,29 €;3.784,79 €;831;-33,29;8.308,88 €;'sin fechas';14/12/2010;'EROSKICOMIDA';'Gastos_Compras';'Supermercado';'VARIABLES'
14/12/2010;14/12/2010;'EROSKI-[COMIDA]';-61,36 €;3.723,43 €;832;-61,36;8.247,52 €;'sin fechas';14/12/2010;'EROSKICOMIDA';'Gastos_Compras';'Supermercado';'VARIABLES'
14/12/2010;14/12/2010;'QUOTA T. Visa Ele';-23,00 €;3.700,43 €;833;-23,00;8.224,52 €;'sin fechas';14/12/2010;'QUOTA';'Gastos_Banco y organismos';'Cargos banco';'FIJO'
14/12/2010;14/12/2010;'VIENA';-9,00 €;3.691,43 €;834;-9,00;8.215,52 €;'sin fechas';14/12/2010;'VIENA';'Gastos_Ocio y transporte';'Restaurantes';'VARIABLES'
15/12/2010;15/12/2010;'CAFET.C T PRAT';-3,50 €;3.687,93 €;835;-3,50;8.212,02 €;'sin fechas';15/12/2010;'CAFETC';'Gastos_Ocio y transporte';'Restaurantes';'VARIABLES'
15/12/2010;15/12/2010;'CAFET.C T PRAT';-1,50 €;3.686,43 €;836;-1,50;8.210,52 €;'sin fechas';15/12/2010;'CAFETC';'Gastos_Ocio y transporte';'Restaurantes';'VARIABLES'
15/12/2010;15/12/2010;'CCM VIDA Y P SEGURO PRESTAMO';-27,82 €;3.658,61 €;837;-27,82;8.182,70 €;'sin fechas';15/12/2010;'CCM';'Gastos_Seguros';'Seguro vida';'FIJO'
15/12/2010;15/12/2010;'CCM VIDA Y PENSIO 000000493358';-19,49 €;3.639,12 €;838;-19,49;8.163,21 €;'sin fechas';15/12/2010;'CCM';'Gastos_Seguros';'Seguro vida';'FIJO'
15/12/2010;15/12/2010;'CEDIPSA 12793-\\EL PRAT DE L';-20,00 €;3.619,12 €;839;-20,00;8.143,21 €;'sin fechas';15/12/2010;'CEDIPSA';'Gastos_Ocio y transporte';'Gasolina';'VARIABLES'
16/12/2010;16/12/2010;'CAFET.C T PRAT';-1,15 €;3.617,97 €;840;-1,15;8.142,06 €;'sin fechas';16/12/2010;'CAFETC';'Gastos_Ocio y transporte';'Restaurantes';'VARIABLES'
16/12/2010;16/12/2010;'ENDESA ENERG EE_XXI40025545678';-53,54 €;3.564,43 €;841;-53,54;8.088,52 €;'sin fechas';16/12/2010;'ENDESA';'Gastos_Servicios tipicos';'Electricidad';'FIJO'
16/12/2010;17/12/2010;'INFORMACIO I TECNOLOGIA DE CAT';1.671,11 €;5.235,54 €;842;1.671,11;9.759,63 €;'sin fechas';17/12/2010;'INFORMACIO';'Ingresos';'Nomina';'FIJO'
16/12/2010;16/12/2010;'RESTAURANTES';-41,22 €;5.194,32 €;843;-41,22;9.718,41 €;'sin fechas';16/12/2010;'RESTAURANTES';'Gastos_Ocio y transporte';'Restaurantes';'VARIABLES'
17/12/2010;17/12/2010;'CAFET.C T PRAT';-1,20 €;5.193,12 €;844;-1,20;9.717,21 €;'sin fechas';17/12/2010;'CAFETC';'Gastos_Ocio y transporte';'Restaurantes';'VARIABLES'
18/12/2010;18/12/2010;'COM. MANT. ACTIVAS DE LIQ.';-2,54 €;5.190,58 €;845;-2,54;9.714,67 €;'sin fechas';18/12/2010;'COM';'Gastos_Banco y organismos';'Cargos banco';'FIJO'
18/12/2010;18/12/2010;'ES STA. MARGARITA';-43,40 €;5.147,18 €;846;-43,40;9.671,27 €;'sin fechas';18/12/2010;'STA';'Gastos_Ocio y transporte';'Gasolina';'VARIABLES'
18/12/2010;18/12/2010;'IMP.RET.A CTA';-0,02 €;5.147,16 €;847;-0,02;9.671,25 €;'sin fechas';18/12/2010;'IMPRETA';'Gastos_Banco y organismos';'Impuestos';'FIJO'
18/12/2010;18/12/2010;'INTERESES';0,09 €;5.147,25 €;848;0,09;9.671,34 €;'sin fechas';18/12/2010;'INTERESES';'Ingresos';'Rendimientos';
20/12/2010;20/12/2010;'CAFET.C T PRAT';-5,00 €;5.142,25 €;849;-5,00;9.666,34 €;'sin fechas';20/12/2010;'CAFETC';'Gastos_Ocio y transporte';'Restaurantes';'VARIABLES'
20/12/2010;20/12/2010;'ONO';-98,29 €;5.043,96 €;850;-98,29;9.568,05 €;'sin fechas';20/12/2010;'ONO';'Gastos_Servicios tipicos';'Telecomunicaciones';'FIJO'
21/12/2010;21/12/2010;'CAFET.C T PRAT';-1,20 €;5.042,76 €;851;-1,20;9.566,85 €;'sin fechas';21/12/2010;'CAFETC';'Gastos_Ocio y transporte';'Restaurantes';'VARIABLES'
21/12/2010;21/12/2010;'CAFET.C T PRAT';-7,30 €;5.035,46 €;852;-7,30;9.559,55 €;'sin fechas';21/12/2010;'CAFETC';'Gastos_Ocio y transporte';'Restaurantes';'VARIABLES'
21/12/2010;21/12/2010;'DIETISTA';-60,00 €;4.975,46 €;853;-60,00;9.499,55 €;'sin fechas';21/12/2010;'DIETISTA';'Gastos_Salud, saber y deporte';'Otros Salud';'VARIABLES'
21/12/2010;21/12/2010;'EL CORTE INGLES';-19,95 €;4.955,51 €;854;-19,95;9.479,60 €;'sin fechas';21/12/2010;'CORTE';'Gastos_Compras';'Supermercado';'VARIABLES'
21/12/2010;21/12/2010;'FOMENT DE TERRASSA, S.A. FOMEN';2.221,60 €;7.177,11 €;855;2.221,60;11.701,20 €;'sin fechas';21/12/2010;'FOMENT';'Ingresos';'Nomina';'FIJO'
21/12/2010;21/12/2010;'FRANCE TELEC ORANGE MOVIL 0211';-20,14 €;7.156,97 €;856;-20,14;11.681,06 €;'sin fechas';21/12/2010;'FRANCE';'Gastos_Servicios tipicos';'Telecomunicaciones';'FIJO'
21/12/2010;21/12/2010;'MERCADONA';-130,92 €;7.026,05 €;857;-130,92;11.550,14 €;'sin fechas';21/12/2010;'MERCADONA';'Gastos_Compras';'Supermercado';'VARIABLES'
21/12/2010;21/12/2010;'REINT.CAJERO';-60,00 €;6.966,05 €;858;-60,00;11.490,14 €;'sin fechas';21/12/2010;'REINTCAJERO';'Gastos_Gastos varios';'Efectivo';'VARIABLES'
22/12/2010;22/12/2010;'CAFET.C T PRAT';-1,20 €;6.964,85 €;859;-1,20;11.488,94 €;'sin fechas';22/12/2010;'CAFETC';'Gastos_Ocio y transporte';'Restaurantes';'VARIABLES'
22/12/2010;22/12/2010;'CAPRABO';-6,41 €;6.958,44 €;860;-6,41;11.482,53 €;'sin fechas';22/12/2010;'CAPRABO';'Gastos_Compras';'Supermercado';'VARIABLES'
22/12/2010;22/12/2010;'EROSKI-[COMIDA]';-72,79 €;6.885,65 €;861;-72,79;11.409,74 €;'sin fechas';22/12/2010;'EROSKICOMIDA';'Gastos_Compras';'Supermercado';'VARIABLES'
22/12/2010;22/12/2010;'GIFI';-17,99 €;6.867,66 €;862;-17,99;11.391,75 €;'sin fechas';22/12/2010;'GIFI';'Gastos_Compras';'Hogar';'VARIABLES'
22/12/2010;22/12/2010;'JUGUETILANDIA TERR';-18,30 €;6.849,36 €;863;-18,30;11.373,45 €;'sin fechas';22/12/2010;'JUGUETILANDIA';'Gastos_Compras';'Niños';'VARIABLES'
22/12/2010;22/12/2010;'VIENA';-14,10 €;6.835,26 €;864;-14,10;11.359,35 €;'sin fechas';22/12/2010;'VIENA';'Gastos_Ocio y transporte';'Restaurantes';'VARIABLES'
23/12/2010;23/12/2010;'MINA PUBLICA AIGUES T.01A75789';-36,33 €;6.798,93 €;865;-36,33;11.323,02 €;'sin fechas';23/12/2010;'MINA';'Gastos_Servicios tipicos';'Agua';'FIJO'
24/12/2010;24/12/2010;'AG.TRIBUT GABRIEL';100,00 €;6.898,93 €;866;100,00;11.423,02 €;'sin fechas';24/12/2010;'AGTRIBUT';'Ingresos';'Subvenciones';
25/12/2010;25/12/2010;'ES STA. MARGARITA';-31,36 €;6.867,57 €;867;-31,36;11.391,66 €;'sin fechas';25/12/2010;'STA';'Gastos_Ocio y transporte';'Gasolina';'VARIABLES'
27/12/2010;27/12/2010;'C&A';-56,00 €;6.811,57 €;868;-56,00;11.335,66 €;'sin fechas';27/12/2010;'CA';'Gastos_Compras';'Ropa';'VARIABLES'
27/12/2010;27/12/2010;'CAFET.C T PRAT';-1,65 €;6.809,92 €;869;-1,65;11.334,01 €;'sin fechas';27/12/2010;'CAFETC';'Gastos_Ocio y transporte';'Restaurantes';'VARIABLES'
27/12/2010;27/12/2010;'FRANCE TELEC ORANGE MOVIL 0211';-65,63 €;6.744,29 €;870;-65,63;11.268,38 €;'sin fechas';27/12/2010;'FRANCE';'Gastos_Servicios tipicos';'Telecomunicaciones';'FIJO'
27/12/2010;27/12/2010;'PRIMARK';-23,50 €;6.720,79 €;871;-23,50;11.244,88 €;'sin fechas';27/12/2010;'PRIMARK';'Gastos_Compras';'Ropa';'VARIABLES'
27/12/2010;27/12/2010;'SPRINGFIELD \\RONDA';-65,05 €;6.655,74 €;872;-65,05;11.179,83 €;'sin fechas';27/12/2010;'SPRINGFIELD';'Gastos_Compras';'Ropa';'VARIABLES'
28/12/2010;28/12/2010;'AJUNTAMENT DE TER 850000031046';-36,18 €;6.619,56 €;873;-36,18;11.143,65 €;'sin fechas';28/12/2010;'AJUNTAMENT';'Gastos_Banco y organismos';'Ayuntamiento';'FIJO'
28/12/2010;28/12/2010;'FARMACIA';-1,65 €;6.617,91 €;874;-1,65;11.142,00 €;'sin fechas';28/12/2010;'FARMACIA';'Gastos_Salud, saber y deporte';'Farmacia';'VARIABLES'
28/12/2010;29/12/2010;'INFORMACIO I TECNOLOGIA DE CAT';1.534,24 €;8.152,15 €;875;1.534,24;12.676,24 €;'sin fechas';29/12/2010;'INFORMACIO';'Ingresos';'Nomina';'FIJO'
28/12/2010;28/12/2010;'COMISIONES';-1,50 €;8.150,65 €;876;-1,50;12.674,74 €;'sin fechas';28/12/2010;'COMISIONES';'Gastos_Banco y organismos';'Cargos banco';'FIJO'
28/12/2010;28/12/2010;'TRANSCARGO';-200,00 €;7.950,65 €;877;-200,00;12.474,74 €;'sin fechas';28/12/2010;'TRANSCARGO';'Gastos_Gastos varios';'Transferencias';'VARIABLES'
29/12/2010;29/12/2010;'TRANSFAVOR';200,00 €;8.150,65 €;878;200,00;12.674,74 €;'sin fechas';29/12/2010;'TRANSFAVOR';'Ingresos';'Transferencias';'VARIABLES'
30/12/2010;30/12/2010;'CAJA DE SEGUROS R 300045047898';-278,94 €;7.871,71 €;879;-278,94;12.395,80 €;'sin fechas';30/12/2010;'CAJA';'Gastos_Seguros';'Seguro hogar';'FIJO'
31/12/2010;31/12/2010;'AUTOPISTA TERR';-5,30 €;7.866,41 €;880;-5,30;12.390,50 €;'sin fechas';31/12/2010;'AUTOPISTA';'Gastos_Ocio y transporte';'Parking y peaje';'VARIABLES'
31/12/2010;31/12/2010;'AUTOPISTA TERR';-3,50 €;7.862,91 €;881;-3,50;12.387,00 €;'sin fechas';31/12/2010;'AUTOPISTA';'Gastos_Ocio y transporte';'Parking y peaje';'VARIABLES'
31/12/2010;29/12/2010;'COMISIONES';-1,50 €;7.861,41 €;882;-1,50;12.385,50 €;'sin fechas';29/12/2010;'COMISIONES';'Gastos_Banco y organismos';'Cargos banco';'FIJO'
31/12/2010;31/12/2010;'ES STA. MARGARITA';-10,47 €;7.850,94 €;883;-10,47;12.375,03 €;'sin fechas';31/12/2010;'STA';'Gastos_Ocio y transporte';'Gasolina';'VARIABLES'
31/12/2010;31/12/2010;'RECIBO PTMOS. 3061-0960001518';-598,03 €;7.252,91 €;884;-598,03;11.777,00 €;'sin fechas';31/12/2010;'RECIBO';'Gastos_Banco y organismos';'Hipoteca';'FIJO'
31/12/2010;31/12/2010;'RECIBO PTMOS. 3061-0960004140';-137,10 €;7.115,81 €;885;-137,10;11.639,90 €;'sin fechas';31/12/2010;'RECIBO';'Gastos_Banco y organismos';'Hipoteca';'FIJO'
01/01/2011;01/01/2011;'MANTENIMIENTO';-1,25 €;7.114,56 €;886;-1,25;11.638,65 €;'sin fechas';01/01/2011;'MANTENIMIENTO';'Gastos_Banco y organismos';'Cargos banco';'FIJO'
02/01/2011;02/01/2011;'AUTOPISTA TERR';-5,40 €;7.109,16 €;887;-5,40;11.633,25 €;'sin fechas';02/01/2011;'AUTOPISTA';'Gastos_Ocio y transporte';'Parking y peaje';'VARIABLES'
02/01/2011;02/01/2011;'AUTOPISTA TERR';-3,55 €;7.105,61 €;888;-3,55;11.629,70 €;'sin fechas';02/01/2011;'AUTOPISTA';'Gastos_Ocio y transporte';'Parking y peaje';'VARIABLES'
02/01/2011;02/01/2011;'AUTOPISTA TERR';-6,00 €;7.099,61 €;889;-6,00;11.623,70 €;'sin fechas';02/01/2011;'AUTOPISTA';'Gastos_Ocio y transporte';'Parking y peaje';'VARIABLES'
03/01/2011;03/01/2011;'CIA.DE SEGUROS AD 006662671613';-73,20 €;7.026,41 €;890;-73,20;11.550,50 €;'sin fechas';03/01/2011;'CIADE';'Gastos_Salud, saber y deporte';'Medico';'VARIABLES'
03/01/2011;03/01/2011;'DIETISTA';-60,00 €;6.966,41 €;891;-60,00;11.490,50 €;'sin fechas';03/01/2011;'DIETISTA';'Gastos_Salud, saber y deporte';'Otros Salud';'VARIABLES'
07/01/2011;07/01/2011;'CELIO TERRASSA';-30,00 €;6.936,41 €;894;-30,00;11.460,50 €;'sin fechas';07/01/2011;'CELIO';'Gastos_Compras';'Ropa';'VARIABLES'
07/01/2011;07/01/2011;'CUINA\''M';-13,30 €;6.923,11 €;895;-13,30;11.447,20 €;'sin fechas';07/01/2011;'CUINAM';'Gastos_Ocio y transporte';'Restaurantes';'VARIABLES'
07/01/2011;07/01/2011;'FARMACIA';-19,95 €;6.903,16 €;896;-19,95;11.427,25 €;'sin fechas';07/01/2011;'FARMACIA';'Gastos_Salud, saber y deporte';'Farmacia';'VARIABLES'
07/01/2011;07/01/2011;'H&M';-44,95 €;6.858,21 €;897;-44,95;11.382,30 €;'sin fechas';07/01/2011;'HM';'Gastos_Compras';'Ropa';'VARIABLES'
07/01/2011;07/01/2011;'H&M';-37,00 €;6.821,21 €;898;-37,00;11.345,30 €;'sin fechas';07/01/2011;'HM';'Gastos_Compras';'Ropa';'VARIABLES'
07/01/2011;07/01/2011;'IMPUESTOS RETENIDOS A CUENTA3061.1990014513 00002';-12,79 €;6.808,42 €;899;-12,79;11.332,51 €;'sin fechas';07/01/2011;'IMPUESTOS';'Gastos_Banco y organismos';'Impuestos';'FIJO'
07/01/2011;07/01/2011;'INTERESES CUENTA AHORRO PLAZO 3061.1990014513 00002';67,30 €;6.875,72 €;900;67,30;11.399,81 €;'sin fechas';07/01/2011;'INTERESES';'Ingresos';'Rendimientos';
07/01/2011;07/01/2011;'PLANET SHOES';-40,00 €;6.835,72 €;901;-40,00;11.359,81 €;'sin fechas';07/01/2011;'PLANET';'Gastos_Compras';'Ropa';'VARIABLES'
08/01/2011;08/01/2011;'CANTINA MARIACHI';-26,40 €;6.809,32 €;902;-26,40;11.333,41 €;'sin fechas';08/01/2011;'CANTINA';'Gastos_Ocio y transporte';'Restaurantes';'VARIABLES'
08/01/2011;08/01/2011;'ES STA. MARGARITA';-35,00 €;6.774,32 €;903;-35,00;11.298,41 €;'sin fechas';08/01/2011;'STA';'Gastos_Ocio y transporte';'Gasolina';'VARIABLES'
08/01/2011;08/01/2011;'H&M';-18,00 €;6.756,32 €;904;-18,00;11.280,41 €;'sin fechas';08/01/2011;'HM';'Gastos_Compras';'Ropa';'VARIABLES'
10/01/2011;10/01/2011;'EROSKI-[COMIDA]';-90,36 €;6.665,96 €;905;-90,36;11.190,05 €;'sin fechas';10/01/2011;'EROSKICOMIDA';'Gastos_Compras';'Supermercado';'VARIABLES'
10/01/2011;10/01/2011;'TOCINERIES VENTURA';-9,67 €;6.656,29 €;906;-9,67;11.180,38 €;'sin fechas';10/01/2011;'TOCINERIES';'Gastos_Compras';'Supermercado';'VARIABLES'
11/01/2011;11/01/2011;'CIA. DE SEGUROS ADESLAS S.A.';259,20 €;6.915,49 €;907;259,20;11.439,58 €;'sin fechas';11/01/2011;'CIA';'Ingresos';'Devoluciones';'VARIABLES'
11/01/2011;11/01/2011;'CIA. DE SEGUROS ADESLAS S.A.';259,20 €;7.174,69 €;908;259,20;11.698,78 €;'sin fechas';11/01/2011;'CIA';'Ingresos';'Devoluciones';'VARIABLES'
13/01/2011;13/01/2011;'PRIMARK';-6,00 €;7.168,69 €;909;-6,00;11.692,78 €;'sin fechas';13/01/2011;'PRIMARK';'Gastos_Compras';'Ropa';'VARIABLES'
14/01/2011;14/01/2011;'CCM VIDA Y P SEGURO PRESTAMO';-27,76 €;7.140,93 €;910;-27,76;11.665,02 €;'sin fechas';14/01/2011;'CCM';'Gastos_Seguros';'Seguro vida';'FIJO'
14/01/2011;14/01/2011;'CCM VIDA Y PENSIO 000000493358';-19,45 €;7.121,48 €;911;-19,45;11.645,57 €;'sin fechas';14/01/2011;'CCM';'Gastos_Seguros';'Seguro vida';'FIJO'
14/01/2011;14/01/2011;'MERCADONA';-6,25 €;7.115,23 €;912;-6,25;11.639,32 €;'sin fechas';14/01/2011;'MERCADONA';'Gastos_Compras';'Supermercado';'VARIABLES'
15/01/2011;15/01/2011;'BON AREA';-14,83 €;7.100,40 €;913;-14,83;11.624,49 €;'sin fechas';15/01/2011;'BON';'Gastos_Compras';'Supermercado';'VARIABLES'
15/01/2011;15/01/2011;'CAPRABO';-18,74 €;7.081,66 €;914;-18,74;11.605,75 €;'sin fechas';15/01/2011;'CAPRABO';'Gastos_Compras';'Supermercado';'VARIABLES'
15/01/2011;15/01/2011;'FARMACIA';-19,70 €;7.061,96 €;915;-19,70;11.586,05 €;'sin fechas';15/01/2011;'FARMACIA';'Gastos_Salud, saber y deporte';'Farmacia';'VARIABLES'
15/01/2011;15/01/2011;'FASHION KANAK \\BADALONA';-26,85 €;7.035,11 €;916;-26,85;11.559,20 €;'sin fechas';15/01/2011;'FASHION';'Gastos_Compras';'Ropa';'VARIABLES'
15/01/2011;15/01/2011;'GAMBRINUS MAQUINI';-52,95 €;6.982,16 €;917;-52,95;11.506,25 €;'sin fechas';15/01/2011;'GAMBRINUS';'Gastos_Ocio y transporte';'Restaurantes';'VARIABLES'
15/01/2011;15/01/2011;'KUROKAI';-29,98 €;6.952,18 €;918;-29,98;11.476,27 €;'sin fechas';15/01/2011;'KUROKAI';'Gastos_Compras';'Ropa';'VARIABLES'
15/01/2011;15/01/2011;'STARBUCKS';-5,30 €;6.946,88 €;919;-5,30;11.470,97 €;'sin fechas';15/01/2011;'STARBUCKS';'Gastos_Ocio y transporte';'Restaurantes';'VARIABLES'
17/01/2011;17/01/2011;'ALCAMPO';-49,77 €;6.897,11 €;920;-49,77;11.421,20 €;'sin fechas';17/01/2011;'ALCAMPO';'Gastos_Compras';'Supermercado';'VARIABLES'
17/01/2011;17/01/2011;'ALCAMPO';-17,55 €;6.879,56 €;921;-17,55;11.403,65 €;'sin fechas';17/01/2011;'ALCAMPO';'Gastos_Compras';'Supermercado';'VARIABLES'
17/01/2011;17/01/2011;'CANGUROS';-200,00 €;6.679,56 €;922;-200,00;11.203,65 €;'sin fechas';17/01/2011;'CANGUROS';'Gastos_Salud, saber y deporte';'Estudios';'VARIABLES'
17/01/2011;17/01/2011;'DIETISTA';-62,00 €;6.617,56 €;923;-62,00;11.141,65 €;'sin fechas';17/01/2011;'DIETISTA';'Gastos_Salud, saber y deporte';'Otros Salud';'VARIABLES'
17/01/2011;17/01/2011;'ES STA. MARGARITA';-26,30 €;6.591,26 €;924;-26,30;11.115,35 €;'sin fechas';17/01/2011;'STA';'Gastos_Ocio y transporte';'Gasolina';'VARIABLES'
17/01/2011;17/01/2011;'PARKING DIETISTA';-7,00 €;6.584,26 €;925;-7,00;11.108,35 €;'sin fechas';17/01/2011;'PARKING';'Gastos_Ocio y transporte';'Parking y peaje';'VARIABLES'
17/01/2011;17/01/2011;'REINT.CAJERO';-31,00 €;6.553,26 €;926;-31,00;11.077,35 €;'sin fechas';17/01/2011;'REINTCAJERO';'Gastos_Gastos varios';'Efectivo';'VARIABLES'
18/01/2011;18/01/2011;'BON AREA';-14,46 €;6.538,80 €;927;-14,46;11.062,89 €;'sin fechas';18/01/2011;'BON';'Gastos_Compras';'Supermercado';'VARIABLES'
18/01/2011;18/01/2011;'MAXIMERCA S.A';-4,44 €;6.534,36 €;928;-4,44;11.058,45 €;'sin fechas';18/01/2011;'MAXIMERCA';'Gastos_Compras';'Hogar';'VARIABLES'
18/01/2011;18/01/2011;'ONO';-75,01 €;6.459,35 €;929;-75,01;10.983,44 €;'sin fechas';18/01/2011;'ONO';'Gastos_Servicios tipicos';'Telecomunicaciones';'FIJO'
19/01/2011;19/01/2011;'AUTOPISTA TERR';-1,25 €;6.458,10 €;930;-1,25;10.982,19 €;'sin fechas';19/01/2011;'AUTOPISTA';'Gastos_Ocio y transporte';'Parking y peaje';'VARIABLES'
20/01/2011;20/01/2011;'ENDESA ENERG EE_XXI40025545678';-105,59 €;6.352,51 €;931;-105,59;10.876,60 €;'sin fechas';20/01/2011;'ENDESA';'Gastos_Servicios tipicos';'Electricidad';'FIJO'
20/01/2011;20/01/2011;'IKEA';-139,65 €;6.212,86 €;932;-139,65;10.736,95 €;'sin fechas';20/01/2011;'IKEA';'Gastos_Vivienda y vehiculo';'Mnto. hogar';'VARIABLES'
21/01/2011;21/01/2011;'AG.TRIBUT GABRIEL';100,00 €;6.312,86 €;933;100,00;10.836,95 €;'sin fechas';21/01/2011;'AGTRIBUT';'Ingresos';'Subvenciones';
21/01/2011;21/01/2011;'BIJOU BRIGITTE';-4,95 €;6.307,91 €;934;-4,95;10.832,00 €;'sin fechas';21/01/2011;'BIJOU';'Gastos_Compras';'Ropa';'VARIABLES'
21/01/2011;21/01/2011;'CAFET.C T PRAT';-5,95 €;6.301,96 €;935;-5,95;10.826,05 €;'sin fechas';21/01/2011;'CAFETC';'Gastos_Ocio y transporte';'Restaurantes';'VARIABLES'
21/01/2011;21/01/2011;'ES STA. MARGARITA';-41,00 €;6.260,96 €;936;-41,00;10.785,05 €;'sin fechas';21/01/2011;'STA';'Gastos_Ocio y transporte';'Gasolina';'VARIABLES'
21/01/2011;21/01/2011;'MOVIL [NESTOR]';-29,78 €;6.231,18 €;937;-29,78;10.755,27 €;'sin fechas';21/01/2011;'MOVIL';'Gastos_Servicios tipicos';'Telecomunicaciones';'FIJO'
22/01/2011;22/01/2011;'BOLIN SHIJIA, SCP';-30,60 €;6.200,58 €;938;-30,60;10.724,67 €;'sin fechas';22/01/2011;'BOLIN';'Gastos_Ocio y transporte';'Restaurantes';'VARIABLES'
22/01/2011;22/01/2011;'BRICOKING TERRASSA';-24,08 €;6.176,50 €;939;-24,08;10.700,59 €;'sin fechas';22/01/2011;'BRICOKING';'Gastos_Vivienda y vehiculo';'Mnto. hogar';'VARIABLES'
22/01/2011;22/01/2011;'EROSKI-[COMIDA]';-165,01 €;6.011,49 €;940;-165,01;10.535,58 €;'sin fechas';22/01/2011;'EROSKICOMIDA';'Gastos_Compras';'Supermercado';'VARIABLES'
22/01/2011;22/01/2011;'VIENA';-9,35 €;6.002,14 €;941;-9,35;10.526,23 €;'sin fechas';22/01/2011;'VIENA';'Gastos_Ocio y transporte';'Restaurantes';'VARIABLES'
24/01/2011;24/01/2011;'MERCADONA';-150,53 €;5.851,61 €;942;-150,53;10.375,70 €;'sin fechas';24/01/2011;'MERCADONA';'Gastos_Compras';'Supermercado';'VARIABLES'
25/01/2011;25/01/2011;'BON AREA';-1,43 €;5.850,18 €;943;-1,43;10.374,27 €;'sin fechas';25/01/2011;'BON';'Gastos_Compras';'Supermercado';'VARIABLES'
25/01/2011;25/01/2011;'FARMACIA';-14,00 €;5.836,18 €;944;-14,00;10.360,27 €;'sin fechas';25/01/2011;'FARMACIA';'Gastos_Salud, saber y deporte';'Farmacia';'VARIABLES'
26/01/2011;26/01/2011;'BRICOKING TERRASSA';-7,10 €;5.829,08 €;945;-7,10;10.353,17 €;'sin fechas';26/01/2011;'BRICOKING';'Gastos_Vivienda y vehiculo';'Mnto. hogar';'VARIABLES'
26/01/2011;26/01/2011;'CAPRABO';-57,36 €;5.771,72 €;946;-57,36;10.295,81 €;'sin fechas';26/01/2011;'CAPRABO';'Gastos_Compras';'Supermercado';'VARIABLES'
26/01/2011;26/01/2011;'DIETISTA';-62,00 €;5.709,72 €;947;-62,00;10.233,81 €;'sin fechas';26/01/2011;'DIETISTA';'Gastos_Salud, saber y deporte';'Otros Salud';'VARIABLES'
26/01/2011;26/01/2011;'LIMPIEZA';-60,00 €;5.649,72 €;948;-60,00;10.173,81 €;'sin fechas';26/01/2011;'LIMPIEZA';'Gastos_Vivienda y vehiculo';'Serv. domestico';'FIJO'
26/01/2011;26/01/2011;'REINT.CAJERO';-128,00 €;5.521,72 €;949;-128,00;10.045,81 €;'sin fechas';26/01/2011;'REINTCAJERO';'Gastos_Gastos varios';'Efectivo';'VARIABLES'
26/01/2011;26/01/2011;'VIENA';-16,90 €;5.504,82 €;950;-16,90;10.028,91 €;'sin fechas';26/01/2011;'VIENA';'Gastos_Ocio y transporte';'Restaurantes';'VARIABLES'
27/01/2011;27/01/2011;'CAFET.C T PRAT';-0,80 €;5.504,02 €;951;-0,80;10.028,11 €;'sin fechas';27/01/2011;'CAFETC';'Gastos_Ocio y transporte';'Restaurantes';'VARIABLES'
27/01/2011;27/01/2011;'CAFET.C T PRAT';-7,40 €;5.496,62 €;952;-7,40;10.020,71 €;'sin fechas';27/01/2011;'CAFETC';'Gastos_Ocio y transporte';'Restaurantes';'VARIABLES'
27/01/2011;27/01/2011;'FOMENT DE TERRASSA, S.A. FOMEN';1.512,52 €;7.009,14 €;953;1.512,52;11.533,23 €;'sin fechas';27/01/2011;'FOMENT';'Ingresos';'Nomina';'FIJO'
28/01/2011;28/01/2011;'CAFET.C T PRAT';-1,85 €;7.007,29 €;954;-1,85;11.531,38 €;'sin fechas';28/01/2011;'CAFETC';'Gastos_Ocio y transporte';'Restaurantes';'VARIABLES'
28/01/2011;28/01/2011;'EROSKI-[COMIDA]';-28,50 €;6.978,79 €;955;-28,50;11.502,88 €;'sin fechas';28/01/2011;'EROSKICOMIDA';'Gastos_Compras';'Supermercado';'VARIABLES'
28/01/2011;28/01/2011;'INFORMACIO I TECNOLOGIA DE CAT';1.526,18 €;8.504,97 €;956;1.526,18;13.029,06 €;'sin fechas';28/01/2011;'INFORMACIO';'Ingresos';'Nomina';'FIJO'
28/01/2011;28/01/2011;'MOVIL [BEA]';-57,81 €;8.447,16 €;957;-57,81;12.971,25 €;'sin fechas';28/01/2011;'MOVIL';'Gastos_Servicios tipicos';'Telecomunicaciones';'FIJO'
28/01/2011;28/01/2011;'NATURA TERRASSA';-25,90 €;8.421,26 €;958;-25,90;12.945,35 €;'sin fechas';28/01/2011;'NATURA';'Gastos_Salud, saber y deporte';'Estudios';'VARIABLES'
29/01/2011;29/01/2011;'BON AREA';-28,26 €;8.393,00 €;959;-28,26;12.917,09 €;'sin fechas';29/01/2011;'BON';'Gastos_Compras';'Supermercado';'VARIABLES'
29/01/2011;29/01/2011;'TOCINERIES VENTURA';-17,81 €;8.375,19 €;960;-17,81;12.899,28 €;'sin fechas';29/01/2011;'TOCINERIES';'Gastos_Compras';'Supermercado';'VARIABLES'
31/01/2011;31/01/2011;'CAFET.C T PRAT';-1,85 €;8.373,34 €;961;-1,85;12.897,43 €;'sin fechas';31/01/2011;'CAFETC';'Gastos_Ocio y transporte';'Restaurantes';'VARIABLES'
31/01/2011;31/01/2011;'RECIBO PTMOS. 3061-0960001518';-598,03 €;7.775,31 €;962;-598,03;12.299,40 €;'sin fechas';31/01/2011;'RECIBO';'Gastos_Banco y organismos';'Hipoteca';'FIJO'
31/01/2011;31/01/2011;'RECIBO PTMOS. 3061-0960004140';-137,10 €;7.638,21 €;963;-137,10;12.162,30 €;'sin fechas';31/01/2011;'RECIBO';'Gastos_Banco y organismos';'Hipoteca';'FIJO'
01/02/2011;01/02/2011;'AUTOPISTA TERR';-4,15 €;7.634,06 €;964;-4,15;12.158,15 €;'sin fechas';01/02/2011;'AUTOPISTA';'Gastos_Ocio y transporte';'Parking y peaje';'VARIABLES'
01/02/2011;01/02/2011;'CAFET.C T PRAT';-2,40 €;7.631,66 €;965;-2,40;12.155,75 €;'sin fechas';01/02/2011;'CAFETC';'Gastos_Ocio y transporte';'Restaurantes';'VARIABLES'
01/02/2011;01/02/2011;'EROSKI-[COMIDA]';-115,04 €;7.516,62 €;966;-115,04;12.040,71 €;'sin fechas';01/02/2011;'EROSKICOMIDA';'Gastos_Compras';'Supermercado';'VARIABLES'
01/02/2011;01/02/2011;'FARMACIA';-25,05 €;7.491,57 €;967;-25,05;12.015,66 €;'sin fechas';01/02/2011;'FARMACIA';'Gastos_Salud, saber y deporte';'Farmacia';'VARIABLES'
01/02/2011;01/02/2011;'MANTENIMIENTO';-1,50 €;7.490,07 €;968;-1,50;12.014,16 €;'sin fechas';01/02/2011;'MANTENIMIENTO';'Gastos_Banco y organismos';'Cargos banco';'FIJO'
02/02/2011;02/02/2011;'CAFET.C T PRAT';-0,70 €;7.489,37 €;969;-0,70;12.013,46 €;'sin fechas';02/02/2011;'CAFETC';'Gastos_Ocio y transporte';'Restaurantes';'VARIABLES'
02/02/2011;02/02/2011;'E.S. RUBI E 9';-40,00 €;7.449,37 €;970;-40,00;11.973,46 €;'sin fechas';02/02/2011;'RUBI';'Gastos_Ocio y transporte';'Gasolina';'VARIABLES'
02/02/2011;02/02/2011;'FARMACIA';-27,87 €;7.421,50 €;971;-27,87;11.945,59 €;'sin fechas';02/02/2011;'FARMACIA';'Gastos_Salud, saber y deporte';'Farmacia';'VARIABLES'
02/02/2011;02/02/2011;'TOCINERIES VENTURA';-6,83 €;7.414,67 €;972;-6,83;11.938,76 €;'sin fechas';02/02/2011;'TOCINERIES';'Gastos_Compras';'Supermercado';'VARIABLES'
03/02/2011;03/02/2011;'C&A';-24,95 €;7.389,72 €;973;-24,95;11.913,81 €;'sin fechas';03/02/2011;'CA';'Gastos_Compras';'Ropa';'VARIABLES'
03/02/2011;03/02/2011;'CIA.DE SEGUROS AD 006662671613';-73,20 €;7.316,52 €;974;-73,20;11.840,61 €;'sin fechas';03/02/2011;'CIADE';'Gastos_Salud, saber y deporte';'Medico';'VARIABLES'
03/02/2011;03/02/2011;'MOMENTI DI...P\\CORNELL DE';-9,10 €;7.307,42 €;975;-9,10;11.831,51 €;'sin fechas';03/02/2011;'MOMENTI';'Gastos_Ocio y transporte';'Restaurantes';'VARIABLES'
03/02/2011;03/02/2011;'REINT.CAJERO';-30,00 €;7.277,42 €;976;-30,00;11.801,51 €;'sin fechas';03/02/2011;'REINTCAJERO';'Gastos_Gastos varios';'Efectivo';'VARIABLES'
03/02/2011;03/02/2011;'RESTAURANTES';-13,91 €;7.263,51 €;977;-13,91;11.787,60 €;'sin fechas';03/02/2011;'RESTAURANTES';'Gastos_Ocio y transporte';'Restaurantes';'VARIABLES'
04/02/2011;04/02/2011;'CAFET.C T PRAT';-2,05 €;7.261,46 €;978;-2,05;11.785,55 €;'sin fechas';04/02/2011;'CAFETC';'Gastos_Ocio y transporte';'Restaurantes';'VARIABLES'
04/02/2011;04/02/2011;'CARREFOUR-[COMIDA]';-16,78 €;7.244,68 €;979;-16,78;11.768,77 €;'sin fechas';04/02/2011;'CARREFOURCOMIDA';'Gastos_Compras';'Supermercado';'VARIABLES'
04/02/2011;04/02/2011;'MOVIL [BEA]';-20,00 €;7.224,68 €;980;-20,00;11.748,77 €;'sin fechas';04/02/2011;'MOVIL';'Gastos_Servicios tipicos';'Telecomunicaciones';'FIJO'
04/02/2011;04/02/2011;'MOVIL [NESTOR]';-20,00 €;7.204,68 €;981;-20,00;11.728,77 €;'sin fechas';04/02/2011;'MOVIL';'Gastos_Servicios tipicos';'Telecomunicaciones';'FIJO'
05/02/2011;05/02/2011;'BON AREA';-18,79 €;7.185,89 €;982;-18,79;11.709,98 €;'sin fechas';05/02/2011;'BON';'Gastos_Compras';'Supermercado';'VARIABLES'
05/02/2011;05/02/2011;'CREDITO';-42,99 €;7.142,90 €;983;-42,99;11.666,99 €;'sin fechas';05/02/2011;'CREDITO';'No computable';'Recibo Tarjeta';
05/02/2011;05/02/2011;'FARMACIA';-3,12 €;7.139,78 €;984;-3,12;11.663,87 €;'sin fechas';05/02/2011;'FARMACIA';'Gastos_Salud, saber y deporte';'Farmacia';'VARIABLES'
05/02/2011;05/02/2011;'LA BRASA';-55,50 €;7.084,28 €;985;-55,50;11.608,37 €;'sin fechas';05/02/2011;'BRASA';'Gastos_Ocio y transporte';'Restaurantes';'VARIABLES'
08/02/2011;08/02/2011;'CAFET.C T PRAT';-1,90 €;7.082,38 €;986;-1,90;11.606,47 €;'sin fechas';08/02/2011;'CAFETC';'Gastos_Ocio y transporte';'Restaurantes';'VARIABLES'
08/02/2011;08/02/2011;'COMISIONES';-8,00 €;7.074,38 €;987;-8,00;11.598,47 €;'sin fechas';08/02/2011;'COMISIONES';'Gastos_Banco y organismos';'Cargos banco';'FIJO'
08/02/2011;08/02/2011;'ESCOLA BRESSOL EINA';-200,00 €;6.874,38 €;988;-200,00;11.398,47 €;'sin fechas';08/02/2011;'ESCOLA';'Gastos_Salud, saber y deporte';'Estudios';'VARIABLES'
09/02/2011;09/02/2011;'CAFET.C T PRAT';-2,70 €;6.871,68 €;989;-2,70;11.395,77 €;'sin fechas';09/02/2011;'CAFETC';'Gastos_Ocio y transporte';'Restaurantes';'VARIABLES'
09/02/2011;09/02/2011;'TOCINERIES VENTURA';-13,00 €;6.858,68 €;990;-13,00;11.382,77 €;'sin fechas';09/02/2011;'TOCINERIES';'Gastos_Compras';'Supermercado';'VARIABLES'
10/02/2011;10/02/2011;'CAFET.C T PRAT';-1,90 €;6.856,78 €;991;-1,90;11.380,87 €;'sin fechas';10/02/2011;'CAFETC';'Gastos_Ocio y transporte';'Restaurantes';'VARIABLES'
10/02/2011;10/02/2011;'CAFET.C T PRAT';-6,00 €;6.850,78 €;992;-6,00;11.374,87 €;'sin fechas';10/02/2011;'CAFETC';'Gastos_Ocio y transporte';'Restaurantes';'VARIABLES'
10/02/2011;10/02/2011;'CANGUROS';-200,00 €;6.650,78 €;993;-200,00;11.174,87 €;'sin fechas';10/02/2011;'CANGUROS';'Gastos_Salud, saber y deporte';'Estudios';'VARIABLES'
10/02/2011;10/02/2011;'DIETISTA';-60,00 €;6.590,78 €;994;-60,00;11.114,87 €;'sin fechas';10/02/2011;'DIETISTA';'Gastos_Salud, saber y deporte';'Otros Salud';'VARIABLES'
10/02/2011;10/02/2011;'COMISIONES';-1,50 €;6.589,28 €;995;-1,50;11.113,37 €;'sin fechas';10/02/2011;'COMISIONES';'Gastos_Banco y organismos';'Cargos banco';'FIJO'
11/02/2011;11/02/2011;'CAFET.C T PRAT';-2,55 €;6.586,73 €;996;-2,55;11.110,82 €;'sin fechas';11/02/2011;'CAFETC';'Gastos_Ocio y transporte';'Restaurantes';'VARIABLES'
11/02/2011;11/02/2011;'VIDA SANA';-112,32 €;6.474,41 €;997;-112,32;10.998,50 €;'sin fechas';11/02/2011;'VIDA';'Gastos_Salud, saber y deporte';'Belleza';'VARIABLES'
12/02/2011;12/02/2011;'FARMACIA';-4,50 €;6.469,91 €;998;-4,50;10.994,00 €;'sin fechas';12/02/2011;'FARMACIA';'Gastos_Salud, saber y deporte';'Farmacia';'VARIABLES'
12/02/2011;12/02/2011;'LA BRASA';-18,50 €;6.451,41 €;999;-18,50;10.975,50 €;'sin fechas';12/02/2011;'BRASA';'Gastos_Ocio y transporte';'Restaurantes';'VARIABLES'
12/02/2011;12/02/2011;'MERCADONA';-19,87 €;6.431,54 €;1000;-19,87;10.955,63 €;'sin fechas';12/02/2011;'MERCADONA';'Gastos_Compras';'Supermercado';'VARIABLES'
14/02/2011;14/02/2011;'BON AREA';-13,30 €;6.418,24 €;1001;-13,30;10.942,33 €;'sin fechas';14/02/2011;'BON';'Gastos_Compras';'Supermercado';'VARIABLES'
14/02/2011;14/02/2011;'CAFET.C T PRAT';-2,40 €;6.415,84 €;1002;-2,40;10.939,93 €;'sin fechas';14/02/2011;'CAFETC';'Gastos_Ocio y transporte';'Restaurantes';'VARIABLES'
15/02/2011;15/02/2011;'CAFET.C T PRAT';-2,40 €;6.413,44 €;1003;-2,40;10.937,53 €;'sin fechas';15/02/2011;'CAFETC';'Gastos_Ocio y transporte';'Restaurantes';'VARIABLES'
15/02/2011;15/02/2011;'CAFET.C T PRAT';-7,40 €;6.406,04 €;1004;-7,40;10.930,13 €;'sin fechas';15/02/2011;'CAFETC';'Gastos_Ocio y transporte';'Restaurantes';'VARIABLES'
15/02/2011;15/02/2011;'CCM VIDA Y P SEGURO PRESTAMO';-27,69 €;6.378,35 €;1005;-27,69;10.902,44 €;'sin fechas';15/02/2011;'CCM';'Gastos_Seguros';'Seguro vida';'FIJO'
15/02/2011;15/02/2011;'CCM VIDA Y PENSIO 000000493358';-19,40 €;6.358,95 €;1006;-19,40;10.883,04 €;'sin fechas';15/02/2011;'CCM';'Gastos_Seguros';'Seguro vida';'FIJO'
15/02/2011;15/02/2011;'COMISIONES';-23,00 €;6.335,95 €;1007;-23,00;10.860,04 €;'sin fechas';15/02/2011;'COMISIONES';'Gastos_Banco y organismos';'Cargos banco';'FIJO'
15/02/2011;15/02/2011;'E.S. MOLINS \\MOLINS DE REY';-46,44 €;6.289,51 €;1008;-46,44;10.813,60 €;'sin fechas';15/02/2011;'MOLINS';'Gastos_Ocio y transporte';'Gasolina';'VARIABLES'
15/02/2011;15/02/2011;'GAS NATURAL';-223,36 €;6.066,15 €;1009;-223,36;10.590,24 €;'sin fechas';15/02/2011;'GAS';'Gastos_Servicios tipicos';'Gas';'FIJO'
16/02/2011;16/02/2011;'AG.TRIBUT GABRIEL';100,00 €;6.166,15 €;1010;100,00;10.690,24 €;'sin fechas';16/02/2011;'AGTRIBUT';'Ingresos';'Subvenciones';
16/02/2011;16/02/2011;'CAFET.C T PRAT';-2,65 €;6.163,50 €;1011;-2,65;10.687,59 €;'sin fechas';16/02/2011;'CAFETC';'Gastos_Ocio y transporte';'Restaurantes';'VARIABLES'
16/02/2011;16/02/2011;'COMISIONES';-10,00 €;6.153,50 €;1012;-10,00;10.677,59 €;'sin fechas';16/02/2011;'COMISIONES';'Gastos_Banco y organismos';'Cargos banco';'FIJO'
16/02/2011;16/02/2011;'COMISIONES';-8,00 €;6.145,50 €;1013;-8,00;10.669,59 €;'sin fechas';16/02/2011;'COMISIONES';'Gastos_Banco y organismos';'Cargos banco';'FIJO'
16/02/2011;16/02/2011;'JOHN\''S ITALIAN CAF';-16,90 €;6.128,60 €;1014;-16,90;10.652,69 €;'sin fechas';16/02/2011;'JOHNS';'Gastos_Ocio y transporte';'Restaurantes';'VARIABLES'
16/02/2011;16/02/2011;'MERCADONA';-21,45 €;6.107,15 €;1015;-21,45;10.631,24 €;'sin fechas';16/02/2011;'MERCADONA';'Gastos_Compras';'Supermercado';'VARIABLES'
16/02/2011;16/02/2011;'MERCADONA';-102,53 €;6.004,62 €;1016;-102,53;10.528,71 €;'sin fechas';16/02/2011;'MERCADONA';'Gastos_Compras';'Supermercado';'VARIABLES'
17/02/2011;17/02/2011;'CAFET.C T PRAT';-3,10 €;6.001,52 €;1017;-3,10;10.525,61 €;'sin fechas';17/02/2011;'CAFETC';'Gastos_Ocio y transporte';'Restaurantes';'VARIABLES'
18/02/2011;18/02/2011;'AUTOPISTA TERR';-1,25 €;6.000,27 €;1018;-1,25;10.524,36 €;'sin fechas';18/02/2011;'AUTOPISTA';'Gastos_Ocio y transporte';'Parking y peaje';'VARIABLES'
18/02/2011;18/02/2011;'AUTOPISTA TERR';-1,95 €;5.998,32 €;1019;-1,95;10.522,41 €;'sin fechas';18/02/2011;'AUTOPISTA';'Gastos_Ocio y transporte';'Parking y peaje';'VARIABLES'
18/02/2011;18/02/2011;'CAFET.C T PRAT';-3,10 €;5.995,22 €;1020;-3,10;10.519,31 €;'sin fechas';18/02/2011;'CAFETC';'Gastos_Ocio y transporte';'Restaurantes';'VARIABLES'
18/02/2011;18/02/2011;'DIETISTA';-62,00 €;5.933,22 €;1021;-62,00;10.457,31 €;'sin fechas';18/02/2011;'DIETISTA';'Gastos_Salud, saber y deporte';'Otros Salud';'VARIABLES'
18/02/2011;18/02/2011;'FARMACIA';-22,95 €;5.910,27 €;1022;-22,95;10.434,36 €;'sin fechas';18/02/2011;'FARMACIA';'Gastos_Salud, saber y deporte';'Farmacia';'VARIABLES'
18/02/2011;18/02/2011;'FRANCE TELEC ORANGE MOVIL 0211';-8,63 €;5.901,64 €;1023;-8,63;10.425,73 €;'sin fechas';18/02/2011;'FRANCE';'Gastos_Servicios tipicos';'Telecomunicaciones';'FIJO'
18/02/2011;18/02/2011;'GRINZING';-8,50 €;5.893,14 €;1024;-8,50;10.417,23 €;'sin fechas';18/02/2011;'GRINZING';'Gastos_Ocio y transporte';'Restaurantes';'VARIABLES'
18/02/2011;18/02/2011;'LIMPIEZA';-120,00 €;5.773,14 €;1025;-120,00;10.297,23 €;'sin fechas';18/02/2011;'LIMPIEZA';'Gastos_Vivienda y vehiculo';'Serv. domestico';'FIJO'
18/02/2011;18/02/2011;'MOVIL [BEA]';-21,84 €;5.751,30 €;1026;-21,84;10.275,39 €;'sin fechas';18/02/2011;'MOVIL';'Gastos_Servicios tipicos';'Telecomunicaciones';'FIJO'
18/02/2011;18/02/2011;'MOVIL [NESTOR]';-21,84 €;5.729,46 €;1027;-21,84;10.253,55 €;'sin fechas';18/02/2011;'MOVIL';'Gastos_Servicios tipicos';'Telecomunicaciones';'FIJO'
18/02/2011;18/02/2011;'ONO';-96,82 €;5.632,64 €;1028;-96,82;10.156,73 €;'sin fechas';18/02/2011;'ONO';'Gastos_Servicios tipicos';'Telecomunicaciones';'FIJO'
18/02/2011;18/02/2011;'REINT.CAJERO';-18,00 €;5.614,64 €;1029;-18,00;10.138,73 €;'sin fechas';18/02/2011;'REINTCAJERO';'Gastos_Gastos varios';'Efectivo';'VARIABLES'
18/02/2011;18/02/2011;'YVES ROCHER';-43,35 €;5.571,29 €;1030;-43,35;10.095,38 €;'sin fechas';18/02/2011;'YVES';'Gastos_Salud, saber y deporte';'Belleza';'VARIABLES'
19/02/2011;19/02/2011;'VIENA';-9,20 €;5.562,09 €;1031;-9,20;10.086,18 €;'sin fechas';19/02/2011;'VIENA';'Gastos_Ocio y transporte';'Restaurantes';'VARIABLES'
21/02/2011;21/02/2011;'CAFET.C T PRAT';-2,70 €;5.559,39 €;1032;-2,70;10.083,48 €;'sin fechas';21/02/2011;'CAFETC';'Gastos_Ocio y transporte';'Restaurantes';'VARIABLES'
21/02/2011;21/02/2011;'TOCINERIES VENTURA';-27,11 €;5.532,28 €;1033;-27,11;10.056,37 €;'sin fechas';21/02/2011;'TOCINERIES';'Gastos_Compras';'Supermercado';'VARIABLES'
22/02/2011;22/02/2011;'CAFET.C T PRAT';-1,70 €;5.530,58 €;1034;-1,70;10.054,67 €;'sin fechas';22/02/2011;'CAFETC';'Gastos_Ocio y transporte';'Restaurantes';'VARIABLES'
22/02/2011;22/02/2011;'ENDESA ENERG EE_XXI40025545678';-70,53 €;5.460,05 €;1035;-70,53;9.984,14 €;'sin fechas';22/02/2011;'ENDESA';'Gastos_Servicios tipicos';'Electricidad';'FIJO'
22/02/2011;22/02/2011;'MERCADONA';-18,96 €;5.441,09 €;1036;-18,96;9.965,18 €;'sin fechas';22/02/2011;'MERCADONA';'Gastos_Compras';'Supermercado';'VARIABLES'
22/02/2011;22/02/2011;'MUERDE LA PAST\\CORNELLA LLO';-53,75 €;5.387,34 €;1037;-53,75;9.911,43 €;'sin fechas';22/02/2011;'MUERDE';'Gastos_Ocio y transporte';'Restaurantes';'VARIABLES'
22/02/2011;22/02/2011;'SPLAU 1038 \\EL PRAT DE LL';-3,45 €;5.383,89 €;1038;-3,45;9.907,98 €;'sin fechas';22/02/2011;'SPLAU';'Gastos_Ocio y transporte';'Restaurantes';'VARIABLES'
23/02/2011;23/02/2011;'CAFET.C T PRAT';-3,10 €;5.380,79 €;1039;-3,10;9.904,88 €;'sin fechas';23/02/2011;'CAFETC';'Gastos_Ocio y transporte';'Restaurantes';'VARIABLES'
23/02/2011;23/02/2011;'CAFET.C T PRAT';-4,40 €;5.376,39 €;1040;-4,40;9.900,48 €;'sin fechas';23/02/2011;'CAFETC';'Gastos_Ocio y transporte';'Restaurantes';'VARIABLES'
23/02/2011;23/02/2011;'CARREFOUR-[COMIDA]';-37,94 €;5.338,45 €;1041;-37,94;9.862,54 €;'sin fechas';23/02/2011;'CARREFOURCOMIDA';'Gastos_Compras';'Supermercado';'VARIABLES'
23/02/2011;23/02/2011;'DIETISTA';-62,00 €;5.276,45 €;1042;-62,00;9.800,54 €;'sin fechas';23/02/2011;'DIETISTA';'Gastos_Salud, saber y deporte';'Otros Salud';'VARIABLES'
23/02/2011;23/02/2011;'EUROP ASSISTANCE';-26,73 €;5.249,72 €;1043;-26,73;9.773,81 €;'sin fechas';23/02/2011;'EUROP';'No computable';'No computable';'No computable'
23/02/2011;23/02/2011;'MOVIL [BEA]';-20,00 €;5.229,72 €;1044;-20,00;9.753,81 €;'sin fechas';23/02/2011;'MOVIL';'Gastos_Servicios tipicos';'Telecomunicaciones';'FIJO'
23/02/2011;23/02/2011;'MOVIL [BEA]+ [NESTOR]';-98,00 €;5.131,72 €;1045;-98,00;9.655,81 €;'sin fechas';23/02/2011;'MOVIL';'Gastos_Servicios tipicos';'Telecomunicaciones';'FIJO'
23/02/2011;23/02/2011;'MOVIL [NESTOR]';-20,00 €;5.111,72 €;1046;-20,00;9.635,81 €;'sin fechas';23/02/2011;'MOVIL';'Gastos_Servicios tipicos';'Telecomunicaciones';'FIJO'
23/02/2011;23/02/2011;'REINT.CAJERO';-8,00 €;5.103,72 €;1047;-8,00;9.627,81 €;'sin fechas';23/02/2011;'REINTCAJERO';'Gastos_Gastos varios';'Efectivo';'VARIABLES'
23/02/2011;23/02/2011;'SPANAIR';-211,87 €;4.891,85 €;1048;-211,87;9.415,94 €;'sin fechas';23/02/2011;'SPANAIR';'Gastos_Ocio y transporte';'Vacaciones';'VARIABLES'
23/02/2011;23/02/2011;'SPANAIR';-32,87 €;4.858,98 €;1049;-32,87;9.383,07 €;'sin fechas';23/02/2011;'SPANAIR';'Gastos_Ocio y transporte';'Vacaciones';'VARIABLES'
23/02/2011;23/02/2011;'SPANAIR';-211,87 €;4.647,11 €;1050;-211,87;9.171,20 €;'sin fechas';23/02/2011;'SPANAIR';'Gastos_Ocio y transporte';'Vacaciones';'VARIABLES'
24/02/2011;24/02/2011;'CAFET.C T PRAT';-3,10 €;4.644,01 €;1051;-3,10;9.168,10 €;'sin fechas';24/02/2011;'CAFETC';'Gastos_Ocio y transporte';'Restaurantes';'VARIABLES'
24/02/2011;24/02/2011;'ES STA. MARGARITA';-46,81 €;4.597,20 €;1052;-46,81;9.121,29 €;'sin fechas';24/02/2011;'STA';'Gastos_Ocio y transporte';'Gasolina';'VARIABLES'
25/02/2011;25/02/2011;'BONIFICACION';4,31 €;4.601,51 €;1053;4,31;9.125,60 €;'sin fechas';25/02/2011;'BONIFICACION';'Ingresos';'Otros ingresos';'VARIABLES'
25/02/2011;25/02/2011;'CAFET.C T PRAT';-3,05 €;4.598,46 €;1054;-3,05;9.122,55 €;'sin fechas';25/02/2011;'CAFETC';'Gastos_Ocio y transporte';'Restaurantes';'VARIABLES'
25/02/2011;25/02/2011;'FRANCE TELEC ORANGE MOVIL 0211';-6,88 €;4.591,58 €;1055;-6,88;9.115,67 €;'sin fechas';25/02/2011;'FRANCE';'Gastos_Servicios tipicos';'Telecomunicaciones';'FIJO'
25/02/2011;25/02/2011;'INFORMACIO I TECNOLOGIA DE CAT';1.526,20 €;6.117,78 €;1056;1.526,20;10.641,87 €;'sin fechas';25/02/2011;'INFORMACIO';'Ingresos';'Nomina';'FIJO'
25/02/2011;25/02/2011;'TOCINERIES VENTURA';-22,26 €;6.095,52 €;1057;-22,26;10.619,61 €;'sin fechas';25/02/2011;'TOCINERIES';'Gastos_Compras';'Supermercado';'VARIABLES'
26/02/2011;26/02/2011;'LIZARRAN';-17,70 €;6.077,82 €;1058;-17,70;10.601,91 €;'sin fechas';26/02/2011;'LIZARRAN';'Gastos_Ocio y transporte';'Restaurantes';'VARIABLES'
26/02/2011;26/02/2011;'STARBUCKS';-6,50 €;6.071,32 €;1059;-6,50;10.595,41 €;'sin fechas';26/02/2011;'STARBUCKS';'Gastos_Ocio y transporte';'Restaurantes';'VARIABLES'
27/02/2011;27/02/2011;'CALÇOTADA';-40,00 €;6.031,32 €;1060;-40,00;10.555,41 €;'sin fechas';27/02/2011;'CALOTADA';'Gastos_Ocio y transporte';'Restaurantes';'VARIABLES'
27/02/2011;27/02/2011;'DIETISTA';-31,00 €;6.000,32 €;1061;-31,00;10.524,41 €;'sin fechas';27/02/2011;'DIETISTA';'Gastos_Salud, saber y deporte';'Otros Salud';'VARIABLES'
27/02/2011;27/02/2011;'PARKING DIETISTA';-4,60 €;5.995,72 €;1062;-4,60;10.519,81 €;'sin fechas';27/02/2011;'PARKING';'Gastos_Ocio y transporte';'Parking y peaje';'VARIABLES'
27/02/2011;27/02/2011;'REINT.CAJERO';-51,20 €;5.944,52 €;1063;-51,20;10.468,61 €;'sin fechas';27/02/2011;'REINTCAJERO';'Gastos_Gastos varios';'Efectivo';'VARIABLES'
27/02/2011;27/02/2011;'VIENA';-13,00 €;5.931,52 €;1064;-13,00;10.455,61 €;'sin fechas';27/02/2011;'VIENA';'Gastos_Ocio y transporte';'Restaurantes';'VARIABLES'
28/02/2011;28/02/2011;'BON AREA';-19,98 €;5.911,54 €;1065;-19,98;10.435,63 €;'sin fechas';28/02/2011;'BON';'Gastos_Compras';'Supermercado';'VARIABLES'
28/02/2011;28/02/2011;'CAFET.C T PRAT';-3,10 €;5.908,44 €;1066;-3,10;10.432,53 €;'sin fechas';28/02/2011;'CAFETC';'Gastos_Ocio y transporte';'Restaurantes';'VARIABLES'
28/02/2011;28/02/2011;'FOMENT DE TERRASSA, S.A. FOMEN';1.552,36 €;7.460,80 €;1067;1.552,36;11.984,89 €;'sin fechas';28/02/2011;'FOMENT';'Ingresos';'Nomina';'FIJO'
28/02/2011;28/02/2011;'RECIBO PTMOS. 3061-0960001518';-598,03 €;6.862,77 €;1068;-598,03;11.386,86 €;'sin fechas';28/02/2011;'RECIBO';'Gastos_Banco y organismos';'Hipoteca';'FIJO'
28/02/2011;28/02/2011;'RECIBO PTMOS. 3061-0960004140';-137,10 €;6.725,67 €;1069;-137,10;11.249,76 €;'sin fechas';28/02/2011;'RECIBO';'Gastos_Banco y organismos';'Hipoteca';'FIJO'
01/03/2011;01/03/2011;'AJUNTAMENT DE TER 010000520716';-37,18 €;6.688,49 €;1070;-37,18;11.212,58 €;'sin fechas';01/03/2011;'AJUNTAMENT';'Gastos_Banco y organismos';'Ayuntamiento';'FIJO'
01/03/2011;01/03/2011;'AUTOPISTA TERR';-2,25 €;6.686,24 €;1071;-2,25;11.210,33 €;'sin fechas';01/03/2011;'AUTOPISTA';'Gastos_Ocio y transporte';'Parking y peaje';'VARIABLES'
01/03/2011;01/03/2011;'CAFET.C T PRAT';-2,60 €;6.683,64 €;1072;-2,60;11.207,73 €;'sin fechas';01/03/2011;'CAFETC';'Gastos_Ocio y transporte';'Restaurantes';'VARIABLES'
01/03/2011;01/03/2011;'CIA.DE SEGUROS AD 006662671613';-73,20 €;6.610,44 €;1073;-73,20;11.134,53 €;'sin fechas';01/03/2011;'CIADE';'Gastos_Salud, saber y deporte';'Medico';'VARIABLES'
01/03/2011;01/03/2011;'MANTENIMIENTO';-1,50 €;6.608,94 €;1074;-1,50;11.133,03 €;'sin fechas';01/03/2011;'MANTENIMIENTO';'Gastos_Banco y organismos';'Cargos banco';'FIJO'
02/03/2011;02/03/2011;'CAFET.C T PRAT';-3,10 €;6.605,84 €;1075;-3,10;11.129,93 €;'sin fechas';02/03/2011;'CAFETC';'Gastos_Ocio y transporte';'Restaurantes';'VARIABLES'
03/03/2011;03/03/2011;'BRICOKING TERRASSA';-29,95 €;6.575,89 €;1076;-29,95;11.099,98 €;'sin fechas';03/03/2011;'BRICOKING';'Gastos_Vivienda y vehiculo';'Mnto. hogar';'VARIABLES'
03/03/2011;03/03/2011;'CAFET.C T PRAT';-3,25 €;6.572,64 €;1077;-3,25;11.096,73 €;'sin fechas';03/03/2011;'CAFETC';'Gastos_Ocio y transporte';'Restaurantes';'VARIABLES'
03/03/2011;03/03/2011;'FF.CC.GENERALITAT';-20,00 €;6.552,64 €;1078;-20,00;11.076,73 €;'sin fechas';03/03/2011;'FFCCGENERALITAT';'Gastos_Ocio y transporte';'Transporte';'VARIABLES'
03/03/2011;03/03/2011;'GRINZING';-14,00 €;6.538,64 €;1079;-14,00;11.062,73 €;'sin fechas';03/03/2011;'GRINZING';'Gastos_Ocio y transporte';'Restaurantes';'VARIABLES'
03/03/2011;03/03/2011;'REINT.CAJERO';-166,00 €;6.372,64 €;1080;-166,00;10.896,73 €;'sin fechas';03/03/2011;'REINTCAJERO';'Gastos_Gastos varios';'Efectivo';'VARIABLES'
03/03/2011;03/03/2011;'TOCINERIES VENTURA';-20,58 €;6.352,06 €;1081;-20,58;10.876,15 €;'sin fechas';03/03/2011;'TOCINERIES';'Gastos_Compras';'Supermercado';'VARIABLES'
04/03/2011;04/03/2011;'ALCAMPO';-37,48 €;6.314,58 €;1082;-37,48;10.838,67 €;'sin fechas';04/03/2011;'ALCAMPO';'Gastos_Compras';'Supermercado';'VARIABLES'
04/03/2011;04/03/2011;'CAFET.C T PRAT';-3,40 €;6.311,18 €;1083;-3,40;10.835,27 €;'sin fechas';04/03/2011;'CAFETC';'Gastos_Ocio y transporte';'Restaurantes';'VARIABLES'
04/03/2011;04/03/2011;'EL CORTE INGLES';-100,00 €;6.211,18 €;1084;-100,00;10.735,27 €;'sin fechas';04/03/2011;'CORTE';'Gastos_Compras';'Supermercado';'VARIABLES'
04/03/2011;04/03/2011;'EL CORTE INGLES';-43,00 €;6.168,18 €;1085;-43,00;10.692,27 €;'sin fechas';04/03/2011;'CORTE';'Gastos_Compras';'Supermercado';'VARIABLES'
04/03/2011;04/03/2011;'KUROKAI';-19,99 €;6.148,19 €;1086;-19,99;10.672,28 €;'sin fechas';04/03/2011;'KUROKAI';'Gastos_Compras';'Ropa';'VARIABLES'
04/03/2011;04/03/2011;'VIENA';-15,45 €;6.132,74 €;1087;-15,45;10.656,83 €;'sin fechas';04/03/2011;'VIENA';'Gastos_Ocio y transporte';'Restaurantes';'VARIABLES'
04/03/2011;04/03/2011;'XFERA MOVILES SA 2767906';-5,79 €;6.126,95 €;1088;-5,79;10.651,04 €;'sin fechas';04/03/2011;'XFERA';'Gastos_Servicios tipicos';'Telecomunicaciones';'FIJO'
05/03/2011;05/03/2011;'AUTOPISTA TERR';-4,40 €;6.122,55 €;1089;-4,40;10.646,64 €;'sin fechas';05/03/2011;'AUTOPISTA';'Gastos_Ocio y transporte';'Parking y peaje';'VARIABLES'
05/03/2011;05/03/2011;'COM. MANT. ACTIVAS DE LIQ.';-3,85 €;6.118,70 €;1090;-3,85;10.642,79 €;'sin fechas';05/03/2011;'COM';'Gastos_Banco y organismos';'Cargos banco';'FIJO'
05/03/2011;05/03/2011;'CREDITO';-56,54 €;6.062,16 €;1091;-56,54;10.586,25 €;'sin fechas';05/03/2011;'CREDITO';'No computable';'Recibo Tarjeta';
05/03/2011;05/03/2011;'DETEMPLE';-40,00 €;6.022,16 €;1092;-40,00;10.546,25 €;'sin fechas';05/03/2011;'DETEMPLE';'Gastos_Ocio y transporte';'Gasolina';'VARIABLES'
05/03/2011;05/03/2011;'IMP.RET.A CTA';-0,03 €;6.022,13 €;1093;-0,03;10.546,22 €;'sin fechas';05/03/2011;'IMPRETA';'Gastos_Banco y organismos';'Impuestos';'FIJO'
05/03/2011;05/03/2011;'INTERESES';0,14 €;6.022,27 €;1094;0,14;10.546,36 €;'sin fechas';05/03/2011;'INTERESES';'Ingresos';'Rendimientos';
05/03/2011;05/03/2011;'LA BRASA';-52,49 €;5.969,78 €;1095;-52,49;10.493,87 €;'sin fechas';05/03/2011;'BRASA';'Gastos_Ocio y transporte';'Restaurantes';'VARIABLES'
05/03/2011;05/03/2011;'TOCINERIES VENTURA';-25,37 €;5.944,41 €;1096;-25,37;10.468,50 €;'sin fechas';05/03/2011;'TOCINERIES';'Gastos_Compras';'Supermercado';'VARIABLES'
05/03/2011;05/03/2011;'YVES ROCHER';-55,15 €;5.889,26 €;1097;-55,15;10.413,35 €;'sin fechas';05/03/2011;'YVES';'Gastos_Salud, saber y deporte';'Belleza';'VARIABLES'
06/03/2011;06/03/2011;'LA BRASA';-49,18 €;5.840,08 €;1098;-49,18;10.364,17 €;'sin fechas';06/03/2011;'BRASA';'Gastos_Ocio y transporte';'Restaurantes';'VARIABLES'
08/03/2011;08/03/2011;'ES STA. MARGARITA';-40,00 €;5.800,08 €;1099;-40,00;10.324,17 €;'sin fechas';08/03/2011;'STA';'Gastos_Ocio y transporte';'Gasolina';'VARIABLES'
09/03/2011;09/03/2011;'CAFET.C T PRAT';-3,25 €;5.796,83 €;1100;-3,25;10.320,92 €;'sin fechas';09/03/2011;'CAFETC';'Gastos_Ocio y transporte';'Restaurantes';'VARIABLES'
09/03/2011;09/03/2011;'DUIT\''S C.B. \\EL PRAT DE LL';-10,00 €;5.786,83 €;1101;-10,00;10.310,92 €;'sin fechas';09/03/2011;'DUITS';'Gastos_Ocio y transporte';'Restaurantes';'VARIABLES'
09/03/2011;09/03/2011;'ONO';-18,84 €;5.767,99 €;1102;-18,84;10.292,08 €;'sin fechas';09/03/2011;'ONO';'Gastos_Servicios tipicos';'Telecomunicaciones';'FIJO'
09/03/2011;09/03/2011;'ONO';-4,12 €;5.763,87 €;1103;-4,12;10.287,96 €;'sin fechas';09/03/2011;'ONO';'Gastos_Servicios tipicos';'Telecomunicaciones';'FIJO'
09/03/2011;09/03/2011;'VIDA SANA';-112,32 €;5.651,55 €;1104;-112,32;10.175,64 €;'sin fechas';09/03/2011;'VIDA';'Gastos_Salud, saber y deporte';'Belleza';'VARIABLES'
10/03/2011;10/03/2011;'CAFET.C T PRAT';-3,10 €;5.648,45 €;1105;-3,10;10.172,54 €;'sin fechas';10/03/2011;'CAFETC';'Gastos_Ocio y transporte';'Restaurantes';'VARIABLES'
10/03/2011;10/03/2011;'TOCINERIES VENTURA';-17,29 €;5.631,16 €;1106;-17,29;10.155,25 €;'sin fechas';10/03/2011;'TOCINERIES';'Gastos_Compras';'Supermercado';'VARIABLES'
11/03/2011;11/03/2011;'AKI 104 - TERRASSA';-15,45 €;5.615,71 €;1107;-15,45;10.139,80 €;'sin fechas';11/03/2011;'AKI';'Gastos_Vivienda y vehiculo';'Mnto. hogar';'VARIABLES'
11/03/2011;11/03/2011;'CAFET.C T PRAT';-3,40 €;5.612,31 €;1108;-3,40;10.136,40 €;'sin fechas';11/03/2011;'CAFETC';'Gastos_Ocio y transporte';'Restaurantes';'VARIABLES'
11/03/2011;11/03/2011;'CARREFOUR-[MODA]';-18,00 €;5.594,31 €;1109;-18,00;10.118,40 €;'sin fechas';11/03/2011;'CARREFOURMODA';'Gastos_Compras';'Supermercado';'VARIABLES'
11/03/2011;11/03/2011;'MERCADONA';-152,94 €;5.441,37 €;1110;-152,94;9.965,46 €;'sin fechas';11/03/2011;'MERCADONA';'Gastos_Compras';'Supermercado';'VARIABLES'
12/03/2011;12/03/2011;'AUTOPISTA TERR';-0,70 €;5.440,67 €;1111;-0,70;9.964,76 €;'sin fechas';12/03/2011;'AUTOPISTA';'Gastos_Ocio y transporte';'Parking y peaje';'VARIABLES'
14/03/2011;14/03/2011;'CAFET.C T PRAT';-3,10 €;5.437,57 €;1112;-3,10;9.961,66 €;'sin fechas';14/03/2011;'CAFETC';'Gastos_Ocio y transporte';'Restaurantes';'VARIABLES'
14/03/2011;14/03/2011;'FARMACIA';-24,16 €;5.413,41 €;1113;-24,16;9.937,50 €;'sin fechas';14/03/2011;'FARMACIA';'Gastos_Salud, saber y deporte';'Farmacia';'VARIABLES'
15/03/2011;15/03/2011;'CAFET.C T PRAT';-3,40 €;5.410,01 €;1114;-3,40;9.934,10 €;'sin fechas';15/03/2011;'CAFETC';'Gastos_Ocio y transporte';'Restaurantes';'VARIABLES'
15/03/2011;15/03/2011;'CCM VIDA Y P SEGURO PRESTAMO';-27,62 €;5.382,39 €;1115;-27,62;9.906,48 €;'sin fechas';15/03/2011;'CCM';'Gastos_Seguros';'Seguro vida';'FIJO'
15/03/2011;15/03/2011;'CCM VIDA Y PENSIO 000000493358';-19,35 €;5.363,04 €;1116;-19,35;9.887,13 €;'sin fechas';15/03/2011;'CCM';'Gastos_Seguros';'Seguro vida';'FIJO'
15/03/2011;15/03/2011;'MERCADONA';-34,01 €;5.329,03 €;1117;-34,01;9.853,12 €;'sin fechas';15/03/2011;'MERCADONA';'Gastos_Compras';'Supermercado';'VARIABLES'
16/03/2011;16/03/2011;'CAFET.C T PRAT';-2,75 €;5.326,28 €;1118;-2,75;9.850,37 €;'sin fechas';16/03/2011;'CAFETC';'Gastos_Ocio y transporte';'Restaurantes';'VARIABLES'
16/03/2011;16/03/2011;'CAFET.C T PRAT';-8,60 €;5.317,68 €;1119;-8,60;9.841,77 €;'sin fechas';16/03/2011;'CAFETC';'Gastos_Ocio y transporte';'Restaurantes';'VARIABLES'
16/03/2011;16/03/2011;'CAPRABO';-32,72 €;5.284,96 €;1120;-32,72;9.809,05 €;'sin fechas';16/03/2011;'CAPRABO';'Gastos_Compras';'Supermercado';'VARIABLES'
16/03/2011;16/03/2011;'CAPRABO';-9,97 €;5.274,99 €;1121;-9,97;9.799,08 €;'sin fechas';16/03/2011;'CAPRABO';'Gastos_Compras';'Supermercado';'VARIABLES'
16/03/2011;16/03/2011;'ES STA. MARGARITA';-47,23 €;5.227,76 €;1122;-47,23;9.751,85 €;'sin fechas';16/03/2011;'STA';'Gastos_Ocio y transporte';'Gasolina';'VARIABLES'
17/03/2011;17/03/2011;'AG.TRIBUT GABRIEL';100,00 €;5.327,76 €;1123;100,00;9.851,85 €;'sin fechas';17/03/2011;'AGTRIBUT';'Ingresos';'Subvenciones';
17/03/2011;17/03/2011;'CERTIO ITV VIL\\VILADECAVALL';-44,00 €;5.283,76 €;1124;-44,00;9.807,85 €;'sin fechas';17/03/2011;'CERTIO';'Gastos_Vivienda y vehiculo';'Mnto. vehiculo';'VARIABLE'
17/03/2011;17/03/2011;'ONO';-92,36 €;5.191,40 €;1125;-92,36;9.715,49 €;'sin fechas';17/03/2011;'ONO';'Gastos_Servicios tipicos';'Telecomunicaciones';'FIJO'
18/03/2011;18/03/2011;'CAFET.C T PRAT';-3,90 €;5.187,50 €;1126;-3,90;9.711,59 €;'sin fechas';18/03/2011;'CAFETC';'Gastos_Ocio y transporte';'Restaurantes';'VARIABLES'
18/03/2011;18/03/2011;'FARMACIA';-6,56 €;5.180,94 €;1127;-6,56;9.705,03 €;'sin fechas';18/03/2011;'FARMACIA';'Gastos_Salud, saber y deporte';'Farmacia';'VARIABLES'
18/03/2011;18/03/2011;'TOCINERIES VENTURA';-19,54 €;5.161,40 €;1128;-19,54;9.685,49 €;'sin fechas';18/03/2011;'TOCINERIES';'Gastos_Compras';'Supermercado';'VARIABLES'
19/03/2011;19/03/2011;'BOLIN SHIJIA, SCP';-30,60 €;5.130,80 €;1129;-30,60;9.654,89 €;'sin fechas';19/03/2011;'BOLIN';'Gastos_Ocio y transporte';'Restaurantes';'VARIABLES'
19/03/2011;19/03/2011;'COCHE&PARKING';-4,50 €;5.126,30 €;1130;-4,50;9.650,39 €;'sin fechas';19/03/2011;'COCHEPARKING';'Gastos_Ocio y transporte';'Parking y peaje';'VARIABLES'
19/03/2011;19/03/2011;'EL TALLER';-8,70 €;5.117,60 €;1131;-8,70;9.641,69 €;'sin fechas';19/03/2011;'TALLER';'Gastos_Ocio y transporte';'Espectáculos';'VARIABLES'
20/03/2011;20/03/2011;'VIENA';-4,95 €;5.112,65 €;1132;-4,95;9.636,74 €;'sin fechas';20/03/2011;'VIENA';'Gastos_Ocio y transporte';'Restaurantes';'VARIABLES'
21/03/2011;21/03/2011;'CAFET.C T PRAT';-3,10 €;5.109,55 €;1133;-3,10;9.633,64 €;'sin fechas';21/03/2011;'CAFETC';'Gastos_Ocio y transporte';'Restaurantes';'VARIABLES'
21/03/2011;21/03/2011;'CANGUROS';-200,00 €;4.909,55 €;1134;-200,00;9.433,64 €;'sin fechas';21/03/2011;'CANGUROS';'Gastos_Salud, saber y deporte';'Estudios';'VARIABLES'
21/03/2011;21/03/2011;'ENDESA ENERG EE_XXI40025545678';-98,47 €;4.811,08 €;1135;-98,47;9.335,17 €;'sin fechas';21/03/2011;'ENDESA';'Gastos_Servicios tipicos';'Electricidad';'FIJO'
21/03/2011;21/03/2011;'REINT.CAJERO';-100,00 €;4.711,08 €;1136;-100,00;9.235,17 €;'sin fechas';21/03/2011;'REINTCAJERO';'Gastos_Gastos varios';'Efectivo';'VARIABLES'
22/03/2011;22/03/2011;'BON AREA';-24,38 €;4.686,70 €;1137;-24,38;9.210,79 €;'sin fechas';22/03/2011;'BON';'Gastos_Compras';'Supermercado';'VARIABLES'
22/03/2011;22/03/2011;'CAFET.C T PRAT';-3,10 €;4.683,60 €;1138;-3,10;9.207,69 €;'sin fechas';22/03/2011;'CAFETC';'Gastos_Ocio y transporte';'Restaurantes';'VARIABLES'
23/03/2011;23/03/2011;'CAFET.C T PRAT';-3,10 €;4.680,50 €;1139;-3,10;9.204,59 €;'sin fechas';23/03/2011;'CAFETC';'Gastos_Ocio y transporte';'Restaurantes';'VARIABLES'
23/03/2011;23/03/2011;'CAFET.C T PRAT';-7,40 €;4.673,10 €;1140;-7,40;9.197,19 €;'sin fechas';23/03/2011;'CAFETC';'Gastos_Ocio y transporte';'Restaurantes';'VARIABLES'
23/03/2011;23/03/2011;'DIETISTA';-62,00 €;4.611,10 €;1141;-62,00;9.135,19 €;'sin fechas';23/03/2011;'DIETISTA';'Gastos_Salud, saber y deporte';'Otros Salud';'VARIABLES'
23/03/2011;23/03/2011;'REINT.CAJERO';-38,00 €;4.573,10 €;1142;-38,00;9.097,19 €;'sin fechas';23/03/2011;'REINTCAJERO';'Gastos_Gastos varios';'Efectivo';'VARIABLES'
24/03/2011;24/03/2011;'CAFET.C T PRAT';-3,10 €;4.570,00 €;1143;-3,10;9.094,09 €;'sin fechas';24/03/2011;'CAFETC';'Gastos_Ocio y transporte';'Restaurantes';'VARIABLES'
24/03/2011;24/03/2011;'MINA PUBLICA AIGUES T.01A75789';-39,49 €;4.530,51 €;1144;-39,49;9.054,60 €;'sin fechas';24/03/2011;'MINA';'Gastos_Servicios tipicos';'Agua';'FIJO'
25/03/2011;25/03/2011;'BOLIN SHIJIA, SCP';-8,25 €;4.522,26 €;1145;-8,25;9.046,35 €;'sin fechas';25/03/2011;'BOLIN';'Gastos_Ocio y transporte';'Restaurantes';'VARIABLES'
25/03/2011;25/03/2011;'CAFET.C T PRAT';-3,40 €;4.518,86 €;1146;-3,40;9.042,95 €;'sin fechas';25/03/2011;'CAFETC';'Gastos_Ocio y transporte';'Restaurantes';'VARIABLES'
25/03/2011;25/03/2011;'FOMENT DE TERRASSA, S.A. FOMEN';1.551,53 €;6.070,39 €;1147;1.551,53;10.594,48 €;'sin fechas';25/03/2011;'FOMENT';'Ingresos';'Nomina';'FIJO'
25/03/2011;25/03/2011;'OCIO&RESTAURANTE';-25,00 €;6.045,39 €;1148;-25,00;10.569,48 €;'sin fechas';25/03/2011;'OCIORESTAURANTE';'Gastos_Ocio y transporte';'Restaurantes';'VARIABLES'
25/03/2011;25/03/2011;'REINT.CAJERO';-6,00 €;6.039,39 €;1149;-6,00;10.563,48 €;'sin fechas';25/03/2011;'REINTCAJERO';'Gastos_Gastos varios';'Efectivo';'VARIABLES'
26/03/2011;26/03/2011;'BCN HERON CITY';-19,00 €;6.020,39 €;1150;-19,00;10.544,48 €;'sin fechas';26/03/2011;'BCN';'Gastos_Vivienda y vehiculo';'Mnto. vehiculo';'VARIABLE'
26/03/2011;26/03/2011;'BON AREA';-11,33 €;6.009,06 €;1151;-11,33;10.533,15 €;'sin fechas';26/03/2011;'BON';'Gastos_Compras';'Supermercado';'VARIABLES'
26/03/2011;26/03/2011;'EL CORTE INGLES';-39,00 €;5.970,06 €;1152;-39,00;10.494,15 €;'sin fechas';26/03/2011;'CORTE';'Gastos_Compras';'Supermercado';'VARIABLES'
26/03/2011;26/03/2011;'FARMACIA';-28,25 €;5.941,81 €;1153;-28,25;10.465,90 €;'sin fechas';26/03/2011;'FARMACIA';'Gastos_Salud, saber y deporte';'Farmacia';'VARIABLES'
26/03/2011;26/03/2011;'INTERKITS';-19,99 €;5.921,82 €;1154;-19,99;10.445,91 €;'sin fechas';26/03/2011;'INTERKITS';'Gastos_Compras';'Niños';'VARIABLES'
26/03/2011;26/03/2011;'JINNAM EUROPA SL';-18,50 €;5.903,32 €;1155;-18,50;10.427,41 €;'sin fechas';26/03/2011;'JINNAM';'Gastos_Ocio y transporte';'Restaurantes';'VARIABLES'
26/03/2011;26/03/2011;'WEST GATE S L';-49,90 €;5.853,42 €;1156;-49,90;10.377,51 €;'sin fechas';26/03/2011;'WEST';'Gastos_Compras';'Hogar';'VARIABLES'
27/03/2011;27/03/2011;'ES STA. MARGARITA';-43,07 €;5.810,35 €;1157;-43,07;10.334,44 €;'sin fechas';27/03/2011;'STA';'Gastos_Ocio y transporte';'Gasolina';'VARIABLES'
27/03/2011;27/03/2011;'VIENA';-15,45 €;5.794,90 €;1158;-15,45;10.318,99 €;'sin fechas';27/03/2011;'VIENA';'Gastos_Ocio y transporte';'Restaurantes';'VARIABLES'
28/03/2011;28/03/2011;'CAFET.C T PRAT';-3,10 €;5.791,80 €;1159;-3,10;10.315,89 €;'sin fechas';28/03/2011;'CAFETC';'Gastos_Ocio y transporte';'Restaurantes';'VARIABLES'
28/03/2011;28/03/2011;'QUEVIURES MANUEL S';-13,88 €;5.777,92 €;1160;-13,88;10.302,01 €;'sin fechas';28/03/2011;'QUEVIURES';'Gastos_Compras';'Supermercado';'VARIABLES'
29/03/2011;29/03/2011;'CAFET.C T PRAT';-2,90 €;5.775,02 €;1161;-2,90;10.299,11 €;'sin fechas';29/03/2011;'CAFETC';'Gastos_Ocio y transporte';'Restaurantes';'VARIABLES'
30/03/2011;30/03/2011;'BON AREA';-8,33 €;5.766,69 €;1162;-8,33;10.290,78 €;'sin fechas';30/03/2011;'BON';'Gastos_Compras';'Supermercado';'VARIABLES'
30/03/2011;30/03/2011;'CAFET.C T PRAT';-3,10 €;5.763,59 €;1163;-3,10;10.287,68 €;'sin fechas';30/03/2011;'CAFETC';'Gastos_Ocio y transporte';'Restaurantes';'VARIABLES'
30/03/2011;30/03/2011;'INFORMACIO I TECNOLOGIA DE CAT';1.526,20 €;7.289,79 €;1164;1.526,20;11.813,88 €;'sin fechas';30/03/2011;'INFORMACIO';'Ingresos';'Nomina';'FIJO'
30/03/2011;30/03/2011;'LIMPIEZA';-150,00 €;7.139,79 €;1165;-150,00;11.663,88 €;'sin fechas';30/03/2011;'LIMPIEZA';'Gastos_Vivienda y vehiculo';'Serv. domestico';'FIJO'
30/03/2011;30/03/2011;'MERCADONA';-179,24 €;6.960,55 €;1166;-179,24;11.484,64 €;'sin fechas';30/03/2011;'MERCADONA';'Gastos_Compras';'Supermercado';'VARIABLES'
31/03/2011;31/03/2011;'CAFET.C T PRAT';-3,10 €;6.957,45 €;1167;-3,10;11.481,54 €;'sin fechas';31/03/2011;'CAFETC';'Gastos_Ocio y transporte';'Restaurantes';'VARIABLES'
31/03/2011;31/03/2011;'RECIBO PTMOS. 3061-0960001518';-598,03 €;6.359,42 €;1168;-598,03;10.883,51 €;'sin fechas';31/03/2011;'RECIBO';'Gastos_Banco y organismos';'Hipoteca';'FIJO'
31/03/2011;31/03/2011;'RECIBO PTMOS. 3061-0960004140';-137,10 €;6.222,32 €;1169;-137,10;10.746,41 €;'sin fechas';31/03/2011;'RECIBO';'Gastos_Banco y organismos';'Hipoteca';'FIJO'
31/03/2011;31/03/2011;'TOCINERIES VENTURA';-16,07 €;6.206,25 €;1170;-16,07;10.730,34 €;'sin fechas';31/03/2011;'TOCINERIES';'Gastos_Compras';'Supermercado';'VARIABLES'
01/04/2011;01/04/2011;'AJUNTAMENT DE TER 010000520716';-37,18 €;6.169,07 €;1171;-37,18;10.693,16 €;'sin fechas';01/04/2011;'AJUNTAMENT';'Gastos_Banco y organismos';'Ayuntamiento';'FIJO'
01/04/2011;01/04/2011;'CAFET.C T PRAT';-3,40 €;6.165,67 €;1172;-3,40;10.689,76 €;'sin fechas';01/04/2011;'CAFETC';'Gastos_Ocio y transporte';'Restaurantes';'VARIABLES'
01/04/2011;01/04/2011;'CIA.DE SEGUROS AD 006662671613';-73,20 €;6.092,47 €;1173;-73,20;10.616,56 €;'sin fechas';01/04/2011;'CIADE';'Gastos_Salud, saber y deporte';'Medico';'VARIABLES'
01/04/2011;01/04/2011;'MANTENIMIENTO';-1,50 €;6.090,97 €;1174;-1,50;10.615,06 €;'sin fechas';01/04/2011;'MANTENIMIENTO';'Gastos_Banco y organismos';'Cargos banco';'FIJO'
01/04/2011;01/04/2011;'REINT.CAJERO';-50,00 €;6.040,97 €;1175;-50,00;10.565,06 €;'sin fechas';01/04/2011;'REINTCAJERO';'Gastos_Gastos varios';'Efectivo';'VARIABLES'
01/04/2011;01/04/2011;'TOCINERIES VENTURA';-12,93 €;6.028,04 €;1176;-12,93;10.552,13 €;'sin fechas';01/04/2011;'TOCINERIES';'Gastos_Compras';'Supermercado';'VARIABLES'
02/04/2011;02/04/2011;'CINESA HERON CITY';-24,30 €;6.003,74 €;1177;-24,30;10.527,83 €;'sin fechas';02/04/2011;'CINESA';'Gastos_Ocio y transporte';'Espectáculos';'VARIABLES'
02/04/2011;02/04/2011;'H&M';-20,00 €;5.983,74 €;1178;-20,00;10.507,83 €;'sin fechas';02/04/2011;'HM';'Gastos_Compras';'Ropa';'VARIABLES'
02/04/2011;02/04/2011;'SENSUALOVE';-52,45 €;5.931,29 €;1179;-52,45;10.455,38 €;'sin fechas';02/04/2011;'SENSUALOVE';'Gastos_Compras';'Otras compras';'VARIABLES'
02/04/2011;02/04/2011;'STARBUCKS';-8,00 €;5.923,29 €;1180;-8,00;10.447,38 €;'sin fechas';02/04/2011;'STARBUCKS';'Gastos_Ocio y transporte';'Restaurantes';'VARIABLES'
04/04/2011;04/04/2011;'CAFET.C T PRAT';-3,10 €;5.920,19 €;1181;-3,10;10.444,28 €;'sin fechas';04/04/2011;'CAFETC';'Gastos_Ocio y transporte';'Restaurantes';'VARIABLES'
05/04/2011;05/04/2011;'CAFET.C T PRAT';-2,95 €;5.917,24 €;1182;-2,95;10.441,33 €;'sin fechas';05/04/2011;'CAFETC';'Gastos_Ocio y transporte';'Restaurantes';'VARIABLES'
05/04/2011;05/04/2011;'CREDITO';-31,04 €;5.886,20 €;1183;-31,04;10.410,29 €;'sin fechas';05/04/2011;'CREDITO';'No computable';'Recibo Tarjeta';
05/04/2011;05/04/2011;'GRINZING';-17,50 €;5.868,70 €;1184;-17,50;10.392,79 €;'sin fechas';05/04/2011;'GRINZING';'Gastos_Ocio y transporte';'Restaurantes';'VARIABLES'
05/04/2011;05/04/2011;'H&M';-34,80 €;5.833,90 €;1185;-34,80;10.357,99 €;'sin fechas';05/04/2011;'HM';'Gastos_Compras';'Ropa';'VARIABLES'
05/04/2011;05/04/2011;'MERCADONA';-11,93 €;5.821,97 €;1186;-11,93;10.346,06 €;'sin fechas';05/04/2011;'MERCADONA';'Gastos_Compras';'Supermercado';'VARIABLES'
05/04/2011;05/04/2011;'SEGUROS CATALANA';-293,04 €;5.528,93 €;1187;-293,04;10.053,02 €;'sin fechas';05/04/2011;'CATALANA';'Gastos_Ocio y transporte';'Parking y peaje';'VARIABLES'
05/04/2011;05/04/2011;'TOCINERIES VENTURA';-12,02 €;5.516,91 €;1188;-12,02;10.041,00 €;'sin fechas';05/04/2011;'TOCINERIES';'Gastos_Compras';'Supermercado';'VARIABLES'
05/04/2011;05/04/2011;'VILAR RURAL';-67,00 €;5.449,91 €;1189;-67,00;9.974,00 €;'sin fechas';05/04/2011;'VILAR';'Gastos_Ocio y transporte';'Vacaciones';'VARIABLES'
05/04/2011;05/04/2011;'XFERA MOVILES SA 2767906';-22,63 €;5.427,28 €;1190;-22,63;9.951,37 €;'sin fechas';05/04/2011;'XFERA';'Gastos_Servicios tipicos';'Telecomunicaciones';'FIJO'
05/04/2011;05/04/2011;'Z TERRASSA';-9,95 €;5.417,33 €;1191;-9,95;9.941,42 €;'sin fechas';05/04/2011;'ZTERASSA';'Gastos_Compras';'Ropa';'VARIABLES'
06/04/2011;06/04/2011;'CAFET.C T PRAT';-3,10 €;5.414,23 €;1192;-3,10;9.938,32 €;'sin fechas';06/04/2011;'CAFETC';'Gastos_Ocio y transporte';'Restaurantes';'VARIABLES'
06/04/2011;06/04/2011;'DIETISTA';-62,00 €;5.352,23 €;1193;-62,00;9.876,32 €;'sin fechas';06/04/2011;'DIETISTA';'Gastos_Salud, saber y deporte';'Otros Salud';'VARIABLES'
06/04/2011;06/04/2011;'DUIT\''S C.B. \\EL PRAT DE LL';-10,00 €;5.342,23 €;1194;-10,00;9.866,32 €;'sin fechas';06/04/2011;'DUITS';'Gastos_Ocio y transporte';'Restaurantes';'VARIABLES'
06/04/2011;06/04/2011;'FRUTERIA';-10,00 €;5.332,23 €;1195;-10,00;9.856,32 €;'sin fechas';06/04/2011;'FRUTERIA';'Gastos_Compras';'Supermercado';'VARIABLES'
06/04/2011;06/04/2011;'GASOLINERA';-20,00 €;5.312,23 €;1196;-20,00;9.836,32 €;'sin fechas';06/04/2011;'GASOLINERA';'Gastos_Ocio y transporte';'Gasolina';'VARIABLES'
06/04/2011;06/04/2011;'REINT.CAJERO';-28,00 €;5.284,23 €;1197;-28,00;9.808,32 €;'sin fechas';06/04/2011;'REINTCAJERO';'Gastos_Gastos varios';'Efectivo';'VARIABLES'
07/04/2011;07/04/2011;'TRANSFAVOR 3061.1990014513 00001';9.000,00 €;14.284,23 €;1198;9.000,00;18.808,32 €;'sin fechas';07/04/2011;'TRANSFAVOR';'Ingresos';'Transferencias';'VARIABLES'
07/04/2011;07/04/2011;'AUTOPISTA TERR';-1,25 €;14.282,98 €;1199;-1,25;18.807,07 €;'sin fechas';07/04/2011;'AUTOPISTA';'Gastos_Ocio y transporte';'Parking y peaje';'VARIABLES'
07/04/2011;07/04/2011;'AUTOPISTA TERR';-0,65 €;14.282,33 €;1200;-0,65;18.806,42 €;'sin fechas';07/04/2011;'AUTOPISTA';'Gastos_Ocio y transporte';'Parking y peaje';'VARIABLES'
07/04/2011;07/04/2011;'CAFET.C T PRAT';-3,10 €;14.279,23 €;1201;-3,10;18.803,32 €;'sin fechas';07/04/2011;'CAFETC';'Gastos_Ocio y transporte';'Restaurantes';'VARIABLES'
07/04/2011;07/04/2011;'CAFET.C T PRAT';-7,40 €;14.271,83 €;1202;-7,40;18.795,92 €;'sin fechas';07/04/2011;'CAFETC';'Gastos_Ocio y transporte';'Restaurantes';'VARIABLES'
07/04/2011;07/04/2011;'IMPUESTOS RETENIDOS A CUENTA3061.1990014513 00002';-12,51 €;14.259,32 €;1203;-12,51;18.783,41 €;'sin fechas';07/04/2011;'IMPUESTOS';'Gastos_Banco y organismos';'Impuestos';'FIJO'
07/04/2011;07/04/2011;'INTERESES CUENTA AHORRO PLAZO 3061.1990014513 00002';65,84 €;14.325,16 €;1204;65,84;18.849,25 €;'sin fechas';07/04/2011;'INTERESES';'Ingresos';'Rendimientos';
07/04/2011;07/04/2011;'PRIMARK';-23,00 €;14.302,16 €;1205;-23,00;18.826,25 €;'sin fechas';07/04/2011;'PRIMARK';'Gastos_Compras';'Ropa';'VARIABLES'
07/04/2011;07/04/2011;'RODILLA SANCHEZ S';-8,45 €;14.293,71 €;1206;-8,45;18.817,80 €;'sin fechas';07/04/2011;'RODILLA';'Gastos_Ocio y transporte';'Restaurantes';'VARIABLES'
08/04/2011;08/04/2011;'CAFET.C T PRAT';-2,70 €;14.291,01 €;1207;-2,70;18.815,10 €;'sin fechas';08/04/2011;'CAFETC';'Gastos_Ocio y transporte';'Restaurantes';'VARIABLES'
09/04/2011;09/04/2011;'ES STA. MARGARITA';-48,59 €;14.242,42 €;1208;-48,59;18.766,51 €;'sin fechas';09/04/2011;'STA';'Gastos_Ocio y transporte';'Gasolina';'VARIABLES'
09/04/2011;09/04/2011;'H&M';-22,90 €;14.219,52 €;1209;-22,90;18.743,61 €;'sin fechas';09/04/2011;'HM';'Gastos_Compras';'Ropa';'VARIABLES'
09/04/2011;09/04/2011;'INTERKITS';-20,00 €;14.199,52 €;1210;-20,00;18.723,61 €;'sin fechas';09/04/2011;'INTERKITS';'Gastos_Compras';'Niños';'VARIABLES'
09/04/2011;09/04/2011;'METRO BARCELONA';-7,85 €;14.191,67 €;1211;-7,85;18.715,76 €;'sin fechas';09/04/2011;'METRO';'Gastos_Ocio y transporte';'Transporte';'VARIABLES'
10/04/2011;10/04/2011;'AUTOPISTA TERR';-3,55 €;14.188,12 €;1212;-3,55;18.712,21 €;'sin fechas';10/04/2011;'AUTOPISTA';'Gastos_Ocio y transporte';'Parking y peaje';'VARIABLES'
10/04/2011;10/04/2011;'AUTOPISTA TERR';-4,20 €;14.183,92 €;1213;-4,20;18.708,01 €;'sin fechas';10/04/2011;'AUTOPISTA';'Gastos_Ocio y transporte';'Parking y peaje';'VARIABLES'
10/04/2011;10/04/2011;'AUTOPISTA TERR';-2,80 €;14.181,12 €;1214;-2,80;18.705,21 €;'sin fechas';10/04/2011;'AUTOPISTA';'Gastos_Ocio y transporte';'Parking y peaje';'VARIABLES'
10/04/2011;10/04/2011;'CAFE DE FIORE T\\SECUITA, LA';-19,55 €;14.161,57 €;1215;-19,55;18.685,66 €;'sin fechas';10/04/2011;'CAFE';'Gastos_Ocio y transporte';'Restaurantes';'VARIABLES'
10/04/2011;10/04/2011;'VIENA';-10,00 €;14.151,57 €;1216;-10,00;18.675,66 €;'sin fechas';10/04/2011;'VIENA';'Gastos_Ocio y transporte';'Restaurantes';'VARIABLES'
11/04/2011;11/04/2011;'BON AREA';-9,04 €;14.142,53 €;1217;-9,04;18.666,62 €;'sin fechas';11/04/2011;'BON';'Gastos_Compras';'Supermercado';'VARIABLES'
11/04/2011;11/04/2011;'CAFET.C T PRAT';-3,10 €;14.139,43 €;1218;-3,10;18.663,52 €;'sin fechas';11/04/2011;'CAFETC';'Gastos_Ocio y transporte';'Restaurantes';'VARIABLES'
12/04/2011;12/04/2011;'AUTOPISTA TERR';-2,25 €;14.137,18 €;1219;-2,25;18.661,27 €;'sin fechas';12/04/2011;'AUTOPISTA';'Gastos_Ocio y transporte';'Parking y peaje';'VARIABLES'
12/04/2011;12/04/2011;'BON AREA';-20,97 €;14.116,21 €;1220;-20,97;18.640,30 €;'sin fechas';12/04/2011;'BON';'Gastos_Compras';'Supermercado';'VARIABLES'
12/04/2011;12/04/2011;'BONIFICACION';0,69 €;14.116,90 €;1221;0,69;18.640,99 €;'sin fechas';12/04/2011;'BONIFICACION';'Ingresos';'Otros ingresos';'VARIABLES'
12/04/2011;12/04/2011;'CAFET.C T PRAT';-3,90 €;14.113,00 €;1222;-3,90;18.637,09 €;'sin fechas';12/04/2011;'CAFETC';'Gastos_Ocio y transporte';'Restaurantes';'VARIABLES'
12/04/2011;12/04/2011;'GAS NATURAL';-219,38 €;13.893,62 €;1223;-219,38;18.417,71 €;'sin fechas';12/04/2011;'GAS';'Gastos_Servicios tipicos';'Gas';'FIJO'
13/04/2011;13/04/2011;'CAFET.C T PRAT';-3,10 €;13.890,52 €;1224;-3,10;18.414,61 €;'sin fechas';13/04/2011;'CAFETC';'Gastos_Ocio y transporte';'Restaurantes';'VARIABLES'
14/04/2011;14/04/2011;'BON AREA';-25,14 €;13.865,38 €;1225;-25,14;18.389,47 €;'sin fechas';14/04/2011;'BON';'Gastos_Compras';'Supermercado';'VARIABLES'
14/04/2011;14/04/2011;'CAFET.C T PRAT';-3,10 €;13.862,28 €;1226;-3,10;18.386,37 €;'sin fechas';14/04/2011;'CAFETC';'Gastos_Ocio y transporte';'Restaurantes';'VARIABLES'
14/04/2011;14/04/2011;'CAFET.C T PRAT';-7,40 €;13.854,88 €;1227;-7,40;18.378,97 €;'sin fechas';14/04/2011;'CAFETC';'Gastos_Ocio y transporte';'Restaurantes';'VARIABLES'
14/04/2011;14/04/2011;'CANGUROS';-200,00 €;13.654,88 €;1228;-200,00;18.178,97 €;'sin fechas';14/04/2011;'CANGUROS';'Gastos_Salud, saber y deporte';'Estudios';'VARIABLES'
14/04/2011;14/04/2011;'ENTREGA PTMO. 3061-0960004140';-5.700,00 €;7.954,88 €;1229;-5.700,00;12.478,97 €;'sin fechas';14/04/2011;'ENTREGA';'Gastos_Banco y organismos';'Hipoteca';'FIJO'
14/04/2011;14/04/2011;'REINT.CAJERO';-100,00 €;7.854,88 €;1230;-100,00;12.378,97 €;'sin fechas';14/04/2011;'REINTCAJERO';'Gastos_Gastos varios';'Efectivo';'VARIABLES'
15/04/2011;15/04/2011;'CAFET.C T PRAT';-3,20 €;7.851,68 €;1231;-3,20;12.375,77 €;'sin fechas';15/04/2011;'CAFETC';'Gastos_Ocio y transporte';'Restaurantes';'VARIABLES'
15/04/2011;15/04/2011;'CCM VIDA Y P SEGURO PRESTAMO';-27,56 €;7.824,12 €;1232;-27,56;12.348,21 €;'sin fechas';15/04/2011;'CCM';'Gastos_Seguros';'Seguro vida';'FIJO'
15/04/2011;15/04/2011;'CCM VIDA Y PENSIO 000000493358';-19,31 €;7.804,81 €;1233;-19,31;12.328,90 €;'sin fechas';15/04/2011;'CCM';'Gastos_Seguros';'Seguro vida';'FIJO'
16/04/2011;16/04/2011;'AUTOPISTA TERR';-0,40 €;7.804,41 €;1234;-0,40;12.328,50 €;'sin fechas';16/04/2011;'AUTOPISTA';'Gastos_Ocio y transporte';'Parking y peaje';'VARIABLES'
16/04/2011;16/04/2011;'BON AREA';-19,62 €;7.784,79 €;1235;-19,62;12.308,88 €;'sin fechas';16/04/2011;'BON';'Gastos_Compras';'Supermercado';'VARIABLES'
16/04/2011;16/04/2011;'EL TALLER';-4,05 €;7.780,74 €;1236;-4,05;12.304,83 €;'sin fechas';16/04/2011;'TALLER';'Gastos_Ocio y transporte';'Espectáculos';'VARIABLES'
16/04/2011;16/04/2011;'ES STA. MARGARITA';-47,45 €;7.733,29 €;1237;-47,45;12.257,38 €;'sin fechas';16/04/2011;'STA';'Gastos_Ocio y transporte';'Gasolina';'VARIABLES'
16/04/2011;16/04/2011;'FASHION KANAK \\BADALONA';-17,99 €;7.715,30 €;1238;-17,99;12.239,39 €;'sin fechas';16/04/2011;'FASHION';'Gastos_Compras';'Ropa';'VARIABLES'
16/04/2011;16/04/2011;'GAME';-42,85 €;7.672,45 €;1239;-42,85;12.196,54 €;'sin fechas';16/04/2011;'GAME';'Gastos_Compras';'Hobbys';'VARIABLES'
16/04/2011;16/04/2011;'M&S';-30,00 €;7.642,45 €;1240;-30,00;12.166,54 €;'sin fechas';16/04/2011;'MS';'Gastos_Compras';'Ropa';'VARIABLES'
16/04/2011;16/04/2011;'STARBUCKS';-4,05 €;7.638,40 €;1241;-4,05;12.162,49 €;'sin fechas';16/04/2011;'STARBUCKS';'Gastos_Ocio y transporte';'Restaurantes';'VARIABLES'
16/04/2011;16/04/2011;'VIENA';-9,95 €;7.628,45 €;1242;-9,95;12.152,54 €;'sin fechas';16/04/2011;'VIENA';'Gastos_Ocio y transporte';'Restaurantes';'VARIABLES'
18/04/2011;18/04/2011;'CAFET.C T PRAT';-3,20 €;7.625,25 €;1243;-3,20;12.149,34 €;'sin fechas';18/04/2011;'CAFETC';'Gastos_Ocio y transporte';'Restaurantes';'VARIABLES'
19/04/2011;19/04/2011;'AG.TRIBUT GABRIEL';100,00 €;7.725,25 €;1244;100,00;12.249,34 €;'sin fechas';19/04/2011;'AGTRIBUT';'Ingresos';'Subvenciones';
19/04/2011;19/04/2011;'CAFET.C T PRAT';-3,40 €;7.721,85 €;1245;-3,40;12.245,94 €;'sin fechas';19/04/2011;'CAFETC';'Gastos_Ocio y transporte';'Restaurantes';'VARIABLES'
19/04/2011;19/04/2011;'ENDESA ENERG EE_XXI40025545678';-62,82 €;7.659,03 €;1246;-62,82;12.183,12 €;'sin fechas';19/04/2011;'ENDESA';'Gastos_Servicios tipicos';'Electricidad';'FIJO'
19/04/2011;19/04/2011;'ONO';-85,38 €;7.573,65 €;1247;-85,38;12.097,74 €;'sin fechas';19/04/2011;'ONO';'Gastos_Servicios tipicos';'Telecomunicaciones';'FIJO'
20/04/2011;20/04/2011;'CAFET.C T PRAT';-3,40 €;7.570,25 €;1248;-3,40;12.094,34 €;'sin fechas';20/04/2011;'CAFETC';'Gastos_Ocio y transporte';'Restaurantes';'VARIABLES'
20/04/2011;20/04/2011;'EROSKI-[COMIDA]';-39,55 €;7.530,70 €;1249;-39,55;12.054,79 €;'sin fechas';20/04/2011;'EROSKICOMIDA';'Gastos_Compras';'Supermercado';'VARIABLES'
20/04/2011;20/04/2011;'MERCADONA';-17,05 €;7.513,65 €;1250;-17,05;12.037,74 €;'sin fechas';20/04/2011;'MERCADONA';'Gastos_Compras';'Supermercado';'VARIABLES'
20/04/2011;20/04/2011;'MERKALZADOS TARRAS';-25,00 €;7.488,65 €;1251;-25,00;12.012,74 €;'sin fechas';20/04/2011;'MERKALZADOS';'Gastos_Compras';'Ropa';'VARIABLES'
20/04/2011;20/04/2011;'VIENA';-18,45 €;7.470,20 €;1252;-18,45;11.994,29 €;'sin fechas';20/04/2011;'VIENA';'Gastos_Ocio y transporte';'Restaurantes';'VARIABLES'
21/04/2011;21/04/2011;'CAFET.C T PRAT';-3,85 €;7.466,35 €;1253;-3,85;11.990,44 €;'sin fechas';21/04/2011;'CAFETC';'Gastos_Ocio y transporte';'Restaurantes';'VARIABLES'
21/04/2011;21/04/2011;'CIA. DE SEGUROS ADESLAS S.A.';453,60 €;7.919,95 €;1254;453,60;12.444,04 €;'sin fechas';21/04/2011;'CIA';'Ingresos';'Devoluciones';'VARIABLES'
21/04/2011;21/04/2011;'FARMACIA';-8,15 €;7.911,80 €;1255;-8,15;12.435,89 €;'sin fechas';21/04/2011;'FARMACIA';'Gastos_Salud, saber y deporte';'Farmacia';'VARIABLES'
22/04/2011;22/04/2011;'CAFET.EROPUERT';-14,80 €;7.897,00 €;1256;-14,80;12.421,09 €;'sin fechas';22/04/2011;'CAFETEROPUERT';'Gastos_Ocio y transporte';'Restaurantes';'VARIABLES'
22/04/2011;22/04/2011;'FARMACIA';-6,50 €;7.890,50 €;1257;-6,50;12.414,59 €;'sin fechas';22/04/2011;'FARMACIA';'Gastos_Salud, saber y deporte';'Farmacia';'VARIABLES'
22/04/2011;22/04/2011;'REST.EL ZARCILLO \\MOTRIL';-195,10 €;7.695,40 €;1258;-195,10;12.219,49 €;'sin fechas';22/04/2011;'RESTEL';'Gastos_Ocio y transporte';'Restaurantes';'VARIABLES'
23/04/2011;23/04/2011;'LIDL MOTRIL TDA.0657\\MOTRIL';-20,98 €;7.674,42 €;1259;-20,98;12.198,51 €;'sin fechas';23/04/2011;'LIDL';'Gastos_Compras';'Supermercado';'VARIABLES'
24/04/2011;24/04/2011;'FARMACIA';-3,90 €;7.670,52 €;1260;-3,90;12.194,61 €;'sin fechas';24/04/2011;'FARMACIA';'Gastos_Salud, saber y deporte';'Farmacia';'VARIABLES'
25/04/2011;25/04/2011;'LA CAMPERERIA \\GRANADA';-28,45 €;7.642,07 €;1261;-28,45;12.166,16 €;'sin fechas';25/04/2011;'CAMPERERIA';'Gastos_Ocio y transporte';'Restaurantes';'VARIABLES'
25/04/2011;25/04/2011;'VACACIONES';-12,70 €;7.629,37 €;1262;-12,70;12.153,46 €;'sin fechas';25/04/2011;'VACACIONES';'Gastos_Ocio y transporte';'Vacaciones';'VARIABLES'
26/04/2011;26/04/2011;'AEROPUERTO GRANAD\\CHAUCHINA';-14,50 €;7.614,87 €;1263;-14,50;12.138,96 €;'sin fechas';26/04/2011;'AEROPUERTO';'Gastos_Ocio y transporte';'Vacaciones';'VARIABLES'
26/04/2011;26/04/2011;'FLORES CORREA\\GRANADA-MOTRI';-50,00 €;7.564,87 €;1264;-50,00;12.088,96 €;'sin fechas';26/04/2011;'FLORES';'Gastos_Compras';'Regalos';'VARIABLES'
26/04/2011;26/04/2011;'LIMPIEZA';-120,00 €;7.444,87 €;1265;-120,00;11.968,96 €;'sin fechas';26/04/2011;'LIMPIEZA';'Gastos_Vivienda y vehiculo';'Serv. domestico';'FIJO'
27/04/2011;27/04/2011;'2310-CDR T1 SK';-17,05 €;7.427,82 €;1266;-17,05;11.951,91 €;'sin fechas';27/04/2011;'CDR';'Gastos_Compras';'Otras compras';'VARIABLES'
27/04/2011;27/04/2011;'BON AREA';-19,45 €;7.408,37 €;1267;-19,45;11.932,46 €;'sin fechas';27/04/2011;'BON';'Gastos_Compras';'Supermercado';'VARIABLES'
27/04/2011;27/04/2011;'CAFET.C T PRAT';-3,40 €;7.404,97 €;1268;-3,40;11.929,06 €;'sin fechas';27/04/2011;'CAFETC';'Gastos_Ocio y transporte';'Restaurantes';'VARIABLES'
27/04/2011;27/04/2011;'FOMENT DE TERRASSA, S.A. FOMEN';1.555,79 €;8.960,76 €;1269;1.555,79;13.484,85 €;'sin fechas';27/04/2011;'FOMENT';'Ingresos';'Nomina';'FIJO'
28/04/2011;28/04/2011;'CAFET.C T PRAT';-3,40 €;8.957,36 €;1270;-3,40;13.481,45 €;'sin fechas';28/04/2011;'CAFETC';'Gastos_Ocio y transporte';'Restaurantes';'VARIABLES'
28/04/2011;28/04/2011;'INFORMACIO I TECNOLOGIA DE CAT';1.526,20 €;10.483,56 €;1271;1.526,20;15.007,65 €;'sin fechas';28/04/2011;'INFORMACIO';'Ingresos';'Nomina';'FIJO'
29/04/2011;29/04/2011;'FF.CC.GENERALITAT';-21,25 €;10.462,31 €;1272;-21,25;14.986,40 €;'sin fechas';29/04/2011;'FFCCGENERALITAT';'Gastos_Ocio y transporte';'Transporte';'VARIABLES'
29/04/2011;29/04/2011;'NOSTRUM';-12,45 €;10.449,86 €;1273;-12,45;14.973,95 €;'sin fechas';29/04/2011;'NOSTRUM';'Gastos_Ocio y transporte';'Restaurantes';'VARIABLES'
29/04/2011;29/04/2011;'TOCINERIES VENTURA';-23,51 €;10.426,35 €;1274;-23,51;14.950,44 €;'sin fechas';29/04/2011;'TOCINERIES';'Gastos_Compras';'Supermercado';'VARIABLES'
30/04/2011;30/04/2011;'MERCADONA';-19,09 €;10.407,26 €;1275;-19,09;14.931,35 €;'sin fechas';30/04/2011;'MERCADONA';'Gastos_Compras';'Supermercado';'VARIABLES'
30/04/2011;30/04/2011;'RECIBO PTMOS. 3061-0960001518';-598,03 €;9.809,23 €;1276;-598,03;14.333,32 €;'sin fechas';30/04/2011;'RECIBO';'Gastos_Banco y organismos';'Hipoteca';'FIJO'
30/04/2011;30/04/2011;'RECIBO PTMOS. 3061-0960004140';-41,30 €;9.767,93 €;1277;-41,30;14.292,02 €;'sin fechas';30/04/2011;'RECIBO';'Gastos_Banco y organismos';'Hipoteca';'FIJO'
01/05/2011;01/05/2011;'AUTOPISTA TERR';-15,60 €;9.752,33 €;1278;-15,60;14.276,42 €;'sin fechas';01/05/2011;'AUTOPISTA';'Gastos_Ocio y transporte';'Parking y peaje';'VARIABLES'
01/05/2011;01/05/2011;'AUTOPISTA TERR';-5,74 €;9.746,59 €;1279;-5,74;14.270,68 €;'sin fechas';01/05/2011;'AUTOPISTA';'Gastos_Ocio y transporte';'Parking y peaje';'VARIABLES'
01/05/2011;01/05/2011;'AUTOPISTA TERR';-5,74 €;9.740,85 €;1280;-5,74;14.264,94 €;'sin fechas';01/05/2011;'AUTOPISTA';'Gastos_Ocio y transporte';'Parking y peaje';'VARIABLES'
01/05/2011;01/05/2011;'ES STA. MARGARITA';-41,35 €;9.699,50 €;1281;-41,35;14.223,59 €;'sin fechas';01/05/2011;'STA';'Gastos_Ocio y transporte';'Gasolina';'VARIABLES'
01/05/2011;01/05/2011;'MANTENIMIENTO';-1,50 €;9.698,00 €;1282;-1,50;14.222,09 €;'sin fechas';01/05/2011;'MANTENIMIENTO';'Gastos_Banco y organismos';'Cargos banco';'FIJO'
01/05/2011;01/05/2011;'REINT.CAJERO';-50,00 €;9.648,00 €;1283;-50,00;14.172,09 €;'sin fechas';01/05/2011;'REINTCAJERO';'Gastos_Gastos varios';'Efectivo';'VARIABLES'
02/05/2011;02/05/2011;'AJUNTAMENT DE TER 010000520716';-37,18 €;9.610,82 €;1284;-37,18;14.134,91 €;'sin fechas';02/05/2011;'AJUNTAMENT';'Gastos_Banco y organismos';'Ayuntamiento';'FIJO'
02/05/2011;02/05/2011;'AUTOPISTA TERR';-1,50 €;9.609,32 €;1285;-1,50;14.133,41 €;'sin fechas';02/05/2011;'AUTOPISTA';'Gastos_Ocio y transporte';'Parking y peaje';'VARIABLES'
02/05/2011;02/05/2011;'CAFET.C T PRAT';-1,70 €;9.607,62 €;1286;-1,70;14.131,71 €;'sin fechas';02/05/2011;'CAFETC';'Gastos_Ocio y transporte';'Restaurantes';'VARIABLES'
02/05/2011;02/05/2011;'CIA.DE SEGUROS AD 006662671613';-73,20 €;9.534,42 €;1287;-73,20;14.058,51 €;'sin fechas';02/05/2011;'CIADE';'Gastos_Salud, saber y deporte';'Medico';'VARIABLES'
02/05/2011;02/05/2011;'MERCADONA';-10,49 €;9.523,93 €;1288;-10,49;14.048,02 €;'sin fechas';02/05/2011;'MERCADONA';'Gastos_Compras';'Supermercado';'VARIABLES'
02/05/2011;02/05/2011;'MERCADONA';-139,26 €;9.384,67 €;1289;-139,26;13.908,76 €;'sin fechas';02/05/2011;'MERCADONA';'Gastos_Compras';'Supermercado';'VARIABLES'
03/05/2011;03/05/2011;'AJUNTAMENT BARCELON 0332641FMY';-66,79 €;9.317,88 €;1290;-66,79;13.841,97 €;'sin fechas';03/05/2011;'AJUNTAMENT';'Gastos_Banco y organismos';'Ayuntamiento';'FIJO'
03/05/2011;03/05/2011;'AUTOPISTA TERR';-5,95 €;9.311,93 €;1291;-5,95;13.836,02 €;'sin fechas';03/05/2011;'AUTOPISTA';'Gastos_Ocio y transporte';'Parking y peaje';'VARIABLES'
03/05/2011;03/05/2011;'AUTOPISTA TERR';-3,76 €;9.308,17 €;1292;-3,76;13.832,26 €;'sin fechas';03/05/2011;'AUTOPISTA';'Gastos_Ocio y transporte';'Parking y peaje';'VARIABLES'
03/05/2011;03/05/2011;'CAFET.C T PRAT';-3,40 €;9.304,77 €;1293;-3,40;13.828,86 €;'sin fechas';03/05/2011;'CAFETC';'Gastos_Ocio y transporte';'Restaurantes';'VARIABLES'
03/05/2011;03/05/2011;'IRIS FLORISTES';-25,00 €;9.279,77 €;1294;-25,00;13.803,86 €;'sin fechas';03/05/2011;'IRIS';'Gastos_Compras';'Regalos';'VARIABLES'
04/05/2011;04/05/2011;'DIETISTA';-62,00 €;9.217,77 €;1295;-62,00;13.741,86 €;'sin fechas';04/05/2011;'DIETISTA';'Gastos_Salud, saber y deporte';'Otros Salud';'VARIABLES'
04/05/2011;04/05/2011;'DUIT\''S C.B. \\EL PRAT DE LL';-10,00 €;9.207,77 €;1296;-10,00;13.731,86 €;'sin fechas';04/05/2011;'DUITS';'Gastos_Ocio y transporte';'Restaurantes';'VARIABLES'
04/05/2011;04/05/2011;'FRUTERIA';-8,00 €;9.199,77 €;1297;-8,00;13.723,86 €;'sin fechas';04/05/2011;'FRUTERIA';'Gastos_Compras';'Supermercado';'VARIABLES'
04/05/2011;04/05/2011;'REINT.CAJERO';-30,00 €;9.169,77 €;1298;-30,00;13.693,86 €;'sin fechas';04/05/2011;'REINTCAJERO';'Gastos_Gastos varios';'Efectivo';'VARIABLES'
05/05/2011;05/05/2011;'CAFET.C T PRAT';-2,00 €;9.167,77 €;1299;-2,00;13.691,86 €;'sin fechas';05/05/2011;'CAFETC';'Gastos_Ocio y transporte';'Restaurantes';'VARIABLES'
05/05/2011;05/05/2011;'CREDITO';-26,26 €;9.141,51 €;1300;-26,26;13.665,60 €;'sin fechas';05/05/2011;'CREDITO';'No computable';'Recibo Tarjeta';
05/05/2011;05/05/2011;'TOCINERIES VENTURA';-8,15 €;9.133,36 €;1301;-8,15;13.657,45 €;'sin fechas';05/05/2011;'TOCINERIES';'Gastos_Compras';'Supermercado';'VARIABLES'
05/05/2011;05/05/2011;'VACACIONES';-275,69 €;8.857,67 €;1302;-275,69;13.381,76 €;'sin fechas';05/05/2011;'VACACIONES';'Gastos_Ocio y transporte';'Vacaciones';'VARIABLES'
05/05/2011;05/05/2011;'XFERA MOVILES SA 2767906';-29,81 €;8.827,86 €;1303;-29,81;13.351,95 €;'sin fechas';05/05/2011;'XFERA';'Gastos_Servicios tipicos';'Telecomunicaciones';'FIJO'
07/05/2011;07/05/2011;'BON AREA';-19,84 €;8.808,02 €;1304;-19,84;13.332,11 €;'sin fechas';07/05/2011;'BON';'Gastos_Compras';'Supermercado';'VARIABLES'
09/05/2011;09/05/2011;'CANGUROS';-200,00 €;8.608,02 €;1305;-200,00;13.132,11 €;'sin fechas';09/05/2011;'CANGUROS';'Gastos_Salud, saber y deporte';'Estudios';'VARIABLES'
09/05/2011;09/05/2011;'MERCADONA';-26,06 €;8.581,96 €;1306;-26,06;13.106,05 €;'sin fechas';09/05/2011;'MERCADONA';'Gastos_Compras';'Supermercado';'VARIABLES'
09/05/2011;09/05/2011;'REINT.CAJERO';-100,00 €;8.481,96 €;1307;-100,00;13.006,05 €;'sin fechas';09/05/2011;'REINTCAJERO';'Gastos_Gastos varios';'Efectivo';'VARIABLES'
10/05/2011;10/05/2011;'CAFET.C T PRAT';-3,35 €;8.478,61 €;1308;-3,35;13.002,70 €;'sin fechas';10/05/2011;'CAFETC';'Gastos_Ocio y transporte';'Restaurantes';'VARIABLES'
11/05/2011;11/05/2011;'CAFET.C T PRAT';-3,40 €;8.475,21 €;1309;-3,40;12.999,30 €;'sin fechas';11/05/2011;'CAFETC';'Gastos_Ocio y transporte';'Restaurantes';'VARIABLES'
12/05/2011;12/05/2011;'CAFET.C T PRAT';-3,40 €;8.471,81 €;1310;-3,40;12.995,90 €;'sin fechas';12/05/2011;'CAFETC';'Gastos_Ocio y transporte';'Restaurantes';'VARIABLES'
12/05/2011;12/05/2011;'ES STA. MARGARITA';-50,92 €;8.420,89 €;1311;-50,92;12.944,98 €;'sin fechas';12/05/2011;'STA';'Gastos_Ocio y transporte';'Gasolina';'VARIABLES'
13/05/2011;13/05/2011;'CAFET.C T PRAT';-4,20 €;8.416,69 €;1312;-4,20;12.940,78 €;'sin fechas';13/05/2011;'CAFETC';'Gastos_Ocio y transporte';'Restaurantes';'VARIABLES'
13/05/2011;13/05/2011;'FARMACIA';-13,02 €;8.403,67 €;1313;-13,02;12.927,76 €;'sin fechas';13/05/2011;'FARMACIA';'Gastos_Salud, saber y deporte';'Farmacia';'VARIABLES'
14/05/2011;14/05/2011;'BON AREA';-18,47 €;8.385,20 €;1314;-18,47;12.909,29 €;'sin fechas';14/05/2011;'BON';'Gastos_Compras';'Supermercado';'VARIABLES'
16/05/2011;16/05/2011;'CAFET.C T PRAT';-3,40 €;8.381,80 €;1315;-3,40;12.905,89 €;'sin fechas';16/05/2011;'CAFETC';'Gastos_Ocio y transporte';'Restaurantes';'VARIABLES'
16/05/2011;16/05/2011;'CCM VIDA Y P SEGURO PRESTAMO';-27,49 €;8.354,31 €;1316;-27,49;12.878,40 €;'sin fechas';16/05/2011;'CCM';'Gastos_Seguros';'Seguro vida';'FIJO'
16/05/2011;16/05/2011;'CCM VIDA Y PENSIO 000000493358';-19,26 €;8.335,05 €;1317;-19,26;12.859,14 €;'sin fechas';16/05/2011;'CCM';'Gastos_Seguros';'Seguro vida';'FIJO'
17/05/2011;17/05/2011;'CAFET.C T PRAT';-3,40 €;8.331,65 €;1318;-3,40;12.855,74 €;'sin fechas';17/05/2011;'CAFETC';'Gastos_Ocio y transporte';'Restaurantes';'VARIABLES'
17/05/2011;17/05/2011;'FARMACIA';-51,14 €;8.280,51 €;1319;-51,14;12.804,60 €;'sin fechas';17/05/2011;'FARMACIA';'Gastos_Salud, saber y deporte';'Farmacia';'VARIABLES'
17/05/2011;17/05/2011;'FRUITES I VERDURES';-2,94 €;8.277,57 €;1320;-2,94;12.801,66 €;'sin fechas';17/05/2011;'FRUITES';'Gastos_Compras';'Supermercado';'VARIABLES'
17/05/2011;17/05/2011;'TOCINERIES VENTURA';-13,74 €;8.263,83 €;1321;-13,74;12.787,92 €;'sin fechas';17/05/2011;'TOCINERIES';'Gastos_Compras';'Supermercado';'VARIABLES'
18/05/2011;18/05/2011;'CAFET.C T PRAT';-3,40 €;8.260,43 €;1322;-3,40;12.784,52 €;'sin fechas';18/05/2011;'CAFETC';'Gastos_Ocio y transporte';'Restaurantes';'VARIABLES'
18/05/2011;18/05/2011;'CAFET.C T PRAT';-7,40 €;8.253,03 €;1323;-7,40;12.777,12 €;'sin fechas';18/05/2011;'CAFETC';'Gastos_Ocio y transporte';'Restaurantes';'VARIABLES'
18/05/2011;18/05/2011;'ONO';-86,25 €;8.166,78 €;1324;-86,25;12.690,87 €;'sin fechas';18/05/2011;'ONO';'Gastos_Servicios tipicos';'Telecomunicaciones';'FIJO'
18/05/2011;18/05/2011;'REINT.CAJERO';-50,00 €;8.116,78 €;1325;-50,00;12.640,87 €;'sin fechas';18/05/2011;'REINTCAJERO';'Gastos_Gastos varios';'Efectivo';'VARIABLES'
19/05/2011;19/05/2011;'CAFET.C T PRAT';-3,25 €;8.113,53 €;1326;-3,25;12.637,62 €;'sin fechas';19/05/2011;'CAFETC';'Gastos_Ocio y transporte';'Restaurantes';'VARIABLES'
19/05/2011;19/05/2011;'COMISIONES';-4,00 €;8.109,53 €;1327;-4,00;12.633,62 €;'sin fechas';19/05/2011;'COMISIONES';'Gastos_Banco y organismos';'Cargos banco';'FIJO'
19/05/2011;19/05/2011;'ENDESA ENERG EE_XXI40025545678';-82,25 €;8.027,28 €;1328;-82,25;12.551,37 €;'sin fechas';19/05/2011;'ENDESA';'Gastos_Servicios tipicos';'Electricidad';'FIJO'
19/05/2011;19/05/2011;'FARMACIA';-18,45 €;8.008,83 €;1329;-18,45;12.532,92 €;'sin fechas';19/05/2011;'FARMACIA';'Gastos_Salud, saber y deporte';'Farmacia';'VARIABLES'
19/05/2011;19/05/2011;'MERCADONA';-0,99 €;8.007,84 €;1330;-0,99;12.531,93 €;'sin fechas';19/05/2011;'MERCADONA';'Gastos_Compras';'Supermercado';'VARIABLES'
19/05/2011;19/05/2011;'MERCADONA';-12,15 €;7.995,69 €;1331;-12,15;12.519,78 €;'sin fechas';19/05/2011;'MERCADONA';'Gastos_Compras';'Supermercado';'VARIABLES'
19/05/2011;19/05/2011;'MERCADONA';-153,20 €;7.842,49 €;1332;-153,20;12.366,58 €;'sin fechas';19/05/2011;'MERCADONA';'Gastos_Compras';'Supermercado';'VARIABLES'
19/05/2011;19/05/2011;'REINT.CAJERO';-100,00 €;7.742,49 €;1333;-100,00;12.266,58 €;'sin fechas';19/05/2011;'REINTCAJERO';'Gastos_Gastos varios';'Efectivo';'VARIABLES'
20/05/2011;20/05/2011;'AG.TRIBUT GABRIEL';100,00 €;7.842,49 €;1334;100,00;12.366,58 €;'sin fechas';20/05/2011;'AGTRIBUT';'Ingresos';'Subvenciones';
20/05/2011;20/05/2011;'CAFET.C T PRAT';-3,35 €;7.839,14 €;1335;-3,35;12.363,23 €;'sin fechas';20/05/2011;'CAFETC';'Gastos_Ocio y transporte';'Restaurantes';'VARIABLES'
20/05/2011;20/05/2011;'RODELAS PERRUQUERS';-20,00 €;7.819,14 €;1336;-20,00;12.343,23 €;'sin fechas';20/05/2011;'RODELAS';'Gastos_Salud, saber y deporte';'Belleza';'VARIABLES'
21/05/2011;21/05/2011;'VIENA';-46,98 €;7.772,16 €;1337;-46,98;12.296,25 €;'sin fechas';21/05/2011;'VIENA';'Gastos_Ocio y transporte';'Restaurantes';'VARIABLES'
23/05/2011;23/05/2011;'FRUITES I VERDURES';-4,46 €;7.767,70 €;1338;-4,46;12.291,79 €;'sin fechas';23/05/2011;'FRUITES';'Gastos_Compras';'Supermercado';'VARIABLES'
24/05/2011;24/05/2011;'CAFET.C T PRAT';-3,90 €;7.763,80 €;1339;-3,90;12.287,89 €;'sin fechas';24/05/2011;'CAFETC';'Gastos_Ocio y transporte';'Restaurantes';'VARIABLES'
25/05/2011;25/05/2011;'AUTOPISTA TERR';-3,01 €;7.760,79 €;1340;-3,01;12.284,88 €;'sin fechas';25/05/2011;'AUTOPISTA';'Gastos_Ocio y transporte';'Parking y peaje';'VARIABLES'
25/05/2011;25/05/2011;'AUTOPISTA TERR';-1,25 €;7.759,54 €;1341;-1,25;12.283,63 €;'sin fechas';25/05/2011;'AUTOPISTA';'Gastos_Ocio y transporte';'Parking y peaje';'VARIABLES'
25/05/2011;25/05/2011;'AUTOPISTA TERR';-9,50 €;7.750,04 €;1342;-9,50;12.274,13 €;'sin fechas';25/05/2011;'AUTOPISTA';'Gastos_Ocio y transporte';'Parking y peaje';'VARIABLES'
25/05/2011;25/05/2011;'BON AREA';-25,14 €;7.724,90 €;1343;-25,14;12.248,99 €;'sin fechas';25/05/2011;'BON';'Gastos_Compras';'Supermercado';'VARIABLES'
25/05/2011;25/05/2011;'LASER OFTALMICO C';-1.350,00 €;6.374,90 €;1344;-1.350,00;10.898,99 €;'sin fechas';25/05/2011;'LASER';'Gastos_Salud, saber y deporte';'Medico';'VARIABLES'
26/05/2011;26/05/2011;'AUTOPISTA TERR';-3,76 €;6.371,14 €;1345;-3,76;10.895,23 €;'sin fechas';26/05/2011;'AUTOPISTA';'Gastos_Ocio y transporte';'Parking y peaje';'VARIABLES'
26/05/2011;26/05/2011;'AUTOPISTA TERR';-2,85 €;6.368,29 €;1346;-2,85;10.892,38 €;'sin fechas';26/05/2011;'AUTOPISTA';'Gastos_Ocio y transporte';'Parking y peaje';'VARIABLES'
26/05/2011;26/05/2011;'AUTOPISTA TERR';-1,25 €;6.367,04 €;1347;-1,25;10.891,13 €;'sin fechas';26/05/2011;'AUTOPISTA';'Gastos_Ocio y transporte';'Parking y peaje';'VARIABLES'
26/05/2011;26/05/2011;'BON AREA';-12,59 €;6.354,45 €;1348;-12,59;10.878,54 €;'sin fechas';26/05/2011;'BON';'Gastos_Compras';'Supermercado';'VARIABLES'
27/05/2011;27/05/2011;'FOMENT DE TERRASSA, S.A. FOMEN';1.541,02 €;7.895,47 €;1349;1.541,02;12.419,56 €;'sin fechas';27/05/2011;'FOMENT';'Ingresos';'Nomina';'FIJO'
29/05/2011;29/05/2011;'REINT.CAJERO';-25,00 €;7.870,47 €;1350;-25,00;12.394,56 €;'sin fechas';29/05/2011;'REINTCAJERO';'Gastos_Gastos varios';'Efectivo';'VARIABLES'
29/05/2011;29/05/2011;'REST.EL ZARCILLO \\MOTRIL';-33,30 €;7.837,17 €;1351;-33,30;12.361,26 €;'sin fechas';29/05/2011;'RESTEL';'Gastos_Ocio y transporte';'Restaurantes';'VARIABLES'
30/05/2011;30/05/2011;'CAFET.C T PRAT';-3,25 €;7.833,92 €;1352;-3,25;12.358,01 €;'sin fechas';30/05/2011;'CAFETC';'Gastos_Ocio y transporte';'Restaurantes';'VARIABLES'
30/05/2011;30/05/2011;'INFORMACIO I TECNOLOGIA DE CAT';1.526,20 €;9.360,12 €;1353;1.526,20;13.884,21 €;'sin fechas';30/05/2011;'INFORMACIO';'Ingresos';'Nomina';'FIJO'
30/05/2011;30/05/2011;'MERCADONA';-14,37 €;9.345,75 €;1354;-14,37;13.869,84 €;'sin fechas';30/05/2011;'MERCADONA';'Gastos_Compras';'Supermercado';'VARIABLES'
31/05/2011;31/05/2011;'CAFET.C T PRAT';-3,05 €;9.342,70 €;1355;-3,05;13.866,79 €;'sin fechas';31/05/2011;'CAFETC';'Gastos_Ocio y transporte';'Restaurantes';'VARIABLES'
31/05/2011;31/05/2011;'GASOLINERA';-50,06 €;9.292,64 €;1356;-50,06;13.816,73 €;'sin fechas';31/05/2011;'GASOLINERA';'Gastos_Ocio y transporte';'Gasolina';'VARIABLES'
31/05/2011;31/05/2011;'LIMPIEZA';-120,00 €;9.172,64 €;1357;-120,00;13.696,73 €;'sin fechas';31/05/2011;'LIMPIEZA';'Gastos_Vivienda y vehiculo';'Serv. domestico';'FIJO'
31/05/2011;31/05/2011;'RECIBO PTMOS. 3061-0960001518';-598,03 €;8.574,61 €;1358;-598,03;13.098,70 €;'sin fechas';31/05/2011;'RECIBO';'Gastos_Banco y organismos';'Hipoteca';'FIJO'
31/05/2011;31/05/2011;'REINT.CAJERO';-30,00 €;8.544,61 €;1359;-30,00;13.068,70 €;'sin fechas';31/05/2011;'REINTCAJERO';'Gastos_Gastos varios';'Efectivo';'VARIABLES'
01/06/2011;01/06/2011;'AUTOPISTA TERR';-3,76 €;8.540,85 €;1360;-3,76;13.064,94 €;'sin fechas';01/06/2011;'AUTOPISTA';'Gastos_Ocio y transporte';'Parking y peaje';'VARIABLES'
01/06/2011;01/06/2011;'AUTOPISTA TERR';-2,65 €;8.538,20 €;1361;-2,65;13.062,29 €;'sin fechas';01/06/2011;'AUTOPISTA';'Gastos_Ocio y transporte';'Parking y peaje';'VARIABLES'
01/06/2011;01/06/2011;'CAFET.C T PRAT';-3,10 €;8.535,10 €;1362;-3,10;13.059,19 €;'sin fechas';01/06/2011;'CAFETC';'Gastos_Ocio y transporte';'Restaurantes';'VARIABLES'
01/06/2011;01/06/2011;'CIA.DE SEGUROS AD 006662671613';-73,20 €;8.461,90 €;1363;-73,20;12.985,99 €;'sin fechas';01/06/2011;'CIADE';'Gastos_Salud, saber y deporte';'Medico';'VARIABLES'
01/06/2011;01/06/2011;'FARMACIA';-10,68 €;8.451,22 €;1364;-10,68;12.975,31 €;'sin fechas';01/06/2011;'FARMACIA';'Gastos_Salud, saber y deporte';'Farmacia';'VARIABLES'
01/06/2011;01/06/2011;'MANTENIMIENTO';-1,50 €;8.449,72 €;1365;-1,50;12.973,81 €;'sin fechas';01/06/2011;'MANTENIMIENTO';'Gastos_Banco y organismos';'Cargos banco';'FIJO'
01/06/2011;01/06/2011;'MERCADONA';-21,70 €;8.428,02 €;1366;-21,70;12.952,11 €;'sin fechas';01/06/2011;'MERCADONA';'Gastos_Compras';'Supermercado';'VARIABLES'
01/06/2011;01/06/2011;'TOCINERIES VENTURA';-17,86 €;8.410,16 €;1367;-17,86;12.934,25 €;'sin fechas';01/06/2011;'TOCINERIES';'Gastos_Compras';'Supermercado';'VARIABLES'
03/06/2011;03/06/2011;'C&A';-51,00 €;8.359,16 €;1368;-51,00;12.883,25 €;'sin fechas';03/06/2011;'CA';'Gastos_Compras';'Ropa';'VARIABLES'
03/06/2011;03/06/2011;'H&M';-29,80 €;8.329,36 €;1369;-29,80;12.853,45 €;'sin fechas';03/06/2011;'HM';'Gastos_Compras';'Ropa';'VARIABLES'
03/06/2011;03/06/2011;'MERCADONA';-19,51 €;8.309,85 €;1370;-19,51;12.833,94 €;'sin fechas';03/06/2011;'MERCADONA';'Gastos_Compras';'Supermercado';'VARIABLES'
03/06/2011;03/06/2011;'MERCADONA';-16,23 €;8.293,62 €;1371;-16,23;12.817,71 €;'sin fechas';03/06/2011;'MERCADONA';'Gastos_Compras';'Supermercado';'VARIABLES'
03/06/2011;03/06/2011;'PRIMARK';-9,00 €;8.284,62 €;1372;-9,00;12.808,71 €;'sin fechas';03/06/2011;'PRIMARK';'Gastos_Compras';'Ropa';'VARIABLES'
04/06/2011;04/06/2011;'AUTOPISTA TERR';-1,80 €;8.282,82 €;1373;-1,80;12.806,91 €;'sin fechas';04/06/2011;'AUTOPISTA';'Gastos_Ocio y transporte';'Parking y peaje';'VARIABLES'
04/06/2011;04/06/2011;'AUTOPISTA TERR';-3,15 €;8.279,67 €;1374;-3,15;12.803,76 €;'sin fechas';04/06/2011;'AUTOPISTA';'Gastos_Ocio y transporte';'Parking y peaje';'VARIABLES'
04/06/2011;04/06/2011;'GASOLINERA';-26,96 €;8.252,71 €;1375;-26,96;12.776,80 €;'sin fechas';04/06/2011;'GASOLINERA';'Gastos_Ocio y transporte';'Gasolina';'VARIABLES'
04/06/2011;04/06/2011;'TOCINERIES VENTURA';-41,54 €;8.211,17 €;1376;-41,54;12.735,26 €;'sin fechas';04/06/2011;'TOCINERIES';'Gastos_Compras';'Supermercado';'VARIABLES'
05/06/2011;05/06/2011;'COM. MANT. ACTIVAS DE LIQ.';-4,50 €;8.206,67 €;1377;-4,50;12.730,76 €;'sin fechas';05/06/2011;'COM';'Gastos_Banco y organismos';'Cargos banco';'FIJO'
05/06/2011;05/06/2011;'IMP.RET.A CTA';-0,04 €;8.206,63 €;1378;-0,04;12.730,72 €;'sin fechas';05/06/2011;'IMPRETA';'Gastos_Banco y organismos';'Impuestos';'FIJO'
05/06/2011;05/06/2011;'INTERESES';0,21 €;8.206,84 €;1379;0,21;12.730,93 €;'sin fechas';05/06/2011;'INTERESES';'Ingresos';'Rendimientos';
05/06/2011;05/06/2011;'OTROS';-11,50 €;8.195,34 €;1380;-11,50;12.719,43 €;'sin fechas';05/06/2011;'OTROS';'Gastos_Gastos varios';'Otros gastos';'VARIABLES'
06/06/2011;06/06/2011;'AUTOPISTA TERR';-8,45 €;8.186,89 €;1381;-8,45;12.710,98 €;'sin fechas';06/06/2011;'AUTOPISTA';'Gastos_Ocio y transporte';'Parking y peaje';'VARIABLES'
06/06/2011;06/06/2011;'CAFET.C T PRAT';-3,25 €;8.183,64 €;1382;-3,25;12.707,73 €;'sin fechas';06/06/2011;'CAFETC';'Gastos_Ocio y transporte';'Restaurantes';'VARIABLES'
06/06/2011;06/06/2011;'DIETISTA';-62,00 €;8.121,64 €;1383;-62,00;12.645,73 €;'sin fechas';06/06/2011;'DIETISTA';'Gastos_Salud, saber y deporte';'Otros Salud';'VARIABLES'
06/06/2011;06/06/2011;'GINOS LA MAQUINIS';-25,90 €;8.095,74 €;1384;-25,90;12.619,83 €;'sin fechas';06/06/2011;'GINOS';'Gastos_Ocio y transporte';'Restaurantes';'VARIABLES'
06/06/2011;06/06/2011;'LIZARRAN';-10,30 €;8.085,44 €;1385;-10,30;12.609,53 €;'sin fechas';06/06/2011;'LIZARRAN';'Gastos_Ocio y transporte';'Restaurantes';'VARIABLES'
06/06/2011;06/06/2011;'REINT.CAJERO';-38,00 €;8.047,44 €;1386;-38,00;12.571,53 €;'sin fechas';06/06/2011;'REINTCAJERO';'Gastos_Gastos varios';'Efectivo';'VARIABLES'
06/06/2011;06/06/2011;'XFERA MOVILES SA 2767906';-42,06 €;8.005,38 €;1387;-42,06;12.529,47 €;'sin fechas';06/06/2011;'XFERA';'Gastos_Servicios tipicos';'Telecomunicaciones';'FIJO'
07/06/2011;07/06/2011;'CAFET.C T PRAT';-3,10 €;8.002,28 €;1388;-3,10;12.526,37 €;'sin fechas';07/06/2011;'CAFETC';'Gastos_Ocio y transporte';'Restaurantes';'VARIABLES'
07/06/2011;07/06/2011;'MERCADONA';-51,41 €;7.950,87 €;1389;-51,41;12.474,96 €;'sin fechas';07/06/2011;'MERCADONA';'Gastos_Compras';'Supermercado';'VARIABLES'
08/06/2011;08/06/2011;'CAFET.C T PRAT';-3,45 €;7.947,42 €;1390;-3,45;12.471,51 €;'sin fechas';08/06/2011;'CAFETC';'Gastos_Ocio y transporte';'Restaurantes';'VARIABLES'
10/06/2011;10/06/2011;'AUTOPISTA TERR';-3,15 €;7.944,27 €;1391;-3,15;12.468,36 €;'sin fechas';10/06/2011;'AUTOPISTA';'Gastos_Ocio y transporte';'Parking y peaje';'VARIABLES'
10/06/2011;10/06/2011;'CAFET.C T PRAT';-4,05 €;7.940,22 €;1392;-4,05;12.464,31 €;'sin fechas';10/06/2011;'CAFETC';'Gastos_Ocio y transporte';'Restaurantes';'VARIABLES'
10/06/2011;10/06/2011;'CAPRABO';-44,29 €;7.895,93 €;1393;-44,29;12.420,02 €;'sin fechas';10/06/2011;'CAPRABO';'Gastos_Compras';'Supermercado';'VARIABLES'
10/06/2011;10/06/2011;'ES STA. MARGARITA';-30,56 €;7.865,37 €;1394;-30,56;12.389,46 €;'sin fechas';10/06/2011;'STA';'Gastos_Ocio y transporte';'Gasolina';'VARIABLES'
10/06/2011;10/06/2011;'VIENA';-10,30 €;7.855,07 €;1395;-10,30;12.379,16 €;'sin fechas';10/06/2011;'VIENA';'Gastos_Ocio y transporte';'Restaurantes';'VARIABLES'
13/06/2011;13/06/2011;'AUTOPISTA TERR';-3,15 €;7.851,92 €;1396;-3,15;12.376,01 €;'sin fechas';13/06/2011;'AUTOPISTA';'Gastos_Ocio y transporte';'Parking y peaje';'VARIABLES'
13/06/2011;13/06/2011;'GAS NATURAL';-116,82 €;7.735,10 €;1397;-116,82;12.259,19 €;'sin fechas';13/06/2011;'GAS';'Gastos_Servicios tipicos';'Gas';'FIJO'
13/06/2011;13/06/2011;'VILAR RURAL';-399,75 €;7.335,35 €;1398;-399,75;11.859,44 €;'sin fechas';13/06/2011;'VILAR';'Gastos_Ocio y transporte';'Vacaciones';'VARIABLES'
14/06/2011;14/06/2011;'AUTOPISTA TERR';-0,70 €;7.334,65 €;1399;-0,70;11.858,74 €;'sin fechas';14/06/2011;'AUTOPISTA';'Gastos_Ocio y transporte';'Parking y peaje';'VARIABLES'
14/06/2011;14/06/2011;'AUTOPISTA TERR';-1,23 €;7.333,42 €;1400;-1,23;11.857,51 €;'sin fechas';14/06/2011;'AUTOPISTA';'Gastos_Ocio y transporte';'Parking y peaje';'VARIABLES'
14/06/2011;14/06/2011;'CAFET.C T PRAT';-1,40 €;7.332,02 €;1401;-1,40;11.856,11 €;'sin fechas';14/06/2011;'CAFETC';'Gastos_Ocio y transporte';'Restaurantes';'VARIABLES'
14/06/2011;14/06/2011;'CAPRABO';-3,00 €;7.329,02 €;1402;-3,00;11.853,11 €;'sin fechas';14/06/2011;'CAPRABO';'Gastos_Compras';'Supermercado';'VARIABLES'
14/06/2011;14/06/2011;'DOROTHY PEREINS EVAN\\MATARO';-78,00 €;7.251,02 €;1403;-78,00;11.775,11 €;'sin fechas';14/06/2011;'DOROTHY';'Gastos_Compras';'Ropa';'VARIABLES'
14/06/2011;14/06/2011;'FRANKFURT PIZZERIA K\\MATARO';-13,30 €;7.237,72 €;1404;-13,30;11.761,81 €;'sin fechas';14/06/2011;'FRANKFURT';'Gastos_Ocio y transporte';'Restaurantes';'VARIABLES'
15/06/2011;15/06/2011;'A.E.A.T. DEVOLUCIONES TRIBUTAR';419,94 €;7.657,66 €;1405;419,94;12.181,75 €;'sin fechas';15/06/2011;'AEAT';'Ingresos';'Devoluciones';'VARIABLES'
15/06/2011;15/06/2011;'CAFET.C T PRAT';-3,85 €;7.653,81 €;1406;-3,85;12.177,90 €;'sin fechas';15/06/2011;'CAFETC';'Gastos_Ocio y transporte';'Restaurantes';'VARIABLES'
15/06/2011;15/06/2011;'CCM VIDA Y P SEGURO PRESTAMO';-27,42 €;7.626,39 €;1407;-27,42;12.150,48 €;'sin fechas';15/06/2011;'CCM';'Gastos_Seguros';'Seguro vida';'FIJO'
15/06/2011;15/06/2011;'CCM VIDA Y PENSIO 000000493358';-19,21 €;7.607,18 €;1408;-19,21;12.131,27 €;'sin fechas';15/06/2011;'CCM';'Gastos_Seguros';'Seguro vida';'FIJO'
16/06/2011;16/06/2011;'CAFET.C T PRAT';-3,35 €;7.603,83 €;1409;-3,35;12.127,92 €;'sin fechas';16/06/2011;'CAFETC';'Gastos_Ocio y transporte';'Restaurantes';'VARIABLES'
16/06/2011;16/06/2011;'OCIO&OTROS';-60,00 €;7.543,83 €;1410;-60,00;12.067,92 €;'sin fechas';16/06/2011;'OCIOOTROS';'Gastos_Ocio y transporte';'Otros ocio';'VARIABLES'
16/06/2011;16/06/2011;'OCIO&OTROS';-240,00 €;7.303,83 €;1411;-240,00;11.827,92 €;'sin fechas';16/06/2011;'OCIOOTROS';'Gastos_Ocio y transporte';'Otros ocio';'VARIABLES'
17/06/2011;17/06/2011;'EROSKI-[COMIDA]';-57,71 €;7.246,12 €;1412;-57,71;11.770,21 €;'sin fechas';17/06/2011;'EROSKICOMIDA';'Gastos_Compras';'Supermercado';'VARIABLES'
17/06/2011;17/06/2011;'EROSKI-[OTROS]';-219,00 €;7.027,12 €;1413;-219,00;11.551,21 €;'sin fechas';17/06/2011;'EROSKIOTROS';'Gastos_Compras';'Supermercado';'VARIABLES'
17/06/2011;17/06/2011;'ONO';-83,50 €;6.943,62 €;1414;-83,50;11.467,71 €;'sin fechas';17/06/2011;'ONO';'Gastos_Servicios tipicos';'Telecomunicaciones';'FIJO'
18/06/2011;18/06/2011;'AUTOPISTA TERR';-1,80 €;6.941,82 €;1415;-1,80;11.465,91 €;'sin fechas';18/06/2011;'AUTOPISTA';'Gastos_Ocio y transporte';'Parking y peaje';'VARIABLES'
18/06/2011;18/06/2011;'AUTOPISTA TERR';-3,10 €;6.938,72 €;1416;-3,10;11.462,81 €;'sin fechas';18/06/2011;'AUTOPISTA';'Gastos_Ocio y transporte';'Parking y peaje';'VARIABLES'
18/06/2011;18/06/2011;'BON AREA';-12,74 €;6.925,98 €;1417;-12,74;11.450,07 €;'sin fechas';18/06/2011;'BON';'Gastos_Compras';'Supermercado';'VARIABLES'
18/06/2011;18/06/2011;'FARMACIA';-24,51 €;6.901,47 €;1418;-24,51;11.425,56 €;'sin fechas';18/06/2011;'FARMACIA';'Gastos_Salud, saber y deporte';'Farmacia';'VARIABLES'
18/06/2011;18/06/2011;'GAMAX \\TARRASA';-47,50 €;6.853,97 €;1419;-47,50;11.378,06 €;'sin fechas';18/06/2011;'GAMAX';'Gastos_Compras';'Ropa';'VARIABLES'
18/06/2011;18/06/2011;'GASOLINERA';-24,30 €;6.829,67 €;1420;-24,30;11.353,76 €;'sin fechas';18/06/2011;'GASOLINERA';'Gastos_Ocio y transporte';'Gasolina';'VARIABLES'
20/06/2011;20/06/2011;'AG.TRIBUT GABRIEL';100,00 €;6.929,67 €;1421;100,00;11.453,76 €;'sin fechas';20/06/2011;'AGTRIBUT';'Ingresos';'Subvenciones';
20/06/2011;20/06/2011;'CAFET.C T PRAT';-2,40 €;6.927,27 €;1422;-2,40;11.451,36 €;'sin fechas';20/06/2011;'CAFETC';'Gastos_Ocio y transporte';'Restaurantes';'VARIABLES'
20/06/2011;20/06/2011;'FOMENT DE TERRASSA, S.A. FOMEN';3.200,64 €;10.127,91 €;1423;3.200,64;14.652,00 €;'sin fechas';20/06/2011;'FOMENT';'Ingresos';'Nomina';'FIJO'
20/06/2011;20/06/2011;'MERCADONA';-1,34 €;10.126,57 €;1424;-1,34;14.650,66 €;'sin fechas';20/06/2011;'MERCADONA';'Gastos_Compras';'Supermercado';'VARIABLES'
20/06/2011;20/06/2011;'MERCADONA';-181,47 €;9.945,10 €;1425;-181,47;14.469,19 €;'sin fechas';20/06/2011;'MERCADONA';'Gastos_Compras';'Supermercado';'VARIABLES'
20/06/2011;20/06/2011;'TOYOTA ORIENT CARS';-215,96 €;9.729,14 €;1426;-215,96;14.253,23 €;'sin fechas';20/06/2011;'TOYOTA';'Gastos_Vivienda y vehiculo';'Mnto. vehiculo';'VARIABLE'
21/06/2011;21/06/2011;'CAFET.C T PRAT';-2,40 €;9.726,74 €;1427;-2,40;14.250,83 €;'sin fechas';21/06/2011;'CAFETC';'Gastos_Ocio y transporte';'Restaurantes';'VARIABLES'
21/06/2011;21/06/2011;'ENDESA ENERG EE_XXI40025545678';-57,68 €;9.669,06 €;1428;-57,68;14.193,15 €;'sin fechas';21/06/2011;'ENDESA';'Gastos_Servicios tipicos';'Electricidad';'FIJO'
22/06/2011;22/06/2011;'AUTOPISTA TERR';-3,35 €;9.665,71 €;1429;-3,35;14.189,80 €;'sin fechas';22/06/2011;'AUTOPISTA';'Gastos_Ocio y transporte';'Parking y peaje';'VARIABLES'
22/06/2011;22/06/2011;'AUTOPISTA TERR';-5,15 €;9.660,56 €;1430;-5,15;14.184,65 €;'sin fechas';22/06/2011;'AUTOPISTA';'Gastos_Ocio y transporte';'Parking y peaje';'VARIABLES'
22/06/2011;22/06/2011;'CAFET.C T PRAT';-1,40 €;9.659,16 €;1431;-1,40;14.183,25 €;'sin fechas';22/06/2011;'CAFETC';'Gastos_Ocio y transporte';'Restaurantes';'VARIABLES'
22/06/2011;22/06/2011;'CARREFOUR-[COMIDA]';-39,03 €;9.620,13 €;1432;-39,03;14.144,22 €;'sin fechas';22/06/2011;'CARREFOURCOMIDA';'Gastos_Compras';'Supermercado';'VARIABLES'
22/06/2011;22/06/2011;'ES STA. MARGARITA';-48,83 €;9.571,30 €;1433;-48,83;14.095,39 €;'sin fechas';22/06/2011;'STA';'Gastos_Ocio y transporte';'Gasolina';'VARIABLES'
22/06/2011;22/06/2011;'RESTAURANTES';-16,80 €;9.554,50 €;1434;-16,80;14.078,59 €;'sin fechas';22/06/2011;'RESTAURANTES';'Gastos_Ocio y transporte';'Restaurantes';'VARIABLES'
22/06/2011;22/06/2011;'TOCINERIES VENTURA';-26,99 €;9.527,51 €;1435;-26,99;14.051,60 €;'sin fechas';22/06/2011;'TOCINERIES';'Gastos_Compras';'Supermercado';'VARIABLES'
23/06/2011;23/06/2011;'CAFET.C T PRAT';-1,40 €;9.526,11 €;1436;-1,40;14.050,20 €;'sin fechas';23/06/2011;'CAFETC';'Gastos_Ocio y transporte';'Restaurantes';'VARIABLES'
23/06/2011;23/06/2011;'CASA SABATERS';-40,00 €;9.486,11 €;1437;-40,00;14.010,20 €;'sin fechas';23/06/2011;'CASA';'Gastos_Ocio y transporte';'Restaurantes';'VARIABLES'
23/06/2011;23/06/2011;'MERCADONA';-7,60 €;9.478,51 €;1438;-7,60;14.002,60 €;'sin fechas';23/06/2011;'MERCADONA';'Gastos_Compras';'Supermercado';'VARIABLES'
23/06/2011;23/06/2011;'MINA PUBLICA AIGUES T.01A75789';-34,59 €;9.443,92 €;1439;-34,59;13.968,01 €;'sin fechas';23/06/2011;'MINA';'Gastos_Servicios tipicos';'Agua';'FIJO'
23/06/2011;23/06/2011;'REINT.CAJERO';-100,00 €;9.343,92 €;1440;-100,00;13.868,01 €;'sin fechas';23/06/2011;'REINTCAJERO';'Gastos_Gastos varios';'Efectivo';'VARIABLES'
25/06/2011;25/06/2011;'FASHION KANAK \\BADALONA';-36,98 €;9.306,94 €;1441;-36,98;13.831,03 €;'sin fechas';25/06/2011;'FASHION';'Gastos_Compras';'Ropa';'VARIABLES'
25/06/2011;25/06/2011;'KUROKAI';-43,98 €;9.262,96 €;1442;-43,98;13.787,05 €;'sin fechas';25/06/2011;'KUROKAI';'Gastos_Compras';'Ropa';'VARIABLES'
25/06/2011;25/06/2011;'MERCADONA';-14,43 €;9.248,53 €;1443;-14,43;13.772,62 €;'sin fechas';25/06/2011;'MERCADONA';'Gastos_Compras';'Supermercado';'VARIABLES'
25/06/2011;25/06/2011;'RESTAURANTES';-40,75 €;9.207,78 €;1444;-40,75;13.731,87 €;'sin fechas';25/06/2011;'RESTAURANTES';'Gastos_Ocio y transporte';'Restaurantes';'VARIABLES'
26/06/2011;26/06/2011;'AMC PARC VALLES';-17,40 €;9.190,38 €;1445;-17,40;13.714,47 €;'sin fechas';26/06/2011;'AMC';'Gastos_Ocio y transporte';'Espectáculos';'VARIABLES'
26/06/2011;26/06/2011;'VIENA';-15,50 €;9.174,88 €;1446;-15,50;13.698,97 €;'sin fechas';26/06/2011;'VIENA';'Gastos_Ocio y transporte';'Restaurantes';'VARIABLES'
27/06/2011;27/06/2011;'CAFET.C T PRAT';-2,95 €;9.171,93 €;1447;-2,95;13.696,02 €;'sin fechas';27/06/2011;'CAFETC';'Gastos_Ocio y transporte';'Restaurantes';'VARIABLES'
27/06/2011;27/06/2011;'CANGUROS';-200,00 €;8.971,93 €;1448;-200,00;13.496,02 €;'sin fechas';27/06/2011;'CANGUROS';'Gastos_Salud, saber y deporte';'Estudios';'VARIABLES'
27/06/2011;27/06/2011;'DIETISTA';-62,00 €;8.909,93 €;1449;-62,00;13.434,02 €;'sin fechas';27/06/2011;'DIETISTA';'Gastos_Salud, saber y deporte';'Otros Salud';'VARIABLES'
27/06/2011;27/06/2011;'FARMACIA';-77,91 €;8.832,02 €;1450;-77,91;13.356,11 €;'sin fechas';27/06/2011;'FARMACIA';'Gastos_Salud, saber y deporte';'Farmacia';'VARIABLES'
27/06/2011;27/06/2011;'REINT.CAJERO';-38,00 €;8.794,02 €;1451;-38,00;13.318,11 €;'sin fechas';27/06/2011;'REINTCAJERO';'Gastos_Gastos varios';'Efectivo';'VARIABLES'
28/06/2011;28/06/2011;'AUTOPISTA TERR';-1,80 €;8.792,22 €;1452;-1,80;13.316,31 €;'sin fechas';28/06/2011;'AUTOPISTA';'Gastos_Ocio y transporte';'Parking y peaje';'VARIABLES'
28/06/2011;28/06/2011;'CAFET.C T PRAT';-1,40 €;8.790,82 €;1453;-1,40;13.314,91 €;'sin fechas';28/06/2011;'CAFETC';'Gastos_Ocio y transporte';'Restaurantes';'VARIABLES'
28/06/2011;28/06/2011;'INFORMACIO I TECNOLOGIA DE CAT';1.526,20 €;10.317,02 €;1454;1.526,20;14.841,11 €;'sin fechas';28/06/2011;'INFORMACIO';'Ingresos';'Nomina';'FIJO'
29/06/2011;29/06/2011;'A.E.A.T. DEVOLUCIONES TRIBUTAR';623,86 €;10.940,88 €;1455;623,86;15.464,97 €;'sin fechas';29/06/2011;'AEAT';'Ingresos';'Devoluciones';'VARIABLES'
29/06/2011;29/06/2011;'CAFET.C T PRAT';-3,90 €;10.936,98 €;1456;-3,90;15.461,07 €;'sin fechas';29/06/2011;'CAFETC';'Gastos_Ocio y transporte';'Restaurantes';'VARIABLES'
30/06/2011;30/06/2011;'LA CARBASSA DEL PA';-8,95 €;10.928,03 €;1457;-8,95;15.452,12 €;'sin fechas';30/06/2011;'CARBASSA';'Gastos_Ocio y transporte';'Restaurantes';'VARIABLES'
30/06/2011;30/06/2011;'RECIBO PTMOS. 3061-0960001518';-598,03 €;10.330,00 €;1458;-598,03;14.854,09 €;'sin fechas';30/06/2011;'RECIBO';'Gastos_Banco y organismos';'Hipoteca';'FIJO'
30/06/2011;30/06/2011;'TANGO PASSEIG';-20,00 €;10.310,00 €;1459;-20,00;14.834,09 €;'sin fechas';30/06/2011;'TANGO';'No computable';'No computable';'No computable'
30/06/2011;30/06/2011;'TIBET LHASA BAR RES';-15,90 €;10.294,10 €;1460;-15,90;14.818,19 €;'sin fechas';30/06/2011;'TIBET';'Gastos_Ocio y transporte';'Restaurantes';'VARIABLES'
01/07/2011;01/07/2011;'AJUNTAMENT DE TER 010000520716';-37,18 €;10.256,92 €;1461;-37,18;14.781,01 €;'sin fechas';01/07/2011;'AJUNTAMENT';'Gastos_Banco y organismos';'Ayuntamiento';'FIJO'
01/07/2011;01/07/2011;'ALCAMPO';-5,38 €;10.251,54 €;1462;-5,38;14.775,63 €;'sin fechas';01/07/2011;'ALCAMPO';'Gastos_Compras';'Supermercado';'VARIABLES'
01/07/2011;01/07/2011;'BON AREA';-8,76 €;10.242,78 €;1463;-8,76;14.766,87 €;'sin fechas';01/07/2011;'BON';'Gastos_Compras';'Supermercado';'VARIABLES'
01/07/2011;01/07/2011;'CANTINA MARIACHI';-26,50 €;10.216,28 €;1464;-26,50;14.740,37 €;'sin fechas';01/07/2011;'CANTINA';'Gastos_Ocio y transporte';'Restaurantes';'VARIABLES'
01/07/2011;01/07/2011;'CAPRABO';-7,38 €;10.208,90 €;1465;-7,38;14.732,99 €;'sin fechas';01/07/2011;'CAPRABO';'Gastos_Compras';'Supermercado';'VARIABLES'
01/07/2011;01/07/2011;'CIA.DE SEGUROS AD 006662671613';-73,20 €;10.135,70 €;1466;-73,20;14.659,79 €;'sin fechas';01/07/2011;'CIADE';'Gastos_Salud, saber y deporte';'Medico';'VARIABLES'
01/07/2011;01/07/2011;'IKEA';-4,50 €;10.131,20 €;1467;-4,50;14.655,29 €;'sin fechas';01/07/2011;'IKEA';'Gastos_Vivienda y vehiculo';'Mnto. hogar';'VARIABLES'
01/07/2011;01/07/2011;'IKEA';-54,96 €;10.076,24 €;1468;-54,96;14.600,33 €;'sin fechas';01/07/2011;'IKEA';'Gastos_Vivienda y vehiculo';'Mnto. hogar';'VARIABLES'
01/07/2011;01/07/2011;'MANTENIMIENTO';-1,50 €;10.074,74 €;1469;-1,50;14.598,83 €;'sin fechas';01/07/2011;'MANTENIMIENTO';'Gastos_Banco y organismos';'Cargos banco';'FIJO'
01/07/2011;01/07/2011;'PRIMARK';-9,00 €;10.065,74 €;1470;-9,00;14.589,83 €;'sin fechas';01/07/2011;'PRIMARK';'Gastos_Compras';'Ropa';'VARIABLES'
02/07/2011;02/07/2011;'COMISIONES';-3,60 €;10.062,14 €;1471;-3,60;14.586,23 €;'sin fechas';02/07/2011;'COMISIONES';'Gastos_Banco y organismos';'Cargos banco';'FIJO'
02/07/2011;02/07/2011;'ACUARIOS OCEANWOR';-29,50 €;10.032,64 €;1472;-29,50;14.556,73 €;'sin fechas';02/07/2011;'ACUARIOS';'Gastos_Ocio y transporte';'Espectáculos';'VARIABLES'
02/07/2011;02/07/2011;'AUTOPISTA TERR';-17,00 €;10.015,64 €;1473;-17,00;14.539,73 €;'sin fechas';02/07/2011;'AUTOPISTA';'Gastos_Ocio y transporte';'Parking y peaje';'VARIABLES'
02/07/2011;02/07/2011;'L\''AQUARIUM DE BAR';-8,00 €;10.007,64 €;1474;-8,00;14.531,73 €;'sin fechas';02/07/2011;'LAQUARIUM';'Gastos_Ocio y transporte';'Espectáculos';'VARIABLES'
02/07/2011;02/07/2011;'LIMPIEZA';-90,00 €;9.917,64 €;1475;-90,00;14.441,73 €;'sin fechas';02/07/2011;'LIMPIEZA';'Gastos_Vivienda y vehiculo';'Serv. domestico';'FIJO'
03/07/2011;03/07/2011;'FARMACIA';-11,46 €;9.906,18 €;1476;-11,46;14.430,27 €;'sin fechas';03/07/2011;'FARMACIA';'Gastos_Salud, saber y deporte';'Farmacia';'VARIABLES'
04/07/2011;04/07/2011;'AUTOPISTA TERR';-5,45 €;9.900,73 €;1477;-5,45;14.424,82 €;'sin fechas';04/07/2011;'AUTOPISTA';'Gastos_Ocio y transporte';'Parking y peaje';'VARIABLES'
04/07/2011;04/07/2011;'C&A';-28,00 €;9.872,73 €;1478;-28,00;14.396,82 €;'sin fechas';04/07/2011;'CA';'Gastos_Compras';'Ropa';'VARIABLES'
04/07/2011;04/07/2011;'CAFET.C T PRAT';-4,05 €;9.868,68 €;1479;-4,05;14.392,77 €;'sin fechas';04/07/2011;'CAFETC';'Gastos_Ocio y transporte';'Restaurantes';'VARIABLES'
04/07/2011;04/07/2011;'CASA SABATERS';-59,00 €;9.809,68 €;1480;-59,00;14.333,77 €;'sin fechas';04/07/2011;'CASA';'Gastos_Ocio y transporte';'Restaurantes';'VARIABLES'
04/07/2011;04/07/2011;'FARMACIA';-10,30 €;9.799,38 €;1481;-10,30;14.323,47 €;'sin fechas';04/07/2011;'FARMACIA';'Gastos_Salud, saber y deporte';'Farmacia';'VARIABLES'
04/07/2011;04/07/2011;'METRO BARCELONA';-8,25 €;9.791,13 €;1482;-8,25;14.315,22 €;'sin fechas';04/07/2011;'METRO';'Gastos_Ocio y transporte';'Transporte';'VARIABLES'
04/07/2011;04/07/2011;'PASTA CORNER';-7,70 €;9.783,43 €;1483;-7,70;14.307,52 €;'sin fechas';04/07/2011;'PASTA';'Gastos_Ocio y transporte';'Restaurantes';'VARIABLES'
04/07/2011;04/07/2011;'REINT.CAJERO';-22,90 €;9.760,53 €;1484;-22,90;14.284,62 €;'sin fechas';04/07/2011;'REINTCAJERO';'Gastos_Gastos varios';'Efectivo';'VARIABLES'
04/07/2011;04/07/2011;'STARBUCKS';-4,90 €;9.755,63 €;1485;-4,90;14.279,72 €;'sin fechas';04/07/2011;'STARBUCKS';'Gastos_Ocio y transporte';'Restaurantes';'VARIABLES'
05/07/2011;05/07/2011;'AUTOPISTA TERR';-1,25 €;9.754,38 €;1486;-1,25;14.278,47 €;'sin fechas';05/07/2011;'AUTOPISTA';'Gastos_Ocio y transporte';'Parking y peaje';'VARIABLES'
05/07/2011;05/07/2011;'BODIQUE TERRASSA';-78,49 €;9.675,89 €;1487;-78,49;14.199,98 €;'sin fechas';05/07/2011;'BODIQUE';'Gastos_Compras';'Ropa';'VARIABLES'
05/07/2011;05/07/2011;'CAFET.C T PRAT';-4,85 €;9.671,04 €;1488;-4,85;14.195,13 €;'sin fechas';05/07/2011;'CAFETC';'Gastos_Ocio y transporte';'Restaurantes';'VARIABLES'
05/07/2011;05/07/2011;'GRINZING';-11,00 €;9.660,04 €;1489;-11,00;14.184,13 €;'sin fechas';05/07/2011;'GRINZING';'Gastos_Ocio y transporte';'Restaurantes';'VARIABLES'
05/07/2011;05/07/2011;'M&S';-27,00 €;9.633,04 €;1490;-27,00;14.157,13 €;'sin fechas';05/07/2011;'MS';'Gastos_Compras';'Ropa';'VARIABLES'
05/07/2011;05/07/2011;'XFERA MOVILES SA 2767906';-42,82 €;9.590,22 €;1491;-42,82;14.114,31 €;'sin fechas';05/07/2011;'XFERA';'Gastos_Servicios tipicos';'Telecomunicaciones';'FIJO'
06/07/2011;06/07/2011;'CAFET.C T PRAT';-3,45 €;9.586,77 €;1492;-3,45;14.110,86 €;'sin fechas';06/07/2011;'CAFETC';'Gastos_Ocio y transporte';'Restaurantes';'VARIABLES'
06/07/2011;06/07/2011;'ES STA. MARGARITA';-44,93 €;9.541,84 €;1493;-44,93;14.065,93 €;'sin fechas';06/07/2011;'STA';'Gastos_Ocio y transporte';'Gasolina';'VARIABLES'
07/07/2011;07/07/2011;'CAFET.C T PRAT';-3,10 €;9.538,74 €;1494;-3,10;14.062,83 €;'sin fechas';07/07/2011;'CAFETC';'Gastos_Ocio y transporte';'Restaurantes';'VARIABLES'
07/07/2011;07/07/2011;'CARREFOUR-[COMIDA]';-1,02 €;9.537,72 €;1495;-1,02;14.061,81 €;'sin fechas';07/07/2011;'CARREFOURCOMIDA';'Gastos_Compras';'Supermercado';'VARIABLES'
07/07/2011;07/07/2011;'H&M';-19,95 €;9.517,77 €;1496;-19,95;14.041,86 €;'sin fechas';07/07/2011;'HM';'Gastos_Compras';'Ropa';'VARIABLES'
07/07/2011;07/07/2011;'LIZARRAN';-15,50 €;9.502,27 €;1497;-15,50;14.026,36 €;'sin fechas';07/07/2011;'LIZARRAN';'Gastos_Ocio y transporte';'Restaurantes';'VARIABLES'
07/07/2011;07/07/2011;'VIENA';-7,00 €;9.495,27 €;1498;-7,00;14.019,36 €;'sin fechas';07/07/2011;'VIENA';'Gastos_Ocio y transporte';'Restaurantes';'VARIABLES'
08/07/2011;08/07/2011;'CAFET.C T PRAT';-1,50 €;9.493,77 €;1499;-1,50;14.017,86 €;'sin fechas';08/07/2011;'CAFETC';'Gastos_Ocio y transporte';'Restaurantes';'VARIABLES'
08/07/2011;08/07/2011;'CAFET.C T PRAT';-1,55 €;9.492,22 €;1500;-1,55;14.016,31 €;'sin fechas';08/07/2011;'CAFETC';'Gastos_Ocio y transporte';'Restaurantes';'VARIABLES'
08/07/2011;08/07/2011;'CAPRABO';-5,78 €;9.486,44 €;1501;-5,78;14.010,53 €;'sin fechas';08/07/2011;'CAPRABO';'Gastos_Compras';'Supermercado';'VARIABLES'
08/07/2011;08/07/2011;'CENTRES AUTOEQUIP';-242,70 €;9.243,74 €;1502;-242,70;13.767,83 €;'sin fechas';08/07/2011;'CENTRES';'Gastos_Vivienda y vehiculo';'Mnto. vehiculo';'VARIABLE'
08/07/2011;08/07/2011;'VIENA';-6,45 €;9.237,29 €;1503;-6,45;13.761,38 €;'sin fechas';08/07/2011;'VIENA';'Gastos_Ocio y transporte';'Restaurantes';'VARIABLES'
09/07/2011;09/07/2011;'LA CARBASSA DEL PA';-8,40 €;9.228,89 €;1504;-8,40;13.752,98 €;'sin fechas';09/07/2011;'CARBASSA';'Gastos_Ocio y transporte';'Restaurantes';'VARIABLES'
09/07/2011;09/07/2011;'MERCADONA';-25,27 €;9.203,62 €;1505;-25,27;13.727,71 €;'sin fechas';09/07/2011;'MERCADONA';'Gastos_Compras';'Supermercado';'VARIABLES'
11/07/2011;11/07/2011;'CAFET.C T PRAT';-4,05 €;9.199,57 €;1506;-4,05;13.723,66 €;'sin fechas';11/07/2011;'CAFETC';'Gastos_Ocio y transporte';'Restaurantes';'VARIABLES'
11/07/2011;11/07/2011;'CAPRABO';-5,63 €;9.193,94 €;1507;-5,63;13.718,03 €;'sin fechas';11/07/2011;'CAPRABO';'Gastos_Compras';'Supermercado';'VARIABLES'
11/07/2011;11/07/2011;'REINT.CAJERO';-150,00 €;9.043,94 €;1508;-150,00;13.568,03 €;'sin fechas';11/07/2011;'REINTCAJERO';'Gastos_Gastos varios';'Efectivo';'VARIABLES'
12/07/2011;12/07/2011;'CAFET.C T PRAT';-2,35 €;9.041,59 €;1509;-2,35;13.565,68 €;'sin fechas';12/07/2011;'CAFETC';'Gastos_Ocio y transporte';'Restaurantes';'VARIABLES'
12/07/2011;12/07/2011;'LOTERIASYAPUESTAS.ES\\MADRID';-20,00 €;9.021,59 €;1510;-20,00;13.545,68 €;'sin fechas';12/07/2011;'LOTERIASYAPUESTASESMADRID';'Gastos_Ocio y transporte';'Loterias';
12/07/2011;12/07/2011;'RODELAS PERRUQUERS';-13,50 €;9.008,09 €;1511;-13,50;13.532,18 €;'sin fechas';12/07/2011;'RODELAS';'Gastos_Salud, saber y deporte';'Belleza';'VARIABLES'
12/07/2011;12/07/2011;'TOCINERIES VENTURA';-5,40 €;9.002,69 €;1512;-5,40;13.526,78 €;'sin fechas';12/07/2011;'TOCINERIES';'Gastos_Compras';'Supermercado';'VARIABLES'
13/07/2011;13/07/2011;'CAFET.C T PRAT';-2,70 €;8.999,99 €;1513;-2,70;13.524,08 €;'sin fechas';13/07/2011;'CAFETC';'Gastos_Ocio y transporte';'Restaurantes';'VARIABLES'
13/07/2011;13/07/2011;'READING 8';-24,81 €;8.975,18 €;1514;-24,81;13.499,27 €;'sin fechas';13/07/2011;'READING';'Gastos_Salud, saber y deporte';'Estudios';'VARIABLES'
13/07/2011;13/07/2011;'REINT.CAJERO';-350,00 €;8.625,18 €;1515;-350,00;13.149,27 €;'sin fechas';13/07/2011;'REINTCAJERO';'Gastos_Gastos varios';'Efectivo';'VARIABLES'
13/07/2011;13/07/2011;'RODELAS PERRUQUERS';-16,95 €;8.608,23 €;1516;-16,95;13.132,32 €;'sin fechas';13/07/2011;'RODELAS';'Gastos_Salud, saber y deporte';'Belleza';'VARIABLES'
13/07/2011;13/07/2011;'TRANSPORTS MUNICIP';-16,50 €;8.591,73 €;1517;-16,50;13.115,82 €;'sin fechas';13/07/2011;'TRANSPORTS';'Gastos_Ocio y transporte';'Transporte';'VARIABLES'
14/07/2011;14/07/2011;'CAFET.C T PRAT';-3,20 €;8.588,53 €;1518;-3,20;13.112,62 €;'sin fechas';14/07/2011;'CAFETC';'Gastos_Ocio y transporte';'Restaurantes';'VARIABLES'
14/07/2011;14/07/2011;'CARREFOUR-[MODA]';-54,23 €;8.534,30 €;1519;-54,23;13.058,39 €;'sin fechas';14/07/2011;'CARREFOURMODA';'Gastos_Compras';'Supermercado';'VARIABLES'
14/07/2011;14/07/2011;'DECATHLON';-16,95 €;8.517,35 €;1520;-16,95;13.041,44 €;'sin fechas';14/07/2011;'DECATHLON';'Gastos_Compras';'Deportivo';'VARIABLES'
15/07/2011;15/07/2011;'CAFET.C T PRAT';-2,50 €;8.514,85 €;1521;-2,50;13.038,94 €;'sin fechas';15/07/2011;'CAFETC';'Gastos_Ocio y transporte';'Restaurantes';'VARIABLES'
15/07/2011;15/07/2011;'CCM VIDA Y P SEGURO PRESTAMO';-27,52 €;8.487,33 €;1522;-27,52;13.011,42 €;'sin fechas';15/07/2011;'CCM';'Gastos_Seguros';'Seguro vida';'FIJO'
15/07/2011;15/07/2011;'CCM VIDA Y PENSIO 000000493358';-19,17 €;8.468,16 €;1523;-19,17;12.992,25 €;'sin fechas';15/07/2011;'CCM';'Gastos_Seguros';'Seguro vida';'FIJO'
15/07/2011;15/07/2011;'EROSKI-[COMIDA]';-23,56 €;8.444,60 €;1524;-23,56;12.968,69 €;'sin fechas';15/07/2011;'EROSKICOMIDA';'Gastos_Compras';'Supermercado';'VARIABLES'
15/07/2011;15/07/2011;'GREENWICH PIEL, S.L\\TARRASA';-9,99 €;8.434,61 €;1525;-9,99;12.958,70 €;'sin fechas';15/07/2011;'GREENWICH';'Gastos_Compras';'Ropa';'VARIABLES'
15/07/2011;18/07/2011;'INFORMACIO I TECNOLOGIA DE CAT';1.666,50 €;10.101,11 €;1526;1.666,50;14.625,20 €;'sin fechas';18/07/2011;'INFORMACIO';'Ingresos';'Nomina';'FIJO'
15/07/2011;15/07/2011;'VIENA';-2,70 €;10.098,41 €;1527;-2,70;14.622,50 €;'sin fechas';15/07/2011;'VIENA';'Gastos_Ocio y transporte';'Restaurantes';'VARIABLES'
16/07/2011;16/07/2011;'ES STA. MARGARITA';-43,14 €;10.055,27 €;1528;-43,14;14.579,36 €;'sin fechas';16/07/2011;'STA';'Gastos_Ocio y transporte';'Gasolina';'VARIABLES'
16/07/2011;16/07/2011;'MERCADONA';-213,94 €;9.841,33 €;1529;-213,94;14.365,42 €;'sin fechas';16/07/2011;'MERCADONA';'Gastos_Compras';'Supermercado';'VARIABLES'
16/07/2011;16/07/2011;'SUMA XERTA II \\XERTA';-24,95 €;9.816,38 €;1530;-24,95;14.340,47 €;'sin fechas';16/07/2011;'SUMA';'Gastos_Compras';'Supermercado';'VARIABLES'
16/07/2011;16/07/2011;'VIENA';-9,90 €;9.806,48 €;1531;-9,90;14.330,57 €;'sin fechas';16/07/2011;'VIENA';'Gastos_Ocio y transporte';'Restaurantes';'VARIABLES'
18/07/2011;18/07/2011;'ONO';-92,67 €;9.713,81 €;1532;-92,67;14.237,90 €;'sin fechas';18/07/2011;'ONO';'Gastos_Servicios tipicos';'Telecomunicaciones';'FIJO'
18/07/2011;18/07/2011;'SABECO';-65,69 €;9.648,12 €;1533;-65,69;14.172,21 €;'sin fechas';18/07/2011;'SABECO';'Gastos_Compras';'Supermercado';'VARIABLES'
20/07/2011;20/07/2011;'AG.TRIBUT GABRIEL';100,00 €;9.748,12 €;1534;100,00;14.272,21 €;'sin fechas';20/07/2011;'AGTRIBUT';'Ingresos';'Subvenciones';
20/07/2011;20/07/2011;'ENDESA ENERG EE_XXI40025545678';-95,07 €;9.653,05 €;1535;-95,07;14.177,14 €;'sin fechas';20/07/2011;'ENDESA';'Gastos_Servicios tipicos';'Electricidad';'FIJO'
22/07/2011;16/07/2011;'AUTOPISTA TERR';-6,00 €;9.647,05 €;1536;-6,00;14.171,14 €;'sin fechas';16/07/2011;'AUTOPISTA';'Gastos_Ocio y transporte';'Parking y peaje';'VARIABLES'
25/07/2011;16/07/2011;'AUTOPISTA TERR';-8,95 €;9.638,10 €;1537;-8,95;14.162,19 €;'sin fechas';16/07/2011;'AUTOPISTA';'Gastos_Ocio y transporte';'Parking y peaje';'VARIABLES'
27/07/2011;27/07/2011;'FOMENT DE TERRASSA, S.A. FOMEN';1.541,02 €;11.179,12 €;1538;1.541,02;15.703,21 €;'sin fechas';27/07/2011;'FOMENT';'Ingresos';'Nomina';'FIJO'
27/07/2011;28/07/2011;'INFORMACIO I TECNOLOGIA DE CAT';1.526,20 €;12.705,32 €;1539;1.526,20;17.229,41 €;'sin fechas';28/07/2011;'INFORMACIO';'Ingresos';'Nomina';'FIJO'
30/07/2011;30/07/2011;'CINES OSCAR \\ROQUETES';-19,00 €;12.686,32 €;1540;-19,00;17.210,41 €;'sin fechas';30/07/2011;'CINES';'Gastos_Ocio y transporte';'Espectáculos';'VARIABLES'
31/07/2011;31/07/2011;'RECIBO PTMOS. 3061-0960001518';-598,03 €;12.088,29 €;1541;-598,03;16.612,38 €;'sin fechas';31/07/2011;'RECIBO';'Gastos_Banco y organismos';'Hipoteca';'FIJO'
01/08/2011;01/08/2011;'AJUNTAMENT DE TER 850000031046';-42,93 €;12.045,36 €;1542;-42,93;16.569,45 €;'sin fechas';01/08/2011;'AJUNTAMENT';'Gastos_Banco y organismos';'Ayuntamiento';'FIJO'
01/08/2011;01/08/2011;'CIA.DE SEGUROS AD 006662671613';-73,20 €;11.972,16 €;1543;-73,20;16.496,25 €;'sin fechas';01/08/2011;'CIADE';'Gastos_Salud, saber y deporte';'Medico';'VARIABLES'
01/08/2011;01/08/2011;'E.S. BAIX EBRE \\TORTOSA';-32,51 €;11.939,65 €;1544;-32,51;16.463,74 €;'sin fechas';01/08/2011;'BAIX';'Gastos_Ocio y transporte';'Gasolina';'VARIABLES'
01/08/2011;01/08/2011;'EMTE MULTISERVICIOS, S 1038842';-67,40 €;11.872,25 €;1545;-67,40;16.396,34 €;'sin fechas';01/08/2011;'EMTE';'Gastos_Servicios tipicos';'Otros servicios';'VARIABLES'
01/08/2011;01/08/2011;'MANTENIMIENTO';-1,50 €;11.870,75 €;1546;-1,50;16.394,84 €;'sin fechas';01/08/2011;'MANTENIMIENTO';'Gastos_Banco y organismos';'Cargos banco';'FIJO'
02/08/2011;02/08/2011;'BON AREA';-27,90 €;11.842,85 €;1547;-27,90;16.366,94 €;'sin fechas';02/08/2011;'BON';'Gastos_Compras';'Supermercado';'VARIABLES'
02/08/2011;02/08/2011;'IKEA';-21,95 €;11.820,90 €;1548;-21,95;16.344,99 €;'sin fechas';02/08/2011;'IKEA';'Gastos_Vivienda y vehiculo';'Mnto. hogar';'VARIABLES'
02/08/2011;02/08/2011;'MEDIA MARKT';-73,90 €;11.747,00 €;1549;-73,90;16.271,09 €;'sin fechas';02/08/2011;'MEDIA';'Gastos_Compras';'Hobbys';'VARIABLES'
02/08/2011;02/08/2011;'RESTAURANTES';-16,40 €;11.730,60 €;1550;-16,40;16.254,69 €;'sin fechas';02/08/2011;'RESTAURANTES';'Gastos_Ocio y transporte';'Restaurantes';'VARIABLES'
03/08/2011;03/08/2011;'CARREFOUR-[COMIDA]';-85,53 €;11.645,07 €;1551;-85,53;16.169,16 €;'sin fechas';03/08/2011;'CARREFOURCOMIDA';'Gastos_Compras';'Supermercado';'VARIABLES'
04/08/2011;04/08/2011;'IKEA';-35,39 €;11.609,68 €;1552;-35,39;16.133,77 €;'sin fechas';04/08/2011;'IKEA';'Gastos_Vivienda y vehiculo';'Mnto. hogar';'VARIABLES'
04/08/2011;04/08/2011;'RESTAURANTES';-9,90 €;11.599,78 €;1553;-9,90;16.123,87 €;'sin fechas';04/08/2011;'RESTAURANTES';'Gastos_Ocio y transporte';'Restaurantes';'VARIABLES'
04/08/2011;04/08/2011;'XFERA MOVILES SA 2767906';-45,71 €;11.554,07 €;1554;-45,71;16.078,16 €;'sin fechas';04/08/2011;'XFERA';'Gastos_Servicios tipicos';'Telecomunicaciones';'FIJO'
05/08/2011;05/08/2011;'ALCAMPO';-49,32 €;11.504,75 €;1555;-49,32;16.028,84 €;'sin fechas';05/08/2011;'ALCAMPO';'Gastos_Compras';'Supermercado';'VARIABLES'
05/08/2011;05/08/2011;'BOLIN SHIJIA, SCP';-21,50 €;11.483,25 €;1556;-21,50;16.007,34 €;'sin fechas';05/08/2011;'BOLIN';'Gastos_Ocio y transporte';'Restaurantes';'VARIABLES'
05/08/2011;05/08/2011;'MERCADONA';-210,18 €;11.273,07 €;1557;-210,18;15.797,16 €;'sin fechas';05/08/2011;'MERCADONA';'Gastos_Compras';'Supermercado';'VARIABLES'
05/08/2011;05/08/2011;'VIENA';-13,60 €;11.259,47 €;1558;-13,60;15.783,56 €;'sin fechas';05/08/2011;'VIENA';'Gastos_Ocio y transporte';'Restaurantes';'VARIABLES'
08/08/2011;08/08/2011;'CAFET.C T PRAT';-0,70 €;11.258,77 €;1559;-0,70;15.782,86 €;'sin fechas';08/08/2011;'CAFETC';'Gastos_Ocio y transporte';'Restaurantes';'VARIABLES'
08/08/2011;08/08/2011;'CASA EVARISTO';-18,26 €;11.240,51 €;1560;-18,26;15.764,60 €;'sin fechas';08/08/2011;'CASA';'Gastos_Ocio y transporte';'Restaurantes';'VARIABLES'
08/08/2011;08/08/2011;'GUSTEMS';-11,97 €;11.228,54 €;1561;-11,97;15.752,63 €;'sin fechas';08/08/2011;'GUSTEMS';'Gastos_Ocio y transporte';'Restaurantes';'VARIABLES'
08/08/2011;08/08/2011;'JAMAICA TERRASSA 1';-4,30 €;11.224,24 €;1562;-4,30;15.748,33 €;'sin fechas';08/08/2011;'JAMAICA';'Gastos_Ocio y transporte';'Restaurantes';'VARIABLES'
08/08/2011;08/08/2011;'TOCINERIES VENTURA';-10,35 €;11.213,89 €;1563;-10,35;15.737,98 €;'sin fechas';08/08/2011;'TOCINERIES';'Gastos_Compras';'Supermercado';'VARIABLES'
09/08/2011;01/08/2011;'AUTOPISTA TERR';-6,00 €;11.207,89 €;1564;-6,00;15.731,98 €;'sin fechas';01/08/2011;'AUTOPISTA';'Gastos_Ocio y transporte';'Parking y peaje';'VARIABLES'
09/08/2011;09/08/2011;'CAFET.C T PRAT';-0,70 €;11.207,19 €;1565;-0,70;15.731,28 €;'sin fechas';09/08/2011;'CAFETC';'Gastos_Ocio y transporte';'Restaurantes';'VARIABLES'
09/08/2011;09/08/2011;'LIDL TERRASSA';-13,55 €;11.193,64 €;1566;-13,55;15.717,73 €;'sin fechas';09/08/2011;'LIDL';'Gastos_Compras';'Supermercado';'VARIABLES'
09/08/2011;09/08/2011;'REINT.CAJERO';-70,00 €;11.123,64 €;1567;-70,00;15.647,73 €;'sin fechas';09/08/2011;'REINTCAJERO';'Gastos_Gastos varios';'Efectivo';'VARIABLES'
10/08/2011;01/08/2011;'AUTOPISTA TERR';-8,95 €;11.114,69 €;1568;-8,95;15.638,78 €;'sin fechas';01/08/2011;'AUTOPISTA';'Gastos_Ocio y transporte';'Parking y peaje';'VARIABLES'
10/08/2011;10/08/2011;'CAFET.C T PRAT';-6,10 €;11.108,59 €;1569;-6,10;15.632,68 €;'sin fechas';10/08/2011;'CAFETC';'Gastos_Ocio y transporte';'Restaurantes';'VARIABLES'
11/08/2011;11/08/2011;'271 MISTER MINIT C';-17,10 €;11.091,49 €;1570;-17,10;15.615,58 €;'sin fechas';11/08/2011;'MISTER';'Gastos_Compras';'Hogar';'VARIABLES'
11/08/2011;11/08/2011;'BLADE CENTER';-29,95 €;11.061,54 €;1571;-29,95;15.585,63 €;'sin fechas';11/08/2011;'BLADE';'Gastos_Compras';'Hobbys';'VARIABLES'
11/08/2011;11/08/2011;'ENTREGA PTMO. 3061-0960001518';-3.000,00 €;8.061,54 €;1572;-3.000,00;12.585,63 €;'sin fechas';11/08/2011;'ENTREGA';'Gastos_Banco y organismos';'Hipoteca';'FIJO'
11/08/2011;11/08/2011;'EROSKI-[COMIDA]';-79,53 €;7.982,01 €;1573;-79,53;12.506,10 €;'sin fechas';11/08/2011;'EROSKICOMIDA';'Gastos_Compras';'Supermercado';'VARIABLES'
11/08/2011;11/08/2011;'GAS NATURAL';-131,32 €;7.850,69 €;1574;-131,32;12.374,78 €;'sin fechas';11/08/2011;'GAS';'Gastos_Servicios tipicos';'Gas';'FIJO'
11/08/2011;11/08/2011;'VIENA';-2,70 €;7.847,99 €;1575;-2,70;12.372,08 €;'sin fechas';11/08/2011;'VIENA';'Gastos_Ocio y transporte';'Restaurantes';'VARIABLES'
12/08/2011;12/08/2011;'GALPGEST-CANAL';-21,20 €;7.826,79 €;1576;-21,20;12.350,88 €;'sin fechas';12/08/2011;'GALPGESTCANAL';'Gastos_Ocio y transporte';'Gasolina';'VARIABLES'
12/08/2011;12/08/2011;'MERCADONA';-19,27 €;7.807,52 €;1577;-19,27;12.331,61 €;'sin fechas';12/08/2011;'MERCADONA';'Gastos_Compras';'Supermercado';'VARIABLES'
12/08/2011;12/08/2011;'TERIOSA TIME,';-48,40 €;7.759,12 €;1578;-48,40;12.283,21 €;'sin fechas';12/08/2011;'TERIOSA';'No computable';'No computable';'No computable'
13/08/2011;13/08/2011;'CARREFOUR-[COMIDA]';-9,94 €;7.749,18 €;1579;-9,94;12.273,27 €;'sin fechas';13/08/2011;'CARREFOURCOMIDA';'Gastos_Compras';'Supermercado';'VARIABLES'
14/08/2011;14/08/2011;'TAKE';-63,18 €;7.686,00 €;1580;-63,18;12.210,09 €;'sin fechas';14/08/2011;'TAKE';'Gastos_Ocio y transporte';'Restaurantes';'VARIABLES'
16/08/2011;16/08/2011;'CCM VIDA Y P SEGURO PRESTAMO';-27,45 €;7.658,55 €;1581;-27,45;12.182,64 €;'sin fechas';16/08/2011;'CCM';'Gastos_Seguros';'Seguro vida';'FIJO'
16/08/2011;16/08/2011;'CCM VIDA Y PENSIO 000000493358';-19,12 €;7.639,43 €;1582;-19,12;12.163,52 €;'sin fechas';16/08/2011;'CCM';'Gastos_Seguros';'Seguro vida';'FIJO'
17/08/2011;17/08/2011;'CATALA GRANADOS SL';-43,96 €;7.595,47 €;1583;-43,96;12.119,56 €;'sin fechas';17/08/2011;'CATALA';'Gastos_Ocio y transporte';'Gasolina';'VARIABLES'
17/08/2011;17/08/2011;'FLORMAR';-5,80 €;7.589,67 €;1584;-5,80;12.113,76 €;'sin fechas';17/08/2011;'FLORMAR';'Gastos_Compras';'Regalos';'VARIABLES'
17/08/2011;17/08/2011;'KIKO';-6,00 €;7.583,67 €;1585;-6,00;12.107,76 €;'sin fechas';17/08/2011;'KIKO';'Gastos_Salud, saber y deporte';'Belleza';'VARIABLES'
17/08/2011;17/08/2011;'MISAKO';-9,00 €;7.574,67 €;1586;-9,00;12.098,76 €;'sin fechas';17/08/2011;'MISAKO';'Gastos_Compras';'Ropa';'VARIABLES'
17/08/2011;17/08/2011;'ONO';-86,47 €;7.488,20 €;1587;-86,47;12.012,29 €;'sin fechas';17/08/2011;'ONO';'Gastos_Servicios tipicos';'Telecomunicaciones';'FIJO'
18/08/2011;18/08/2011;'CAFET.C T PRAT';-1,90 €;7.486,30 €;1588;-1,90;12.010,39 €;'sin fechas';18/08/2011;'CAFETC';'Gastos_Ocio y transporte';'Restaurantes';'VARIABLES'
18/08/2011;18/08/2011;'ENDESA ENERG EE_XXI40025545678';-61,25 €;7.425,05 €;1589;-61,25;11.949,14 €;'sin fechas';18/08/2011;'ENDESA';'Gastos_Servicios tipicos';'Electricidad';'FIJO'
19/08/2011;19/08/2011;'CAFET.C T PRAT';-1,90 €;7.423,15 €;1590;-1,90;11.947,24 €;'sin fechas';19/08/2011;'CAFETC';'Gastos_Ocio y transporte';'Restaurantes';'VARIABLES'
19/08/2011;19/08/2011;'MERCADONA';-15,29 €;7.407,86 €;1591;-15,29;11.931,95 €;'sin fechas';19/08/2011;'MERCADONA';'Gastos_Compras';'Supermercado';'VARIABLES'
19/08/2011;19/08/2011;'PRIMARK';-22,50 €;7.385,36 €;1592;-22,50;11.909,45 €;'sin fechas';19/08/2011;'PRIMARK';'Gastos_Compras';'Ropa';'VARIABLES'
22/08/2011;14/08/2011;'AUTOPISTA TERR';-3,35 €;7.382,01 €;1593;-3,35;11.906,10 €;'sin fechas';14/08/2011;'AUTOPISTA';'Gastos_Ocio y transporte';'Parking y peaje';'VARIABLES'
22/08/2011;15/08/2011;'AUTOPISTA TERR';-3,35 €;7.378,66 €;1594;-3,35;11.902,75 €;'sin fechas';15/08/2011;'AUTOPISTA';'Gastos_Ocio y transporte';'Parking y peaje';'VARIABLES'
22/08/2011;22/08/2011;'BOLIN SHIJIA, SCP';-21,50 €;7.357,16 €;1595;-21,50;11.881,25 €;'sin fechas';22/08/2011;'BOLIN';'Gastos_Ocio y transporte';'Restaurantes';'VARIABLES'
22/08/2011;22/08/2011;'EROSKI-[OTROS]';-50,64 €;7.306,52 €;1596;-50,64;11.830,61 €;'sin fechas';22/08/2011;'EROSKIOTROS';'Gastos_Compras';'Supermercado';'VARIABLES'
23/08/2011;23/08/2011;'AG.TRIBUT GABRIEL';100,00 €;7.406,52 €;1597;100,00;11.930,61 €;'sin fechas';23/08/2011;'AGTRIBUT';'Ingresos';'Subvenciones';
23/08/2011;23/08/2011;'TOCINERIES VENTURA';-9,56 €;7.396,96 €;1598;-9,56;11.921,05 €;'sin fechas';23/08/2011;'TOCINERIES';'Gastos_Compras';'Supermercado';'VARIABLES'
24/08/2011;24/08/2011;'CANGUROS';-200,00 €;7.196,96 €;1599;-200,00;11.721,05 €;'sin fechas';24/08/2011;'CANGUROS';'Gastos_Salud, saber y deporte';'Estudios';'VARIABLES'
24/08/2011;24/08/2011;'REINT.CAJERO';-20,00 €;7.176,96 €;1600;-20,00;11.701,05 €;'sin fechas';24/08/2011;'REINTCAJERO';'Gastos_Gastos varios';'Efectivo';'VARIABLES'
25/08/2011;25/08/2011;'CAFET.C T PRAT';-4,00 €;7.172,96 €;1601;-4,00;11.697,05 €;'sin fechas';25/08/2011;'CAFETC';'Gastos_Ocio y transporte';'Restaurantes';'VARIABLES'
25/08/2011;25/08/2011;'CAPRABO';-14,73 €;7.158,23 €;1602;-14,73;11.682,32 €;'sin fechas';25/08/2011;'CAPRABO';'Gastos_Compras';'Supermercado';'VARIABLES'
25/08/2011;25/08/2011;'DIETISTA';-62,00 €;7.096,23 €;1603;-62,00;11.620,32 €;'sin fechas';25/08/2011;'DIETISTA';'Gastos_Salud, saber y deporte';'Otros Salud';'VARIABLES'
25/08/2011;25/08/2011;'REINT.CAJERO';-38,00 €;7.058,23 €;1604;-38,00;11.582,32 €;'sin fechas';25/08/2011;'REINTCAJERO';'Gastos_Gastos varios';'Efectivo';'VARIABLES'
26/08/2011;26/08/2011;'E.S. RUBI II';-30,00 €;7.028,23 €;1605;-30,00;11.552,32 €;'sin fechas';26/08/2011;'RUBI';'Gastos_Ocio y transporte';'Gasolina';'VARIABLES'
26/08/2011;26/08/2011;'FOMENT DE TERRASSA, S.A. FOMEN';2.119,52 €;9.147,75 €;1606;2.119,52;13.671,84 €;'sin fechas';26/08/2011;'FOMENT';'Ingresos';'Nomina';'FIJO'
27/08/2011;27/08/2011;'BUENAS MIGAS';-4,30 €;9.143,45 €;1607;-4,30;13.667,54 €;'sin fechas';27/08/2011;'BUENAS';'Gastos_Ocio y transporte';'Restaurantes';'VARIABLES'
27/08/2011;27/08/2011;'EL CORTE INGLES';-49,90 €;9.093,55 €;1608;-49,90;13.617,64 €;'sin fechas';27/08/2011;'CORTE';'Gastos_Compras';'Supermercado';'VARIABLES'
27/08/2011;27/08/2011;'FF.CC.GENERALITAT';-22,35 €;9.071,20 €;1609;-22,35;13.595,29 €;'sin fechas';27/08/2011;'FFCCGENERALITAT';'Gastos_Ocio y transporte';'Transporte';'VARIABLES'
27/08/2011;27/08/2011;'LA VACA PACA';-43,60 €;9.027,60 €;1610;-43,60;13.551,69 €;'sin fechas';27/08/2011;'VACA';'Gastos_Ocio y transporte';'Restaurantes';'VARIABLES'
29/08/2011;29/08/2011;'CAFET.C T PRAT';-1,90 €;9.025,70 €;1611;-1,90;13.549,79 €;'sin fechas';29/08/2011;'CAFETC';'Gastos_Ocio y transporte';'Restaurantes';'VARIABLES'
29/08/2011;29/08/2011;'FARMACIA';-77,91 €;8.947,79 €;1612;-77,91;13.471,88 €;'sin fechas';29/08/2011;'FARMACIA';'Gastos_Salud, saber y deporte';'Farmacia';'VARIABLES'
29/08/2011;30/08/2011;'INFORMACIO I TECNOLOGIA DE CAT';1.526,20 €;10.473,99 €;1613;1.526,20;14.998,08 €;'sin fechas';30/08/2011;'INFORMACIO';'Ingresos';'Nomina';'FIJO'
29/08/2011;29/08/2011;'FRANKFURT LES LLETRES';-5,15 €;10.468,84 €;1614;-5,15;14.992,93 €;'sin fechas';29/08/2011;'FRANKFURT';'Gastos_Ocio y transporte';'Restaurantes';'VARIABLES'
29/08/2011;29/08/2011;'MERCADONA';-30,99 €;10.437,85 €;1615;-30,99;14.961,94 €;'sin fechas';29/08/2011;'MERCADONA';'Gastos_Compras';'Supermercado';'VARIABLES'
30/08/2011;30/08/2011;'GRINZING';-4,90 €;10.432,95 €;1616;-4,90;14.957,04 €;'sin fechas';30/08/2011;'GRINZING';'Gastos_Ocio y transporte';'Restaurantes';'VARIABLES'
30/08/2011;30/08/2011;'REINT.CAJERO';-40,00 €;10.392,95 €;1617;-40,00;14.917,04 €;'sin fechas';30/08/2011;'REINTCAJERO';'Gastos_Gastos varios';'Efectivo';'VARIABLES'
31/08/2011;31/08/2011;'CAPRABO';-13,40 €;10.379,55 €;1618;-13,40;14.903,64 €;'sin fechas';31/08/2011;'CAPRABO';'Gastos_Compras';'Supermercado';'VARIABLES'
31/08/2011;31/08/2011;'EL CORTE INGLES';-53,90 €;10.325,65 €;1619;-53,90;14.849,74 €;'sin fechas';31/08/2011;'CORTE';'Gastos_Compras';'Supermercado';'VARIABLES'
31/08/2011;31/08/2011;'EL CORTE INGLES';-2,05 €;10.323,60 €;1620;-2,05;14.847,69 €;'sin fechas';31/08/2011;'CORTE';'Gastos_Compras';'Supermercado';'VARIABLES'
31/08/2011;31/08/2011;'RECIBO PTMOS. 3061-0960001518';-583,25 €;9.740,35 €;1621;-583,25;14.264,44 €;'sin fechas';31/08/2011;'RECIBO';'Gastos_Banco y organismos';'Hipoteca';'FIJO'
01/09/2011;01/09/2011;'BOSSANOVA';-22,00 €;9.718,35 €;1622;-22,00;14.242,44 €;'sin fechas';01/09/2011;'BOSSANOVA';'Gastos_Compras';'Ropa';'VARIABLES'
01/09/2011;01/09/2011;'CIA.DE SEGUROS AD 006662671613';-73,20 €;9.645,15 €;1623;-73,20;14.169,24 €;'sin fechas';01/09/2011;'CIADE';'Gastos_Salud, saber y deporte';'Medico';'VARIABLES'
01/09/2011;01/09/2011;'DECATHLON';-22,95 €;9.622,20 €;1624;-22,95;14.146,29 €;'sin fechas';01/09/2011;'DECATHLON';'Gastos_Compras';'Deportivo';'VARIABLES'
01/09/2011;01/09/2011;'ES STA. MARGARITA';-43,29 €;9.578,91 €;1625;-43,29;14.103,00 €;'sin fechas';01/09/2011;'STA';'Gastos_Ocio y transporte';'Gasolina';'VARIABLES'
01/09/2011;01/09/2011;'GAME';-12,95 €;9.565,96 €;1626;-12,95;14.090,05 €;'sin fechas';01/09/2011;'GAME';'Gastos_Compras';'Hobbys';'VARIABLES'
01/09/2011;01/09/2011;'H&M';-19,95 €;9.546,01 €;1627;-19,95;14.070,10 €;'sin fechas';01/09/2011;'HM';'Gastos_Compras';'Ropa';'VARIABLES'
01/09/2011;01/09/2011;'MANTENIMIENTO';-1,50 €;9.544,51 €;1628;-1,50;14.068,60 €;'sin fechas';01/09/2011;'MANTENIMIENTO';'Gastos_Banco y organismos';'Cargos banco';'FIJO'
01/09/2011;01/09/2011;'MERCADONA';-3,24 €;9.541,27 €;1629;-3,24;14.065,36 €;'sin fechas';01/09/2011;'MERCADONA';'Gastos_Compras';'Supermercado';'VARIABLES'
01/09/2011;01/09/2011;'MERCADONA';-140,57 €;9.400,70 €;1630;-140,57;13.924,79 €;'sin fechas';01/09/2011;'MERCADONA';'Gastos_Compras';'Supermercado';'VARIABLES'
01/09/2011;01/09/2011;'OCIO&OTROS';-80,00 €;9.320,70 €;1631;-80,00;13.844,79 €;'sin fechas';01/09/2011;'OCIOOTROS';'Gastos_Ocio y transporte';'Otros ocio';'VARIABLES'
01/09/2011;01/09/2011;'REINT.CAJERO';-7,60 €;9.313,10 €;1632;-7,60;13.837,19 €;'sin fechas';01/09/2011;'REINTCAJERO';'Gastos_Gastos varios';'Efectivo';'VARIABLES'
01/09/2011;01/09/2011;'RESTAURANTES';-24,80 €;9.288,30 €;1633;-24,80;13.812,39 €;'sin fechas';01/09/2011;'RESTAURANTES';'Gastos_Ocio y transporte';'Restaurantes';'VARIABLES'
01/09/2011;01/09/2011;'SERVICIOS&PARKING';-212,40 €;9.075,90 €;1634;-212,40;13.599,99 €;'sin fechas';01/09/2011;'SERVICIOSPARKING';'Gastos_Ocio y transporte';'Parking y peaje';'VARIABLES'
02/09/2011;02/09/2011;'C&A';-29,00 €;9.046,90 €;1635;-29,00;13.570,99 €;'sin fechas';02/09/2011;'CA';'Gastos_Compras';'Ropa';'VARIABLES'
02/09/2011;02/09/2011;'CARREFOUR-[COMIDA]';-32,07 €;9.014,83 €;1636;-32,07;13.538,92 €;'sin fechas';02/09/2011;'CARREFOURCOMIDA';'Gastos_Compras';'Supermercado';'VARIABLES'
02/09/2011;02/09/2011;'FARMACIA';-27,71 €;8.987,12 €;1637;-27,71;13.511,21 €;'sin fechas';02/09/2011;'FARMACIA';'Gastos_Salud, saber y deporte';'Farmacia';'VARIABLES'
02/09/2011;02/09/2011;'FOREVER 21';-18,95 €;8.968,17 €;1638;-18,95;13.492,26 €;'sin fechas';02/09/2011;'FOREVER';'Gastos_Compras';'Ropa';'VARIABLES'
02/09/2011;02/09/2011;'RESTAURANTES';-47,80 €;8.920,37 €;1639;-47,80;13.444,46 €;'sin fechas';02/09/2011;'RESTAURANTES';'Gastos_Ocio y transporte';'Restaurantes';'VARIABLES'
03/09/2011;05/09/2011;'COM. MANT. ACTIVAS DE LIQ.';-4,50 €;8.915,87 €;1640;-4,50;13.439,96 €;'sin fechas';05/09/2011;'COM';'Gastos_Banco y organismos';'Cargos banco';'FIJO'
03/09/2011;03/09/2011;'DHR TRADE SL';-12,10 €;8.903,77 €;1641;-12,10;13.427,86 €;'sin fechas';03/09/2011;'DHR';'Gastos_Ocio y transporte';'Gasolina';'VARIABLES'
03/09/2011;03/09/2011;'FARMACIA';-89,23 €;8.814,54 €;1642;-89,23;13.338,63 €;'sin fechas';03/09/2011;'FARMACIA';'Gastos_Salud, saber y deporte';'Farmacia';'VARIABLES'
03/09/2011;05/09/2011;'IMP.RET.A CTA';-0,05 €;8.814,49 €;1643;-0,05;13.338,58 €;'sin fechas';05/09/2011;'IMPRETA';'Gastos_Banco y organismos';'Impuestos';'FIJO'
03/09/2011;05/09/2011;'INTERESES';0,24 €;8.814,73 €;1644;0,24;13.338,82 €;'sin fechas';05/09/2011;'INTERESES';'Ingresos';'Rendimientos';
03/09/2011;03/09/2011;'LA BRASA';-35,01 €;8.779,72 €;1645;-35,01;13.303,81 €;'sin fechas';03/09/2011;'BRASA';'Gastos_Ocio y transporte';'Restaurantes';'VARIABLES'
03/09/2011;03/09/2011;'METRO BARCELONA';-8,25 €;8.771,47 €;1646;-8,25;13.295,56 €;'sin fechas';03/09/2011;'METRO';'Gastos_Ocio y transporte';'Transporte';'VARIABLES'
05/09/2011;05/09/2011;'BON AREA';-4,97 €;8.766,50 €;1647;-4,97;13.290,59 €;'sin fechas';05/09/2011;'BON';'Gastos_Compras';'Supermercado';'VARIABLES'
06/09/2011;06/09/2011;'XFERA MOVILES SA 2767906';-44,54 €;8.721,96 €;1648;-44,54;13.246,05 €;'sin fechas';06/09/2011;'XFERA';'Gastos_Servicios tipicos';'Telecomunicaciones';'FIJO'
07/09/2011;07/09/2011;'BLITZ';-70,80 €;8.651,16 €;1649;-70,80;13.175,25 €;'sin fechas';07/09/2011;'BLITZ';'Gastos_Vivienda y vehiculo';'Alquiler Parking';'FIJO'
07/09/2011;07/09/2011;'DIETISTA';-62,00 €;8.589,16 €;1650;-62,00;13.113,25 €;'sin fechas';07/09/2011;'DIETISTA';'Gastos_Salud, saber y deporte';'Otros Salud';'VARIABLES'
07/09/2011;07/09/2011;'ESCOLA BRESSOL EINA';-236,00 €;8.353,16 €;1651;-236,00;12.877,25 €;'sin fechas';07/09/2011;'ESCOLA';'Gastos_Salud, saber y deporte';'Estudios';'VARIABLES'
07/09/2011;07/09/2011;'ESCOLA BRESSOL EINA';-161,07 €;8.192,09 €;1652;-161,07;12.716,18 €;'sin fechas';07/09/2011;'ESCOLA';'Gastos_Salud, saber y deporte';'Estudios';'VARIABLES'
07/09/2011;07/09/2011;'OCIO&OTROS';-300,00 €;7.892,09 €;1653;-300,00;12.416,18 €;'sin fechas';07/09/2011;'OCIOOTROS';'Gastos_Ocio y transporte';'Otros ocio';'VARIABLES'
07/09/2011;07/09/2011;'REINT.CAJERO';-38,00 €;7.854,09 €;1654;-38,00;12.378,18 €;'sin fechas';07/09/2011;'REINTCAJERO';'Gastos_Gastos varios';'Efectivo';'VARIABLES'
08/09/2011;08/09/2011;'FARMACIA';-9,65 €;7.844,44 €;1655;-9,65;12.368,53 €;'sin fechas';08/09/2011;'FARMACIA';'Gastos_Salud, saber y deporte';'Farmacia';'VARIABLES'
08/09/2011;08/09/2011;'IKEA';-10,03 €;7.834,41 €;1656;-10,03;12.358,50 €;'sin fechas';08/09/2011;'IKEA';'Gastos_Vivienda y vehiculo';'Mnto. hogar';'VARIABLES'
09/09/2011;09/09/2011;'CAFET.C T PRAT';-4,25 €;7.830,16 €;1657;-4,25;12.354,25 €;'sin fechas';09/09/2011;'CAFETC';'Gastos_Ocio y transporte';'Restaurantes';'VARIABLES'
09/09/2011;09/09/2011;'RODELAS PERRUQUERS';-13,50 €;7.816,66 €;1658;-13,50;12.340,75 €;'sin fechas';09/09/2011;'RODELAS';'Gastos_Salud, saber y deporte';'Belleza';'VARIABLES'
10/09/2011;10/09/2011;'MERCADONA';-1,94 €;7.814,72 €;1659;-1,94;12.338,81 €;'sin fechas';10/09/2011;'MERCADONA';'Gastos_Compras';'Supermercado';'VARIABLES'
11/09/2011;11/09/2011;'BOLIN SHIJIA, SCP';-21,50 €;7.793,22 €;1660;-21,50;12.317,31 €;'sin fechas';11/09/2011;'BOLIN';'Gastos_Ocio y transporte';'Restaurantes';'VARIABLES'
11/09/2011;11/09/2011;'VIENA';-1,50 €;7.791,72 €;1661;-1,50;12.315,81 €;'sin fechas';11/09/2011;'VIENA';'Gastos_Ocio y transporte';'Restaurantes';'VARIABLES'
12/09/2011;12/09/2011;'CAFET.C T PRAT';-1,90 €;7.789,82 €;1662;-1,90;12.313,91 €;'sin fechas';12/09/2011;'CAFETC';'Gastos_Ocio y transporte';'Restaurantes';'VARIABLES'
12/09/2011;12/09/2011;'EROSKI-[OTROS]';-13,99 €;7.775,83 €;1663;-13,99;12.299,92 €;'sin fechas';12/09/2011;'EROSKIOTROS';'Gastos_Compras';'Supermercado';'VARIABLES'
12/09/2011;12/09/2011;'GAMAX \\TARRASA';-47,50 €;7.728,33 €;1664;-47,50;12.252,42 €;'sin fechas';12/09/2011;'GAMAX';'Gastos_Compras';'Ropa';'VARIABLES'
12/09/2011;12/09/2011;'MERCADONA';-29,70 €;7.698,63 €;1665;-29,70;12.222,72 €;'sin fechas';12/09/2011;'MERCADONA';'Gastos_Compras';'Supermercado';'VARIABLES'
12/09/2011;12/09/2011;'MERCADONA';-2,00 €;7.696,63 €;1666;-2,00;12.220,72 €;'sin fechas';12/09/2011;'MERCADONA';'Gastos_Compras';'Supermercado';'VARIABLES'
13/09/2011;13/09/2011;'DIVAN RESTAURANT T';-22,90 €;7.673,73 €;1667;-22,90;12.197,82 €;'sin fechas';13/09/2011;'DIVAN';'Gastos_Ocio y transporte';'Restaurantes';'VARIABLES'
13/09/2011;13/09/2011;'ES STA. MARGARITA';-43,78 €;7.629,95 €;1668;-43,78;12.154,04 €;'sin fechas';13/09/2011;'STA';'Gastos_Ocio y transporte';'Gasolina';'VARIABLES'
13/09/2011;13/09/2011;'FARMACIA';-9,00 €;7.620,95 €;1669;-9,00;12.145,04 €;'sin fechas';13/09/2011;'FARMACIA';'Gastos_Salud, saber y deporte';'Farmacia';'VARIABLES'
15/09/2011;17/09/2011;'CAFET.C T PRAT';-1,90 €;7.619,05 €;1670;-1,90;12.143,14 €;'sin fechas';17/09/2011;'CAFETC';'Gastos_Ocio y transporte';'Restaurantes';'VARIABLES'
15/09/2011;15/09/2011;'CCM VIDA Y P SEGURO PRESTAMO';-26,69 €;7.592,36 €;1671;-26,69;12.116,45 €;'sin fechas';15/09/2011;'CCM';'Gastos_Seguros';'Seguro vida';'FIJO'
15/09/2011;15/09/2011;'CCM VIDA Y PENSIO 000000493358';-18,60 €;7.573,76 €;1672;-18,60;12.097,85 €;'sin fechas';15/09/2011;'CCM';'Gastos_Seguros';'Seguro vida';'FIJO'
16/09/2011;16/09/2011;'CAFET.C T PRAT';-1,90 €;7.571,86 €;1673;-1,90;12.095,95 €;'sin fechas';16/09/2011;'CAFETC';'Gastos_Ocio y transporte';'Restaurantes';'VARIABLES'
16/09/2011;10/09/2011;'COCHE&PARKING';-4,95 €;7.566,91 €;1674;-4,95;12.091,00 €;'sin fechas';10/09/2011;'COCHEPARKING';'Gastos_Ocio y transporte';'Parking y peaje';'VARIABLES'
16/09/2011;04/09/2011;'COCHE&PARKING';-1,70 €;7.565,21 €;1675;-1,70;12.089,30 €;'sin fechas';04/09/2011;'COCHEPARKING';'Gastos_Ocio y transporte';'Parking y peaje';'VARIABLES'
16/09/2011;16/09/2011;'GAS NATURAL';-231,43 €;7.333,78 €;1676;-231,43;11.857,87 €;'sin fechas';16/09/2011;'GAS';'Gastos_Servicios tipicos';'Gas';'FIJO'
17/09/2011;19/09/2011;'AG.TRIBUT GABRIEL';100,00 €;7.433,78 €;1677;100,00;11.957,87 €;'sin fechas';19/09/2011;'AGTRIBUT';'Ingresos';'Subvenciones';
17/09/2011;17/09/2011;'BON AREA';-14,49 €;7.419,29 €;1678;-14,49;11.943,38 €;'sin fechas';17/09/2011;'BON';'Gastos_Compras';'Supermercado';'VARIABLES'
17/09/2011;17/09/2011;'CAFET.C T PRAT';-1,90 €;7.417,39 €;1679;-1,90;11.941,48 €;'sin fechas';17/09/2011;'CAFETC';'Gastos_Ocio y transporte';'Restaurantes';'VARIABLES'
18/09/2011;13/09/2011;'COCHE&PARKING';-4,25 €;7.413,14 €;1680;-4,25;11.937,23 €;'sin fechas';13/09/2011;'COCHEPARKING';'Gastos_Ocio y transporte';'Parking y peaje';'VARIABLES'
18/09/2011;18/09/2011;'QUEVIURES MANUEL S';-17,18 €;7.395,96 €;1681;-17,18;11.920,05 €;'sin fechas';18/09/2011;'QUEVIURES';'Gastos_Compras';'Supermercado';'VARIABLES'
20/09/2011;20/09/2011;'ALCAMPO';-78,97 €;7.316,99 €;1682;-78,97;11.841,08 €;'sin fechas';20/09/2011;'ALCAMPO';'Gastos_Compras';'Supermercado';'VARIABLES'
20/09/2011;20/09/2011;'CASA DEL LLIBRE';-19,90 €;7.297,09 €;1683;-19,90;11.821,18 €;'sin fechas';20/09/2011;'CASA';'Gastos_Ocio y transporte';'Restaurantes';'VARIABLES'
20/09/2011;20/09/2011;'ENDESA ENERG EE_XXI40025545678';-68,63 €;7.228,46 €;1684;-68,63;11.752,55 €;'sin fechas';20/09/2011;'ENDESA';'Gastos_Servicios tipicos';'Electricidad';'FIJO'
20/09/2011;20/09/2011;'MERCADONA';-55,21 €;7.173,25 €;1685;-55,21;11.697,34 €;'sin fechas';20/09/2011;'MERCADONA';'Gastos_Compras';'Supermercado';'VARIABLES'
20/09/2011;20/09/2011;'ONO';-94,24 €;7.079,01 €;1686;-94,24;11.603,10 €;'sin fechas';20/09/2011;'ONO';'Gastos_Servicios tipicos';'Telecomunicaciones';'FIJO'
20/09/2011;20/09/2011;'PLAT PREU SL';-9,20 €;7.069,81 €;1687;-9,20;11.593,90 €;'sin fechas';20/09/2011;'PLAT';'Gastos_Ocio y transporte';'Restaurantes';'VARIABLES'
20/09/2011;20/09/2011;'TRANSPORTS MUNICIP';-16,50 €;7.053,31 €;1688;-16,50;11.577,40 €;'sin fechas';20/09/2011;'TRANSPORTS';'Gastos_Ocio y transporte';'Transporte';'VARIABLES'
22/09/2011;22/09/2011;'BRICOKING TERRASSA';-9,45 €;7.043,86 €;1689;-9,45;11.567,95 €;'sin fechas';22/09/2011;'BRICOKING';'Gastos_Vivienda y vehiculo';'Mnto. hogar';'VARIABLES'
22/09/2011;22/09/2011;'DIETISTA';-62,00 €;6.981,86 €;1690;-62,00;11.505,95 €;'sin fechas';22/09/2011;'DIETISTA';'Gastos_Salud, saber y deporte';'Otros Salud';'VARIABLES'
22/09/2011;22/09/2011;'LIMPIEZA';-120,00 €;6.861,86 €;1691;-120,00;11.385,95 €;'sin fechas';22/09/2011;'LIMPIEZA';'Gastos_Vivienda y vehiculo';'Serv. domestico';'FIJO'
22/09/2011;22/09/2011;'REINT.CAJERO';-118,00 €;6.743,86 €;1692;-118,00;11.267,95 €;'sin fechas';22/09/2011;'REINTCAJERO';'Gastos_Gastos varios';'Efectivo';'VARIABLES'
23/09/2011;23/09/2011;'BON AREA';-11,11 €;6.732,75 €;1693;-11,11;11.256,84 €;'sin fechas';23/09/2011;'BON';'Gastos_Compras';'Supermercado';'VARIABLES'
23/09/2011;23/09/2011;'CAFET.C T PRAT';-4,25 €;6.728,50 €;1694;-4,25;11.252,59 €;'sin fechas';23/09/2011;'CAFETC';'Gastos_Ocio y transporte';'Restaurantes';'VARIABLES'
23/09/2011;17/09/2011;'TABASA A S.C';-3,35 €;6.725,15 €;1695;-3,35;11.249,24 €;'sin fechas';17/09/2011;'TABASA';'Gastos_Ocio y transporte';'Parking y peaje';'VARIABLES'
24/09/2011;24/09/2011;'CAFET.C T PRAT';-1,90 €;6.723,25 €;1696;-1,90;11.247,34 €;'sin fechas';24/09/2011;'CAFETC';'Gastos_Ocio y transporte';'Restaurantes';'VARIABLES'
24/09/2011;24/09/2011;'TOCINERIES VENTURA';-7,48 €;6.715,77 €;1697;-7,48;11.239,86 €;'sin fechas';24/09/2011;'TOCINERIES';'Gastos_Compras';'Supermercado';'VARIABLES'
25/09/2011;25/09/2011;'GASOLINERA';-20,00 €;6.695,77 €;1698;-20,00;11.219,86 €;'sin fechas';25/09/2011;'GASOLINERA';'Gastos_Ocio y transporte';'Gasolina';'VARIABLES'
25/09/2011;25/09/2011;'VIENA';-13,55 €;6.682,22 €;1699;-13,55;11.206,31 €;'sin fechas';25/09/2011;'VIENA';'Gastos_Ocio y transporte';'Restaurantes';'VARIABLES'
26/09/2011;23/09/2011;'CASA SABATERS';-50,00 €;6.632,22 €;1700;-50,00;11.156,31 €;'sin fechas';23/09/2011;'CASA';'Gastos_Ocio y transporte';'Restaurantes';'VARIABLES'
26/09/2011;23/09/2011;'COCHE&PARKING';-3,70 €;6.628,52 €;1701;-3,70;11.152,61 €;'sin fechas';23/09/2011;'COCHEPARKING';'Gastos_Ocio y transporte';'Parking y peaje';'VARIABLES'
26/09/2011;23/09/2011;'HOGAR&OTROS';-140,25 €;6.488,27 €;1702;-140,25;11.012,36 €;'sin fechas';23/09/2011;'HOGAROTROS';'Gastos_Vivienda y vehiculo';'Otros vivienda';'VARIABLES'
26/09/2011;23/09/2011;'MERCADONA';-3,28 €;6.484,99 €;1703;-3,28;11.009,08 €;'sin fechas';23/09/2011;'MERCADONA';'Gastos_Compras';'Supermercado';'VARIABLES'
26/09/2011;26/09/2011;'MINA PUBLICA AIGUES T.01A75789';-32,26 €;6.452,73 €;1704;-32,26;10.976,82 €;'sin fechas';26/09/2011;'MINA';'Gastos_Servicios tipicos';'Agua';'FIJO'
26/09/2011;23/09/2011;'RESTAURANTES';-28,00 €;6.424,73 €;1705;-28,00;10.948,82 €;'sin fechas';23/09/2011;'RESTAURANTES';'Gastos_Ocio y transporte';'Restaurantes';'VARIABLES'
27/09/2011;27/09/2011;'FOMENT DE TERRASSA, S.A. FOMEN';1.541,37 €;7.966,10 €;1706;1.541,37;12.490,19 €;'sin fechas';27/09/2011;'FOMENT';'Ingresos';'Nomina';'FIJO'
27/09/2011;27/09/2011;'GASOLINERA';-39,97 €;7.926,13 €;1707;-39,97;12.450,22 €;'sin fechas';27/09/2011;'GASOLINERA';'Gastos_Ocio y transporte';'Gasolina';'VARIABLES'
28/09/2011;25/09/2011;'DIVAN RESTAURANT T';-17,60 €;7.908,53 €;1708;-17,60;12.432,62 €;'sin fechas';25/09/2011;'DIVAN';'Gastos_Ocio y transporte';'Restaurantes';'VARIABLES'
29/09/2011;30/09/2011;'INFORMACIO I TECNOLOGIA DE CAT';1.578,41 €;9.486,94 €;1709;1.578,41;14.011,03 €;'sin fechas';30/09/2011;'INFORMACIO';'Ingresos';'Nomina';'FIJO'
29/09/2011;26/09/2011;'JUEGUETOON';-14,99 €;9.471,95 €;1710;-14,99;13.996,04 €;'sin fechas';26/09/2011;'JUEGUETOON';'Gastos_Compras';'Niños';'VARIABLES'
29/09/2011;26/09/2011;'MERCADONA';-170,74 €;9.301,21 €;1711;-170,74;13.825,30 €;'sin fechas';26/09/2011;'MERCADONA';'Gastos_Compras';'Supermercado';'VARIABLES'
30/09/2011;22/09/2011;'AUTOPISTA TERR';-3,35 €;9.297,86 €;1712;-3,35;13.821,95 €;'sin fechas';22/09/2011;'AUTOPISTA';'Gastos_Ocio y transporte';'Parking y peaje';'VARIABLES'
30/09/2011;30/09/2011;'FARMACIA';-36,27 €;9.261,59 €;1713;-36,27;13.785,68 €;'sin fechas';30/09/2011;'FARMACIA';'Gastos_Salud, saber y deporte';'Farmacia';'VARIABLES'
30/09/2011;30/09/2011;'RECIBO PTMOS. 3061-0960001518';-583,25 €;8.678,34 €;1714;-583,25;13.202,43 €;'sin fechas';30/09/2011;'RECIBO';'Gastos_Banco y organismos';'Hipoteca';'FIJO'
01/10/2011;01/10/2011;'MANTENIMIENTO';-1,50 €;8.676,84 €;1715;-1,50;13.200,93 €;'sin fechas';01/10/2011;'MANTENIMIENTO';'Gastos_Banco y organismos';'Cargos banco';'FIJO'
01/10/2011;01/10/2011;'VIENA';-13,10 €;8.663,74 €;1716;-13,10;13.187,83 €;'sin fechas';01/10/2011;'VIENA';'Gastos_Ocio y transporte';'Restaurantes';'VARIABLES'
03/10/2011;03/10/2011;'AJUNTAMENT DE TER 850000031046';-37,18 €;8.626,56 €;1717;-37,18;13.150,65 €;'sin fechas';03/10/2011;'AJUNTAMENT';'Gastos_Banco y organismos';'Ayuntamiento';'FIJO'
03/10/2011;03/10/2011;'CIA.DE SEGUROS AD 006662671613';-73,20 €;8.553,36 €;1718;-73,20;13.077,45 €;'sin fechas';03/10/2011;'CIADE';'Gastos_Salud, saber y deporte';'Medico';'VARIABLES'
03/10/2011;03/10/2011;'ESCOLA BRESSOL EINA';-102,00 €;8.451,36 €;1719;-102,00;12.975,45 €;'sin fechas';03/10/2011;'ESCOLA';'Gastos_Salud, saber y deporte';'Estudios';'VARIABLES'
03/10/2011;03/10/2011;'TICKETS [ABONO]';350,00 €;8.801,36 €;1720;350,00;13.325,45 €;'sin fechas';03/10/2011;'TICKETS';'Gastos_Salud, saber y deporte';'Estudios';'VARIABLES'
03/10/2011;03/10/2011;'TICKETS [CARGO]';-350,00 €;8.451,36 €;1721;-350,00;12.975,45 €;'sin fechas';03/10/2011;'TICKETS';'Gastos_Salud, saber y deporte';'Estudios';'VARIABLES'
04/10/2011;04/10/2011;'CAPRABO';-5,46 €;8.445,90 €;1722;-5,46;12.969,99 €;'sin fechas';04/10/2011;'CAPRABO';'Gastos_Compras';'Supermercado';'VARIABLES'
04/10/2011;04/10/2011;'ES STA. MARGARITA';-33,05 €;8.412,85 €;1723;-33,05;12.936,94 €;'sin fechas';04/10/2011;'STA';'Gastos_Ocio y transporte';'Gasolina';'VARIABLES'
04/10/2011;04/10/2011;'MERCADONA';-14,54 €;8.398,31 €;1724;-14,54;12.922,40 €;'sin fechas';04/10/2011;'MERCADONA';'Gastos_Compras';'Supermercado';'VARIABLES'
04/10/2011;04/10/2011;'SEGUROS CATALANA';-293,04 €;8.105,27 €;1725;-293,04;12.629,36 €;'sin fechas';04/10/2011;'CATALANA';'Gastos_Ocio y transporte';'Parking y peaje';'VARIABLES'
04/10/2011;04/10/2011;'XFERA MOVILES SA 2767906';-43,95 €;8.061,32 €;1726;-43,95;12.585,41 €;'sin fechas';04/10/2011;'XFERA';'Gastos_Servicios tipicos';'Telecomunicaciones';'FIJO'
05/10/2011;05/10/2011;'BLITZ';-70,80 €;7.990,52 €;1727;-70,80;12.514,61 €;'sin fechas';05/10/2011;'BLITZ';'Gastos_Vivienda y vehiculo';'Alquiler Parking';'FIJO'
05/10/2011;05/10/2011;'MERCADONA';-29,44 €;7.961,08 €;1728;-29,44;12.485,17 €;'sin fechas';05/10/2011;'MERCADONA';'Gastos_Compras';'Supermercado';'VARIABLES'
05/10/2011;05/10/2011;'TRANSPORTS MUNICIP';-16,50 €;7.944,58 €;1729;-16,50;12.468,67 €;'sin fechas';05/10/2011;'TRANSPORTS';'Gastos_Ocio y transporte';'Transporte';'VARIABLES'
06/10/2011;06/10/2011;'IBERDROLA GE IBERDRO1011516485';-137,88 €;7.806,70 €;1730;-137,88;12.330,79 €;'sin fechas';06/10/2011;'IBERDROLA';'Gastos_Servicios tipicos';'Electricidad';'FIJO'
07/10/2011;07/10/2011;'CAFET.C T PRAT';-4,25 €;7.802,45 €;1731;-4,25;12.326,54 €;'sin fechas';07/10/2011;'CAFETC';'Gastos_Ocio y transporte';'Restaurantes';'VARIABLES'
08/10/2011;08/10/2011;'VIENA';-9,35 €;7.793,10 €;1732;-9,35;12.317,19 €;'sin fechas';08/10/2011;'VIENA';'Gastos_Ocio y transporte';'Restaurantes';'VARIABLES'
10/10/2011;01/10/2011;'AUTOPISTA TERR';-6,92 €;7.786,18 €;1733;-6,92;12.310,27 €;'sin fechas';01/10/2011;'AUTOPISTA';'Gastos_Ocio y transporte';'Parking y peaje';'VARIABLES'
10/10/2011;01/10/2011;'AUTOPISTA TERR';-6,92 €;7.779,26 €;1734;-6,92;12.303,35 €;'sin fechas';01/10/2011;'AUTOPISTA';'Gastos_Ocio y transporte';'Parking y peaje';'VARIABLES'
10/10/2011;01/10/2011;'AUTOPISTA TERR';-6,92 €;7.772,34 €;1735;-6,92;12.296,43 €;'sin fechas';01/10/2011;'AUTOPISTA';'Gastos_Ocio y transporte';'Parking y peaje';'VARIABLES'
10/10/2011;01/10/2011;'AUTOPISTA TERR';-6,92 €;7.765,42 €;1736;-6,92;12.289,51 €;'sin fechas';01/10/2011;'AUTOPISTA';'Gastos_Ocio y transporte';'Parking y peaje';'VARIABLES'
10/10/2011;10/10/2011;'DIETISTA';-62,00 €;7.703,42 €;1737;-62,00;12.227,51 €;'sin fechas';10/10/2011;'DIETISTA';'Gastos_Salud, saber y deporte';'Otros Salud';'VARIABLES'
10/10/2011;10/10/2011;'HOGAR&OTROS';-44,43 €;7.658,99 €;1738;-44,43;12.183,08 €;'sin fechas';10/10/2011;'HOGAROTROS';'Gastos_Vivienda y vehiculo';'Otros vivienda';'VARIABLES'
10/10/2011;10/10/2011;'REINT.CAJERO';-38,00 €;7.620,99 €;1739;-38,00;12.145,08 €;'sin fechas';10/10/2011;'REINTCAJERO';'Gastos_Gastos varios';'Efectivo';'VARIABLES'
11/10/2011;11/10/2011;'COCHE&PARKING';-3,74 €;7.617,25 €;1740;-3,74;12.141,34 €;'sin fechas';11/10/2011;'COCHEPARKING';'Gastos_Ocio y transporte';'Parking y peaje';'VARIABLES'
13/10/2011;13/10/2011;'ES STA. MARGARITA';-48,60 €;7.568,65 €;1741;-48,60;12.092,74 €;'sin fechas';13/10/2011;'STA';'Gastos_Ocio y transporte';'Gasolina';'VARIABLES'
13/10/2011;13/10/2011;'VIENA';-11,70 €;7.556,95 €;1742;-11,70;12.081,04 €;'sin fechas';13/10/2011;'VIENA';'Gastos_Ocio y transporte';'Restaurantes';'VARIABLES'
14/10/2011;14/10/2011;'BON AREA';-15,12 €;7.541,83 €;1743;-15,12;12.065,92 €;'sin fechas';14/10/2011;'BON';'Gastos_Compras';'Supermercado';'VARIABLES'
14/10/2011;14/10/2011;'BON AREA';-9,28 €;7.532,55 €;1744;-9,28;12.056,64 €;'sin fechas';14/10/2011;'BON';'Gastos_Compras';'Supermercado';'VARIABLES'
14/10/2011;14/10/2011;'FARMACIA';-8,62 €;7.523,93 €;1745;-8,62;12.048,02 €;'sin fechas';14/10/2011;'FARMACIA';'Gastos_Salud, saber y deporte';'Farmacia';'VARIABLES'
14/10/2011;14/10/2011;'FARMACIA';-9,75 €;7.514,18 €;1746;-9,75;12.038,27 €;'sin fechas';14/10/2011;'FARMACIA';'Gastos_Salud, saber y deporte';'Farmacia';'VARIABLES'
16/10/2011;16/10/2011;'ALCAMPO';-59,11 €;7.455,07 €;1747;-59,11;11.979,16 €;'sin fechas';16/10/2011;'ALCAMPO';'Gastos_Compras';'Supermercado';'VARIABLES'
16/10/2011;16/10/2011;'CAFET.C T PRAT';-4,25 €;7.450,82 €;1748;-4,25;11.974,91 €;'sin fechas';16/10/2011;'CAFETC';'Gastos_Ocio y transporte';'Restaurantes';'VARIABLES'
16/10/2011;16/10/2011;'FLUNCH';-20,55 €;7.430,27 €;1749;-20,55;11.954,36 €;'sin fechas';16/10/2011;'FLUNCH';'Gastos_Ocio y transporte';'Restaurantes';'VARIABLES'
17/10/2011;17/10/2011;'CCM VIDA Y P SEGURO PRESTAMO';-26,63 €;7.403,64 €;1750;-26,63;11.927,73 €;'sin fechas';17/10/2011;'CCM';'Gastos_Seguros';'Seguro vida';'FIJO'
17/10/2011;17/10/2011;'CCM VIDA Y PENSIO 000000493358';-18,56 €;7.385,08 €;1751;-18,56;11.909,17 €;'sin fechas';17/10/2011;'CCM';'Gastos_Seguros';'Seguro vida';'FIJO'
17/10/2011;17/10/2011;'ONO';-88,10 €;7.296,98 €;1752;-88,10;11.821,07 €;'sin fechas';17/10/2011;'ONO';'Gastos_Servicios tipicos';'Telecomunicaciones';'FIJO'
18/10/2011;18/10/2011;'FARMACIA';-7,70 €;7.289,28 €;1753;-7,70;11.813,37 €;'sin fechas';18/10/2011;'FARMACIA';'Gastos_Salud, saber y deporte';'Farmacia';'VARIABLES'
18/10/2011;18/10/2011;'H&M';-68,65 €;7.220,63 €;1754;-68,65;11.744,72 €;'sin fechas';18/10/2011;'HM';'Gastos_Compras';'Ropa';'VARIABLES'
19/10/2011;19/10/2011;'ENDESA ENERG EE_XXI40025545678';-82,15 €;7.138,48 €;1755;-82,15;11.662,57 €;'sin fechas';19/10/2011;'ENDESA';'Gastos_Servicios tipicos';'Electricidad';'FIJO'
19/10/2011;19/10/2011;'LLIBR.SANT JORDI';-10,60 €;7.127,88 €;1756;-10,60;11.651,97 €;'sin fechas';19/10/2011;'LLIBRSANT';'Gastos_Compras';'Libreria';'VARIABLES'
19/10/2011;19/10/2011;'MERCADONA';-18,00 €;7.109,88 €;1757;-18,00;11.633,97 €;'sin fechas';19/10/2011;'MERCADONA';'Gastos_Compras';'Supermercado';'VARIABLES'
20/10/2011;20/10/2011;'CAFET.C T PRAT';-7,40 €;7.102,48 €;1758;-7,40;11.626,57 €;'sin fechas';20/10/2011;'CAFETC';'Gastos_Ocio y transporte';'Restaurantes';'VARIABLES'
20/10/2011;20/10/2011;'DHR TRADE SL';-8,90 €;7.093,58 €;1759;-8,90;11.617,67 €;'sin fechas';20/10/2011;'DHR';'Gastos_Ocio y transporte';'Gasolina';'VARIABLES'
20/10/2011;20/10/2011;'MERCADONA';-163,11 €;6.930,47 €;1760;-163,11;11.454,56 €;'sin fechas';20/10/2011;'MERCADONA';'Gastos_Compras';'Supermercado';'VARIABLES'
21/10/2011;21/10/2011;'A.E.A.T. DEVOLUCIONES TRIBUTAR';100,00 €;7.030,47 €;1761;100,00;11.554,56 €;'sin fechas';21/10/2011;'AEAT';'Ingresos';'Devoluciones';'VARIABLES'
22/10/2011;22/10/2011;'LIMPIEZA';-90,00 €;6.940,47 €;1762;-90,00;11.464,56 €;'sin fechas';22/10/2011;'LIMPIEZA';'Gastos_Vivienda y vehiculo';'Serv. domestico';'FIJO'
22/10/2011;22/10/2011;'REINT.CAJERO';-60,00 €;6.880,47 €;1763;-60,00;11.404,56 €;'sin fechas';22/10/2011;'REINTCAJERO';'Gastos_Gastos varios';'Efectivo';'VARIABLES'
27/10/2011;27/10/2011;'CAFET.C T PRAT';-4,25 €;6.876,22 €;1764;-4,25;11.400,31 €;'sin fechas';27/10/2011;'CAFETC';'Gastos_Ocio y transporte';'Restaurantes';'VARIABLES'
27/10/2011;27/10/2011;'FOMENT DE TERRASSA, S.A. FOMEN';1.541,37 €;8.417,59 €;1765;1.541,37;12.941,68 €;'sin fechas';27/10/2011;'FOMENT';'Ingresos';'Nomina';'FIJO'
28/10/2011;28/10/2011;'CAFET.C T PRAT';-1,20 €;8.416,39 €;1766;-1,20;12.940,48 €;'sin fechas';28/10/2011;'CAFETC';'Gastos_Ocio y transporte';'Restaurantes';'VARIABLES'
28/10/2011;21/10/2011;'COCHE&PARKING';-2,90 €;8.413,49 €;1767;-2,90;12.937,58 €;'sin fechas';21/10/2011;'COCHEPARKING';'Gastos_Ocio y transporte';'Parking y peaje';'VARIABLES'
28/10/2011;31/10/2011;'INFORMACIO I TECNOLOGIA DE CAT';1.270,40 €;9.683,89 €;1768;1.270,40;14.207,98 €;'sin fechas';31/10/2011;'INFORMACIO';'Ingresos';'Nomina';'FIJO'
29/10/2011;29/10/2011;'BON AREA';-20,10 €;9.663,79 €;1769;-20,10;14.187,88 €;'sin fechas';29/10/2011;'BON';'Gastos_Compras';'Supermercado';'VARIABLES'
29/10/2011;29/10/2011;'C&A';-36,37 €;9.627,42 €;1770;-36,37;14.151,51 €;'sin fechas';29/10/2011;'CA';'Gastos_Compras';'Ropa';'VARIABLES'
29/10/2011;29/10/2011;'CAPRABO';-40,09 €;9.587,33 €;1771;-40,09;14.111,42 €;'sin fechas';29/10/2011;'CAPRABO';'Gastos_Compras';'Supermercado';'VARIABLES'
29/10/2011;29/10/2011;'CATALA GRANADOS SL';-48,69 €;9.538,64 €;1772;-48,69;14.062,73 €;'sin fechas';29/10/2011;'CATALA';'Gastos_Ocio y transporte';'Gasolina';'VARIABLES'
29/10/2011;29/10/2011;'VIENA';-14,70 €;9.523,94 €;1773;-14,70;14.048,03 €;'sin fechas';29/10/2011;'VIENA';'Gastos_Ocio y transporte';'Restaurantes';'VARIABLES'
31/10/2011;31/10/2011;'RECIBO PTMOS. 3061-0960001518';-583,25 €;8.940,69 €;1774;-583,25;13.464,78 €;'sin fechas';31/10/2011;'RECIBO';'Gastos_Banco y organismos';'Hipoteca';'FIJO'
01/11/2011;01/11/2011;'DIETISTA';-31,00 €;8.909,69 €;1775;-31,00;13.433,78 €;'sin fechas';01/11/2011;'DIETISTA';'Gastos_Salud, saber y deporte';'Otros Salud';'VARIABLES'
01/11/2011;01/11/2011;'MEDIA MARKT';-24,99 €;8.884,70 €;1776;-24,99;13.408,79 €;'sin fechas';01/11/2011;'MEDIA';'Gastos_Compras';'Hobbys';'VARIABLES'
01/11/2011;01/11/2011;'PRIMARK';-14,00 €;8.870,70 €;1777;-14,00;13.394,79 €;'sin fechas';01/11/2011;'PRIMARK';'Gastos_Compras';'Ropa';'VARIABLES'
01/11/2011;01/11/2011;'REINT.CAJERO';-69,00 €;8.801,70 €;1778;-69,00;13.325,79 €;'sin fechas';01/11/2011;'REINTCAJERO';'Gastos_Gastos varios';'Efectivo';'VARIABLES'
01/11/2011;01/11/2011;'SPLAU 1038 \\EL PRAT DE LL';-10,75 €;8.790,95 €;1779;-10,75;13.315,04 €;'sin fechas';01/11/2011;'SPLAU';'Gastos_Ocio y transporte';'Restaurantes';'VARIABLES'
01/11/2011;02/11/2011;'COMISIONES';-1,50 €;8.789,45 €;1780;-1,50;13.313,54 €;'sin fechas';02/11/2011;'COMISIONES';'Gastos_Banco y organismos';'Cargos banco';'FIJO'
01/11/2011;02/11/2011;'TRANSCARGO';-200,00 €;8.589,45 €;1781;-200,00;13.113,54 €;'sin fechas';02/11/2011;'TRANSCARGO';'Gastos_Gastos varios';'Transferencias';'VARIABLES'
01/11/2011;02/11/2011;'TRANSFAVOR';200,00 €;8.789,45 €;1782;200,00;13.313,54 €;'sin fechas';02/11/2011;'TRANSFAVOR';'Ingresos';'Transferencias';'VARIABLES'
02/11/2011;02/11/2011;'ADESLAS CENTRAL 006662671613';-73,20 €;8.716,25 €;1783;-73,20;13.240,34 €;'sin fechas';02/11/2011;'ADESLAS';'Gastos_Salud, saber y deporte';'Medico';'VARIABLES'
02/11/2011;02/11/2011;'TICKETS [ABONO]';350,00 €;9.066,25 €;1784;350,00;13.590,34 €;'sin fechas';02/11/2011;'TICKETS';'Gastos_Salud, saber y deporte';'Estudios';'VARIABLES'
02/11/2011;02/11/2011;'TICKETS [CARGO]';-350,00 €;8.716,25 €;1785;-350,00;13.240,34 €;'sin fechas';02/11/2011;'TICKETS';'Gastos_Salud, saber y deporte';'Estudios';'VARIABLES'
03/11/2011;03/11/2011;'BOLIN SHIJIA, SCP';-21,50 €;8.694,75 €;1786;-21,50;13.218,84 €;'sin fechas';03/11/2011;'BOLIN';'Gastos_Ocio y transporte';'Restaurantes';'VARIABLES'
03/11/2011;27/10/2011;'COCHE&PARKING';-1,70 €;8.693,05 €;1787;-1,70;13.217,14 €;'sin fechas';27/10/2011;'COCHEPARKING';'Gastos_Ocio y transporte';'Parking y peaje';'VARIABLES'
03/11/2011;03/11/2011;'JUEGUETOON';-10,00 €;8.683,05 €;1788;-10,00;13.207,14 €;'sin fechas';03/11/2011;'JUEGUETOON';'Gastos_Compras';'Niños';'VARIABLES'
03/11/2011;03/11/2011;'TRANSPORTS MUNICIP';-16,50 €;8.666,55 €;1789;-16,50;13.190,64 €;'sin fechas';03/11/2011;'TRANSPORTS';'Gastos_Ocio y transporte';'Transporte';'VARIABLES'
04/11/2011;04/11/2011;'ESCOLA BRESSOL EINA';-74,10 €;8.592,45 €;1790;-74,10;13.116,54 €;'sin fechas';04/11/2011;'ESCOLA';'Gastos_Salud, saber y deporte';'Estudios';'VARIABLES'
04/11/2011;04/11/2011;'VIENA';-10,60 €;8.581,85 €;1791;-10,60;13.105,94 €;'sin fechas';04/11/2011;'VIENA';'Gastos_Ocio y transporte';'Restaurantes';'VARIABLES'
04/11/2011;04/11/2011;'XFERA MOVILES SA 2767906';-31,78 €;8.550,07 €;1792;-31,78;13.074,16 €;'sin fechas';04/11/2011;'XFERA';'Gastos_Servicios tipicos';'Telecomunicaciones';'FIJO'
05/11/2011;05/11/2011;'CAFET.C T PRAT';-2,55 €;8.547,52 €;1793;-2,55;13.071,61 €;'sin fechas';05/11/2011;'CAFETC';'Gastos_Ocio y transporte';'Restaurantes';'VARIABLES'
05/11/2011;05/11/2011;'TOCINERIES VENTURA';-11,45 €;8.536,07 €;1794;-11,45;13.060,16 €;'sin fechas';05/11/2011;'TOCINERIES';'Gastos_Compras';'Supermercado';'VARIABLES'
06/11/2011;06/11/2011;'GIFI';-39,49 €;8.496,58 €;1795;-39,49;13.020,67 €;'sin fechas';06/11/2011;'GIFI';'Gastos_Compras';'Hogar';'VARIABLES'
06/11/2011;06/11/2011;'VIENA';-18,95 €;8.477,63 €;1796;-18,95;13.001,72 €;'sin fechas';06/11/2011;'VIENA';'Gastos_Ocio y transporte';'Restaurantes';'VARIABLES'
07/11/2011;07/11/2011;'BLITZ';-70,80 €;8.406,83 €;1797;-70,80;12.930,92 €;'sin fechas';07/11/2011;'BLITZ';'Gastos_Vivienda y vehiculo';'Alquiler Parking';'FIJO'
08/11/2011;08/11/2011;'FARMACIA';-9,02 €;8.397,81 €;1798;-9,02;12.921,90 €;'sin fechas';08/11/2011;'FARMACIA';'Gastos_Salud, saber y deporte';'Farmacia';'VARIABLES'
08/11/2011;08/11/2011;'MERCADONA';-16,53 €;8.381,28 €;1799;-16,53;12.905,37 €;'sin fechas';08/11/2011;'MERCADONA';'Gastos_Compras';'Supermercado';'VARIABLES'
10/11/2011;09/11/2011;'CATALA GRANADOS SL';-35,32 €;8.345,96 €;1800;-35,32;12.870,05 €;'sin fechas';09/11/2011;'CATALA';'Gastos_Ocio y transporte';'Gasolina';'VARIABLES'
10/11/2011;08/11/2011;'EROSKI-[COMIDA]';-53,94 €;8.292,02 €;1801;-53,94;12.816,11 €;'sin fechas';08/11/2011;'EROSKICOMIDA';'Gastos_Compras';'Supermercado';'VARIABLES'
10/11/2011;10/11/2011;'FARMACIA';-30,94 €;8.261,08 €;1802;-30,94;12.785,17 €;'sin fechas';10/11/2011;'FARMACIA';'Gastos_Salud, saber y deporte';'Farmacia';'VARIABLES'
10/11/2011;10/11/2011;'REINT.CAJERO';-150,00 €;8.111,08 €;1803;-150,00;12.635,17 €;'sin fechas';10/11/2011;'REINTCAJERO';'Gastos_Gastos varios';'Efectivo';'VARIABLES'
10/11/2011;08/11/2011;'VIENA';-13,55 €;8.097,53 €;1804;-13,55;12.621,62 €;'sin fechas';08/11/2011;'VIENA';'Gastos_Ocio y transporte';'Restaurantes';'VARIABLES'
11/11/2011;11/11/2011;'CAFET.C T PRAT';-2,05 €;8.095,48 €;1805;-2,05;12.619,57 €;'sin fechas';11/11/2011;'CAFETC';'Gastos_Ocio y transporte';'Restaurantes';'VARIABLES'
14/11/2011;14/11/2011;'BON AREA';-12,68 €;8.082,80 €;1806;-12,68;12.606,89 €;'sin fechas';14/11/2011;'BON';'Gastos_Compras';'Supermercado';'VARIABLES'
14/11/2011;14/11/2011;'CAFET.C T PRAT';-2,05 €;8.080,75 €;1807;-2,05;12.604,84 €;'sin fechas';14/11/2011;'CAFETC';'Gastos_Ocio y transporte';'Restaurantes';'VARIABLES'
15/11/2011;15/11/2011;'CCM VIDA Y P SEGURO PRESTAMO';-26,56 €;8.054,19 €;1808;-26,56;12.578,28 €;'sin fechas';15/11/2011;'CCM';'Gastos_Seguros';'Seguro vida';'FIJO'
15/11/2011;15/11/2011;'CCM VIDA Y PENSIO 000000493358';-18,50 €;8.035,69 €;1809;-18,50;12.559,78 €;'sin fechas';15/11/2011;'CCM';'Gastos_Seguros';'Seguro vida';'FIJO'
16/11/2011;16/11/2011;'A.E.A.T. DEVOLUCIONES TRIBUTAR';100,00 €;8.135,69 €;1810;100,00;12.659,78 €;'sin fechas';16/11/2011;'AEAT';'Ingresos';'Devoluciones';'VARIABLES'
16/11/2011;16/11/2011;'MERCADONA';-11,44 €;8.124,25 €;1811;-11,44;12.648,34 €;'sin fechas';16/11/2011;'MERCADONA';'Gastos_Compras';'Supermercado';'VARIABLES'
17/11/2011;15/11/2011;'BON AREA';-21,14 €;8.103,11 €;1812;-21,14;12.627,20 €;'sin fechas';15/11/2011;'BON';'Gastos_Compras';'Supermercado';'VARIABLES'
17/11/2011;15/11/2011;'BURGUER KING';-11,75 €;8.091,36 €;1813;-11,75;12.615,45 €;'sin fechas';15/11/2011;'BURGUER';'Gastos_Ocio y transporte';'Restaurantes';'VARIABLES'
18/11/2011;18/11/2011;'ONO';-85,29 €;8.006,07 €;1814;-85,29;12.530,16 €;'sin fechas';18/11/2011;'ONO';'Gastos_Servicios tipicos';'Telecomunicaciones';'FIJO'
19/11/2011;19/11/2011;'CAFET.C T PRAT';-1,20 €;8.004,87 €;1815;-1,20;12.528,96 €;'sin fechas';19/11/2011;'CAFETC';'Gastos_Ocio y transporte';'Restaurantes';'VARIABLES'
20/11/2011;20/11/2011;'CAFET.C T PRAT';-3,30 €;8.001,57 €;1816;-3,30;12.525,66 €;'sin fechas';20/11/2011;'CAFETC';'Gastos_Ocio y transporte';'Restaurantes';'VARIABLES'
20/11/2011;20/11/2011;'ES STA. MARGARITA';-49,77 €;7.951,80 €;1817;-49,77;12.475,89 €;'sin fechas';20/11/2011;'STA';'Gastos_Ocio y transporte';'Gasolina';'VARIABLES'
20/11/2011;20/11/2011;'HOSPITAL GRAL';-2,95 €;7.948,85 €;1818;-2,95;12.472,94 €;'sin fechas';20/11/2011;'HOSPITAL';'Gastos_Salud, saber y deporte';'Medico';'VARIABLES'
20/11/2011;20/11/2011;'HOSPITAL GRAL';-12,65 €;7.936,20 €;1819;-12,65;12.460,29 €;'sin fechas';20/11/2011;'HOSPITAL';'Gastos_Salud, saber y deporte';'Medico';'VARIABLES'
20/11/2011;20/11/2011;'QUOTA T. Visa Ele';-26,00 €;7.910,20 €;1820;-26,00;12.434,29 €;'sin fechas';20/11/2011;'QUOTA';'Gastos_Banco y organismos';'Cargos banco';'FIJO'
21/11/2011;21/11/2011;'CAFET.C T PRAT';-2,05 €;7.908,15 €;1821;-2,05;12.432,24 €;'sin fechas';21/11/2011;'CAFETC';'Gastos_Ocio y transporte';'Restaurantes';'VARIABLES'
21/11/2011;21/11/2011;'ENDESA ENERG EE_XXI40025545678';-75,07 €;7.833,08 €;1822;-75,07;12.357,17 €;'sin fechas';21/11/2011;'ENDESA';'Gastos_Servicios tipicos';'Electricidad';'FIJO'
21/11/2011;21/11/2011;'JOHN\''S ITALIAN CAF';-25,36 €;7.807,72 €;1823;-25,36;12.331,81 €;'sin fechas';21/11/2011;'JOHNS';'Gastos_Ocio y transporte';'Restaurantes';'VARIABLES'
21/11/2011;21/11/2011;'MERCADONA';-146,91 €;7.660,81 €;1824;-146,91;12.184,90 €;'sin fechas';21/11/2011;'MERCADONA';'Gastos_Compras';'Supermercado';'VARIABLES'
24/11/2011;22/11/2011;'BON AREA';-27,52 €;7.633,29 €;1825;-27,52;12.157,38 €;'sin fechas';22/11/2011;'BON';'Gastos_Compras';'Supermercado';'VARIABLES'
24/11/2011;24/11/2011;'CAFET.C T PRAT';-1,20 €;7.632,09 €;1826;-1,20;12.156,18 €;'sin fechas';24/11/2011;'CAFETC';'Gastos_Ocio y transporte';'Restaurantes';'VARIABLES'
24/11/2011;24/11/2011;'IBERDROLA GE IBERDRO1011516485';-196,86 €;7.435,23 €;1827;-196,86;11.959,32 €;'sin fechas';24/11/2011;'IBERDROLA';'Gastos_Servicios tipicos';'Electricidad';'FIJO'
24/11/2011;23/11/2011;'JOHN\''S ITALIAN CAF';-54,12 €;7.381,11 €;1828;-54,12;11.905,20 €;'sin fechas';23/11/2011;'JOHNS';'Gastos_Ocio y transporte';'Restaurantes';'VARIABLES'
24/11/2011;22/11/2011;'RESTAURANTES';-71,40 €;7.309,71 €;1829;-71,40;11.833,80 €;'sin fechas';22/11/2011;'RESTAURANTES';'Gastos_Ocio y transporte';'Restaurantes';'VARIABLES'
25/11/2011;20/11/2011;'COCHE&PARKING';-1,90 €;7.307,81 €;1830;-1,90;11.831,90 €;'sin fechas';20/11/2011;'COCHEPARKING';'Gastos_Ocio y transporte';'Parking y peaje';'VARIABLES'
25/11/2011;25/11/2011;'FARMACIA';-19,71 €;7.288,10 €;1831;-19,71;11.812,19 €;'sin fechas';25/11/2011;'FARMACIA';'Gastos_Salud, saber y deporte';'Farmacia';'VARIABLES'
25/11/2011;25/11/2011;'FOMENT DE TERRASSA, S.A. FOMEN';1.650,07 €;8.938,17 €;1832;1.650,07;13.462,26 €;'sin fechas';25/11/2011;'FOMENT';'Ingresos';'Nomina';'FIJO'
25/11/2011;25/11/2011;'LIMPIEZA';-150,00 €;8.788,17 €;1833;-150,00;13.312,26 €;'sin fechas';25/11/2011;'LIMPIEZA';'Gastos_Vivienda y vehiculo';'Serv. domestico';'FIJO'
25/11/2011;25/11/2011;'REINT.CAJERO';-150,00 €;8.638,17 €;1834;-150,00;13.162,26 €;'sin fechas';25/11/2011;'REINTCAJERO';'Gastos_Gastos varios';'Efectivo';'VARIABLES'
25/11/2011;25/11/2011;'RODELAS PERRUQUERS';-13,50 €;8.624,67 €;1835;-13,50;13.148,76 €;'sin fechas';25/11/2011;'RODELAS';'Gastos_Salud, saber y deporte';'Belleza';'VARIABLES'
26/11/2011;26/11/2011;'CAFET.C T PRAT';-1,70 €;8.622,97 €;1836;-1,70;13.147,06 €;'sin fechas';26/11/2011;'CAFETC';'Gastos_Ocio y transporte';'Restaurantes';'VARIABLES'
27/11/2011;27/11/2011;'FARMACIA';-10,48 €;8.612,49 €;1837;-10,48;13.136,58 €;'sin fechas';27/11/2011;'FARMACIA';'Gastos_Salud, saber y deporte';'Farmacia';'VARIABLES'
28/11/2011;28/11/2011;'BON AREA';-21,38 €;8.591,11 €;1838;-21,38;13.115,20 €;'sin fechas';28/11/2011;'BON';'Gastos_Compras';'Supermercado';'VARIABLES'
28/11/2011;24/11/2011;'COCHE&PARKING';-5,80 €;8.585,31 €;1839;-5,80;13.109,40 €;'sin fechas';24/11/2011;'COCHEPARKING';'Gastos_Ocio y transporte';'Parking y peaje';'VARIABLES'
28/11/2011;29/11/2011;'INFORMACIO I TECNOLOGIA DE CAT';1.271,09 €;9.856,40 €;1840;1.271,09;14.380,49 €;'sin fechas';29/11/2011;'INFORMACIO';'Ingresos';'Nomina';'FIJO'
30/11/2011;30/11/2011;'MERCADONA';-16,11 €;9.840,29 €;1841;-16,11;14.364,38 €;'sin fechas';30/11/2011;'MERCADONA';'Gastos_Compras';'Supermercado';'VARIABLES'
30/11/2011;30/11/2011;'RECIBO PTMOS. 3061-0960001518';-583,25 €;9.257,04 €;1842;-583,25;13.781,13 €;'sin fechas';30/11/2011;'RECIBO';'Gastos_Banco y organismos';'Hipoteca';'FIJO'
01/12/2011;01/12/2011;'AJUNTAMENT DE TER 010000520716';-37,19 €;9.219,85 €;1843;-37,19;13.743,94 €;'sin fechas';01/12/2011;'AJUNTAMENT';'Gastos_Banco y organismos';'Ayuntamiento';'FIJO'
01/12/2011;29/11/2011;'CAPRABO';-4,13 €;9.215,72 €;1844;-4,13;13.739,81 €;'sin fechas';29/11/2011;'CAPRABO';'Gastos_Compras';'Supermercado';'VARIABLES'
01/12/2011;29/11/2011;'CARREFOUR-[OTROS]';-83,41 €;9.132,31 €;1845;-83,41;13.656,40 €;'sin fechas';29/11/2011;'CARREFOUROTROS';'Gastos_Compras';'Supermercado';'VARIABLES'
01/12/2011;01/12/2011;'CREDITO';-12,20 €;9.120,11 €;1846;-12,20;13.644,20 €;'sin fechas';01/12/2011;'CREDITO';'No computable';'Recibo Tarjeta';
01/12/2011;01/12/2011;'MANTENIMIENTO';-1,50 €;9.118,61 €;1847;-1,50;13.642,70 €;'sin fechas';01/12/2011;'MANTENIMIENTO';'Gastos_Banco y organismos';'Cargos banco';'FIJO'
01/12/2011;24/11/2011;'TABASA A S.C';-3,35 €;9.115,26 €;1848;-3,35;13.639,35 €;'sin fechas';24/11/2011;'TABASA';'Gastos_Ocio y transporte';'Parking y peaje';'VARIABLES'
02/12/2011;02/12/2011;'CAFET.C T PRAT';-2,40 €;9.112,86 €;1849;-2,40;13.636,95 €;'sin fechas';02/12/2011;'CAFETC';'Gastos_Ocio y transporte';'Restaurantes';'VARIABLES'
02/12/2011;02/12/2011;'CAFET.C T PRAT';-4,25 €;9.108,61 €;1850;-4,25;13.632,70 €;'sin fechas';02/12/2011;'CAFETC';'Gastos_Ocio y transporte';'Restaurantes';'VARIABLES'
02/12/2011;24/11/2011;'COCHE&PARKING';-1,65 €;9.106,96 €;1851;-1,65;13.631,05 €;'sin fechas';24/11/2011;'COCHEPARKING';'Gastos_Ocio y transporte';'Parking y peaje';'VARIABLES'
02/12/2011;02/12/2011;'COMISIONES';-11,00 €;9.095,96 €;1852;-11,00;13.620,05 €;'sin fechas';02/12/2011;'COMISIONES';'Gastos_Banco y organismos';'Cargos banco';'FIJO'
03/12/2011;03/12/2011;'C&A';-16,50 €;9.079,46 €;1853;-16,50;13.603,55 €;'sin fechas';03/12/2011;'CA';'Gastos_Compras';'Ropa';'VARIABLES'
03/12/2011;03/12/2011;'CAFET.C T PRAT';-2,40 €;9.077,06 €;1854;-2,40;13.601,15 €;'sin fechas';03/12/2011;'CAFETC';'Gastos_Ocio y transporte';'Restaurantes';'VARIABLES'
03/12/2011;03/12/2011;'CAPRABO';-5,53 €;9.071,53 €;1855;-5,53;13.595,62 €;'sin fechas';03/12/2011;'CAPRABO';'Gastos_Compras';'Supermercado';'VARIABLES'
03/12/2011;05/12/2011;'COM. MANT. ACTIVAS DE LIQ.';-4,50 €;9.067,03 €;1856;-4,50;13.591,12 €;'sin fechas';05/12/2011;'COM';'Gastos_Banco y organismos';'Cargos banco';'FIJO'
03/12/2011;03/12/2011;'ES STA. MARGARITA';-47,32 €;9.019,71 €;1857;-47,32;13.543,80 €;'sin fechas';03/12/2011;'STA';'Gastos_Ocio y transporte';'Gasolina';'VARIABLES'
03/12/2011;03/12/2011;'TOCINERIES VENTURA';-17,40 €;9.002,31 €;1858;-17,40;13.526,40 €;'sin fechas';03/12/2011;'TOCINERIES';'Gastos_Compras';'Supermercado';'VARIABLES'
04/12/2011;04/12/2011;'CAFET.C T PRAT';-2,40 €;8.999,91 €;1859;-2,40;13.524,00 €;'sin fechas';04/12/2011;'CAFETC';'Gastos_Ocio y transporte';'Restaurantes';'VARIABLES'
04/12/2011;04/12/2011;'VIENA';-15,10 €;8.984,81 €;1860;-15,10;13.508,90 €;'sin fechas';04/12/2011;'VIENA';'Gastos_Ocio y transporte';'Restaurantes';'VARIABLES'
05/12/2011;05/12/2011;'ADESLAS CENTRAL 006662671613';-73,20 €;8.911,61 €;1861;-73,20;13.435,70 €;'sin fechas';05/12/2011;'ADESLAS';'Gastos_Salud, saber y deporte';'Medico';'VARIABLES'
05/12/2011;05/12/2011;'CAFET.C T PRAT';-3,35 €;8.908,26 €;1862;-3,35;13.432,35 €;'sin fechas';05/12/2011;'CAFETC';'Gastos_Ocio y transporte';'Restaurantes';'VARIABLES'
05/12/2011;05/12/2011;'XFERA MOVILES SA 2767906';-40,87 €;8.867,39 €;1863;-40,87;13.391,48 €;'sin fechas';05/12/2011;'XFERA';'Gastos_Servicios tipicos';'Telecomunicaciones';'FIJO'
07/12/2011;07/12/2011;'BLITZ';-70,80 €;8.796,59 €;1864;-70,80;13.320,68 €;'sin fechas';07/12/2011;'BLITZ';'Gastos_Vivienda y vehiculo';'Alquiler Parking';'FIJO'
07/12/2011;07/12/2011;'ESCOLA BRESSOL EINA';-63,50 €;8.733,09 €;1865;-63,50;13.257,18 €;'sin fechas';07/12/2011;'ESCOLA';'Gastos_Salud, saber y deporte';'Estudios';'VARIABLES'
07/12/2011;07/12/2011;'GAS NATURAL';-10,27 €;8.722,82 €;1866;-10,27;13.246,91 €;'sin fechas';07/12/2011;'GAS';'Gastos_Servicios tipicos';'Gas';'FIJO'
07/12/2011;07/12/2011;'TICKETS [ABONO]';350,00 €;9.072,82 €;1867;350,00;13.596,91 €;'sin fechas';07/12/2011;'TICKETS';'Gastos_Salud, saber y deporte';'Estudios';'VARIABLES'
07/12/2011;07/12/2011;'TICKETS [CARGO]';-350,00 €;8.722,82 €;1868;-350,00;13.246,91 €;'sin fechas';07/12/2011;'TICKETS';'Gastos_Salud, saber y deporte';'Estudios';'VARIABLES'
08/12/2011;07/12/2011;'AMC PARC VALLES';-11,60 €;8.711,22 €;1869;-11,60;13.235,31 €;'sin fechas';07/12/2011;'AMC';'Gastos_Ocio y transporte';'Espectáculos';'VARIABLES'
08/12/2011;08/12/2011;'CAFET.C T PRAT';-3,40 €;8.707,82 €;1870;-3,40;13.231,91 €;'sin fechas';08/12/2011;'CAFETC';'Gastos_Ocio y transporte';'Restaurantes';'VARIABLES'
08/12/2011;06/12/2011;'GAME';-49,90 €;8.657,92 €;1871;-49,90;13.182,01 €;'sin fechas';06/12/2011;'GAME';'Gastos_Compras';'Hobbys';'VARIABLES'
08/12/2011;08/12/2011;'GRINZING';-6,30 €;8.651,62 €;1872;-6,30;13.175,71 €;'sin fechas';08/12/2011;'GRINZING';'Gastos_Ocio y transporte';'Restaurantes';'VARIABLES'
08/12/2011;07/12/2011;'RESTAURANTES';-32,80 €;8.618,82 €;1873;-32,80;13.142,91 €;'sin fechas';07/12/2011;'RESTAURANTES';'Gastos_Ocio y transporte';'Restaurantes';'VARIABLES'
08/12/2011;08/12/2011;'TOYS PATRIMONIAL';-54,96 €;8.563,86 €;1874;-54,96;13.087,95 €;'sin fechas';08/12/2011;'TOYS';'Gastos_Compras';'Niños';'VARIABLES'
08/12/2011;06/12/2011;'VIENA';-10,40 €;8.553,46 €;1875;-10,40;13.077,55 €;'sin fechas';06/12/2011;'VIENA';'Gastos_Ocio y transporte';'Restaurantes';'VARIABLES'
09/12/2011;09/12/2011;'DECATHLON';-67,95 €;8.485,51 €;1876;-67,95;13.009,60 €;'sin fechas';09/12/2011;'DECATHLON';'Gastos_Compras';'Deportivo';'VARIABLES'
09/12/2011;09/12/2011;'HOGAR&OTROS';-25,00 €;8.460,51 €;1877;-25,00;12.984,60 €;'sin fechas';09/12/2011;'HOGAROTROS';'Gastos_Vivienda y vehiculo';'Otros vivienda';'VARIABLES'
09/12/2011;09/12/2011;'PRIMARK';-30,00 €;8.430,51 €;1878;-30,00;12.954,60 €;'sin fechas';09/12/2011;'PRIMARK';'Gastos_Compras';'Ropa';'VARIABLES'
09/12/2011;09/12/2011;'REINT.CAJERO';-9,00 €;8.421,51 €;1879;-9,00;12.945,60 €;'sin fechas';09/12/2011;'REINTCAJERO';'Gastos_Gastos varios';'Efectivo';'VARIABLES'
09/12/2011;09/12/2011;'RESTAURANTES';-16,00 €;8.405,51 €;1880;-16,00;12.929,60 €;'sin fechas';09/12/2011;'RESTAURANTES';'Gastos_Ocio y transporte';'Restaurantes';'VARIABLES'
10/12/2011;10/12/2011;'CAFET.C T PRAT';-1,65 €;8.403,86 €;1881;-1,65;12.927,95 €;'sin fechas';10/12/2011;'CAFETC';'Gastos_Ocio y transporte';'Restaurantes';'VARIABLES'
10/12/2011;01/12/2011;'COCHE&PARKING';-1,10 €;8.402,76 €;1882;-1,10;12.926,85 €;'sin fechas';01/12/2011;'COCHEPARKING';'Gastos_Ocio y transporte';'Parking y peaje';'VARIABLES'
10/12/2011;10/12/2011;'DIETISTA';-31,00 €;8.371,76 €;1883;-31,00;12.895,85 €;'sin fechas';10/12/2011;'DIETISTA';'Gastos_Salud, saber y deporte';'Otros Salud';'VARIABLES'
10/12/2011;09/12/2011;'HOGAR&COMIDA';-20,40 €;8.351,36 €;1884;-20,40;12.875,45 €;'sin fechas';09/12/2011;'HOGARCOMIDA';'Gastos_Compras';'Supermercado';'VARIABLES'
10/12/2011;09/12/2011;'IKEA';-38,93 €;8.312,43 €;1885;-38,93;12.836,52 €;'sin fechas';09/12/2011;'IKEA';'Gastos_Vivienda y vehiculo';'Mnto. hogar';'VARIABLES'
10/12/2011;10/12/2011;'MERCADONA';-35,20 €;8.277,23 €;1886;-35,20;12.801,32 €;'sin fechas';10/12/2011;'MERCADONA';'Gastos_Compras';'Supermercado';'VARIABLES'
10/12/2011;10/12/2011;'REINT.CAJERO';-69,00 €;8.208,23 €;1887;-69,00;12.732,32 €;'sin fechas';10/12/2011;'REINTCAJERO';'Gastos_Gastos varios';'Efectivo';'VARIABLES'
10/12/2011;09/12/2011;'RESTAURANTES';-3,70 €;8.204,53 €;1888;-3,70;12.728,62 €;'sin fechas';09/12/2011;'RESTAURANTES';'Gastos_Ocio y transporte';'Restaurantes';'VARIABLES'
12/12/2011;11/12/2011;'EROSKI-[COMIDA]';-38,77 €;8.165,76 €;1889;-38,77;12.689,85 €;'sin fechas';11/12/2011;'EROSKICOMIDA';'Gastos_Compras';'Supermercado';'VARIABLES'
12/12/2011;12/12/2011;'REINT.CAJERO';-20,00 €;8.145,76 €;1890;-20,00;12.669,85 €;'sin fechas';12/12/2011;'REINTCAJERO';'Gastos_Gastos varios';'Efectivo';'VARIABLES'
12/12/2011;12/12/2011;'RESTAURANTES';-18,60 €;8.127,16 €;1891;-18,60;12.651,25 €;'sin fechas';12/12/2011;'RESTAURANTES';'Gastos_Ocio y transporte';'Restaurantes';'VARIABLES'
12/12/2011;11/12/2011;'VIENA';-10,05 €;8.117,11 €;1892;-10,05;12.641,20 €;'sin fechas';11/12/2011;'VIENA';'Gastos_Ocio y transporte';'Restaurantes';'VARIABLES'
14/12/2011;14/12/2011;'BON AREA';-14,23 €;8.102,88 €;1893;-14,23;12.626,97 €;'sin fechas';14/12/2011;'BON';'Gastos_Compras';'Supermercado';'VARIABLES'
15/12/2011;15/12/2011;'CAFET.C T PRAT';-4,25 €;8.098,63 €;1894;-4,25;12.622,72 €;'sin fechas';15/12/2011;'CAFETC';'Gastos_Ocio y transporte';'Restaurantes';'VARIABLES'
15/12/2011;15/12/2011;'CAFET.C T PRAT';-2,40 €;8.096,23 €;1895;-2,40;12.620,32 €;'sin fechas';15/12/2011;'CAFETC';'Gastos_Ocio y transporte';'Restaurantes';'VARIABLES'
15/12/2011;15/12/2011;'CCM VIDA Y P SEGURO PRESTAMO';-26,49 €;8.069,74 €;1896;-26,49;12.593,83 €;'sin fechas';15/12/2011;'CCM';'Gastos_Seguros';'Seguro vida';'FIJO'
15/12/2011;15/12/2011;'CCM VIDA Y PENSIO 000000493358';-19,15 €;8.050,59 €;1897;-19,15;12.574,68 €;'sin fechas';15/12/2011;'CCM';'Gastos_Seguros';'Seguro vida';'FIJO'
15/12/2011;15/12/2011;'GASOLINERA';-48,17 €;8.002,42 €;1898;-48,17;12.526,51 €;'sin fechas';15/12/2011;'GASOLINERA';'Gastos_Ocio y transporte';'Gasolina';'VARIABLES'
15/12/2011;13/12/2011;'VIENA';-10,85 €;7.991,57 €;1899;-10,85;12.515,66 €;'sin fechas';13/12/2011;'VIENA';'Gastos_Ocio y transporte';'Restaurantes';'VARIABLES'
16/12/2011;16/12/2011;'CAFET.C T PRAT';-3,40 €;7.988,17 €;1900;-3,40;12.512,26 €;'sin fechas';16/12/2011;'CAFETC';'Gastos_Ocio y transporte';'Restaurantes';'VARIABLES'
16/12/2011;16/12/2011;'INFORMACIO I TECNOLOGIA DE CAT';1.724,25 €;9.712,42 €;1901;1.724,25;14.236,51 €;'sin fechas';16/12/2011;'INFORMACIO';'Ingresos';'Nomina';'FIJO'
17/12/2011;17/12/2011;'CAFET.C T PRAT';-2,50 €;9.709,92 €;1902;-2,50;14.234,01 €;'sin fechas';17/12/2011;'CAFETC';'Gastos_Ocio y transporte';'Restaurantes';'VARIABLES'
17/12/2011;17/12/2011;'RESTAURANTES';-14,00 €;9.695,92 €;1903;-14,00;14.220,01 €;'sin fechas';17/12/2011;'RESTAURANTES';'Gastos_Ocio y transporte';'Restaurantes';'VARIABLES'
18/12/2011;18/12/2011;'CAFET.C T PRAT';-1,70 €;9.694,22 €;1904;-1,70;14.218,31 €;'sin fechas';18/12/2011;'CAFETC';'Gastos_Ocio y transporte';'Restaurantes';'VARIABLES'
19/12/2011;19/12/2011;'CAFET.C T PRAT';-3,40 €;9.690,82 €;1905;-3,40;14.214,91 €;'sin fechas';19/12/2011;'CAFETC';'Gastos_Ocio y transporte';'Restaurantes';'VARIABLES'
19/12/2011;08/12/2011;'COCHE&PARKING';-3,40 €;9.687,42 €;1906;-3,40;14.211,51 €;'sin fechas';08/12/2011;'COCHEPARKING';'Gastos_Ocio y transporte';'Parking y peaje';'VARIABLES'
19/12/2011;12/12/2011;'TABASA A S.C';-3,35 €;9.684,07 €;1907;-3,35;14.208,16 €;'sin fechas';12/12/2011;'TABASA';'Gastos_Ocio y transporte';'Parking y peaje';'VARIABLES'
19/12/2011;12/12/2011;'TABASA A S.C';-3,35 €;9.680,72 €;1908;-3,35;14.204,81 €;'sin fechas';12/12/2011;'TABASA';'Gastos_Ocio y transporte';'Parking y peaje';'VARIABLES'
20/12/2011;20/12/2011;'ONO';-87,13 €;9.593,59 €;1909;-87,13;14.117,68 €;'sin fechas';20/12/2011;'ONO';'Gastos_Servicios tipicos';'Telecomunicaciones';'FIJO'
21/12/2011;21/12/2011;'A.E.A.T. DEVOLUCIONES TRIBUTAR';100,00 €;9.693,59 €;1910;100,00;14.217,68 €;'sin fechas';21/12/2011;'AEAT';'Ingresos';'Devoluciones';'VARIABLES'
21/12/2011;21/12/2011;'FOMENT DE TERRASSA, S.A. FOMEN';3.132,03 €;12.825,62 €;1911;3.132,03;17.349,71 €;'sin fechas';21/12/2011;'FOMENT';'Ingresos';'Nomina';'FIJO'
21/12/2011;21/12/2011;'REINT.CAJERO';-60,00 €;12.765,62 €;1912;-60,00;17.289,71 €;'sin fechas';21/12/2011;'REINTCAJERO';'Gastos_Gastos varios';'Efectivo';'VARIABLES'
22/12/2011;20/12/2011;'BON AREA';-16,87 €;12.748,75 €;1913;-16,87;17.272,84 €;'sin fechas';20/12/2011;'BON';'Gastos_Compras';'Supermercado';'VARIABLES'
22/12/2011;22/12/2011;'CAFET.C T PRAT';-1,70 €;12.747,05 €;1914;-1,70;17.271,14 €;'sin fechas';22/12/2011;'CAFETC';'Gastos_Ocio y transporte';'Restaurantes';'VARIABLES'
22/12/2011;22/12/2011;'ENDESA ENERG EE_XXI40025545678';-92,71 €;12.654,34 €;1915;-92,71;17.178,43 €;'sin fechas';22/12/2011;'ENDESA';'Gastos_Servicios tipicos';'Electricidad';'FIJO'
22/12/2011;20/12/2011;'FARMACIA';-23,70 €;12.630,64 €;1916;-23,70;17.154,73 €;'sin fechas';20/12/2011;'FARMACIA';'Gastos_Salud, saber y deporte';'Farmacia';'VARIABLES'
22/12/2011;22/12/2011;'MERCADONA';-164,12 €;12.466,52 €;1917;-164,12;16.990,61 €;'sin fechas';22/12/2011;'MERCADONA';'Gastos_Compras';'Supermercado';'VARIABLES'
22/12/2011;22/12/2011;'MERCADONA';-15,00 €;12.451,52 €;1918;-15,00;16.975,61 €;'sin fechas';22/12/2011;'MERCADONA';'Gastos_Compras';'Supermercado';'VARIABLES'
22/12/2011;22/12/2011;'MINA PUBLICA AIGUES T.01A75789';-37,85 €;12.413,67 €;1919;-37,85;16.937,76 €;'sin fechas';22/12/2011;'MINA';'Gastos_Servicios tipicos';'Agua';'FIJO'
22/12/2011;22/12/2011;'TOYS PATRIMONIAL';-9,99 €;12.403,68 €;1920;-9,99;16.927,77 €;'sin fechas';22/12/2011;'TOYS';'Gastos_Compras';'Niños';'VARIABLES'
23/12/2011;23/12/2011;'CAFET.C T PRAT';-2,55 €;12.401,13 €;1921;-2,55;16.925,22 €;'sin fechas';23/12/2011;'CAFETC';'Gastos_Ocio y transporte';'Restaurantes';'VARIABLES'
23/12/2011;12/12/2011;'COCHE&PARKING';-5,75 €;12.395,38 €;1922;-5,75;16.919,47 €;'sin fechas';12/12/2011;'COCHEPARKING';'Gastos_Ocio y transporte';'Parking y peaje';'VARIABLES'
23/12/2011;12/12/2011;'COCHE&PARKING';-3,10 €;12.392,28 €;1923;-3,10;16.916,37 €;'sin fechas';12/12/2011;'COCHEPARKING';'Gastos_Ocio y transporte';'Parking y peaje';'VARIABLES'
24/12/2011;24/12/2011;'CAFET.C T PRAT';-3,35 €;12.388,93 €;1924;-3,35;16.913,02 €;'sin fechas';24/12/2011;'CAFETC';'Gastos_Ocio y transporte';'Restaurantes';'VARIABLES'
24/12/2011;24/12/2011;'REINT.CAJERO';-20,00 €;12.368,93 €;1925;-20,00;16.893,02 €;'sin fechas';24/12/2011;'REINTCAJERO';'Gastos_Gastos varios';'Efectivo';'VARIABLES'
25/12/2011;25/12/2011;'CAFET.C T PRAT';-2,50 €;12.366,43 €;1926;-2,50;16.890,52 €;'sin fechas';25/12/2011;'CAFETC';'Gastos_Ocio y transporte';'Restaurantes';'VARIABLES'
25/12/2011;25/12/2011;'EROSKI-[COMIDA]';-74,10 €;12.292,33 €;1927;-74,10;16.816,42 €;'sin fechas';25/12/2011;'EROSKICOMIDA';'Gastos_Compras';'Supermercado';'VARIABLES'
26/12/2011;26/12/2011;'EROSKI-[COMIDA]';-57,37 €;12.234,96 €;1928;-57,37;16.759,05 €;'sin fechas';26/12/2011;'EROSKICOMIDA';'Gastos_Compras';'Supermercado';'VARIABLES'
26/12/2011;26/12/2011;'FARMACIA';-6,74 €;12.228,22 €;1929;-6,74;16.752,31 €;'sin fechas';26/12/2011;'FARMACIA';'Gastos_Salud, saber y deporte';'Farmacia';'VARIABLES'
26/12/2011;26/12/2011;'MERCADONA';-42,33 €;12.185,89 €;1930;-42,33;16.709,98 €;'sin fechas';26/12/2011;'MERCADONA';'Gastos_Compras';'Supermercado';'VARIABLES'
28/12/2011;28/12/2011;'CIA. DE SEGUROS ADESLAS S.A.';194,40 €;12.380,29 €;1931;194,40;16.904,38 €;'sin fechas';28/12/2011;'CIA';'Ingresos';'Devoluciones';'VARIABLES'
28/12/2011;28/12/2011;'CIA. DE SEGUROS ADESLAS S.A.';226,80 €;12.607,09 €;1932;226,80;17.131,18 €;'sin fechas';28/12/2011;'CIA';'Ingresos';'Devoluciones';'VARIABLES'
28/12/2011;28/12/2011;'INFORMACIO I TECNOLOGIA DE CAT';1.271,09 €;13.878,18 €;1933;1.271,09;18.402,27 €;'sin fechas';28/12/2011;'INFORMACIO';'Ingresos';'Nomina';'FIJO'
29/12/2011;28/12/2011;'ES STA. MARGARITA';-40,76 €;13.837,42 €;1934;-40,76;18.361,51 €;'sin fechas';28/12/2011;'STA';'Gastos_Ocio y transporte';'Gasolina';'VARIABLES'
29/12/2011;29/12/2011;'ESCOLA BRESSOL EINA';-236,00 €;13.601,42 €;1935;-236,00;18.125,51 €;'sin fechas';29/12/2011;'ESCOLA';'Gastos_Salud, saber y deporte';'Estudios';'VARIABLES'
30/12/2011;30/12/2011;'CAFET.C T PRAT';-2,40 €;13.599,02 €;1936;-2,40;18.123,11 €;'sin fechas';30/12/2011;'CAFETC';'Gastos_Ocio y transporte';'Restaurantes';'VARIABLES'
30/12/2011;30/12/2011;'CAFET.C T PRAT';-4,25 €;13.594,77 €;1937;-4,25;18.118,86 €;'sin fechas';30/12/2011;'CAFETC';'Gastos_Ocio y transporte';'Restaurantes';'VARIABLES'
30/12/2011;30/12/2011;'CAJA DE SEGUROS R 300045047898';-275,10 €;13.319,67 €;1938;-275,10;17.843,76 €;'sin fechas';30/12/2011;'CAJA';'Gastos_Seguros';'Seguro hogar';'FIJO'
30/12/2011;30/12/2011;'FARMACIA';-7,26 €;13.312,41 €;1939;-7,26;17.836,50 €;'sin fechas';30/12/2011;'FARMACIA';'Gastos_Salud, saber y deporte';'Farmacia';'VARIABLES'
31/12/2011;31/12/2011;'CAFET.C T PRAT';-2,40 €;13.310,01 €;1940;-2,40;17.834,10 €;'sin fechas';31/12/2011;'CAFETC';'Gastos_Ocio y transporte';'Restaurantes';'VARIABLES'
31/12/2011;31/12/2011;'CAPRABO';-11,55 €;13.298,46 €;1941;-11,55;17.822,55 €;'sin fechas';31/12/2011;'CAPRABO';'Gastos_Compras';'Supermercado';'VARIABLES'
01/01/2012;01/01/2012;'CAFET.C T PRAT';-1,70 €;13.296,76 €;1942;-1,70;17.820,85 €;'sin fechas';01/01/2012;'CAFETC';'Gastos_Ocio y transporte';'Restaurantes';'VARIABLES'
01/01/2012;01/01/2012;'CAFET.C T PRAT';-1,70 €;13.295,06 €;1943;-1,70;17.819,15 €;'sin fechas';01/01/2012;'CAFETC';'Gastos_Ocio y transporte';'Restaurantes';'VARIABLES'
01/01/2012;01/01/2012;'CREDITO';-19,65 €;13.275,41 €;1944;-19,65;17.799,50 €;'sin fechas';01/01/2012;'CREDITO';'No computable';'Recibo Tarjeta';
01/01/2012;01/01/2012;'MANTENIMIENTO';-1,50 €;13.273,91 €;1945;-1,50;17.798,00 €;'sin fechas';01/01/2012;'MANTENIMIENTO';'Gastos_Banco y organismos';'Cargos banco';'FIJO'
02/01/2012;02/01/2012;'CAFET.C T PRAT';-3,40 €;13.270,51 €;1946;-3,40;17.794,60 €;'sin fechas';02/01/2012;'CAFETC';'Gastos_Ocio y transporte';'Restaurantes';'VARIABLES'
02/01/2012;31/12/2011;'COMUNIDAD';-240,00 €;13.030,51 €;1947;-240,00;17.554,60 €;'sin fechas';31/12/2011;'COMUNIDAD';'Gastos_Vivienda y vehiculo';'Comunidad';'FIJO'
02/01/2012;09/12/2011;'PARKING CAPIO SANIDAD';-3,15 €;13.027,36 €;1948;-3,15;17.551,45 €;'sin fechas';09/12/2011;'PARKING';'Gastos_Ocio y transporte';'Parking y peaje';'VARIABLES'
02/01/2012;31/12/2011;'RECIBO PTMOS. 3061-0960001518';-583,25 €;12.444,11 €;1949;-583,25;16.968,20 €;'sin fechas';31/12/2011;'RECIBO';'Gastos_Banco y organismos';'Hipoteca';'FIJO'
02/01/2012;10/12/2011;'TRANSPORTS MUNICIP';-16,50 €;12.427,61 €;1950;-16,50;16.951,70 €;'sin fechas';10/12/2011;'TRANSPORTS';'Gastos_Ocio y transporte';'Transporte';'VARIABLES'
04/01/2012;04/01/2012;'ESCOLA BRESSOL EINA';-44,10 €;12.383,51 €;1951;-44,10;16.907,60 €;'sin fechas';04/01/2012;'ESCOLA';'Gastos_Salud, saber y deporte';'Estudios';'VARIABLES'
04/01/2012;04/01/2012;'TICKETS [ABONO]';350,00 €;12.733,51 €;1952;350,00;17.257,60 €;'sin fechas';04/01/2012;'TICKETS';'Gastos_Salud, saber y deporte';'Estudios';'VARIABLES'
04/01/2012;04/01/2012;'TICKETS [CARGO]';-350,00 €;12.383,51 €;1953;-350,00;16.907,60 €;'sin fechas';04/01/2012;'TICKETS';'Gastos_Salud, saber y deporte';'Estudios';'VARIABLES'
05/01/2012;05/01/2012;'GAS NATURAL';-10,27 €;12.373,24 €;1954;-10,27;16.897,33 €;'sin fechas';05/01/2012;'GAS';'Gastos_Servicios tipicos';'Gas';'FIJO'
05/01/2012;05/01/2012;'TABASA A S.C';-3,35 €;12.369,89 €;1955;-3,35;16.893,98 €;'sin fechas';05/01/2012;'TABASA';'Gastos_Ocio y transporte';'Parking y peaje';'VARIABLES'
05/01/2012;05/01/2012;'TABASA A S.C';-3,35 €;12.366,54 €;1956;-3,35;16.890,63 €;'sin fechas';05/01/2012;'TABASA';'Gastos_Ocio y transporte';'Parking y peaje';'VARIABLES'
05/01/2012;05/01/2012;'XFERA MOVILES SA 2767906';-41,74 €;12.324,80 €;1957;-41,74;16.848,89 €;'sin fechas';05/01/2012;'XFERA';'Gastos_Servicios tipicos';'Telecomunicaciones';'FIJO'
06/01/2012;06/01/2012;'CAFET.C T PRAT';-6,75 €;12.318,05 €;1958;-6,75;16.842,14 €;'sin fechas';06/01/2012;'CAFETC';'Gastos_Ocio y transporte';'Restaurantes';'VARIABLES'
06/01/2012;06/01/2012;'FARMACIA';-50,72 €;12.267,33 €;1959;-50,72;16.791,42 €;'sin fechas';06/01/2012;'FARMACIA';'Gastos_Salud, saber y deporte';'Farmacia';'VARIABLES'
07/01/2012;07/01/2012;'CAFET.C T PRAT';-1,65 €;12.265,68 €;1960;-1,65;16.789,77 €;'sin fechas';07/01/2012;'CAFETC';'Gastos_Ocio y transporte';'Restaurantes';'VARIABLES'
07/01/2012;07/01/2012;'ES STA. MARGARITA';-45,12 €;12.220,56 €;1961;-45,12;16.744,65 €;'sin fechas';07/01/2012;'STA';'Gastos_Ocio y transporte';'Gasolina';'VARIABLES'
08/01/2012;08/01/2012;'BON AREA';-14,81 €;12.205,75 €;1962;-14,81;16.729,84 €;'sin fechas';08/01/2012;'BON';'Gastos_Compras';'Supermercado';'VARIABLES'
08/01/2012;08/01/2012;'CAFET.C T PRAT';-2,50 €;12.203,25 €;1963;-2,50;16.727,34 €;'sin fechas';08/01/2012;'CAFETC';'Gastos_Ocio y transporte';'Restaurantes';'VARIABLES'
09/01/2012;09/01/2012;'BLITZ';-70,80 €;12.132,45 €;1964;-70,80;16.656,54 €;'sin fechas';09/01/2012;'BLITZ';'Gastos_Vivienda y vehiculo';'Alquiler Parking';'FIJO'
10/01/2012;10/01/2012;'LIMPIEZA';-60,00 €;12.072,45 €;1965;-60,00;16.596,54 €;'sin fechas';10/01/2012;'LIMPIEZA';'Gastos_Vivienda y vehiculo';'Serv. domestico';'FIJO'
10/01/2012;10/01/2012;'MERCADONA';-30,00 €;12.042,45 €;1966;-30,00;16.566,54 €;'sin fechas';10/01/2012;'MERCADONA';'Gastos_Compras';'Supermercado';'VARIABLES'
12/01/2012;10/01/2012;'EROSKI-[COMIDA]';-39,88 €;12.002,57 €;1967;-39,88;16.526,66 €;'sin fechas';10/01/2012;'EROSKICOMIDA';'Gastos_Compras';'Supermercado';'VARIABLES'
12/01/2012;09/01/2012;'RESTAURANTES';-108,85 €;11.893,72 €;1968;-108,85;16.417,81 €;'sin fechas';09/01/2012;'RESTAURANTES';'Gastos_Ocio y transporte';'Restaurantes';'VARIABLES'
12/01/2012;10/01/2012;'VIENA';-10,25 €;11.883,47 €;1969;-10,25;16.407,56 €;'sin fechas';10/01/2012;'VIENA';'Gastos_Ocio y transporte';'Restaurantes';'VARIABLES'
13/01/2012;06/01/2012;'COCHE&PARKING';-1,90 €;11.881,57 €;1970;-1,90;16.405,66 €;'sin fechas';06/01/2012;'COCHEPARKING';'Gastos_Ocio y transporte';'Parking y peaje';'VARIABLES'
13/01/2012;13/01/2012;'FARMACIA';-77,91 €;11.803,66 €;1971;-77,91;16.327,75 €;'sin fechas';13/01/2012;'FARMACIA';'Gastos_Salud, saber y deporte';'Farmacia';'VARIABLES'
13/01/2012;13/01/2012;'TRANSPORTS MUNICIP';-17,00 €;11.786,66 €;1972;-17,00;16.310,75 €;'sin fechas';13/01/2012;'TRANSPORTS';'Gastos_Ocio y transporte';'Transporte';'VARIABLES'
13/01/2012;13/01/2012;'TRANSPORTS MUNICIP';-17,00 €;11.769,66 €;1973;-17,00;16.293,75 €;'sin fechas';13/01/2012;'TRANSPORTS';'Gastos_Ocio y transporte';'Transporte';'VARIABLES'
14/01/2012;14/01/2012;'FARMACIA';-18,33 €;11.751,33 €;1974;-18,33;16.275,42 €;'sin fechas';14/01/2012;'FARMACIA';'Gastos_Salud, saber y deporte';'Farmacia';'VARIABLES'
15/01/2012;15/01/2012;'CAFET.C T PRAT';-3,00 €;11.748,33 €;1975;-3,00;16.272,42 €;'sin fechas';15/01/2012;'CAFETC';'Gastos_Ocio y transporte';'Restaurantes';'VARIABLES'
15/01/2012;15/01/2012;'CAPRABO';-22,14 €;11.726,19 €;1976;-22,14;16.250,28 €;'sin fechas';15/01/2012;'CAPRABO';'Gastos_Compras';'Supermercado';'VARIABLES'
15/01/2012;15/01/2012;'COCHE&PARKING';-12,75 €;11.713,44 €;1977;-12,75;16.237,53 €;'sin fechas';15/01/2012;'COCHEPARKING';'Gastos_Ocio y transporte';'Parking y peaje';'VARIABLES'
16/01/2012;08/01/2012;'AUTOPISTA TERR';-1,31 €;11.712,13 €;1978;-1,31;16.236,22 €;'sin fechas';08/01/2012;'AUTOPISTA';'Gastos_Ocio y transporte';'Parking y peaje';'VARIABLES'
16/01/2012;16/01/2012;'CAFET.C T PRAT';-4,25 €;11.707,88 €;1979;-4,25;16.231,97 €;'sin fechas';16/01/2012;'CAFETC';'Gastos_Ocio y transporte';'Restaurantes';'VARIABLES'
16/01/2012;16/01/2012;'CCM VIDA Y P SEGURO PRESTAMO';-26,42 €;11.681,46 €;1980;-26,42;16.205,55 €;'sin fechas';16/01/2012;'CCM';'Gastos_Seguros';'Seguro vida';'FIJO'
16/01/2012;16/01/2012;'CCM VIDA Y PENSIO 000000493358';-19,11 €;11.662,35 €;1981;-19,11;16.186,44 €;'sin fechas';16/01/2012;'CCM';'Gastos_Seguros';'Seguro vida';'FIJO'
16/01/2012;16/01/2012;'JOHN\''S ITALIAN CAF';-29,25 €;11.633,10 €;1982;-29,25;16.157,19 €;'sin fechas';16/01/2012;'JOHNS';'Gastos_Ocio y transporte';'Restaurantes';'VARIABLES'
16/01/2012;16/01/2012;'MERCADONA';-6,47 €;11.626,63 €;1983;-6,47;16.150,72 €;'sin fechas';16/01/2012;'MERCADONA';'Gastos_Compras';'Supermercado';'VARIABLES'
16/01/2012;16/01/2012;'MERCADONA';-147,58 €;11.479,05 €;1984;-147,58;16.003,14 €;'sin fechas';16/01/2012;'MERCADONA';'Gastos_Compras';'Supermercado';'VARIABLES'
17/01/2012;17/01/2012;'AUTOPISTA TERR';-36,00 €;11.443,05 €;1985;-36,00;15.967,14 €;'sin fechas';17/01/2012;'AUTOPISTA';'Gastos_Ocio y transporte';'Parking y peaje';'VARIABLES'
17/01/2012;17/01/2012;'ONO';-87,90 €;11.355,15 €;1986;-87,90;15.879,24 €;'sin fechas';17/01/2012;'ONO';'Gastos_Servicios tipicos';'Telecomunicaciones';'FIJO'
18/01/2012;18/01/2012;'AG.TRIBUT GABRIEL';100,00 €;11.455,15 €;1987;100,00;15.979,24 €;'sin fechas';18/01/2012;'AGTRIBUT';'Ingresos';'Subvenciones';
19/01/2012;17/01/2012;'DIVAN RESTAURANT T';-6,90 €;11.448,25 €;1988;-6,90;15.972,34 €;'sin fechas';17/01/2012;'DIVAN';'Gastos_Ocio y transporte';'Restaurantes';'VARIABLES'
19/01/2012;19/01/2012;'ES STA. MARGARITA';-47,67 €;11.400,58 €;1989;-47,67;15.924,67 €;'sin fechas';19/01/2012;'STA';'Gastos_Ocio y transporte';'Gasolina';'VARIABLES'
19/01/2012;17/01/2012;'FARMACIA';-1,30 €;11.399,28 €;1990;-1,30;15.923,37 €;'sin fechas';17/01/2012;'FARMACIA';'Gastos_Salud, saber y deporte';'Farmacia';'VARIABLES'
19/01/2012;17/01/2012;'H&M';-29,90 €;11.369,38 €;1991;-29,90;15.893,47 €;'sin fechas';17/01/2012;'HM';'Gastos_Compras';'Ropa';'VARIABLES'
19/01/2012;17/01/2012;'VIENA';-13,05 €;11.356,33 €;1992;-13,05;15.880,42 €;'sin fechas';17/01/2012;'VIENA';'Gastos_Ocio y transporte';'Restaurantes';'VARIABLES'
20/01/2012;20/01/2012;'FARMACIA';-9,06 €;11.347,27 €;1993;-9,06;15.871,36 €;'sin fechas';20/01/2012;'FARMACIA';'Gastos_Salud, saber y deporte';'Farmacia';'VARIABLES'
21/01/2012;21/01/2012;'BON AREA';-4,87 €;11.342,40 €;1994;-4,87;15.866,49 €;'sin fechas';21/01/2012;'BON';'Gastos_Compras';'Supermercado';'VARIABLES'
21/01/2012;21/01/2012;'CAFET.C T PRAT';-2,40 €;11.340,00 €;1995;-2,40;15.864,09 €;'sin fechas';21/01/2012;'CAFETC';'Gastos_Ocio y transporte';'Restaurantes';'VARIABLES'
23/01/2012;23/01/2012;'BON AREA';-6,34 €;11.333,66 €;1996;-6,34;15.857,75 €;'sin fechas';23/01/2012;'BON';'Gastos_Compras';'Supermercado';'VARIABLES'
23/01/2012;23/01/2012;'CAFET.C T PRAT';-2,05 €;11.331,61 €;1997;-2,05;15.855,70 €;'sin fechas';23/01/2012;'CAFETC';'Gastos_Ocio y transporte';'Restaurantes';'VARIABLES'
23/01/2012;23/01/2012;'ENDESA ENERG EE_XXI40025545678';-76,89 €;11.254,72 €;1998;-76,89;15.778,81 €;'sin fechas';23/01/2012;'ENDESA';'Gastos_Servicios tipicos';'Electricidad';'FIJO'
24/01/2012;24/01/2012;'LIMPIEZA';-100,00 €;11.154,72 €;1999;-100,00;15.678,81 €;'sin fechas';24/01/2012;'LIMPIEZA';'Gastos_Vivienda y vehiculo';'Serv. domestico';'FIJO'
24/01/2012;24/01/2012;'REINT.CAJERO';-50,00 €;11.104,72 €;2000;-50,00;15.628,81 €;'sin fechas';24/01/2012;'REINTCAJERO';'Gastos_Gastos varios';'Efectivo';'VARIABLES'
24/01/2012;24/01/2012;'RESTAURANTES';-50,00 €;11.054,72 €;2001;-50,00;15.578,81 €;'sin fechas';24/01/2012;'RESTAURANTES';'Gastos_Ocio y transporte';'Restaurantes';'VARIABLES'
26/01/2012;26/01/2012;'CAFET.C T PRAT';-5,95 €;11.048,77 €;2002;-5,95;15.572,86 €;'sin fechas';26/01/2012;'CAFETC';'Gastos_Ocio y transporte';'Restaurantes';'VARIABLES'
26/01/2012;26/01/2012;'CAPRABO';-29,68 €;11.019,09 €;2003;-29,68;15.543,18 €;'sin fechas';26/01/2012;'CAPRABO';'Gastos_Compras';'Supermercado';'VARIABLES'
26/01/2012;24/01/2012;'FNAC';-109,80 €;10.909,29 €;2004;-109,80;15.433,38 €;'sin fechas';24/01/2012;'FNAC';'Gastos_Compras';'Supermercado';'VARIABLES'
26/01/2012;26/01/2012;'GIFI';-9,45 €;10.899,84 €;2005;-9,45;15.423,93 €;'sin fechas';26/01/2012;'GIFI';'Gastos_Compras';'Hogar';'VARIABLES'
26/01/2012;24/01/2012;'PRIMARK';-33,00 €;10.866,84 €;2006;-33,00;15.390,93 €;'sin fechas';24/01/2012;'PRIMARK';'Gastos_Compras';'Ropa';'VARIABLES'
26/01/2012;24/01/2012;'RESTAURANTES';-10,85 €;10.855,99 €;2007;-10,85;15.380,08 €;'sin fechas';24/01/2012;'RESTAURANTES';'Gastos_Ocio y transporte';'Restaurantes';'VARIABLES'
26/01/2012;26/01/2012;'SEGURCAIXA ADESLA 006662671613';-73,00 €;10.782,99 €;2008;-73,00;15.307,08 €;'sin fechas';26/01/2012;'SEGURCAIXA';'Gastos_Seguros';'Seguro salud';'FIJO'
26/01/2012;26/01/2012;'VIENA';-7,95 €;10.775,04 €;2009;-7,95;15.299,13 €;'sin fechas';26/01/2012;'VIENA';'Gastos_Ocio y transporte';'Restaurantes';'VARIABLES'
27/01/2012;27/01/2012;'FOMENT DE TERRASSA, S.A. FOMEN';1.551,01 €;12.326,05 €;2010;1.551,01;16.850,14 €;'sin fechas';27/01/2012;'FOMENT';'Ingresos';'Nomina';'FIJO'
27/01/2012;27/01/2012;'INFORMACIO I TECNOLOGIA DE CAT';1.254,99 €;13.581,04 €;2011;1.254,99;18.105,13 €;'sin fechas';27/01/2012;'INFORMACIO';'Ingresos';'Nomina';'FIJO'
28/01/2012;28/01/2012;'CAFET.C T PRAT';-3,35 €;13.577,69 €;2012;-3,35;18.101,78 €;'sin fechas';28/01/2012;'CAFETC';'Gastos_Ocio y transporte';'Restaurantes';'VARIABLES'
28/01/2012;24/01/2012;'COCHE&PARKING';-5,10 €;13.572,59 €;2013;-5,10;18.096,68 €;'sin fechas';24/01/2012;'COCHEPARKING';'Gastos_Ocio y transporte';'Parking y peaje';'VARIABLES'
28/01/2012;28/01/2012;'FNAC';-99,90 €;13.472,69 €;2014;-99,90;17.996,78 €;'sin fechas';28/01/2012;'FNAC';'Gastos_Compras';'Supermercado';'VARIABLES'
29/01/2012;29/01/2012;'CAFET.C T PRAT';-4,20 €;13.468,49 €;2015;-4,20;17.992,58 €;'sin fechas';29/01/2012;'CAFETC';'Gastos_Ocio y transporte';'Restaurantes';'VARIABLES'
29/01/2012;29/01/2012;'ES STA. MARGARITA';-50,40 €;13.418,09 €;2016;-50,40;17.942,18 €;'sin fechas';29/01/2012;'STA';'Gastos_Ocio y transporte';'Gasolina';'VARIABLES'
29/01/2012;29/01/2012;'FARMACIA';-28,52 €;13.389,57 €;2017;-28,52;17.913,66 €;'sin fechas';29/01/2012;'FARMACIA';'Gastos_Salud, saber y deporte';'Farmacia';'VARIABLES'
30/01/2012;30/01/2012;'CAFET.C T PRAT';-4,20 €;13.385,37 €;2018;-4,20;17.909,46 €;'sin fechas';30/01/2012;'CAFETC';'Gastos_Ocio y transporte';'Restaurantes';'VARIABLES'
30/01/2012;30/01/2012;'LIDL TERRASSA';-19,62 €;13.365,75 €;2019;-19,62;17.889,84 €;'sin fechas';30/01/2012;'LIDL';'Gastos_Compras';'Supermercado';'VARIABLES'
30/01/2012;30/01/2012;'VIENA';-14,15 €;13.351,60 €;2020;-14,15;17.875,69 €;'sin fechas';30/01/2012;'VIENA';'Gastos_Ocio y transporte';'Restaurantes';'VARIABLES'
31/01/2012;31/01/2012;'COMUNIDAD';-20,00 €;13.331,60 €;2021;-20,00;17.855,69 €;'sin fechas';31/01/2012;'COMUNIDAD';'Gastos_Vivienda y vehiculo';'Comunidad';'FIJO'
31/01/2012;31/01/2012;'RECIBO PTMOS. 3061-0960001518';-583,25 €;12.748,35 €;2022;-583,25;17.272,44 €;'sin fechas';31/01/2012;'RECIBO';'Gastos_Banco y organismos';'Hipoteca';'FIJO'
01/02/2012;31/01/2012;'CREDITO';35,78 €;12.784,13 €;2023;35,78;17.308,22 €;'sin fechas';31/01/2012;'CREDITO';'No computable';'Recibo Tarjeta';
01/02/2012;01/02/2012;'MANTENIMIENTO';-2,25 €;12.781,88 €;2024;-2,25;17.305,97 €;'sin fechas';01/02/2012;'MANTENIMIENTO';'Gastos_Banco y organismos';'Cargos banco';'FIJO'
02/02/2012;02/02/2012;'ADESLAS CENTRAL 006662671613';-73,00 €;12.708,88 €;2025;-73,00;17.232,97 €;'sin fechas';02/02/2012;'ADESLAS';'Gastos_Salud, saber y deporte';'Medico';'VARIABLES'
02/02/2012;12/01/2012;'AUTOPISTA TERR';-1,31 €;12.707,57 €;2026;-1,31;17.231,66 €;'sin fechas';12/01/2012;'AUTOPISTA';'Gastos_Ocio y transporte';'Parking y peaje';'VARIABLES'
02/02/2012;12/01/2012;'AUTOPISTA TERR';-1,31 €;12.706,26 €;2027;-1,31;17.230,35 €;'sin fechas';12/01/2012;'AUTOPISTA';'Gastos_Ocio y transporte';'Parking y peaje';'VARIABLES'
02/02/2012;12/01/2012;'AUTOPISTA TERR';-1,31 €;12.704,95 €;2028;-1,31;17.229,04 €;'sin fechas';12/01/2012;'AUTOPISTA';'Gastos_Ocio y transporte';'Parking y peaje';'VARIABLES'
02/02/2012;16/01/2012;'AUTOPISTA TERR';-1,31 €;12.703,64 €;2029;-1,31;17.227,73 €;'sin fechas';16/01/2012;'AUTOPISTA';'Gastos_Ocio y transporte';'Parking y peaje';'VARIABLES'
02/02/2012;18/01/2012;'AUTOPISTA TERR';-1,31 €;12.702,33 €;2030;-1,31;17.226,42 €;'sin fechas';18/01/2012;'AUTOPISTA';'Gastos_Ocio y transporte';'Parking y peaje';'VARIABLES'
02/02/2012;20/01/2012;'AUTOPISTA TERR';-1,31 €;12.701,02 €;2031;-1,31;17.225,11 €;'sin fechas';20/01/2012;'AUTOPISTA';'Gastos_Ocio y transporte';'Parking y peaje';'VARIABLES'
02/02/2012;20/01/2012;'AUTOPISTA TERR';-1,31 €;12.699,71 €;2032;-1,31;17.223,80 €;'sin fechas';20/01/2012;'AUTOPISTA';'Gastos_Ocio y transporte';'Parking y peaje';'VARIABLES'
02/02/2012;24/01/2012;'CAFET.C T PRAT';-2,40 €;12.697,31 €;2033;-2,40;17.221,40 €;'sin fechas';24/01/2012;'CAFETC';'Gastos_Ocio y transporte';'Restaurantes';'VARIABLES'
02/02/2012;02/02/2012;'CAFET.C T PRAT';-5,95 €;12.691,36 €;2034;-5,95;17.215,45 €;'sin fechas';02/02/2012;'CAFETC';'Gastos_Ocio y transporte';'Restaurantes';'VARIABLES'
02/02/2012;24/01/2012;'FARMACIA';-6,01 €;12.685,35 €;2035;-6,01;17.209,44 €;'sin fechas';24/01/2012;'FARMACIA';'Gastos_Salud, saber y deporte';'Farmacia';'VARIABLES'
02/02/2012;02/02/2012;'FF.CC.GENERALITAT';-2,70 €;12.682,65 €;2036;-2,70;17.206,74 €;'sin fechas';02/02/2012;'FFCCGENERALITAT';'Gastos_Ocio y transporte';'Transporte';'VARIABLES'
02/02/2012;31/01/2012;'JACK AND JONES';-34,97 €;12.647,68 €;2037;-34,97;17.171,77 €;'sin fechas';31/01/2012;'JACK';'Gastos_Compras';'Ropa';'VARIABLES'
02/02/2012;02/02/2012;'MERCADONA';-18,44 €;12.629,24 €;2038;-18,44;17.153,33 €;'sin fechas';02/02/2012;'MERCADONA';'Gastos_Compras';'Supermercado';'VARIABLES'
02/02/2012;12/01/2012;'PARKING CAPIO SANIDAD';-11,20 €;12.618,04 €;2039;-11,20;17.142,13 €;'sin fechas';12/01/2012;'PARKING';'Gastos_Ocio y transporte';'Parking y peaje';'VARIABLES'
02/02/2012;10/01/2012;'SATSA PL. VELLA TERRASSA';-2,30 €;12.615,74 €;2040;-2,30;17.139,83 €;'sin fechas';10/01/2012;'SATSA';'Gastos_Ocio y transporte';'Parking y peaje';'VARIABLES'
02/02/2012;24/01/2012;'VIENA';-1,55 €;12.614,19 €;2041;-1,55;17.138,28 €;'sin fechas';24/01/2012;'VIENA';'Gastos_Ocio y transporte';'Restaurantes';'VARIABLES'
02/02/2012;24/01/2012;'VIENA';-3,15 €;12.611,04 €;2042;-3,15;17.135,13 €;'sin fechas';24/01/2012;'VIENA';'Gastos_Ocio y transporte';'Restaurantes';'VARIABLES'
02/02/2012;31/01/2012;'VIENA';-4,80 €;12.606,24 €;2043;-4,80;17.130,33 €;'sin fechas';31/01/2012;'VIENA';'Gastos_Ocio y transporte';'Restaurantes';'VARIABLES'
03/02/2012;29/01/2012;'AUTOPISTA TERR';-1,31 €;12.604,93 €;2044;-1,31;17.129,02 €;'sin fechas';29/01/2012;'AUTOPISTA';'Gastos_Ocio y transporte';'Parking y peaje';'VARIABLES'
03/02/2012;03/02/2012;'CAFET.C T PRAT';-1,55 €;12.603,38 €;2045;-1,55;17.127,47 €;'sin fechas';03/02/2012;'CAFETC';'Gastos_Ocio y transporte';'Restaurantes';'VARIABLES'
03/02/2012;29/01/2012;'COCHE&PARKING';-2,45 €;12.600,93 €;2046;-2,45;17.125,02 €;'sin fechas';29/01/2012;'COCHEPARKING';'Gastos_Ocio y transporte';'Parking y peaje';'VARIABLES'
03/02/2012;03/02/2012;'XFERA MOVILES SA 2767906';-52,71 €;12.548,22 €;2047;-52,71;17.072,31 €;'sin fechas';03/02/2012;'XFERA';'Gastos_Servicios tipicos';'Telecomunicaciones';'FIJO'
04/02/2012;04/02/2012;'BON AREA';-31,83 €;12.516,39 €;2048;-31,83;17.040,48 €;'sin fechas';04/02/2012;'BON';'Gastos_Compras';'Supermercado';'VARIABLES'
04/02/2012;04/02/2012;'BON AREA';-19,27 €;12.497,12 €;2049;-19,27;17.021,21 €;'sin fechas';04/02/2012;'BON';'Gastos_Compras';'Supermercado';'VARIABLES'
04/02/2012;04/02/2012;'CAPRABO';-27,22 €;12.469,90 €;2050;-27,22;16.993,99 €;'sin fechas';04/02/2012;'CAPRABO';'Gastos_Compras';'Supermercado';'VARIABLES'
04/02/2012;04/02/2012;'VIENA';-9,40 €;12.460,50 €;2051;-9,40;16.984,59 €;'sin fechas';04/02/2012;'VIENA';'Gastos_Ocio y transporte';'Restaurantes';'VARIABLES'
05/02/2012;30/01/2012;'AUTOPISTA TERR';-1,31 €;12.459,19 €;2052;-1,31;16.983,28 €;'sin fechas';30/01/2012;'AUTOPISTA';'Gastos_Ocio y transporte';'Parking y peaje';'VARIABLES'
05/02/2012;05/02/2012;'CAFET.C T PRAT';-1,70 €;12.457,49 €;2053;-1,70;16.981,58 €;'sin fechas';05/02/2012;'CAFETC';'Gastos_Ocio y transporte';'Restaurantes';'VARIABLES'
06/02/2012;06/02/2012;'CAFET.C T PRAT';-4,10 €;12.453,39 €;2054;-4,10;16.977,48 €;'sin fechas';06/02/2012;'CAFETC';'Gastos_Ocio y transporte';'Restaurantes';'VARIABLES'
06/02/2012;06/02/2012;'ESCOLA BRESSOL EINA';-90,00 €;12.363,39 €;2055;-90,00;16.887,48 €;'sin fechas';06/02/2012;'ESCOLA';'Gastos_Salud, saber y deporte';'Estudios';'VARIABLES'
06/02/2012;06/02/2012;'GAS NATURAL';-10,27 €;12.353,12 €;2056;-10,27;16.877,21 €;'sin fechas';06/02/2012;'GAS';'Gastos_Servicios tipicos';'Gas';'FIJO'
06/02/2012;06/02/2012;'IBERDROLA GE IBERDRO1011516485';-242,74 €;12.110,38 €;2057;-242,74;16.634,47 €;'sin fechas';06/02/2012;'IBERDROLA';'Gastos_Servicios tipicos';'Electricidad';'FIJO'
06/02/2012;06/02/2012;'RESTAURANTES';-21,50 €;12.088,88 €;2058;-21,50;16.612,97 €;'sin fechas';06/02/2012;'RESTAURANTES';'Gastos_Ocio y transporte';'Restaurantes';'VARIABLES'
06/02/2012;06/02/2012;'TICKETS [ABONO]';350,00 €;12.438,88 €;2059;350,00;16.962,97 €;'sin fechas';06/02/2012;'TICKETS';'Gastos_Salud, saber y deporte';'Estudios';'VARIABLES'
06/02/2012;06/02/2012;'TICKETS [CARGO]';-350,00 €;12.088,88 €;2060;-350,00;16.612,97 €;'sin fechas';06/02/2012;'TICKETS';'Gastos_Salud, saber y deporte';'Estudios';'VARIABLES'
07/02/2012;07/02/2012;'BLITZ';-70,80 €;12.018,08 €;2061;-70,80;16.542,17 €;'sin fechas';07/02/2012;'BLITZ';'Gastos_Vivienda y vehiculo';'Alquiler Parking';'FIJO'
09/02/2012;09/02/2012;'CAFET.C T PRAT';-2,50 €;12.015,58 €;2062;-2,50;16.539,67 €;'sin fechas';09/02/2012;'CAFETC';'Gastos_Ocio y transporte';'Restaurantes';'VARIABLES'
09/02/2012;09/02/2012;'DIVAN RESTAURANT T';-10,60 €;12.004,98 €;2063;-10,60;16.529,07 €;'sin fechas';09/02/2012;'DIVAN';'Gastos_Ocio y transporte';'Restaurantes';'VARIABLES'
09/02/2012;09/02/2012;'ES STA. MARGARITA';-49,84 €;11.955,14 €;2064;-49,84;16.479,23 €;'sin fechas';09/02/2012;'STA';'Gastos_Ocio y transporte';'Gasolina';'VARIABLES'
09/02/2012;07/02/2012;'HOGAR&OTROS';-120,00 €;11.835,14 €;2065;-120,00;16.359,23 €;'sin fechas';07/02/2012;'HOGAROTROS';'Gastos_Vivienda y vehiculo';'Otros vivienda';'VARIABLES'
09/02/2012;07/02/2012;'JACK AND JONES';-49,95 €;11.785,19 €;2066;-49,95;16.309,28 €;'sin fechas';07/02/2012;'JACK';'Gastos_Compras';'Ropa';'VARIABLES'
09/02/2012;09/02/2012;'MERCADONA';-111,23 €;11.673,96 €;2067;-111,23;16.198,05 €;'sin fechas';09/02/2012;'MERCADONA';'Gastos_Compras';'Supermercado';'VARIABLES'
09/02/2012;07/02/2012;'STARBUCKS';-7,70 €;11.666,26 €;2068;-7,70;16.190,35 €;'sin fechas';07/02/2012;'STARBUCKS';'Gastos_Ocio y transporte';'Restaurantes';'VARIABLES'
10/02/2012;05/02/2012;'AUTOPISTA TERR';-1,31 €;11.664,95 €;2069;-1,31;16.189,04 €;'sin fechas';05/02/2012;'AUTOPISTA';'Gastos_Ocio y transporte';'Parking y peaje';'VARIABLES'
10/02/2012;10/02/2012;'CAFET.C T PRAT';-4,20 €;11.660,75 €;2070;-4,20;16.184,84 €;'sin fechas';10/02/2012;'CAFETC';'Gastos_Ocio y transporte';'Restaurantes';'VARIABLES'
11/02/2012;11/02/2012;'BON AREA';-11,12 €;11.649,63 €;2071;-11,12;16.173,72 €;'sin fechas';11/02/2012;'BON';'Gastos_Compras';'Supermercado';'VARIABLES'
13/02/2012;06/02/2012;'AUTOPISTA TERR';-1,31 €;11.648,32 €;2072;-1,31;16.172,41 €;'sin fechas';06/02/2012;'AUTOPISTA';'Gastos_Ocio y transporte';'Parking y peaje';'VARIABLES'
13/02/2012;13/02/2012;'BON AREA';-13,10 €;11.635,22 €;2073;-13,10;16.159,31 €;'sin fechas';13/02/2012;'BON';'Gastos_Compras';'Supermercado';'VARIABLES'
14/02/2012;14/02/2012;'REINT.CAJERO';-120,00 €;11.515,22 €;2074;-120,00;16.039,31 €;'sin fechas';14/02/2012;'REINTCAJERO';'Gastos_Gastos varios';'Efectivo';'VARIABLES'
15/02/2012;15/02/2012;'CCM VIDA Y PENSIO 000000493358';-19,06 €;11.496,16 €;2075;-19,06;16.020,25 €;'sin fechas';15/02/2012;'CCM';'Gastos_Seguros';'Seguro vida';'FIJO'
16/02/2012;09/02/2012;'AUTOPISTA TERR';-1,31 €;11.494,85 €;2076;-1,31;16.018,94 €;'sin fechas';09/02/2012;'AUTOPISTA';'Gastos_Ocio y transporte';'Parking y peaje';'VARIABLES'
16/02/2012;09/02/2012;'AUTOPISTA TERR';-1,31 €;11.493,54 €;2077;-1,31;16.017,63 €;'sin fechas';09/02/2012;'AUTOPISTA';'Gastos_Ocio y transporte';'Parking y peaje';'VARIABLES'
16/02/2012;14/02/2012;'CAPRABO';-24,98 €;11.468,56 €;2078;-24,98;15.992,65 €;'sin fechas';14/02/2012;'CAPRABO';'Gastos_Compras';'Supermercado';'VARIABLES'
16/02/2012;16/02/2012;'CCM VIDA Y P SEGURO PRESTAMO';-26,36 €;11.442,20 €;2079;-26,36;15.966,29 €;'sin fechas';16/02/2012;'CCM';'Gastos_Seguros';'Seguro vida';'FIJO'
16/02/2012;14/02/2012;'FARMACIA';-34,81 €;11.407,39 €;2080;-34,81;15.931,48 €;'sin fechas';14/02/2012;'FARMACIA';'Gastos_Salud, saber y deporte';'Farmacia';'VARIABLES'
16/02/2012;16/02/2012;'FARMACIA';-3,12 €;11.404,27 €;2081;-3,12;15.928,36 €;'sin fechas';16/02/2012;'FARMACIA';'Gastos_Salud, saber y deporte';'Farmacia';'VARIABLES'
16/02/2012;16/02/2012;'FARMACIA';-17,66 €;11.386,61 €;2082;-17,66;15.910,70 €;'sin fechas';16/02/2012;'FARMACIA';'Gastos_Salud, saber y deporte';'Farmacia';'VARIABLES'
16/02/2012;16/02/2012;'LLIBR.SANT JORDI';-9,75 €;11.376,86 €;2083;-9,75;15.900,95 €;'sin fechas';16/02/2012;'LLIBRSANT';'Gastos_Compras';'Libreria';'VARIABLES'
16/02/2012;16/02/2012;'MERCADONA';-25,72 €;11.351,14 €;2084;-25,72;15.875,23 €;'sin fechas';16/02/2012;'MERCADONA';'Gastos_Compras';'Supermercado';'VARIABLES'
16/02/2012;16/02/2012;'VIENA';-11,70 €;11.339,44 €;2085;-11,70;15.863,53 €;'sin fechas';16/02/2012;'VIENA';'Gastos_Ocio y transporte';'Restaurantes';'VARIABLES'
17/02/2012;17/02/2012;'AG.TRIBUT GABRIEL';100,00 €;11.439,44 €;2086;100,00;15.963,53 €;'sin fechas';17/02/2012;'AGTRIBUT';'Ingresos';'Subvenciones';
17/02/2012;17/02/2012;'ALCAMPO';-7,27 €;11.432,17 €;2087;-7,27;15.956,26 €;'sin fechas';17/02/2012;'ALCAMPO';'Gastos_Compras';'Supermercado';'VARIABLES'
17/02/2012;17/02/2012;'CAFET.C T PRAT';-4,10 €;11.428,07 €;2088;-4,10;15.952,16 €;'sin fechas';17/02/2012;'CAFETC';'Gastos_Ocio y transporte';'Restaurantes';'VARIABLES'
17/02/2012;17/02/2012;'ONO';-109,66 €;11.318,41 €;2089;-109,66;15.842,50 €;'sin fechas';17/02/2012;'ONO';'Gastos_Servicios tipicos';'Telecomunicaciones';'FIJO'
18/02/2012;18/02/2012;'CAFET.C T PRAT';-2,55 €;11.315,86 €;2090;-2,55;15.839,95 €;'sin fechas';18/02/2012;'CAFETC';'Gastos_Ocio y transporte';'Restaurantes';'VARIABLES'
19/02/2012;19/02/2012;'REINT.CAJERO';-28,00 €;11.287,86 €;2091;-28,00;15.811,95 €;'sin fechas';19/02/2012;'REINTCAJERO';'Gastos_Gastos varios';'Efectivo';'VARIABLES'
19/02/2012;19/02/2012;'RESTAURANTES';-59,18 €;11.228,68 €;2092;-59,18;15.752,77 €;'sin fechas';19/02/2012;'RESTAURANTES';'Gastos_Ocio y transporte';'Restaurantes';'VARIABLES'
20/02/2012;20/02/2012;'CAFET.C T PRAT';-4,20 €;11.224,48 €;2093;-4,20;15.748,57 €;'sin fechas';20/02/2012;'CAFETC';'Gastos_Ocio y transporte';'Restaurantes';'VARIABLES'
21/02/2012;21/02/2012;'ENDESA ENERG EE_XXI40025545678';-86,05 €;11.138,43 €;2094;-86,05;15.662,52 €;'sin fechas';21/02/2012;'ENDESA';'Gastos_Servicios tipicos';'Electricidad';'FIJO'
22/02/2012;22/02/2012;'RESTAURANTES';-11,60 €;11.126,83 €;2095;-11,60;15.650,92 €;'sin fechas';22/02/2012;'RESTAURANTES';'Gastos_Ocio y transporte';'Restaurantes';'VARIABLES'
23/02/2012;23/02/2012;'CAFET.C T PRAT';-4,20 €;11.122,63 €;2096;-4,20;15.646,72 €;'sin fechas';23/02/2012;'CAFETC';'Gastos_Ocio y transporte';'Restaurantes';'VARIABLES'
23/02/2012;21/02/2012;'CAPRABO';-31,70 €;11.090,93 €;2097;-31,70;15.615,02 €;'sin fechas';21/02/2012;'CAPRABO';'Gastos_Compras';'Supermercado';'VARIABLES'
23/02/2012;21/02/2012;'FARMACIA';-8,67 €;11.082,26 €;2098;-8,67;15.606,35 €;'sin fechas';21/02/2012;'FARMACIA';'Gastos_Salud, saber y deporte';'Farmacia';'VARIABLES'
24/02/2012;24/02/2012;'CAFET.C T PRAT';-2,40 €;11.079,86 €;2099;-2,40;15.603,95 €;'sin fechas';24/02/2012;'CAFETC';'Gastos_Ocio y transporte';'Restaurantes';'VARIABLES'
25/02/2012;25/02/2012;'CAFET.C T PRAT';-2,40 €;11.077,46 €;2100;-2,40;15.601,55 €;'sin fechas';25/02/2012;'CAFETC';'Gastos_Ocio y transporte';'Restaurantes';'VARIABLES'
25/02/2012;25/02/2012;'FARMACIA';-5,90 €;11.071,56 €;2101;-5,90;15.595,65 €;'sin fechas';25/02/2012;'FARMACIA';'Gastos_Salud, saber y deporte';'Farmacia';'VARIABLES'
25/02/2012;25/02/2012;'MERCADONA';-153,85 €;10.917,71 €;2102;-153,85;15.441,80 €;'sin fechas';25/02/2012;'MERCADONA';'Gastos_Compras';'Supermercado';'VARIABLES'
26/02/2012;26/02/2012;'BON AREA';-27,55 €;10.890,16 €;2103;-27,55;15.414,25 €;'sin fechas';26/02/2012;'BON';'Gastos_Compras';'Supermercado';'VARIABLES'
26/02/2012;26/02/2012;'FARMACIA';-3,25 €;10.886,91 €;2104;-3,25;15.411,00 €;'sin fechas';26/02/2012;'FARMACIA';'Gastos_Salud, saber y deporte';'Farmacia';'VARIABLES'
26/02/2012;26/02/2012;'FARMACIA';-44,85 €;10.842,06 €;2105;-44,85;15.366,15 €;'sin fechas';26/02/2012;'FARMACIA';'Gastos_Salud, saber y deporte';'Farmacia';'VARIABLES'
26/02/2012;26/02/2012;'RESTAURANTES';-18,00 €;10.824,06 €;2106;-18,00;15.348,15 €;'sin fechas';26/02/2012;'RESTAURANTES';'Gastos_Ocio y transporte';'Restaurantes';'VARIABLES'
27/02/2012;27/02/2012;'INFORMACIO I TECNOLOGIA DE CAT';1.676,98 €;12.501,04 €;2107;1.676,98;17.025,13 €;'sin fechas';27/02/2012;'INFORMACIO';'Ingresos';'Nomina';'FIJO'
27/02/2012;27/02/2012;'RESTAURANTES';-24,00 €;12.477,04 €;2108;-24,00;17.001,13 €;'sin fechas';27/02/2012;'RESTAURANTES';'Gastos_Ocio y transporte';'Restaurantes';'VARIABLES'
28/02/2012;28/02/2012;'COMISIONES';-9,00 €;12.468,04 €;2109;-9,00;16.992,13 €;'sin fechas';28/02/2012;'COMISIONES';'Gastos_Banco y organismos';'Cargos banco';'FIJO'
28/02/2012;28/02/2012;'FOMENT DE TERRASSA, S.A. FOMEN';1.571,23 €;14.039,27 €;2110;1.571,23;18.563,36 €;'sin fechas';28/02/2012;'FOMENT';'Ingresos';'Nomina';'FIJO'
28/02/2012;28/02/2012;'REINT.CAJERO';-30,00 €;14.009,27 €;2111;-30,00;18.533,36 €;'sin fechas';28/02/2012;'REINTCAJERO';'Gastos_Gastos varios';'Efectivo';'VARIABLES'
29/02/2012;29/02/2012;'COMUNIDAD';-20,00 €;13.989,27 €;2112;-20,00;18.513,36 €;'sin fechas';29/02/2012;'COMUNIDAD';'Gastos_Vivienda y vehiculo';'Comunidad';'FIJO'
29/02/2012;29/02/2012;'HOGAR&OTROS';-250,00 €;13.739,27 €;2113;-250,00;18.263,36 €;'sin fechas';29/02/2012;'HOGAROTROS';'Gastos_Vivienda y vehiculo';'Otros vivienda';'VARIABLES'
29/02/2012;29/02/2012;'LIMPIEZA';-150,00 €;13.589,27 €;2114;-150,00;18.113,36 €;'sin fechas';29/02/2012;'LIMPIEZA';'Gastos_Vivienda y vehiculo';'Serv. domestico';'FIJO'
29/02/2012;29/02/2012;'RECIBO PTMOS. 3061-0960001518';-583,25 €;13.006,02 €;2115;-583,25;17.530,11 €;'sin fechas';29/02/2012;'RECIBO';'Gastos_Banco y organismos';'Hipoteca';'FIJO'
01/03/2012;01/03/2012;'ADESLAS CENTRAL 006662671613';-73,00 €;12.933,02 €;2116;-73,00;17.457,11 €;'sin fechas';01/03/2012;'ADESLAS';'Gastos_Salud, saber y deporte';'Medico';'VARIABLES'
01/03/2012;01/03/2012;'AJUNTAMENT DE TER 010000520716';-42,95 €;12.890,07 €;2117;-42,95;17.414,16 €;'sin fechas';01/03/2012;'AJUNTAMENT';'Gastos_Banco y organismos';'Ayuntamiento';'FIJO'
01/03/2012;01/03/2012;'ES STA. MARGARITA';-47,06 €;12.843,01 €;2118;-47,06;17.367,10 €;'sin fechas';01/03/2012;'STA';'Gastos_Ocio y transporte';'Gasolina';'VARIABLES'
01/03/2012;01/03/2012;'GAS NATURAL';-10,27 €;12.832,74 €;2119;-10,27;17.356,83 €;'sin fechas';01/03/2012;'GAS';'Gastos_Servicios tipicos';'Gas';'FIJO'
01/03/2012;01/03/2012;'MANTENIMIENTO';-2,25 €;12.830,49 €;2120;-2,25;17.354,58 €;'sin fechas';01/03/2012;'MANTENIMIENTO';'Gastos_Banco y organismos';'Cargos banco';'FIJO'
01/03/2012;01/03/2012;'RESTAURANTES';-23,70 €;12.806,79 €;2121;-23,70;17.330,88 €;'sin fechas';01/03/2012;'RESTAURANTES';'Gastos_Ocio y transporte';'Restaurantes';'VARIABLES'
01/03/2012;01/03/2012;'VIENA';-4,95 €;12.801,84 €;2122;-4,95;17.325,93 €;'sin fechas';01/03/2012;'VIENA';'Gastos_Ocio y transporte';'Restaurantes';'VARIABLES'
02/03/2012;28/02/2012;'A* CUOTA TARJETA PRINCIPAL';-33,00 €;12.768,84 €;2123;-33,00;17.292,93 €;'sin fechas';28/02/2012;'CUOTA';'Gastos_Banco y organismos';'Cargos banco';'FIJO'
02/03/2012;12/02/2012;'AUTOPISTA TERR';-2,39 €;12.766,45 €;2124;-2,39;17.290,54 €;'sin fechas';12/02/2012;'AUTOPISTA';'Gastos_Ocio y transporte';'Parking y peaje';'VARIABLES'
02/03/2012;17/02/2012;'AUTOPISTA TERR';-1,31 €;12.765,14 €;2125;-1,31;17.289,23 €;'sin fechas';17/02/2012;'AUTOPISTA';'Gastos_Ocio y transporte';'Parking y peaje';'VARIABLES'
02/03/2012;20/02/2012;'AUTOPISTA TERR';-1,31 €;12.763,83 €;2126;-1,31;17.287,92 €;'sin fechas';20/02/2012;'AUTOPISTA';'Gastos_Ocio y transporte';'Parking y peaje';'VARIABLES'
02/03/2012;21/02/2012;'AUTOPISTA TERR';-1,31 €;12.762,52 €;2127;-1,31;17.286,61 €;'sin fechas';21/02/2012;'AUTOPISTA';'Gastos_Ocio y transporte';'Parking y peaje';'VARIABLES'
02/03/2012;21/02/2012;'AUTOPISTA TERR';-1,31 €;12.761,21 €;2128;-1,31;17.285,30 €;'sin fechas';21/02/2012;'AUTOPISTA';'Gastos_Ocio y transporte';'Parking y peaje';'VARIABLES'
02/03/2012;22/02/2012;'AUTOPISTA TERR';-1,31 €;12.759,90 €;2129;-1,31;17.283,99 €;'sin fechas';22/02/2012;'AUTOPISTA';'Gastos_Ocio y transporte';'Parking y peaje';'VARIABLES'
02/03/2012;02/03/2012;'CAFET.C T PRAT';-3,20 €;12.756,70 €;2130;-3,20;17.280,79 €;'sin fechas';02/03/2012;'CAFETC';'Gastos_Ocio y transporte';'Restaurantes';'VARIABLES'
02/03/2012;11/02/2012;'SONY ENT NETWORK';-49,99 €;12.706,71 €;2131;-49,99;17.230,80 €;'sin fechas';11/02/2012;'SONY';'Gastos_Servicios tipicos';'Servicios online';'FIJO'
03/03/2012;03/03/2012;'CAFET.C T PRAT';-2,75 €;12.703,96 €;2132;-2,75;17.228,05 €;'sin fechas';03/03/2012;'CAFETC';'Gastos_Ocio y transporte';'Restaurantes';'VARIABLES'
03/03/2012;05/03/2012;'COM. MANT. ACTIVAS DE LIQ.';-4,50 €;12.699,46 €;2133;-4,50;17.223,55 €;'sin fechas';05/03/2012;'COM';'Gastos_Banco y organismos';'Cargos banco';'FIJO'
04/03/2012;04/03/2012;'ALCAMPO';-18,03 €;12.681,43 €;2134;-18,03;17.205,52 €;'sin fechas';04/03/2012;'ALCAMPO';'Gastos_Compras';'Supermercado';'VARIABLES'
04/03/2012;04/03/2012;'CAFET.C T PRAT';-4,00 €;12.677,43 €;2135;-4,00;17.201,52 €;'sin fechas';04/03/2012;'CAFETC';'Gastos_Ocio y transporte';'Restaurantes';'VARIABLES'
05/03/2012;05/03/2012;'CAFET.C T PRAT';-2,15 €;12.675,28 €;2136;-2,15;17.199,37 €;'sin fechas';05/03/2012;'CAFETC';'Gastos_Ocio y transporte';'Restaurantes';'VARIABLES'
05/03/2012;05/03/2012;'MERCADONA';-0,99 €;12.674,29 €;2137;-0,99;17.198,38 €;'sin fechas';05/03/2012;'MERCADONA';'Gastos_Compras';'Supermercado';'VARIABLES'
05/03/2012;05/03/2012;'TOYOTA ORIENT CARS';-206,51 €;12.467,78 €;2138;-206,51;16.991,87 €;'sin fechas';05/03/2012;'TOYOTA';'Gastos_Vivienda y vehiculo';'Mnto. vehiculo';'VARIABLE'
05/03/2012;05/03/2012;'XFERA MOVILES SA 2767906';-49,51 €;12.418,27 €;2139;-49,51;16.942,36 €;'sin fechas';05/03/2012;'XFERA';'Gastos_Servicios tipicos';'Telecomunicaciones';'FIJO'
06/03/2012;01/03/2012;'AUTOPISTA TERR';-1,31 €;12.416,96 €;2140;-1,31;16.941,05 €;'sin fechas';01/03/2012;'AUTOPISTA';'Gastos_Ocio y transporte';'Parking y peaje';'VARIABLES'
06/03/2012;06/03/2012;'BLITZ';-70,80 €;12.346,16 €;2141;-70,80;16.870,25 €;'sin fechas';06/03/2012;'BLITZ';'Gastos_Vivienda y vehiculo';'Alquiler Parking';'FIJO'
06/03/2012;06/03/2012;'ESCOLA BRESSOL EINA';-182,80 €;12.163,36 €;2142;-182,80;16.687,45 €;'sin fechas';06/03/2012;'ESCOLA';'Gastos_Salud, saber y deporte';'Estudios';'VARIABLES'
06/03/2012;06/03/2012;'TICKETS [ABONO]';236,00 €;12.399,36 €;2143;236,00;16.923,45 €;'sin fechas';06/03/2012;'TICKETS';'Gastos_Salud, saber y deporte';'Estudios';'VARIABLES'
06/03/2012;06/03/2012;'TICKETS [CARGO]';-236,00 €;12.163,36 €;2144;-236,00;16.687,45 €;'sin fechas';06/03/2012;'TICKETS';'Gastos_Salud, saber y deporte';'Estudios';'VARIABLES'
08/03/2012;08/03/2012;'CAFET.C T PRAT';-3,65 €;12.159,71 €;2145;-3,65;16.683,80 €;'sin fechas';08/03/2012;'CAFETC';'Gastos_Ocio y transporte';'Restaurantes';'VARIABLES'
08/03/2012;08/03/2012;'DIVAN RESTAURANT T';-12,30 €;12.147,41 €;2146;-12,30;16.671,50 €;'sin fechas';08/03/2012;'DIVAN';'Gastos_Ocio y transporte';'Restaurantes';'VARIABLES'
08/03/2012;08/03/2012;'MERCADONA';-51,82 €;12.095,59 €;2147;-51,82;16.619,68 €;'sin fechas';08/03/2012;'MERCADONA';'Gastos_Compras';'Supermercado';'VARIABLES'
08/03/2012;06/03/2012;'RESTAURANTES';-8,30 €;12.087,29 €;2148;-8,30;16.611,38 €;'sin fechas';06/03/2012;'RESTAURANTES';'Gastos_Ocio y transporte';'Restaurantes';'VARIABLES'
08/03/2012;07/03/2012;'VIENA';-12,10 €;12.075,19 €;2149;-12,10;16.599,28 €;'sin fechas';07/03/2012;'VIENA';'Gastos_Ocio y transporte';'Restaurantes';'VARIABLES'
09/03/2012;04/03/2012;'AUTOPISTA TERR';-2,39 €;12.072,80 €;2150;-2,39;16.596,89 €;'sin fechas';04/03/2012;'AUTOPISTA';'Gastos_Ocio y transporte';'Parking y peaje';'VARIABLES'
09/03/2012;09/03/2012;'CAFET.C T PRAT';-4,10 €;12.068,70 €;2151;-4,10;16.592,79 €;'sin fechas';09/03/2012;'CAFETC';'Gastos_Ocio y transporte';'Restaurantes';'VARIABLES'
09/03/2012;09/03/2012;'REINT.CAJERO';-100,00 €;11.968,70 €;2152;-100,00;16.492,79 €;'sin fechas';09/03/2012;'REINTCAJERO';'Gastos_Gastos varios';'Efectivo';'VARIABLES'
10/03/2012;10/03/2012;'BON AREA';-15,18 €;11.953,52 €;2153;-15,18;16.477,61 €;'sin fechas';10/03/2012;'BON';'Gastos_Compras';'Supermercado';'VARIABLES'
10/03/2012;10/03/2012;'CAFET.C T PRAT';-3,20 €;11.950,32 €;2154;-3,20;16.474,41 €;'sin fechas';10/03/2012;'CAFETC';'Gastos_Ocio y transporte';'Restaurantes';'VARIABLES'
11/03/2012;11/03/2012;'BON AREA';-29,32 €;11.921,00 €;2155;-29,32;16.445,09 €;'sin fechas';11/03/2012;'BON';'Gastos_Compras';'Supermercado';'VARIABLES'
11/03/2012;11/03/2012;'CAFET.C T PRAT';-3,95 €;11.917,05 €;2156;-3,95;16.441,14 €;'sin fechas';11/03/2012;'CAFETC';'Gastos_Ocio y transporte';'Restaurantes';'VARIABLES'
11/03/2012;11/03/2012;'FARMACIA';-1,56 €;11.915,49 €;2157;-1,56;16.439,58 €;'sin fechas';11/03/2012;'FARMACIA';'Gastos_Salud, saber y deporte';'Farmacia';'VARIABLES'
11/03/2012;11/03/2012;'GASOLINERA';-10,00 €;11.905,49 €;2158;-10,00;16.429,58 €;'sin fechas';11/03/2012;'GASOLINERA';'Gastos_Ocio y transporte';'Gasolina';'VARIABLES'
11/03/2012;11/03/2012;'RODELAS PERRUQUERS';-23,50 €;11.881,99 €;2159;-23,50;16.406,08 €;'sin fechas';11/03/2012;'RODELAS';'Gastos_Salud, saber y deporte';'Belleza';'VARIABLES'
12/03/2012;12/03/2012;'CAFET.C T PRAT';-3,90 €;11.878,09 €;2160;-3,90;16.402,18 €;'sin fechas';12/03/2012;'CAFETC';'Gastos_Ocio y transporte';'Restaurantes';'VARIABLES'
12/03/2012;12/03/2012;'TRANSPORTS MUNICIP';-17,00 €;11.861,09 €;2161;-17,00;16.385,18 €;'sin fechas';12/03/2012;'TRANSPORTS';'Gastos_Ocio y transporte';'Transporte';'VARIABLES'
12/03/2012;12/03/2012;'VIENA';-2,05 €;11.859,04 €;2162;-2,05;16.383,13 €;'sin fechas';12/03/2012;'VIENA';'Gastos_Ocio y transporte';'Restaurantes';'VARIABLES'
12/03/2012;12/03/2012;'VIENA';-17,60 €;11.841,44 €;2163;-17,60;16.365,53 €;'sin fechas';12/03/2012;'VIENA';'Gastos_Ocio y transporte';'Restaurantes';'VARIABLES'
14/03/2012;14/03/2012;'ENDESA ENERG EE_XXI40025545678';-51,93 €;11.789,51 €;2164;-51,93;16.313,60 €;'sin fechas';14/03/2012;'ENDESA';'Gastos_Servicios tipicos';'Electricidad';'FIJO'
15/03/2012;15/03/2012;'CAFET.C T PRAT';-3,20 €;11.786,31 €;2165;-3,20;16.310,40 €;'sin fechas';15/03/2012;'CAFETC';'Gastos_Ocio y transporte';'Restaurantes';'VARIABLES'
15/03/2012;15/03/2012;'CCM VIDA Y P SEGURO PRESTAMO';-26,29 €;11.760,02 €;2166;-26,29;16.284,11 €;'sin fechas';15/03/2012;'CCM';'Gastos_Seguros';'Seguro vida';'FIJO'
15/03/2012;15/03/2012;'CCM VIDA Y PENSIO 000000493358';-19,02 €;11.741,00 €;2167;-19,02;16.265,09 €;'sin fechas';15/03/2012;'CCM';'Gastos_Seguros';'Seguro vida';'FIJO'
15/03/2012;13/03/2012;'ES STA. MARGARITA';-51,97 €;11.689,03 €;2168;-51,97;16.213,12 €;'sin fechas';13/03/2012;'STA';'Gastos_Ocio y transporte';'Gasolina';'VARIABLES'
15/03/2012;13/03/2012;'GAME';-49,95 €;11.639,08 €;2169;-49,95;16.163,17 €;'sin fechas';13/03/2012;'GAME';'Gastos_Compras';'Hobbys';'VARIABLES'
15/03/2012;13/03/2012;'H&M';-53,75 €;11.585,33 €;2170;-53,75;16.109,42 €;'sin fechas';13/03/2012;'HM';'Gastos_Compras';'Ropa';'VARIABLES'
15/03/2012;13/03/2012;'HOGAR&OTROS';-24,85 €;11.560,48 €;2171;-24,85;16.084,57 €;'sin fechas';13/03/2012;'HOGAROTROS';'Gastos_Vivienda y vehiculo';'Otros vivienda';'VARIABLES'
15/03/2012;13/03/2012;'STARBUCKS';-6,80 €;11.553,68 €;2172;-6,80;16.077,77 €;'sin fechas';13/03/2012;'STARBUCKS';'Gastos_Ocio y transporte';'Restaurantes';'VARIABLES'
16/03/2012;16/03/2012;'AG.TRIBUT GABRIEL';100,00 €;11.653,68 €;2173;100,00;16.177,77 €;'sin fechas';16/03/2012;'AGTRIBUT';'Ingresos';'Subvenciones';
16/03/2012;16/03/2012;'CAFET.C T PRAT';-3,45 €;11.650,23 €;2174;-3,45;16.174,32 €;'sin fechas';16/03/2012;'CAFETC';'Gastos_Ocio y transporte';'Restaurantes';'VARIABLES'
16/03/2012;16/03/2012;'TOCINERIES VENTURA';-20,13 €;11.630,10 €;2175;-20,13;16.154,19 €;'sin fechas';16/03/2012;'TOCINERIES';'Gastos_Compras';'Supermercado';'VARIABLES'
17/03/2012;17/03/2012;'CAFET.C T PRAT';-3,45 €;11.626,65 €;2176;-3,45;16.150,74 €;'sin fechas';17/03/2012;'CAFETC';'Gastos_Ocio y transporte';'Restaurantes';'VARIABLES'
18/03/2012;18/03/2012;'CAFET.C T PRAT';-2,45 €;11.624,20 €;2177;-2,45;16.148,29 €;'sin fechas';18/03/2012;'CAFETC';'Gastos_Ocio y transporte';'Restaurantes';'VARIABLES'
19/03/2012;19/03/2012;'CAFET.C T PRAT';-3,45 €;11.620,75 €;2178;-3,45;16.144,84 €;'sin fechas';19/03/2012;'CAFETC';'Gastos_Ocio y transporte';'Restaurantes';'VARIABLES'
19/03/2012;19/03/2012;'MERCADONA';-149,26 €;11.471,49 €;2179;-149,26;15.995,58 €;'sin fechas';19/03/2012;'MERCADONA';'Gastos_Compras';'Supermercado';'VARIABLES'
19/03/2012;19/03/2012;'MERCADONA';-0,90 €;11.470,59 €;2180;-0,90;15.994,68 €;'sin fechas';19/03/2012;'MERCADONA';'Gastos_Compras';'Supermercado';'VARIABLES'
20/03/2012;20/03/2012;'ONO';-163,17 €;11.307,42 €;2181;-163,17;15.831,51 €;'sin fechas';20/03/2012;'ONO';'Gastos_Servicios tipicos';'Telecomunicaciones';'FIJO'
21/03/2012;21/03/2012;'MINA PUBLICA AIGUES T.01A75789';-36,11 €;11.271,31 €;2182;-36,11;15.795,40 €;'sin fechas';21/03/2012;'MINA';'Gastos_Servicios tipicos';'Agua';'FIJO'
22/03/2012;21/03/2012;'LA CARBASSA DEL PA';-53,95 €;11.217,36 €;2183;-53,95;15.741,45 €;'sin fechas';21/03/2012;'CARBASSA';'Gastos_Ocio y transporte';'Restaurantes';'VARIABLES'
22/03/2012;20/03/2012;'MERCADONA';-3,23 €;11.214,13 €;2184;-3,23;15.738,22 €;'sin fechas';20/03/2012;'MERCADONA';'Gastos_Compras';'Supermercado';'VARIABLES'
22/03/2012;20/03/2012;'VIENA';-17,55 €;11.196,58 €;2185;-17,55;15.720,67 €;'sin fechas';20/03/2012;'VIENA';'Gastos_Ocio y transporte';'Restaurantes';'VARIABLES'
23/03/2012;23/03/2012;'ES STA. MARGARITA';-14,00 €;11.182,58 €;2186;-14,00;15.706,67 €;'sin fechas';23/03/2012;'STA';'Gastos_Ocio y transporte';'Gasolina';'VARIABLES'
24/03/2012;24/03/2012;'CAFET.C T PRAT';-1,70 €;11.180,88 €;2187;-1,70;15.704,97 €;'sin fechas';24/03/2012;'CAFETC';'Gastos_Ocio y transporte';'Restaurantes';'VARIABLES'
24/03/2012;24/03/2012;'FARMACIA';-32,03 €;11.148,85 €;2188;-32,03;15.672,94 €;'sin fechas';24/03/2012;'FARMACIA';'Gastos_Salud, saber y deporte';'Farmacia';'VARIABLES'
25/03/2012;25/03/2012;'CAFET.C T PRAT';-3,75 €;11.145,10 €;2189;-3,75;15.669,19 €;'sin fechas';25/03/2012;'CAFETC';'Gastos_Ocio y transporte';'Restaurantes';'VARIABLES'
25/03/2012;25/03/2012;'LA BRASA';-23,40 €;11.121,70 €;2190;-23,40;15.645,79 €;'sin fechas';25/03/2012;'BRASA';'Gastos_Ocio y transporte';'Restaurantes';'VARIABLES'
25/03/2012;25/03/2012;'LA BRASA';-23,40 €;11.098,30 €;2191;-23,40;15.622,39 €;'sin fechas';25/03/2012;'BRASA';'Gastos_Ocio y transporte';'Restaurantes';'VARIABLES'
25/03/2012;25/03/2012;'LA BRASA';-23,40 €;11.074,90 €;2192;-23,40;15.598,99 €;'sin fechas';25/03/2012;'BRASA';'Gastos_Ocio y transporte';'Restaurantes';'VARIABLES'
25/03/2012;25/03/2012;'VIENA';-14,50 €;11.060,40 €;2193;-14,50;15.584,49 €;'sin fechas';25/03/2012;'VIENA';'Gastos_Ocio y transporte';'Restaurantes';'VARIABLES'
26/03/2012;26/03/2012;'CAFET.C T PRAT';-4,20 €;11.056,20 €;2194;-4,20;15.580,29 €;'sin fechas';26/03/2012;'CAFETC';'Gastos_Ocio y transporte';'Restaurantes';'VARIABLES'
26/03/2012;26/03/2012;'ES STA. MARGARITA';-55,01 €;11.001,19 €;2195;-55,01;15.525,28 €;'sin fechas';26/03/2012;'STA';'Gastos_Ocio y transporte';'Gasolina';'VARIABLES'
27/03/2012;27/03/2012;'FOMENT DE TERRASSA, S.A. FOMEN';1.566,17 €;12.567,36 €;2196;1.566,17;17.091,45 €;'sin fechas';27/03/2012;'FOMENT';'Ingresos';'Nomina';'FIJO'
27/03/2012;27/03/2012;'REINT.CAJERO';-80,00 €;12.487,36 €;2197;-80,00;17.011,45 €;'sin fechas';27/03/2012;'REINTCAJERO';'Gastos_Gastos varios';'Efectivo';'VARIABLES'
28/03/2012;28/03/2012;'INFORMACIO I TECNOLOGIA DE CAT';1.456,13 €;13.943,49 €;2198;1.456,13;18.467,58 €;'sin fechas';28/03/2012;'INFORMACIO';'Ingresos';'Nomina';'FIJO'
29/03/2012;27/03/2012;'ALCAMPO';-5,99 €;13.937,50 €;2199;-5,99;18.461,59 €;'sin fechas';27/03/2012;'ALCAMPO';'Gastos_Compras';'Supermercado';'VARIABLES'
29/03/2012;28/03/2012;'AMC PARC VALLES';-11,60 €;13.925,90 €;2200;-11,60;18.449,99 €;'sin fechas';28/03/2012;'AMC';'Gastos_Ocio y transporte';'Espectáculos';'VARIABLES'
29/03/2012;29/03/2012;'C&A';-20,00 €;13.905,90 €;2201;-20,00;18.429,99 €;'sin fechas';29/03/2012;'CA';'Gastos_Compras';'Ropa';'VARIABLES'
29/03/2012;29/03/2012;'CAFET.C T PRAT';-3,85 €;13.902,05 €;2202;-3,85;18.426,14 €;'sin fechas';29/03/2012;'CAFETC';'Gastos_Ocio y transporte';'Restaurantes';'VARIABLES'
29/03/2012;29/03/2012;'MERCADONA';-12,34 €;13.889,71 €;2203;-12,34;18.413,80 €;'sin fechas';29/03/2012;'MERCADONA';'Gastos_Compras';'Supermercado';'VARIABLES'
29/03/2012;29/03/2012;'PRIMARK';-9,00 €;13.880,71 €;2204;-9,00;18.404,80 €;'sin fechas';29/03/2012;'PRIMARK';'Gastos_Compras';'Ropa';'VARIABLES'
29/03/2012;27/03/2012;'TOYS R US IBER';-24,99 €;13.855,72 €;2205;-24,99;18.379,81 €;'sin fechas';27/03/2012;'TOYS';'Gastos_Compras';'Niños';'VARIABLES'
29/03/2012;27/03/2012;'VIENA';-14,45 €;13.841,27 €;2206;-14,45;18.365,36 €;'sin fechas';27/03/2012;'VIENA';'Gastos_Ocio y transporte';'Restaurantes';'VARIABLES'
30/03/2012;26/03/2012;'AUTOPISTA TERR';-1,31 €;13.839,96 €;2207;-1,31;18.364,05 €;'sin fechas';26/03/2012;'AUTOPISTA';'Gastos_Ocio y transporte';'Parking y peaje';'VARIABLES'
30/03/2012;26/03/2012;'AUTOPISTA TERR';-1,31 €;13.838,65 €;2208;-1,31;18.362,74 €;'sin fechas';26/03/2012;'AUTOPISTA';'Gastos_Ocio y transporte';'Parking y peaje';'VARIABLES'
30/03/2012;30/03/2012;'CAFET.C T PRAT';-3,85 €;13.834,80 €;2209;-3,85;18.358,89 €;'sin fechas';30/03/2012;'CAFETC';'Gastos_Ocio y transporte';'Restaurantes';'VARIABLES'
31/03/2012;31/03/2012;'BON AREA';-35,36 €;13.799,44 €;2210;-35,36;18.323,53 €;'sin fechas';31/03/2012;'BON';'Gastos_Compras';'Supermercado';'VARIABLES'
31/03/2012;31/03/2012;'CAFET.C T PRAT';-3,30 €;13.796,14 €;2211;-3,30;18.320,23 €;'sin fechas';31/03/2012;'CAFETC';'Gastos_Ocio y transporte';'Restaurantes';'VARIABLES'
31/03/2012;31/03/2012;'COMUNIDAD';-20,00 €;13.776,14 €;2212;-20,00;18.300,23 €;'sin fechas';31/03/2012;'COMUNIDAD';'Gastos_Vivienda y vehiculo';'Comunidad';'FIJO'
31/03/2012;31/03/2012;'DECATHLON';-15,90 €;13.760,24 €;2213;-15,90;18.284,33 €;'sin fechas';31/03/2012;'DECATHLON';'Gastos_Compras';'Deportivo';'VARIABLES'
31/03/2012;31/03/2012;'KIDDY\''S CLASS';-5,95 €;13.754,29 €;2214;-5,95;18.278,38 €;'sin fechas';31/03/2012;'KIDDYS';'Gastos_Compras';'Ropa';'VARIABLES'
31/03/2012;31/03/2012;'LIMPIEZA';-120,00 €;13.634,29 €;2215;-120,00;18.158,38 €;'sin fechas';31/03/2012;'LIMPIEZA';'Gastos_Vivienda y vehiculo';'Serv. domestico';'FIJO'
31/03/2012;31/03/2012;'RECIBO PTMOS. 3061-0960001518';-583,25 €;13.051,04 €;2216;-583,25;17.575,13 €;'sin fechas';31/03/2012;'RECIBO';'Gastos_Banco y organismos';'Hipoteca';'FIJO'
31/03/2012;31/03/2012;'TOYS R US IBER';-4,99 €;13.046,05 €;2217;-4,99;17.570,14 €;'sin fechas';31/03/2012;'TOYS';'Gastos_Compras';'Niños';'VARIABLES'
01/04/2012;01/04/2012;'CAFET.C T PRAT';-4,30 €;13.041,75 €;2218;-4,30;17.565,84 €;'sin fechas';01/04/2012;'CAFETC';'Gastos_Ocio y transporte';'Restaurantes';'VARIABLES'
01/04/2012;27/03/2012;'COCHE&PARKING';-6,25 €;13.035,50 €;2219;-6,25;17.559,59 €;'sin fechas';27/03/2012;'COCHEPARKING';'Gastos_Ocio y transporte';'Parking y peaje';'VARIABLES'
01/04/2012;01/04/2012;'MANTENIMIENTO';-2,25 €;13.033,25 €;2220;-2,25;17.557,34 €;'sin fechas';01/04/2012;'MANTENIMIENTO';'Gastos_Banco y organismos';'Cargos banco';'FIJO'
01/04/2012;01/04/2012;'REINT.CAJERO';-22,00 €;13.011,25 €;2221;-22,00;17.535,34 €;'sin fechas';01/04/2012;'REINTCAJERO';'Gastos_Gastos varios';'Efectivo';'VARIABLES'
02/04/2012;02/04/2012;'ADESLAS CENTRAL 006662671613';-73,00 €;12.938,25 €;2222;-73,00;17.462,34 €;'sin fechas';02/04/2012;'ADESLAS';'Gastos_Salud, saber y deporte';'Medico';'VARIABLES'
02/04/2012;02/04/2012;'AJUNTAMENT DE TER PAAAAAAPNVWE';-42,95 €;12.895,30 €;2223;-42,95;17.419,39 €;'sin fechas';02/04/2012;'AJUNTAMENT';'Gastos_Banco y organismos';'Ayuntamiento';'FIJO'
02/04/2012;28/02/2012;'AUTOPISTA TERR';-1,24 €;12.894,06 €;2224;-1,24;17.418,15 €;'sin fechas';28/02/2012;'AUTOPISTA';'Gastos_Ocio y transporte';'Parking y peaje';'VARIABLES'
02/04/2012;01/03/2012;'AUTOPISTA TERR';-1,31 €;12.892,75 €;2225;-1,31;17.416,84 €;'sin fechas';01/03/2012;'AUTOPISTA';'Gastos_Ocio y transporte';'Parking y peaje';'VARIABLES'
02/04/2012;01/03/2012;'AUTOPISTA TERR';-1,31 €;12.891,44 €;2226;-1,31;17.415,53 €;'sin fechas';01/03/2012;'AUTOPISTA';'Gastos_Ocio y transporte';'Parking y peaje';'VARIABLES'
02/04/2012;02/03/2012;'AUTOPISTA TERR';-1,31 €;12.890,13 €;2227;-1,31;17.414,22 €;'sin fechas';02/03/2012;'AUTOPISTA';'Gastos_Ocio y transporte';'Parking y peaje';'VARIABLES'
02/04/2012;05/03/2012;'AUTOPISTA TERR';-1,31 €;12.888,82 €;2228;-1,31;17.412,91 €;'sin fechas';05/03/2012;'AUTOPISTA';'Gastos_Ocio y transporte';'Parking y peaje';'VARIABLES'
02/04/2012;06/03/2012;'AUTOPISTA TERR';-1,31 €;12.887,51 €;2229;-1,31;17.411,60 €;'sin fechas';06/03/2012;'AUTOPISTA';'Gastos_Ocio y transporte';'Parking y peaje';'VARIABLES'
02/04/2012;07/03/2012;'AUTOPISTA TERR';-1,24 €;12.886,27 €;2230;-1,24;17.410,36 €;'sin fechas';07/03/2012;'AUTOPISTA';'Gastos_Ocio y transporte';'Parking y peaje';'VARIABLES'
02/04/2012;07/03/2012;'AUTOPISTA TERR';-1,31 €;12.884,96 €;2231;-1,31;17.409,05 €;'sin fechas';07/03/2012;'AUTOPISTA';'Gastos_Ocio y transporte';'Parking y peaje';'VARIABLES'
02/04/2012;08/03/2012;'AUTOPISTA TERR';-1,24 €;12.883,72 €;2232;-1,24;17.407,81 €;'sin fechas';08/03/2012;'AUTOPISTA';'Gastos_Ocio y transporte';'Parking y peaje';'VARIABLES'
02/04/2012;08/03/2012;'AUTOPISTA TERR';-1,24 €;12.882,48 €;2233;-1,24;17.406,57 €;'sin fechas';08/03/2012;'AUTOPISTA';'Gastos_Ocio y transporte';'Parking y peaje';'VARIABLES'
02/04/2012;09/03/2012;'AUTOPISTA TERR';-1,24 €;12.881,24 €;2234;-1,24;17.405,33 €;'sin fechas';09/03/2012;'AUTOPISTA';'Gastos_Ocio y transporte';'Parking y peaje';'VARIABLES'
02/04/2012;11/03/2012;'AUTOPISTA TERR';-2,39 €;12.878,85 €;2235;-2,39;17.402,94 €;'sin fechas';11/03/2012;'AUTOPISTA';'Gastos_Ocio y transporte';'Parking y peaje';'VARIABLES'
02/04/2012;11/03/2012;'AUTOPISTA TERR';-2,39 €;12.876,46 €;2236;-2,39;17.400,55 €;'sin fechas';11/03/2012;'AUTOPISTA';'Gastos_Ocio y transporte';'Parking y peaje';'VARIABLES'
02/04/2012;12/03/2012;'AUTOPISTA TERR';-1,24 €;12.875,22 €;2237;-1,24;17.399,31 €;'sin fechas';12/03/2012;'AUTOPISTA';'Gastos_Ocio y transporte';'Parking y peaje';'VARIABLES'
02/04/2012;13/03/2012;'AUTOPISTA TERR';-1,18 €;12.874,04 €;2238;-1,18;17.398,13 €;'sin fechas';13/03/2012;'AUTOPISTA';'Gastos_Ocio y transporte';'Parking y peaje';'VARIABLES'
02/04/2012;13/03/2012;'AUTOPISTA TERR';-1,31 €;12.872,73 €;2239;-1,31;17.396,82 €;'sin fechas';13/03/2012;'AUTOPISTA';'Gastos_Ocio y transporte';'Parking y peaje';'VARIABLES'
02/04/2012;16/03/2012;'AUTOPISTA TERR';-1,18 €;12.871,55 €;2240;-1,18;17.395,64 €;'sin fechas';16/03/2012;'AUTOPISTA';'Gastos_Ocio y transporte';'Parking y peaje';'VARIABLES'
02/04/2012;16/03/2012;'AUTOPISTA TERR';-1,18 €;12.870,37 €;2241;-1,18;17.394,46 €;'sin fechas';16/03/2012;'AUTOPISTA';'Gastos_Ocio y transporte';'Parking y peaje';'VARIABLES'
02/04/2012;19/03/2012;'AUTOPISTA TERR';-1,18 €;12.869,19 €;2242;-1,18;17.393,28 €;'sin fechas';19/03/2012;'AUTOPISTA';'Gastos_Ocio y transporte';'Parking y peaje';'VARIABLES'
02/04/2012;19/03/2012;'AUTOPISTA TERR';-1,31 €;12.867,88 €;2243;-1,31;17.391,97 €;'sin fechas';19/03/2012;'AUTOPISTA';'Gastos_Ocio y transporte';'Parking y peaje';'VARIABLES'
02/04/2012;20/03/2012;'AUTOPISTA TERR';-1,18 €;12.866,70 €;2244;-1,18;17.390,79 €;'sin fechas';20/03/2012;'AUTOPISTA';'Gastos_Ocio y transporte';'Parking y peaje';'VARIABLES'
02/04/2012;20/03/2012;'AUTOPISTA TERR';-1,18 €;12.865,52 €;2245;-1,18;17.389,61 €;'sin fechas';20/03/2012;'AUTOPISTA';'Gastos_Ocio y transporte';'Parking y peaje';'VARIABLES'
02/04/2012;22/03/2012;'AUTOPISTA TERR';-1,18 €;12.864,34 €;2246;-1,18;17.388,43 €;'sin fechas';22/03/2012;'AUTOPISTA';'Gastos_Ocio y transporte';'Parking y peaje';'VARIABLES'
02/04/2012;23/03/2012;'AUTOPISTA TERR';-1,18 €;12.863,16 €;2247;-1,18;17.387,25 €;'sin fechas';23/03/2012;'AUTOPISTA';'Gastos_Ocio y transporte';'Parking y peaje';'VARIABLES'
02/04/2012;23/03/2012;'AUTOPISTA TERR';-1,18 €;12.861,98 €;2248;-1,18;17.386,07 €;'sin fechas';23/03/2012;'AUTOPISTA';'Gastos_Ocio y transporte';'Parking y peaje';'VARIABLES'
02/04/2012;26/03/2012;'AUTOPISTA TERR';-1,18 €;12.860,80 €;2249;-1,18;17.384,89 €;'sin fechas';26/03/2012;'AUTOPISTA';'Gastos_Ocio y transporte';'Parking y peaje';'VARIABLES'
02/04/2012;26/03/2012;'AUTOPISTA TERR';-1,31 €;12.859,49 €;2250;-1,31;17.383,58 €;'sin fechas';26/03/2012;'AUTOPISTA';'Gastos_Ocio y transporte';'Parking y peaje';'VARIABLES'
02/04/2012;27/03/2012;'AUTOPISTA TERR';-1,05 €;12.858,44 €;2251;-1,05;17.382,53 €;'sin fechas';27/03/2012;'AUTOPISTA';'Gastos_Ocio y transporte';'Parking y peaje';'VARIABLES'
02/04/2012;02/04/2012;'CAFET.C T PRAT';-3,40 €;12.855,04 €;2252;-3,40;17.379,13 €;'sin fechas';02/04/2012;'CAFETC';'Gastos_Ocio y transporte';'Restaurantes';'VARIABLES'
02/04/2012;09/03/2012;'SATSA PL. VELLA TERRASSA';-4,25 €;12.850,79 €;2253;-4,25;17.374,88 €;'sin fechas';09/03/2012;'SATSA';'Gastos_Ocio y transporte';'Parking y peaje';'VARIABLES'
02/04/2012;22/03/2012;'SATSA PL. VELLA TERRASSA';-2,30 €;12.848,49 €;2254;-2,30;17.372,58 €;'sin fechas';22/03/2012;'SATSA';'Gastos_Ocio y transporte';'Parking y peaje';'VARIABLES'
03/04/2012;29/03/2012;'AUTOPISTA TERR';-1,31 €;12.847,18 €;2255;-1,31;17.371,27 €;'sin fechas';29/03/2012;'AUTOPISTA';'Gastos_Ocio y transporte';'Parking y peaje';'VARIABLES'
03/04/2012;29/03/2012;'AUTOPISTA TERR';-1,31 €;12.845,87 €;2256;-1,31;17.369,96 €;'sin fechas';29/03/2012;'AUTOPISTA';'Gastos_Ocio y transporte';'Parking y peaje';'VARIABLES'
04/04/2012;04/04/2012;'IBERDROLA GE IBERDRO1011516485';-381,48 €;12.464,39 €;2257;-381,48;16.988,48 €;'sin fechas';04/04/2012;'IBERDROLA';'Gastos_Servicios tipicos';'Electricidad';'FIJO'
04/04/2012;04/04/2012;'SEGUROS CATALANA';-304,93 €;12.159,46 €;2258;-304,93;16.683,55 €;'sin fechas';04/04/2012;'CATALANA';'Gastos_Ocio y transporte';'Parking y peaje';'VARIABLES'
04/04/2012;04/04/2012;'XFERA MOVILES SA 2767906';-41,94 €;12.117,52 €;2259;-41,94;16.641,61 €;'sin fechas';04/04/2012;'XFERA';'Gastos_Servicios tipicos';'Telecomunicaciones';'FIJO'
05/04/2012;03/04/2012;'ALCAMPO';-10,00 €;12.107,52 €;2260;-10,00;16.631,61 €;'sin fechas';03/04/2012;'ALCAMPO';'Gastos_Compras';'Supermercado';'VARIABLES'
05/04/2012;31/03/2012;'AUTOPISTA TERR';-2,39 €;12.105,13 €;2261;-2,39;16.629,22 €;'sin fechas';31/03/2012;'AUTOPISTA';'Gastos_Ocio y transporte';'Parking y peaje';'VARIABLES'
05/04/2012;05/04/2012;'CAFET.C T PRAT';-2,15 €;12.102,98 €;2262;-2,15;16.627,07 €;'sin fechas';05/04/2012;'CAFETC';'Gastos_Ocio y transporte';'Restaurantes';'VARIABLES'
05/04/2012;03/04/2012;'CAPRABO';-36,00 €;12.066,98 €;2263;-36,00;16.591,07 €;'sin fechas';03/04/2012;'CAPRABO';'Gastos_Compras';'Supermercado';'VARIABLES'
05/04/2012;03/04/2012;'ES STA. MARGARITA';-41,38 €;12.025,60 €;2264;-41,38;16.549,69 €;'sin fechas';03/04/2012;'STA';'Gastos_Ocio y transporte';'Gasolina';'VARIABLES'
05/04/2012;05/04/2012;'ESCOLA BRESSOL EINA';-193,40 €;11.832,20 €;2265;-193,40;16.356,29 €;'sin fechas';05/04/2012;'ESCOLA';'Gastos_Salud, saber y deporte';'Estudios';'VARIABLES'
05/04/2012;05/04/2012;'GAS NATURAL';-10,27 €;11.821,93 €;2266;-10,27;16.346,02 €;'sin fechas';05/04/2012;'GAS';'Gastos_Servicios tipicos';'Gas';'FIJO'
05/04/2012;03/04/2012;'RESTAURANTES';-21,90 €;11.800,03 €;2267;-21,90;16.324,12 €;'sin fechas';03/04/2012;'RESTAURANTES';'Gastos_Ocio y transporte';'Restaurantes';'VARIABLES'
05/04/2012;05/04/2012;'TICKETS [ABONO]';236,00 €;12.036,03 €;2268;236,00;16.560,12 €;'sin fechas';05/04/2012;'TICKETS';'Gastos_Salud, saber y deporte';'Estudios';'VARIABLES'
05/04/2012;05/04/2012;'TICKETS [CARGO]';-236,00 €;11.800,03 €;2269;-236,00;16.324,12 €;'sin fechas';05/04/2012;'TICKETS';'Gastos_Salud, saber y deporte';'Estudios';'VARIABLES'
05/04/2012;03/04/2012;'VIENA';-11,70 €;11.788,33 €;2270;-11,70;16.312,42 €;'sin fechas';03/04/2012;'VIENA';'Gastos_Ocio y transporte';'Restaurantes';'VARIABLES'
06/04/2012;06/04/2012;'REINT.CAJERO';-10,56 €;11.777,77 €;2271;-10,56;16.301,86 €;'sin fechas';06/04/2012;'REINTCAJERO';'Gastos_Gastos varios';'Efectivo';'VARIABLES'
07/04/2012;07/04/2012;'CAFET.C T PRAT';-3,45 €;11.774,32 €;2272;-3,45;16.298,41 €;'sin fechas';07/04/2012;'CAFETC';'Gastos_Ocio y transporte';'Restaurantes';'VARIABLES'
07/04/2012;07/04/2012;'DECATHLON';-3,93 €;11.770,39 €;2273;-3,93;16.294,48 €;'sin fechas';07/04/2012;'DECATHLON';'Gastos_Compras';'Deportivo';'VARIABLES'
07/04/2012;07/04/2012;'MERCADONA';-9,33 €;11.761,06 €;2274;-9,33;16.285,15 €;'sin fechas';07/04/2012;'MERCADONA';'Gastos_Compras';'Supermercado';'VARIABLES'
07/04/2012;07/04/2012;'REINT.CAJERO';-14,00 €;11.747,06 €;2275;-14,00;16.271,15 €;'sin fechas';07/04/2012;'REINTCAJERO';'Gastos_Gastos varios';'Efectivo';'VARIABLES'
07/04/2012;07/04/2012;'TOCINERIES VENTURA';-9,89 €;11.737,17 €;2276;-9,89;16.261,26 €;'sin fechas';07/04/2012;'TOCINERIES';'Gastos_Compras';'Supermercado';'VARIABLES'
08/04/2012;08/04/2012;'CAFET.C T PRAT';-3,45 €;11.733,72 €;2277;-3,45;16.257,81 €;'sin fechas';08/04/2012;'CAFETC';'Gastos_Ocio y transporte';'Restaurantes';'VARIABLES'
09/04/2012;09/04/2012;'BLITZ';-70,80 €;11.662,92 €;2278;-70,80;16.187,01 €;'sin fechas';09/04/2012;'BLITZ';'Gastos_Vivienda y vehiculo';'Alquiler Parking';'FIJO'
11/04/2012;11/04/2012;'MERCADONA';-5,92 €;11.657,00 €;2279;-5,92;16.181,09 €;'sin fechas';11/04/2012;'MERCADONA';'Gastos_Compras';'Supermercado';'VARIABLES'
11/04/2012;11/04/2012;'MERCADONA';-163,59 €;11.493,41 €;2280;-163,59;16.017,50 €;'sin fechas';11/04/2012;'MERCADONA';'Gastos_Compras';'Supermercado';'VARIABLES'
12/04/2012;10/04/2012;'DECATHLON';-4,95 €;11.488,46 €;2281;-4,95;16.012,55 €;'sin fechas';10/04/2012;'DECATHLON';'Gastos_Compras';'Deportivo';'VARIABLES'
12/04/2012;12/04/2012;'GASOLINERA';-48,96 €;11.439,50 €;2282;-48,96;15.963,59 €;'sin fechas';12/04/2012;'GASOLINERA';'Gastos_Ocio y transporte';'Gasolina';'VARIABLES'
14/04/2012;14/04/2012;'CAFET.C T PRAT';-3,85 €;11.435,65 €;2283;-3,85;15.959,74 €;'sin fechas';14/04/2012;'CAFETC';'Gastos_Ocio y transporte';'Restaurantes';'VARIABLES'
14/04/2012;14/04/2012;'FARMACIA';-9,48 €;11.426,17 €;2284;-9,48;15.950,26 €;'sin fechas';14/04/2012;'FARMACIA';'Gastos_Salud, saber y deporte';'Farmacia';'VARIABLES'
15/04/2012;15/04/2012;'CAFET.C T PRAT';-3,45 €;11.422,72 €;2285;-3,45;15.946,81 €;'sin fechas';15/04/2012;'CAFETC';'Gastos_Ocio y transporte';'Restaurantes';'VARIABLES'
15/04/2012;15/04/2012;'REINT.CAJERO';-12,00 €;11.410,72 €;2286;-12,00;15.934,81 €;'sin fechas';15/04/2012;'REINTCAJERO';'Gastos_Gastos varios';'Efectivo';'VARIABLES'
16/04/2012;16/04/2012;'CAFET.C T PRAT';-3,45 €;11.407,27 €;2287;-3,45;15.931,36 €;'sin fechas';16/04/2012;'CAFETC';'Gastos_Ocio y transporte';'Restaurantes';'VARIABLES'
16/04/2012;16/04/2012;'CCM VIDA Y P SEGURO PRESTAMO';-26,23 €;11.381,04 €;2288;-26,23;15.905,13 €;'sin fechas';16/04/2012;'CCM';'Gastos_Seguros';'Seguro vida';'FIJO'
16/04/2012;16/04/2012;'CCM VIDA Y PENSIO 000000493358';-18,97 €;11.362,07 €;2289;-18,97;15.886,16 €;'sin fechas';16/04/2012;'CCM';'Gastos_Seguros';'Seguro vida';'FIJO'
16/04/2012;16/04/2012;'ENDESA ENERG EE_XXI40025545678';-78,60 €;11.283,47 €;2290;-78,60;15.807,56 €;'sin fechas';16/04/2012;'ENDESA';'Gastos_Servicios tipicos';'Electricidad';'FIJO'
17/04/2012;17/04/2012;'AG.TRIBUT GABRIEL';100,00 €;11.383,47 €;2291;100,00;15.907,56 €;'sin fechas';17/04/2012;'AGTRIBUT';'Ingresos';'Subvenciones';
17/04/2012;17/04/2012;'ONO';-102,37 €;11.281,10 €;2292;-102,37;15.805,19 €;'sin fechas';17/04/2012;'ONO';'Gastos_Servicios tipicos';'Telecomunicaciones';'FIJO'
18/04/2012;18/04/2012;'MERCADONA';-16,60 €;11.264,50 €;2293;-16,60;15.788,59 €;'sin fechas';18/04/2012;'MERCADONA';'Gastos_Compras';'Supermercado';'VARIABLES'
18/04/2012;18/04/2012;'REINT.CAJERO';-100,00 €;11.164,50 €;2294;-100,00;15.688,59 €;'sin fechas';18/04/2012;'REINTCAJERO';'Gastos_Gastos varios';'Efectivo';'VARIABLES'
19/04/2012;17/04/2012;'ALCAMPO';-13,31 €;11.151,19 €;2295;-13,31;15.675,28 €;'sin fechas';17/04/2012;'ALCAMPO';'Gastos_Compras';'Supermercado';'VARIABLES'
19/04/2012;17/04/2012;'ALCAMPO';-30,24 €;11.120,95 €;2296;-30,24;15.645,04 €;'sin fechas';17/04/2012;'ALCAMPO';'Gastos_Compras';'Supermercado';'VARIABLES'
19/04/2012;17/04/2012;'C&A';-18,00 €;11.102,95 €;2297;-18,00;15.627,04 €;'sin fechas';17/04/2012;'CA';'Gastos_Compras';'Ropa';'VARIABLES'
19/04/2012;17/04/2012;'H&M';-22,85 €;11.080,10 €;2298;-22,85;15.604,19 €;'sin fechas';17/04/2012;'HM';'Gastos_Compras';'Ropa';'VARIABLES'
19/04/2012;17/04/2012;'H&M';-9,95 €;11.070,15 €;2299;-9,95;15.594,24 €;'sin fechas';17/04/2012;'HM';'Gastos_Compras';'Ropa';'VARIABLES'
19/04/2012;17/04/2012;'PRIMARK';-40,50 €;11.029,65 €;2300;-40,50;15.553,74 €;'sin fechas';17/04/2012;'PRIMARK';'Gastos_Compras';'Ropa';'VARIABLES'
19/04/2012;17/04/2012;'RESTAURANTES';-12,65 €;11.017,00 €;2301;-12,65;15.541,09 €;'sin fechas';17/04/2012;'RESTAURANTES';'Gastos_Ocio y transporte';'Restaurantes';'VARIABLES'
19/04/2012;17/04/2012;'RESTAURANTES';-20,85 €;10.996,15 €;2302;-20,85;15.520,24 €;'sin fechas';17/04/2012;'RESTAURANTES';'Gastos_Ocio y transporte';'Restaurantes';'VARIABLES'
20/04/2012;14/04/2012;'AUTOPISTA TERR';-2,39 €;10.993,76 €;2303;-2,39;15.517,85 €;'sin fechas';14/04/2012;'AUTOPISTA';'Gastos_Ocio y transporte';'Parking y peaje';'VARIABLES'
21/04/2012;21/04/2012;'CAFET.C T PRAT';-4,60 €;10.989,16 €;2304;-4,60;15.513,25 €;'sin fechas';21/04/2012;'CAFETC';'Gastos_Ocio y transporte';'Restaurantes';'VARIABLES'
21/04/2012;21/04/2012;'GASOLINERA';-32,25 €;10.956,91 €;2305;-32,25;15.481,00 €;'sin fechas';21/04/2012;'GASOLINERA';'Gastos_Ocio y transporte';'Gasolina';'VARIABLES'
22/04/2012;22/04/2012;'CAFET.C T PRAT';-3,85 €;10.953,06 €;2306;-3,85;15.477,15 €;'sin fechas';22/04/2012;'CAFETC';'Gastos_Ocio y transporte';'Restaurantes';'VARIABLES'
22/04/2012;22/04/2012;'REINT.CAJERO';-22,00 €;10.931,06 €;2307;-22,00;15.455,15 €;'sin fechas';22/04/2012;'REINTCAJERO';'Gastos_Gastos varios';'Efectivo';'VARIABLES'
22/04/2012;22/04/2012;'VIENA';-12,25 €;10.918,81 €;2308;-12,25;15.442,90 €;'sin fechas';22/04/2012;'VIENA';'Gastos_Ocio y transporte';'Restaurantes';'VARIABLES'
23/04/2012;23/04/2012;'CAFET.C T PRAT';-3,45 €;10.915,36 €;2309;-3,45;15.439,45 €;'sin fechas';23/04/2012;'CAFETC';'Gastos_Ocio y transporte';'Restaurantes';'VARIABLES'
24/04/2012;24/04/2012;'COMISIONES';-3,60 €;10.911,76 €;2310;-3,60;15.435,85 €;'sin fechas';24/04/2012;'COMISIONES';'Gastos_Banco y organismos';'Cargos banco';'FIJO'
24/04/2012;24/04/2012;'LIMPIEZA';-90,00 €;10.821,76 €;2311;-90,00;15.345,85 €;'sin fechas';24/04/2012;'LIMPIEZA';'Gastos_Vivienda y vehiculo';'Serv. domestico';'FIJO'
26/04/2012;22/04/2012;'AUTOPISTA TERR';-2,39 €;10.819,37 €;2312;-2,39;15.343,46 €;'sin fechas';22/04/2012;'AUTOPISTA';'Gastos_Ocio y transporte';'Parking y peaje';'VARIABLES'
26/04/2012;26/04/2012;'FOMENT DE TERRASSA, S.A. FOMEN';1.509,73 €;12.329,10 €;2313;1.509,73;16.853,19 €;'sin fechas';26/04/2012;'FOMENT';'Ingresos';'Nomina';'FIJO'
26/04/2012;25/04/2012;'MERCADONA';-21,96 €;12.307,14 €;2314;-21,96;16.831,23 €;'sin fechas';25/04/2012;'MERCADONA';'Gastos_Compras';'Supermercado';'VARIABLES'
26/04/2012;25/04/2012;'RESTAURANTES';-12,10 €;12.295,04 €;2315;-12,10;16.819,13 €;'sin fechas';25/04/2012;'RESTAURANTES';'Gastos_Ocio y transporte';'Restaurantes';'VARIABLES'
27/04/2012;27/04/2012;'INFORMACIO I TECNOLOGIA DE CAT';1.456,13 €;13.751,17 €;2316;1.456,13;18.275,26 €;'sin fechas';27/04/2012;'INFORMACIO';'Ingresos';'Nomina';'FIJO'
28/04/2012;28/04/2012;'CAFET.C T PRAT';-5,35 €;13.745,82 €;2317;-5,35;18.269,91 €;'sin fechas';28/04/2012;'CAFETC';'Gastos_Ocio y transporte';'Restaurantes';'VARIABLES'
28/04/2012;28/04/2012;'GASOLINERA';-30,00 €;13.715,82 €;2318;-30,00;18.239,91 €;'sin fechas';28/04/2012;'GASOLINERA';'Gastos_Ocio y transporte';'Gasolina';'VARIABLES'
28/04/2012;28/04/2012;'MEDIA MARKT';-41,98 €;13.673,84 €;2319;-41,98;18.197,93 €;'sin fechas';28/04/2012;'MEDIA';'Gastos_Compras';'Hobbys';'VARIABLES'
28/04/2012;28/04/2012;'OCIO&CINES';-39,60 €;13.634,24 €;2320;-39,60;18.158,33 €;'sin fechas';28/04/2012;'OCIOCINES';'Gastos_Ocio y transporte';'Espectáculos';'VARIABLES'
29/04/2012;29/04/2012;'BON AREA';-22,48 €;13.611,76 €;2321;-22,48;18.135,85 €;'sin fechas';29/04/2012;'BON';'Gastos_Compras';'Supermercado';'VARIABLES'
29/04/2012;29/04/2012;'CAFET.C T PRAT';-2,45 €;13.609,31 €;2322;-2,45;18.133,40 €;'sin fechas';29/04/2012;'CAFETC';'Gastos_Ocio y transporte';'Restaurantes';'VARIABLES'
29/04/2012;29/04/2012;'REINT.CAJERO';-8,00 €;13.601,31 €;2323;-8,00;18.125,40 €;'sin fechas';29/04/2012;'REINTCAJERO';'Gastos_Gastos varios';'Efectivo';'VARIABLES'
30/04/2012;30/04/2012;'BON AREA';-30,23 €;13.571,08 €;2324;-30,23;18.095,17 €;'sin fechas';30/04/2012;'BON';'Gastos_Compras';'Supermercado';'VARIABLES'
30/04/2012;30/04/2012;'COMUNIDAD';-20,00 €;13.551,08 €;2325;-20,00;18.075,17 €;'sin fechas';30/04/2012;'COMUNIDAD';'Gastos_Vivienda y vehiculo';'Comunidad';'FIJO'
30/04/2012;30/04/2012;'FARMACIA';-8,87 €;13.542,21 €;2326;-8,87;18.066,30 €;'sin fechas';30/04/2012;'FARMACIA';'Gastos_Salud, saber y deporte';'Farmacia';'VARIABLES'
30/04/2012;30/04/2012;'RECIBO PTMOS. 3061-0960001518';-583,25 €;12.958,96 €;2327;-583,25;17.483,05 €;'sin fechas';30/04/2012;'RECIBO';'Gastos_Banco y organismos';'Hipoteca';'FIJO'
01/05/2012;01/05/2012;'MANTENIMIENTO';-2,25 €;12.956,71 €;2328;-2,25;17.480,80 €;'sin fechas';01/05/2012;'MANTENIMIENTO';'Gastos_Banco y organismos';'Cargos banco';'FIJO'
02/05/2012;05/04/2012;'A.C.E.S.A A.VENDR.-LSAP7S';-4,30 €;12.952,41 €;2329;-4,30;17.476,50 €;'sin fechas';05/04/2012;'ACESA';'Gastos_Ocio y transporte';'Parking y peaje';'VARIABLES'
02/05/2012;09/04/2012;'A.C.E.S.A LSCAP7S.-B.MART';-9,20 €;12.943,21 €;2330;-9,20;17.467,30 €;'sin fechas';09/04/2012;'ACESA';'Gastos_Ocio y transporte';'Parking y peaje';'VARIABLES'
02/05/2012;02/05/2012;'ADESLAS CENTRAL 006662671613';-73,00 €;12.870,21 €;2331;-73,00;17.394,30 €;'sin fechas';02/05/2012;'ADESLAS';'Gastos_Salud, saber y deporte';'Medico';'VARIABLES'
02/05/2012;02/05/2012;'AJUNTAMENT DE TER PAAAAAAPNVWE';-42,95 €;12.827,26 €;2332;-42,95;17.351,35 €;'sin fechas';02/05/2012;'AJUNTAMENT';'Gastos_Banco y organismos';'Ayuntamiento';'FIJO'
02/05/2012;05/04/2012;'AUTOPISTA TERR';-3,62 €;12.823,64 €;2333;-3,62;17.347,73 €;'sin fechas';05/04/2012;'AUTOPISTA';'Gastos_Ocio y transporte';'Parking y peaje';'VARIABLES'
02/05/2012;05/04/2012;'AUTOPISTA TERR';-6,05 €;12.817,59 €;2334;-6,05;17.341,68 €;'sin fechas';05/04/2012;'AUTOPISTA';'Gastos_Ocio y transporte';'Parking y peaje';'VARIABLES'
02/05/2012;28/03/2012;'AUTOPISTA TERR';-1,05 €;12.816,54 €;2335;-1,05;17.340,63 €;'sin fechas';28/03/2012;'AUTOPISTA';'Gastos_Ocio y transporte';'Parking y peaje';'VARIABLES'
02/05/2012;29/03/2012;'AUTOPISTA TERR';-1,05 €;12.815,49 €;2336;-1,05;17.339,58 €;'sin fechas';29/03/2012;'AUTOPISTA';'Gastos_Ocio y transporte';'Parking y peaje';'VARIABLES'
02/05/2012;29/03/2012;'AUTOPISTA TERR';-1,05 €;12.814,44 €;2337;-1,05;17.338,53 €;'sin fechas';29/03/2012;'AUTOPISTA';'Gastos_Ocio y transporte';'Parking y peaje';'VARIABLES'
02/05/2012;30/03/2012;'AUTOPISTA TERR';-1,05 €;12.813,39 €;2338;-1,05;17.337,48 €;'sin fechas';30/03/2012;'AUTOPISTA';'Gastos_Ocio y transporte';'Parking y peaje';'VARIABLES'
02/05/2012;31/03/2012;'AUTOPISTA TERR';-2,39 €;12.811,00 €;2339;-2,39;17.335,09 €;'sin fechas';31/03/2012;'AUTOPISTA';'Gastos_Ocio y transporte';'Parking y peaje';'VARIABLES'
02/05/2012;03/04/2012;'AUTOPISTA TERR';-1,31 €;12.809,69 €;2340;-1,31;17.333,78 €;'sin fechas';03/04/2012;'AUTOPISTA';'Gastos_Ocio y transporte';'Parking y peaje';'VARIABLES'
02/05/2012;03/04/2012;'AUTOPISTA TERR';-1,31 €;12.808,38 €;2341;-1,31;17.332,47 €;'sin fechas';03/04/2012;'AUTOPISTA';'Gastos_Ocio y transporte';'Parking y peaje';'VARIABLES'
02/05/2012;04/04/2012;'AUTOPISTA TERR';-1,31 €;12.807,07 €;2342;-1,31;17.331,16 €;'sin fechas';04/04/2012;'AUTOPISTA';'Gastos_Ocio y transporte';'Parking y peaje';'VARIABLES'
02/05/2012;04/04/2012;'AUTOPISTA TERR';-1,31 €;12.805,76 €;2343;-1,31;17.329,85 €;'sin fechas';04/04/2012;'AUTOPISTA';'Gastos_Ocio y transporte';'Parking y peaje';'VARIABLES'
02/05/2012;05/04/2012;'AUTOPISTA TERR';-1,31 €;12.804,45 €;2344;-1,31;17.328,54 €;'sin fechas';05/04/2012;'AUTOPISTA';'Gastos_Ocio y transporte';'Parking y peaje';'VARIABLES'
02/05/2012;09/04/2012;'AUTOPISTA TERR';-2,39 €;12.802,06 €;2345;-2,39;17.326,15 €;'sin fechas';09/04/2012;'AUTOPISTA';'Gastos_Ocio y transporte';'Parking y peaje';'VARIABLES'
02/05/2012;10/04/2012;'AUTOPISTA TERR';-1,24 €;12.800,82 €;2346;-1,24;17.324,91 €;'sin fechas';10/04/2012;'AUTOPISTA';'Gastos_Ocio y transporte';'Parking y peaje';'VARIABLES'
02/05/2012;10/04/2012;'AUTOPISTA TERR';-1,24 €;12.799,58 €;2347;-1,24;17.323,67 €;'sin fechas';10/04/2012;'AUTOPISTA';'Gastos_Ocio y transporte';'Parking y peaje';'VARIABLES'
02/05/2012;11/04/2012;'AUTOPISTA TERR';-1,24 €;12.798,34 €;2348;-1,24;17.322,43 €;'sin fechas';11/04/2012;'AUTOPISTA';'Gastos_Ocio y transporte';'Parking y peaje';'VARIABLES'
02/05/2012;12/04/2012;'AUTOPISTA TERR';-1,24 €;12.797,10 €;2349;-1,24;17.321,19 €;'sin fechas';12/04/2012;'AUTOPISTA';'Gastos_Ocio y transporte';'Parking y peaje';'VARIABLES'
02/05/2012;12/04/2012;'AUTOPISTA TERR';-1,24 €;12.795,86 €;2350;-1,24;17.319,95 €;'sin fechas';12/04/2012;'AUTOPISTA';'Gastos_Ocio y transporte';'Parking y peaje';'VARIABLES'
02/05/2012;13/04/2012;'AUTOPISTA TERR';-1,18 €;12.794,68 €;2351;-1,18;17.318,77 €;'sin fechas';13/04/2012;'AUTOPISTA';'Gastos_Ocio y transporte';'Parking y peaje';'VARIABLES'
02/05/2012;13/04/2012;'AUTOPISTA TERR';-1,31 €;12.793,37 €;2352;-1,31;17.317,46 €;'sin fechas';13/04/2012;'AUTOPISTA';'Gastos_Ocio y transporte';'Parking y peaje';'VARIABLES'
02/05/2012;16/04/2012;'AUTOPISTA TERR';-1,18 €;12.792,19 €;2353;-1,18;17.316,28 €;'sin fechas';16/04/2012;'AUTOPISTA';'Gastos_Ocio y transporte';'Parking y peaje';'VARIABLES'
02/05/2012;16/04/2012;'AUTOPISTA TERR';-1,31 €;12.790,88 €;2354;-1,31;17.314,97 €;'sin fechas';16/04/2012;'AUTOPISTA';'Gastos_Ocio y transporte';'Parking y peaje';'VARIABLES'
02/05/2012;17/04/2012;'AUTOPISTA TERR';-1,18 €;12.789,70 €;2355;-1,18;17.313,79 €;'sin fechas';17/04/2012;'AUTOPISTA';'Gastos_Ocio y transporte';'Parking y peaje';'VARIABLES'
02/05/2012;17/04/2012;'AUTOPISTA TERR';-1,31 €;12.788,39 €;2356;-1,31;17.312,48 €;'sin fechas';17/04/2012;'AUTOPISTA';'Gastos_Ocio y transporte';'Parking y peaje';'VARIABLES'
02/05/2012;18/04/2012;'AUTOPISTA TERR';-1,18 €;12.787,21 €;2357;-1,18;17.311,30 €;'sin fechas';18/04/2012;'AUTOPISTA';'Gastos_Ocio y transporte';'Parking y peaje';'VARIABLES'
02/05/2012;18/04/2012;'AUTOPISTA TERR';-1,18 €;12.786,03 €;2358;-1,18;17.310,12 €;'sin fechas';18/04/2012;'AUTOPISTA';'Gastos_Ocio y transporte';'Parking y peaje';'VARIABLES'
02/05/2012;19/04/2012;'AUTOPISTA TERR';-1,18 €;12.784,85 €;2359;-1,18;17.308,94 €;'sin fechas';19/04/2012;'AUTOPISTA';'Gastos_Ocio y transporte';'Parking y peaje';'VARIABLES'
02/05/2012;20/04/2012;'AUTOPISTA TERR';-1,18 €;12.783,67 €;2360;-1,18;17.307,76 €;'sin fechas';20/04/2012;'AUTOPISTA';'Gastos_Ocio y transporte';'Parking y peaje';'VARIABLES'
02/05/2012;20/04/2012;'AUTOPISTA TERR';-1,31 €;12.782,36 €;2361;-1,31;17.306,45 €;'sin fechas';20/04/2012;'AUTOPISTA';'Gastos_Ocio y transporte';'Parking y peaje';'VARIABLES'
02/05/2012;23/04/2012;'AUTOPISTA TERR';-1,18 €;12.781,18 €;2362;-1,18;17.305,27 €;'sin fechas';23/04/2012;'AUTOPISTA';'Gastos_Ocio y transporte';'Parking y peaje';'VARIABLES'
02/05/2012;23/04/2012;'AUTOPISTA TERR';-1,18 €;12.780,00 €;2363;-1,18;17.304,09 €;'sin fechas';23/04/2012;'AUTOPISTA';'Gastos_Ocio y transporte';'Parking y peaje';'VARIABLES'
02/05/2012;24/04/2012;'AUTOPISTA TERR';-1,05 €;12.778,95 €;2364;-1,05;17.303,04 €;'sin fechas';24/04/2012;'AUTOPISTA';'Gastos_Ocio y transporte';'Parking y peaje';'VARIABLES'
02/05/2012;24/04/2012;'AUTOPISTA TERR';-1,18 €;12.777,77 €;2365;-1,18;17.301,86 €;'sin fechas';24/04/2012;'AUTOPISTA';'Gastos_Ocio y transporte';'Parking y peaje';'VARIABLES'
02/05/2012;25/04/2012;'AUTOPISTA TERR';-1,05 €;12.776,72 €;2366;-1,05;17.300,81 €;'sin fechas';25/04/2012;'AUTOPISTA';'Gastos_Ocio y transporte';'Parking y peaje';'VARIABLES'
02/05/2012;25/04/2012;'AUTOPISTA TERR';-1,05 €;12.775,67 €;2367;-1,05;17.299,76 €;'sin fechas';25/04/2012;'AUTOPISTA';'Gastos_Ocio y transporte';'Parking y peaje';'VARIABLES'
02/05/2012;26/04/2012;'AUTOPISTA TERR';-1,05 €;12.774,62 €;2368;-1,05;17.298,71 €;'sin fechas';26/04/2012;'AUTOPISTA';'Gastos_Ocio y transporte';'Parking y peaje';'VARIABLES'
02/05/2012;26/04/2012;'AUTOPISTA TERR';-1,31 €;12.773,31 €;2369;-1,31;17.297,40 €;'sin fechas';26/04/2012;'AUTOPISTA';'Gastos_Ocio y transporte';'Parking y peaje';'VARIABLES'
02/05/2012;05/04/2012;'AUTOPISTA TERR';-6,20 €;12.767,11 €;2370;-6,20;17.291,20 €;'sin fechas';05/04/2012;'AUTOPISTA';'Gastos_Ocio y transporte';'Parking y peaje';'VARIABLES'
02/05/2012;09/04/2012;'AUTOPISTA TERR';-6,20 €;12.760,91 €;2371;-6,20;17.285,00 €;'sin fechas';09/04/2012;'AUTOPISTA';'Gastos_Ocio y transporte';'Parking y peaje';'VARIABLES'
02/05/2012;10/04/2012;'FARMACIA';-4,92 €;12.755,99 €;2372;-4,92;17.280,08 €;'sin fechas';10/04/2012;'FARMACIA';'Gastos_Salud, saber y deporte';'Farmacia';'VARIABLES'
02/05/2012;29/03/2012;'PARKING CAPIO SANIDAD';-6,95 €;12.749,04 €;2373;-6,95;17.273,13 €;'sin fechas';29/03/2012;'PARKING';'Gastos_Ocio y transporte';'Parking y peaje';'VARIABLES'
03/05/2012;03/05/2012;'AJUNTAMENT BARCELON 0332641FMY';-62,78 €;12.686,26 €;2374;-62,78;17.210,35 €;'sin fechas';03/05/2012;'AJUNTAMENT';'Gastos_Banco y organismos';'Ayuntamiento';'FIJO'
03/05/2012;28/04/2012;'AUTOPISTA TERR';-2,39 €;12.683,87 €;2375;-2,39;17.207,96 €;'sin fechas';28/04/2012;'AUTOPISTA';'Gastos_Ocio y transporte';'Parking y peaje';'VARIABLES'
03/05/2012;01/05/2012;'C&A';-22,50 €;12.661,37 €;2376;-22,50;17.185,46 €;'sin fechas';01/05/2012;'CA';'Gastos_Compras';'Ropa';'VARIABLES'
03/05/2012;01/05/2012;'PRIMARK';-13,50 €;12.647,87 €;2377;-13,50;17.171,96 €;'sin fechas';01/05/2012;'PRIMARK';'Gastos_Compras';'Ropa';'VARIABLES'
03/05/2012;01/05/2012;'RESTAURANTES';-40,45 €;12.607,42 €;2378;-40,45;17.131,51 €;'sin fechas';01/05/2012;'RESTAURANTES';'Gastos_Ocio y transporte';'Restaurantes';'VARIABLES'
03/05/2012;01/05/2012;'VIENA';-12,20 €;12.595,22 €;2379;-12,20;17.119,31 €;'sin fechas';01/05/2012;'VIENA';'Gastos_Ocio y transporte';'Restaurantes';'VARIABLES'
04/05/2012;04/05/2012;'YOIGO';-38,14 €;12.557,08 €;2380;-38,14;17.081,17 €;'sin fechas';04/05/2012;'YOIGO';'Gastos_Servicios tipicos';'Telecomunicaciones';'FIJO'
05/05/2012;05/05/2012;'CAPRABO';-14,48 €;12.542,60 €;2381;-14,48;17.066,69 €;'sin fechas';05/05/2012;'CAPRABO';'Gastos_Compras';'Supermercado';'VARIABLES'
05/05/2012;05/05/2012;'TOCINERIES VENTURA';-9,79 €;12.532,81 €;2382;-9,79;17.056,90 €;'sin fechas';05/05/2012;'TOCINERIES';'Gastos_Compras';'Supermercado';'VARIABLES'
06/05/2012;06/05/2012;'GASOLINERA';-33,95 €;12.498,86 €;2383;-33,95;17.022,95 €;'sin fechas';06/05/2012;'GASOLINERA';'Gastos_Ocio y transporte';'Gasolina';'VARIABLES'
06/05/2012;06/05/2012;'MERCADONA';-155,84 €;12.343,02 €;2384;-155,84;16.867,11 €;'sin fechas';06/05/2012;'MERCADONA';'Gastos_Compras';'Supermercado';'VARIABLES'
06/05/2012;06/05/2012;'MERCADONA';-32,31 €;12.310,71 €;2385;-32,31;16.834,80 €;'sin fechas';06/05/2012;'MERCADONA';'Gastos_Compras';'Supermercado';'VARIABLES'
06/05/2012;06/05/2012;'REINT.CAJERO';-9,63 €;12.301,08 €;2386;-9,63;16.825,17 €;'sin fechas';06/05/2012;'REINTCAJERO';'Gastos_Gastos varios';'Efectivo';'VARIABLES'
07/05/2012;07/05/2012;'CAFET.C T PRAT';-3,90 €;12.297,18 €;2387;-3,90;16.821,27 €;'sin fechas';07/05/2012;'CAFETC';'Gastos_Ocio y transporte';'Restaurantes';'VARIABLES'
07/05/2012;07/05/2012;'CAFET.C T PRAT';-3,20 €;12.293,98 €;2388;-3,20;16.818,07 €;'sin fechas';07/05/2012;'CAFETC';'Gastos_Ocio y transporte';'Restaurantes';'VARIABLES'
07/05/2012;07/05/2012;'FARMACIA';-20,43 €;12.273,55 €;2389;-20,43;16.797,64 €;'sin fechas';07/05/2012;'FARMACIA';'Gastos_Salud, saber y deporte';'Farmacia';'VARIABLES'
07/05/2012;07/05/2012;'GAS NATURAL';-10,27 €;12.263,28 €;2390;-10,27;16.787,37 €;'sin fechas';07/05/2012;'GAS';'Gastos_Servicios tipicos';'Gas';'FIJO'
07/05/2012;07/05/2012;'REINT.CAJERO';-60,00 €;12.203,28 €;2391;-60,00;16.727,37 €;'sin fechas';07/05/2012;'REINTCAJERO';'Gastos_Gastos varios';'Efectivo';'VARIABLES'
08/05/2012;09/05/2012;'COMISIONES';-1,50 €;12.201,78 €;2392;-1,50;16.725,87 €;'sin fechas';09/05/2012;'COMISIONES';'Gastos_Banco y organismos';'Cargos banco';'FIJO'
10/05/2012;08/05/2012;'EROSKI-[OTROS]';-25,88 €;12.175,90 €;2393;-25,88;16.699,99 €;'sin fechas';08/05/2012;'EROSKIOTROS';'Gastos_Compras';'Supermercado';'VARIABLES'
10/05/2012;09/05/2012;'FARMACIA';-21,39 €;12.154,51 €;2394;-21,39;16.678,60 €;'sin fechas';09/05/2012;'FARMACIA';'Gastos_Salud, saber y deporte';'Farmacia';'VARIABLES'
10/05/2012;10/05/2012;'MERCADONA';-36,26 €;12.118,25 €;2395;-36,26;16.642,34 €;'sin fechas';10/05/2012;'MERCADONA';'Gastos_Compras';'Supermercado';'VARIABLES'
10/05/2012;08/05/2012;'RESTAURANTES';-6,70 €;12.111,55 €;2396;-6,70;16.635,64 €;'sin fechas';08/05/2012;'RESTAURANTES';'Gastos_Ocio y transporte';'Restaurantes';'VARIABLES'
10/05/2012;10/05/2012;'TICKETS [ABONO]';236,00 €;12.347,55 €;2397;236,00;16.871,64 €;'sin fechas';10/05/2012;'TICKETS';'Gastos_Salud, saber y deporte';'Estudios';'VARIABLES'
10/05/2012;10/05/2012;'TICKETS [CARGO]';-236,00 €;12.111,55 €;2398;-236,00;16.635,64 €;'sin fechas';10/05/2012;'TICKETS';'Gastos_Salud, saber y deporte';'Estudios';'VARIABLES'
10/05/2012;10/05/2012;'TRANSPORTS MUNICIP';-17,00 €;12.094,55 €;2399;-17,00;16.618,64 €;'sin fechas';10/05/2012;'TRANSPORTS';'Gastos_Ocio y transporte';'Transporte';'VARIABLES'
11/05/2012;11/05/2012;'BLITZ';-70,80 €;12.023,75 €;2400;-70,80;16.547,84 €;'sin fechas';11/05/2012;'BLITZ';'Gastos_Vivienda y vehiculo';'Alquiler Parking';'FIJO'
11/05/2012;11/05/2012;'ESCOLA BRESSOL EINA';-121,20 €;11.902,55 €;2401;-121,20;16.426,64 €;'sin fechas';11/05/2012;'ESCOLA';'Gastos_Salud, saber y deporte';'Estudios';'VARIABLES'
11/05/2012;11/05/2012;'FARMACIA';-10,43 €;11.892,12 €;2402;-10,43;16.416,21 €;'sin fechas';11/05/2012;'FARMACIA';'Gastos_Salud, saber y deporte';'Farmacia';'VARIABLES'
12/05/2012;12/05/2012;'COCHE&PARKING';-8,90 €;11.883,22 €;2403;-8,90;16.407,31 €;'sin fechas';12/05/2012;'COCHEPARKING';'Gastos_Ocio y transporte';'Parking y peaje';'VARIABLES'
13/05/2012;09/05/2012;'AUTOPISTA TERR';-2,39 €;11.880,83 €;2404;-2,39;16.404,92 €;'sin fechas';09/05/2012;'AUTOPISTA';'Gastos_Ocio y transporte';'Parking y peaje';'VARIABLES'
13/05/2012;09/05/2012;'AUTOPISTA TERR';-2,39 €;11.878,44 €;2405;-2,39;16.402,53 €;'sin fechas';09/05/2012;'AUTOPISTA';'Gastos_Ocio y transporte';'Parking y peaje';'VARIABLES'
13/05/2012;13/05/2012;'GASOLINERA';-51,60 €;11.826,84 €;2406;-51,60;16.350,93 €;'sin fechas';13/05/2012;'GASOLINERA';'Gastos_Ocio y transporte';'Gasolina';'VARIABLES'
13/05/2012;13/05/2012;'REINT.CAJERO';-20,00 €;11.806,84 €;2407;-20,00;16.330,93 €;'sin fechas';13/05/2012;'REINTCAJERO';'Gastos_Gastos varios';'Efectivo';'VARIABLES'
13/05/2012;13/05/2012;'VIENA';-17,80 €;11.789,04 €;2408;-17,80;16.313,13 €;'sin fechas';13/05/2012;'VIENA';'Gastos_Ocio y transporte';'Restaurantes';'VARIABLES'
14/05/2012;14/05/2012;'BON AREA';-22,25 €;11.766,79 €;2409;-22,25;16.290,88 €;'sin fechas';14/05/2012;'BON';'Gastos_Compras';'Supermercado';'VARIABLES'
14/05/2012;14/05/2012;'ENDESA ENERG EE_XXI40025545678';-92,96 €;11.673,83 €;2410;-92,96;16.197,92 €;'sin fechas';14/05/2012;'ENDESA';'Gastos_Servicios tipicos';'Electricidad';'FIJO'
14/05/2012;14/05/2012;'TOCINERIES VENTURA';-13,41 €;11.660,42 €;2411;-13,41;16.184,51 €;'sin fechas';14/05/2012;'TOCINERIES';'Gastos_Compras';'Supermercado';'VARIABLES'
15/05/2012;15/05/2012;'CCM VIDA Y P SEGURO PRESTAMO';-26,15 €;11.634,27 €;2412;-26,15;16.158,36 €;'sin fechas';15/05/2012;'CCM';'Gastos_Seguros';'Seguro vida';'FIJO'
15/05/2012;15/05/2012;'CCM VIDA Y PENSIO 000000493358';-18,91 €;11.615,36 €;2413;-18,91;16.139,45 €;'sin fechas';15/05/2012;'CCM';'Gastos_Seguros';'Seguro vida';'FIJO'
16/05/2012;16/05/2012;'REINT.CAJERO';-50,00 €;11.565,36 €;2414;-50,00;16.089,45 €;'sin fechas';16/05/2012;'REINTCAJERO';'Gastos_Gastos varios';'Efectivo';'VARIABLES'
16/05/2012;16/05/2012;'VIENA';-4,95 €;11.560,41 €;2415;-4,95;16.084,50 €;'sin fechas';16/05/2012;'VIENA';'Gastos_Ocio y transporte';'Restaurantes';'VARIABLES'
17/05/2012;15/05/2012;'BON AREA';-19,11 €;11.541,30 €;2416;-19,11;16.065,39 €;'sin fechas';15/05/2012;'BON';'Gastos_Compras';'Supermercado';'VARIABLES'
17/05/2012;17/05/2012;'FF.CC.GENERALITAT';-2,70 €;11.538,60 €;2417;-2,70;16.062,69 €;'sin fechas';17/05/2012;'FFCCGENERALITAT';'Gastos_Ocio y transporte';'Transporte';'VARIABLES'
17/05/2012;17/05/2012;'IKEA';-7,95 €;11.530,65 €;2418;-7,95;16.054,74 €;'sin fechas';17/05/2012;'IKEA';'Gastos_Vivienda y vehiculo';'Mnto. hogar';'VARIABLES'
17/05/2012;17/05/2012;'IKEA';-20,65 €;11.510,00 €;2419;-20,65;16.034,09 €;'sin fechas';17/05/2012;'IKEA';'Gastos_Vivienda y vehiculo';'Mnto. hogar';'VARIABLES'
17/05/2012;17/05/2012;'TOCINERIES VENTURA';-9,98 €;11.500,02 €;2420;-9,98;16.024,11 €;'sin fechas';17/05/2012;'TOCINERIES';'Gastos_Compras';'Supermercado';'VARIABLES'
18/05/2012;14/05/2012;'AUTOPISTA TERR';-1,31 €;11.498,71 €;2421;-1,31;16.022,80 €;'sin fechas';14/05/2012;'AUTOPISTA';'Gastos_Ocio y transporte';'Parking y peaje';'VARIABLES'
18/05/2012;18/05/2012;'ONO';-86,37 €;11.412,34 €;2422;-86,37;15.936,43 €;'sin fechas';18/05/2012;'ONO';'Gastos_Servicios tipicos';'Telecomunicaciones';'FIJO'
19/05/2012;19/05/2012;'C&A';-17,00 €;11.395,34 €;2423;-17,00;15.919,43 €;'sin fechas';19/05/2012;'CA';'Gastos_Compras';'Ropa';'VARIABLES'
19/05/2012;19/05/2012;'CAFET.C T PRAT';-2,95 €;11.392,39 €;2424;-2,95;15.916,48 €;'sin fechas';19/05/2012;'CAFETC';'Gastos_Ocio y transporte';'Restaurantes';'VARIABLES'
19/05/2012;19/05/2012;'RESTAURANTES';-7,40 €;11.384,99 €;2425;-7,40;15.909,08 €;'sin fechas';19/05/2012;'RESTAURANTES';'Gastos_Ocio y transporte';'Restaurantes';'VARIABLES'
19/05/2012;19/05/2012;'VIENA';-16,65 €;11.368,34 €;2426;-16,65;15.892,43 €;'sin fechas';19/05/2012;'VIENA';'Gastos_Ocio y transporte';'Restaurantes';'VARIABLES'
20/05/2012;20/05/2012;'CAFET.C T PRAT';-3,60 €;11.364,74 €;2427;-3,60;15.888,83 €;'sin fechas';20/05/2012;'CAFETC';'Gastos_Ocio y transporte';'Restaurantes';'VARIABLES'
20/05/2012;20/05/2012;'FARMACIA';-27,50 €;11.337,24 €;2428;-27,50;15.861,33 €;'sin fechas';20/05/2012;'FARMACIA';'Gastos_Salud, saber y deporte';'Farmacia';'VARIABLES'
20/05/2012;20/05/2012;'FARMACIA';-6,29 €;11.330,95 €;2429;-6,29;15.855,04 €;'sin fechas';20/05/2012;'FARMACIA';'Gastos_Salud, saber y deporte';'Farmacia';'VARIABLES'
20/05/2012;20/05/2012;'REINT.CAJERO';-17,00 €;11.313,95 €;2430;-17,00;15.838,04 €;'sin fechas';20/05/2012;'REINTCAJERO';'Gastos_Gastos varios';'Efectivo';'VARIABLES'
21/05/2012;17/05/2012;'AUTOPISTA TERR';-1,31 €;11.312,64 €;2431;-1,31;15.836,73 €;'sin fechas';17/05/2012;'AUTOPISTA';'Gastos_Ocio y transporte';'Parking y peaje';'VARIABLES'
21/05/2012;21/05/2012;'CAFET.C T PRAT';-3,45 €;11.309,19 €;2432;-3,45;15.833,28 €;'sin fechas';21/05/2012;'CAFETC';'Gastos_Ocio y transporte';'Restaurantes';'VARIABLES'
21/05/2012;21/05/2012;'FARMACIA';-13,91 €;11.295,28 €;2433;-13,91;15.819,37 €;'sin fechas';21/05/2012;'FARMACIA';'Gastos_Salud, saber y deporte';'Farmacia';'VARIABLES'
22/05/2012;22/05/2012;'AG.TRIBUT GABRIEL';100,00 €;11.395,28 €;2434;100,00;15.919,37 €;'sin fechas';22/05/2012;'AGTRIBUT';'Ingresos';'Subvenciones';
22/05/2012;17/05/2012;'AUTOPISTA TERR';-1,31 €;11.393,97 €;2435;-1,31;15.918,06 €;'sin fechas';17/05/2012;'AUTOPISTA';'Gastos_Ocio y transporte';'Parking y peaje';'VARIABLES'
23/05/2012;23/05/2012;'CAPRABO';-13,75 €;11.380,22 €;2436;-13,75;15.904,31 €;'sin fechas';23/05/2012;'CAPRABO';'Gastos_Compras';'Supermercado';'VARIABLES'
23/05/2012;23/05/2012;'LIMPIEZA';-150,00 €;11.230,22 €;2437;-150,00;15.754,31 €;'sin fechas';23/05/2012;'LIMPIEZA';'Gastos_Vivienda y vehiculo';'Serv. domestico';'FIJO'
23/05/2012;23/05/2012;'VIENA';-8,20 €;11.222,02 €;2438;-8,20;15.746,11 €;'sin fechas';23/05/2012;'VIENA';'Gastos_Ocio y transporte';'Restaurantes';'VARIABLES'
24/05/2012;22/05/2012;'BON AREA';-37,24 €;11.184,78 €;2439;-37,24;15.708,87 €;'sin fechas';22/05/2012;'BON';'Gastos_Compras';'Supermercado';'VARIABLES'
24/05/2012;24/05/2012;'CAFET.C T PRAT';-3,45 €;11.181,33 €;2440;-3,45;15.705,42 €;'sin fechas';24/05/2012;'CAFETC';'Gastos_Ocio y transporte';'Restaurantes';'VARIABLES'
24/05/2012;22/05/2012;'CARREFOUR-[OTROS]';-65,30 €;11.116,03 €;2441;-65,30;15.640,12 €;'sin fechas';22/05/2012;'CARREFOUROTROS';'Gastos_Compras';'Supermercado';'VARIABLES'
24/05/2012;22/05/2012;'EROSKI-[OTROS]';-99,00 €;11.017,03 €;2442;-99,00;15.541,12 €;'sin fechas';22/05/2012;'EROSKIOTROS';'Gastos_Compras';'Supermercado';'VARIABLES'
24/05/2012;23/05/2012;'GASOLINERA';-48,06 €;10.968,97 €;2443;-48,06;15.493,06 €;'sin fechas';23/05/2012;'GASOLINERA';'Gastos_Ocio y transporte';'Gasolina';'VARIABLES'
24/05/2012;24/05/2012;'MERCADONA';-40,89 €;10.928,08 €;2444;-40,89;15.452,17 €;'sin fechas';24/05/2012;'MERCADONA';'Gastos_Compras';'Supermercado';'VARIABLES'
24/05/2012;22/05/2012;'VIENA';-12,50 €;10.915,58 €;2445;-12,50;15.439,67 €;'sin fechas';22/05/2012;'VIENA';'Gastos_Ocio y transporte';'Restaurantes';'VARIABLES'
25/05/2012;19/05/2012;'AUTOPISTA TERR';-1,31 €;10.914,27 €;2446;-1,31;15.438,36 €;'sin fechas';19/05/2012;'AUTOPISTA';'Gastos_Ocio y transporte';'Parking y peaje';'VARIABLES'
25/05/2012;25/05/2012;'CAFET.C T PRAT';-2,80 €;10.911,47 €;2447;-2,80;15.435,56 €;'sin fechas';25/05/2012;'CAFETC';'Gastos_Ocio y transporte';'Restaurantes';'VARIABLES'
25/05/2012;25/05/2012;'FOMENT DE TERRASSA, S.A. FOMEN';1.550,23 €;12.461,70 €;2448;1.550,23;16.985,79 €;'sin fechas';25/05/2012;'FOMENT';'Ingresos';'Nomina';'FIJO'
25/05/2012;25/05/2012;'VIENA';-13,45 €;12.448,25 €;2449;-13,45;16.972,34 €;'sin fechas';25/05/2012;'VIENA';'Gastos_Ocio y transporte';'Restaurantes';'VARIABLES'
26/05/2012;26/05/2012;'CAFET.C T PRAT';-3,45 €;12.444,80 €;2450;-3,45;16.968,89 €;'sin fechas';26/05/2012;'CAFETC';'Gastos_Ocio y transporte';'Restaurantes';'VARIABLES'
27/05/2012;27/05/2012;'BON AREA';-14,49 €;12.430,31 €;2451;-14,49;16.954,40 €;'sin fechas';27/05/2012;'BON';'Gastos_Compras';'Supermercado';'VARIABLES'
27/05/2012;27/05/2012;'CAFET.C T PRAT';-3,75 €;12.426,56 €;2452;-3,75;16.950,65 €;'sin fechas';27/05/2012;'CAFETC';'Gastos_Ocio y transporte';'Restaurantes';'VARIABLES'
27/05/2012;27/05/2012;'REINT.CAJERO';-15,77 €;12.410,79 €;2453;-15,77;16.934,88 €;'sin fechas';27/05/2012;'REINTCAJERO';'Gastos_Gastos varios';'Efectivo';'VARIABLES'
27/05/2012;27/05/2012;'RODELAS PERRUQUERS';-13,50 €;12.397,29 €;2454;-13,50;16.921,38 €;'sin fechas';27/05/2012;'RODELAS';'Gastos_Salud, saber y deporte';'Belleza';'VARIABLES'
28/05/2012;28/05/2012;'CAFET.C T PRAT';-3,45 €;12.393,84 €;2455;-3,45;16.917,93 €;'sin fechas';28/05/2012;'CAFETC';'Gastos_Ocio y transporte';'Restaurantes';'VARIABLES'
28/05/2012;28/05/2012;'INFORMACIO I TECNOLOGIA DE CAT';1.456,13 €;13.849,97 €;2456;1.456,13;18.374,06 €;'sin fechas';28/05/2012;'INFORMACIO';'Ingresos';'Nomina';'FIJO'
29/05/2012;23/05/2012;'AUTOPISTA TERR';-1,31 €;13.848,66 €;2457;-1,31;18.372,75 €;'sin fechas';23/05/2012;'AUTOPISTA';'Gastos_Ocio y transporte';'Parking y peaje';'VARIABLES'
31/05/2012;31/05/2012;'COMUNIDAD';-20,00 €;13.828,66 €;2458;-20,00;18.352,75 €;'sin fechas';31/05/2012;'COMUNIDAD';'Gastos_Vivienda y vehiculo';'Comunidad';'FIJO'
31/05/2012;31/05/2012;'LIBRERIAS CASA DEL LIBRO';-11,95 €;13.816,71 €;2459;-11,95;18.340,80 €;'sin fechas';31/05/2012;'LIBRERIAS';'Gastos_Salud, saber y deporte';'Estudios';'VARIABLES'
31/05/2012;29/05/2012;'MERCADONA';-26,58 €;13.790,13 €;2460;-26,58;18.314,22 €;'sin fechas';29/05/2012;'MERCADONA';'Gastos_Compras';'Supermercado';'VARIABLES'
31/05/2012;31/05/2012;'RECIBO PTMOS. 3061-0960001518';-583,25 €;13.206,88 €;2461;-583,25;17.730,97 €;'sin fechas';31/05/2012;'RECIBO';'Gastos_Banco y organismos';'Hipoteca';'FIJO'
31/05/2012;31/05/2012;'TRANSPORTS MUNICIP';-17,00 €;13.189,88 €;2462;-17,00;17.713,97 €;'sin fechas';31/05/2012;'TRANSPORTS';'Gastos_Ocio y transporte';'Transporte';'VARIABLES'
31/05/2012;31/05/2012;'VIENA';-12,85 €;13.177,03 €;2463;-12,85;17.701,12 €;'sin fechas';31/05/2012;'VIENA';'Gastos_Ocio y transporte';'Restaurantes';'VARIABLES'
01/06/2012;01/06/2012;'ADESLAS CENTRAL 006662671613';-73,00 €;13.104,03 €;2464;-73,00;17.628,12 €;'sin fechas';01/06/2012;'ADESLAS';'Gastos_Salud, saber y deporte';'Medico';'VARIABLES'
01/06/2012;26/05/2012;'AUTOPISTA TERR';-1,31 €;13.102,72 €;2465;-1,31;17.626,81 €;'sin fechas';26/05/2012;'AUTOPISTA';'Gastos_Ocio y transporte';'Parking y peaje';'VARIABLES'
01/06/2012;27/05/2012;'AUTOPISTA TERR';-1,31 €;13.101,41 €;2466;-1,31;17.625,50 €;'sin fechas';27/05/2012;'AUTOPISTA';'Gastos_Ocio y transporte';'Parking y peaje';'VARIABLES'
01/06/2012;27/05/2012;'AUTOPISTA TERR';-1,31 €;13.100,10 €;2467;-1,31;17.624,19 €;'sin fechas';27/05/2012;'AUTOPISTA';'Gastos_Ocio y transporte';'Parking y peaje';'VARIABLES'
01/06/2012;01/06/2012;'CAFET.C T PRAT';-3,75 €;13.096,35 €;2468;-3,75;17.620,44 €;'sin fechas';01/06/2012;'CAFETC';'Gastos_Ocio y transporte';'Restaurantes';'VARIABLES'
01/06/2012;01/06/2012;'MANTENIMIENTO';-2,25 €;13.094,10 €;2469;-2,25;17.618,19 €;'sin fechas';01/06/2012;'MANTENIMIENTO';'Gastos_Banco y organismos';'Cargos banco';'FIJO'
02/06/2012;04/06/2012;'A.E.A.T. DEVOLUCIONES TRIBUTAR';582,63 €;13.676,73 €;2470;582,63;18.200,82 €;'sin fechas';04/06/2012;'AEAT';'Ingresos';'Devoluciones';'VARIABLES'
02/06/2012;30/04/2012;'AUTOPISTA TERR';-1,31 €;13.675,42 €;2471;-1,31;18.199,51 €;'sin fechas';30/04/2012;'AUTOPISTA';'Gastos_Ocio y transporte';'Parking y peaje';'VARIABLES'
02/06/2012;30/04/2012;'AUTOPISTA TERR';-1,31 €;13.674,11 €;2472;-1,31;18.198,20 €;'sin fechas';30/04/2012;'AUTOPISTA';'Gastos_Ocio y transporte';'Parking y peaje';'VARIABLES'
02/06/2012;02/05/2012;'AUTOPISTA TERR';-1,31 €;13.672,80 €;2473;-1,31;18.196,89 €;'sin fechas';02/05/2012;'AUTOPISTA';'Gastos_Ocio y transporte';'Parking y peaje';'VARIABLES'
02/06/2012;02/05/2012;'AUTOPISTA TERR';-1,31 €;13.671,49 €;2474;-1,31;18.195,58 €;'sin fechas';02/05/2012;'AUTOPISTA';'Gastos_Ocio y transporte';'Parking y peaje';'VARIABLES'
02/06/2012;03/05/2012;'AUTOPISTA TERR';-1,31 €;13.670,18 €;2475;-1,31;18.194,27 €;'sin fechas';03/05/2012;'AUTOPISTA';'Gastos_Ocio y transporte';'Parking y peaje';'VARIABLES'
02/06/2012;03/05/2012;'AUTOPISTA TERR';-1,31 €;13.668,87 €;2476;-1,31;18.192,96 €;'sin fechas';03/05/2012;'AUTOPISTA';'Gastos_Ocio y transporte';'Parking y peaje';'VARIABLES'
02/06/2012;04/05/2012;'AUTOPISTA TERR';-1,24 €;13.667,63 €;2477;-1,24;18.191,72 €;'sin fechas';04/05/2012;'AUTOPISTA';'Gastos_Ocio y transporte';'Parking y peaje';'VARIABLES'
02/06/2012;04/05/2012;'AUTOPISTA TERR';-1,31 €;13.666,32 €;2478;-1,31;18.190,41 €;'sin fechas';04/05/2012;'AUTOPISTA';'Gastos_Ocio y transporte';'Parking y peaje';'VARIABLES'
02/06/2012;07/05/2012;'AUTOPISTA TERR';-1,24 €;13.665,08 €;2479;-1,24;18.189,17 €;'sin fechas';07/05/2012;'AUTOPISTA';'Gastos_Ocio y transporte';'Parking y peaje';'VARIABLES'
02/06/2012;07/05/2012;'AUTOPISTA TERR';-1,31 €;13.663,77 €;2480;-1,31;18.187,86 €;'sin fechas';07/05/2012;'AUTOPISTA';'Gastos_Ocio y transporte';'Parking y peaje';'VARIABLES'
02/06/2012;09/05/2012;'AUTOPISTA TERR';-1,31 €;13.662,46 €;2481;-1,31;18.186,55 €;'sin fechas';09/05/2012;'AUTOPISTA';'Gastos_Ocio y transporte';'Parking y peaje';'VARIABLES'
02/06/2012;09/05/2012;'AUTOPISTA TERR';-1,24 €;13.661,22 €;2482;-1,24;18.185,31 €;'sin fechas';09/05/2012;'AUTOPISTA';'Gastos_Ocio y transporte';'Parking y peaje';'VARIABLES'
02/06/2012;10/05/2012;'AUTOPISTA TERR';-1,24 €;13.659,98 €;2483;-1,24;18.184,07 €;'sin fechas';10/05/2012;'AUTOPISTA';'Gastos_Ocio y transporte';'Parking y peaje';'VARIABLES'
02/06/2012;10/05/2012;'AUTOPISTA TERR';-1,24 €;13.658,74 €;2484;-1,24;18.182,83 €;'sin fechas';10/05/2012;'AUTOPISTA';'Gastos_Ocio y transporte';'Parking y peaje';'VARIABLES'
02/06/2012;11/05/2012;'AUTOPISTA TERR';-1,18 €;13.657,56 €;2485;-1,18;18.181,65 €;'sin fechas';11/05/2012;'AUTOPISTA';'Gastos_Ocio y transporte';'Parking y peaje';'VARIABLES'
02/06/2012;11/05/2012;'AUTOPISTA TERR';-1,31 €;13.656,25 €;2486;-1,31;18.180,34 €;'sin fechas';11/05/2012;'AUTOPISTA';'Gastos_Ocio y transporte';'Parking y peaje';'VARIABLES'
02/06/2012;14/05/2012;'AUTOPISTA TERR';-1,18 €;13.655,07 €;2487;-1,18;18.179,16 €;'sin fechas';14/05/2012;'AUTOPISTA';'Gastos_Ocio y transporte';'Parking y peaje';'VARIABLES'
02/06/2012;14/05/2012;'AUTOPISTA TERR';-1,31 €;13.653,76 €;2488;-1,31;18.177,85 €;'sin fechas';14/05/2012;'AUTOPISTA';'Gastos_Ocio y transporte';'Parking y peaje';'VARIABLES'
02/06/2012;15/05/2012;'AUTOPISTA TERR';-1,18 €;13.652,58 €;2489;-1,18;18.176,67 €;'sin fechas';15/05/2012;'AUTOPISTA';'Gastos_Ocio y transporte';'Parking y peaje';'VARIABLES'
02/06/2012;15/05/2012;'AUTOPISTA TERR';-1,18 €;13.651,40 €;2490;-1,18;18.175,49 €;'sin fechas';15/05/2012;'AUTOPISTA';'Gastos_Ocio y transporte';'Parking y peaje';'VARIABLES'
02/06/2012;16/05/2012;'AUTOPISTA TERR';-1,18 €;13.650,22 €;2491;-1,18;18.174,31 €;'sin fechas';16/05/2012;'AUTOPISTA';'Gastos_Ocio y transporte';'Parking y peaje';'VARIABLES'
02/06/2012;16/05/2012;'AUTOPISTA TERR';-1,31 €;13.648,91 €;2492;-1,31;18.173,00 €;'sin fechas';16/05/2012;'AUTOPISTA';'Gastos_Ocio y transporte';'Parking y peaje';'VARIABLES'
02/06/2012;17/05/2012;'AUTOPISTA TERR';-1,18 €;13.647,73 €;2493;-1,18;18.171,82 €;'sin fechas';17/05/2012;'AUTOPISTA';'Gastos_Ocio y transporte';'Parking y peaje';'VARIABLES'
02/06/2012;17/05/2012;'AUTOPISTA TERR';-1,31 €;13.646,42 €;2494;-1,31;18.170,51 €;'sin fechas';17/05/2012;'AUTOPISTA';'Gastos_Ocio y transporte';'Parking y peaje';'VARIABLES'
02/06/2012;17/05/2012;'AUTOPISTA TERR';-1,18 €;13.645,24 €;2495;-1,18;18.169,33 €;'sin fechas';17/05/2012;'AUTOPISTA';'Gastos_Ocio y transporte';'Parking y peaje';'VARIABLES'
02/06/2012;18/05/2012;'AUTOPISTA TERR';-1,18 €;13.644,06 €;2496;-1,18;18.168,15 €;'sin fechas';18/05/2012;'AUTOPISTA';'Gastos_Ocio y transporte';'Parking y peaje';'VARIABLES'
02/06/2012;18/05/2012;'AUTOPISTA TERR';-1,18 €;13.642,88 €;2497;-1,18;18.166,97 €;'sin fechas';18/05/2012;'AUTOPISTA';'Gastos_Ocio y transporte';'Parking y peaje';'VARIABLES'
02/06/2012;21/05/2012;'AUTOPISTA TERR';-1,05 €;13.641,83 €;2498;-1,05;18.165,92 €;'sin fechas';21/05/2012;'AUTOPISTA';'Gastos_Ocio y transporte';'Parking y peaje';'VARIABLES'
02/06/2012;21/05/2012;'AUTOPISTA TERR';-1,18 €;13.640,65 €;2499;-1,18;18.164,74 €;'sin fechas';21/05/2012;'AUTOPISTA';'Gastos_Ocio y transporte';'Parking y peaje';'VARIABLES'
02/06/2012;22/05/2012;'AUTOPISTA TERR';-1,05 €;13.639,60 €;2500;-1,05;18.163,69 €;'sin fechas';22/05/2012;'AUTOPISTA';'Gastos_Ocio y transporte';'Parking y peaje';'VARIABLES'
02/06/2012;22/05/2012;'AUTOPISTA TERR';-1,05 €;13.638,55 €;2501;-1,05;18.162,64 €;'sin fechas';22/05/2012;'AUTOPISTA';'Gastos_Ocio y transporte';'Parking y peaje';'VARIABLES'
02/06/2012;23/05/2012;'AUTOPISTA TERR';-1,05 €;13.637,50 €;2502;-1,05;18.161,59 €;'sin fechas';23/05/2012;'AUTOPISTA';'Gastos_Ocio y transporte';'Parking y peaje';'VARIABLES'
02/06/2012;25/05/2012;'AUTOPISTA TERR';-1,05 €;13.636,45 €;2503;-1,05;18.160,54 €;'sin fechas';25/05/2012;'AUTOPISTA';'Gastos_Ocio y transporte';'Parking y peaje';'VARIABLES'
02/06/2012;25/05/2012;'AUTOPISTA TERR';-1,05 €;13.635,40 €;2504;-1,05;18.159,49 €;'sin fechas';25/05/2012;'AUTOPISTA';'Gastos_Ocio y transporte';'Parking y peaje';'VARIABLES'
02/06/2012;27/04/2012;'PARKING CAPIO SANIDAD';-6,25 €;13.629,15 €;2505;-6,25;18.153,24 €;'sin fechas';27/04/2012;'PARKING';'Gastos_Ocio y transporte';'Parking y peaje';'VARIABLES'
02/06/2012;09/05/2012;'PARKING CAPIO SANIDAD';-6,50 €;13.622,65 €;2506;-6,50;18.146,74 €;'sin fechas';09/05/2012;'PARKING';'Gastos_Ocio y transporte';'Parking y peaje';'VARIABLES'
02/06/2012;14/05/2012;'PARKING CLINICA C';-1,50 €;13.621,15 €;2507;-1,50;18.145,24 €;'sin fechas';14/05/2012;'PARKING';'Gastos_Ocio y transporte';'Parking y peaje';'VARIABLES'
02/06/2012;02/06/2012;'RESTAURANTES';-12,50 €;13.608,65 €;2508;-12,50;18.132,74 €;'sin fechas';02/06/2012;'RESTAURANTES';'Gastos_Ocio y transporte';'Restaurantes';'VARIABLES'
02/06/2012;14/05/2012;'TABASA A S.CUGAT C:2T';-3,53 €;13.605,12 €;2509;-3,53;18.129,21 €;'sin fechas';14/05/2012;'TABASA';'Gastos_Ocio y transporte';'Parking y peaje';'VARIABLES'
03/06/2012;03/06/2012;'ES STA. MARGARITA';-13,59 €;13.591,53 €;2510;-13,59;18.115,62 €;'sin fechas';03/06/2012;'STA';'Gastos_Ocio y transporte';'Gasolina';'VARIABLES'
03/06/2012;03/06/2012;'RESTAURANTES';-12,50 €;13.579,03 €;2511;-12,50;18.103,12 €;'sin fechas';03/06/2012;'RESTAURANTES';'Gastos_Ocio y transporte';'Restaurantes';'VARIABLES'
03/06/2012;03/06/2012;'RESTAURANTES';-3,40 €;13.575,63 €;2512;-3,40;18.099,72 €;'sin fechas';03/06/2012;'RESTAURANTES';'Gastos_Ocio y transporte';'Restaurantes';'VARIABLES'
03/06/2012;03/06/2012;'RESTAURANTES';-12,20 €;13.563,43 €;2513;-12,20;18.087,52 €;'sin fechas';03/06/2012;'RESTAURANTES';'Gastos_Ocio y transporte';'Restaurantes';'VARIABLES'
04/06/2012;03/06/2012;'RESTAURANTES';-12,50 €;13.550,93 €;2514;-12,50;18.075,02 €;'sin fechas';03/06/2012;'RESTAURANTES';'Gastos_Ocio y transporte';'Restaurantes';'VARIABLES'
04/06/2012;04/06/2012;'RESTAURANTES';-12,50 €;13.538,43 €;2515;-12,50;18.062,52 €;'sin fechas';04/06/2012;'RESTAURANTES';'Gastos_Ocio y transporte';'Restaurantes';'VARIABLES'
04/06/2012;04/06/2012;'RESTAURANTES';-12,50 €;13.525,93 €;2516;-12,50;18.050,02 €;'sin fechas';04/06/2012;'RESTAURANTES';'Gastos_Ocio y transporte';'Restaurantes';'VARIABLES'
04/06/2012;04/06/2012;'RESTAURANTES';-7,75 €;13.518,18 €;2517;-7,75;18.042,27 €;'sin fechas';04/06/2012;'RESTAURANTES';'Gastos_Ocio y transporte';'Restaurantes';'VARIABLES'
05/06/2012;05/06/2012;'COM. MANT. ACTIVAS DE LIQ.';-4,50 €;13.513,68 €;2518;-4,50;18.037,77 €;'sin fechas';05/06/2012;'COM';'Gastos_Banco y organismos';'Cargos banco';'FIJO'
05/06/2012;05/06/2012;'ESCOLA BRESSOL EINA';-529,76 €;12.983,92 €;2519;-529,76;17.508,01 €;'sin fechas';05/06/2012;'ESCOLA';'Gastos_Salud, saber y deporte';'Estudios';'VARIABLES'
05/06/2012;05/06/2012;'HOSPITAL GRAL \\SANT CUGAT D';-7,55 €;12.976,37 €;2520;-7,55;17.500,46 €;'sin fechas';05/06/2012;'HOSPITAL';'Gastos_Salud, saber y deporte';'Medico';'VARIABLES'
05/06/2012;05/06/2012;'YOIGO';-43,98 €;12.932,39 €;2521;-43,98;17.456,48 €;'sin fechas';05/06/2012;'YOIGO';'Gastos_Servicios tipicos';'Telecomunicaciones';'FIJO'
06/06/2012;06/06/2012;'A.E.A.T. DEVOLUCIONES TRIBUTAR';1.060,52 €;13.992,91 €;2522;1.060,52;18.517,00 €;'sin fechas';06/06/2012;'AEAT';'Ingresos';'Devoluciones';'VARIABLES'
07/06/2012;05/06/2012;'COCHE&PARKING';-6,10 €;13.986,81 €;2523;-6,10;18.510,90 €;'sin fechas';05/06/2012;'COCHEPARKING';'Gastos_Ocio y transporte';'Parking y peaje';'VARIABLES'
07/06/2012;05/06/2012;'COCHE&PARKING';-7,10 €;13.979,71 €;2524;-7,10;18.503,80 €;'sin fechas';05/06/2012;'COCHEPARKING';'Gastos_Ocio y transporte';'Parking y peaje';'VARIABLES'
07/06/2012;07/06/2012;'GAS NATURAL';-10,27 €;13.969,44 €;2525;-10,27;18.493,53 €;'sin fechas';07/06/2012;'GAS';'Gastos_Servicios tipicos';'Gas';'FIJO'
07/06/2012;07/06/2012;'IBERDROLA GE IBERDRO1011516485';-159,93 €;13.809,51 €;2526;-159,93;18.333,60 €;'sin fechas';07/06/2012;'IBERDROLA';'Gastos_Servicios tipicos';'Electricidad';'FIJO'
08/06/2012;03/06/2012;'AUTOPISTA TERR';-1,31 €;13.808,20 €;2527;-1,31;18.332,29 €;'sin fechas';03/06/2012;'AUTOPISTA';'Gastos_Ocio y transporte';'Parking y peaje';'VARIABLES'
08/06/2012;08/06/2012;'ES STA. MARGARITA';-47,69 €;13.760,51 €;2528;-47,69;18.284,60 €;'sin fechas';08/06/2012;'STA';'Gastos_Ocio y transporte';'Gasolina';'VARIABLES'
08/06/2012;08/06/2012;'FARMACIA';-4,82 €;13.755,69 €;2529;-4,82;18.279,78 €;'sin fechas';08/06/2012;'FARMACIA';'Gastos_Salud, saber y deporte';'Farmacia';'VARIABLES'
08/06/2012;08/06/2012;'RESTAURANTES';-21,50 €;13.734,19 €;2530;-21,50;18.258,28 €;'sin fechas';08/06/2012;'RESTAURANTES';'Gastos_Ocio y transporte';'Restaurantes';'VARIABLES'
10/06/2012;10/06/2012;'CAFET.C T PRAT';-3,75 €;13.730,44 €;2531;-3,75;18.254,53 €;'sin fechas';10/06/2012;'CAFETC';'Gastos_Ocio y transporte';'Restaurantes';'VARIABLES'
10/06/2012;10/06/2012;'TICKETS [ABONO]';236,00 €;13.966,44 €;2532;236,00;18.490,53 €;'sin fechas';10/06/2012;'TICKETS';'Gastos_Salud, saber y deporte';'Estudios';'VARIABLES'
10/06/2012;10/06/2012;'TICKETS [CARGO]';-236,00 €;13.730,44 €;2533;-236,00;18.254,53 €;'sin fechas';10/06/2012;'TICKETS';'Gastos_Salud, saber y deporte';'Estudios';'VARIABLES'
11/06/2012;11/06/2012;'BON AREA';-10,44 €;13.720,00 €;2534;-10,44;18.244,09 €;'sin fechas';11/06/2012;'BON';'Gastos_Compras';'Supermercado';'VARIABLES'
11/06/2012;11/06/2012;'COCHE&PARKING';-8,55 €;13.711,45 €;2535;-8,55;18.235,54 €;'sin fechas';11/06/2012;'COCHEPARKING';'Gastos_Ocio y transporte';'Parking y peaje';'VARIABLES'
11/06/2012;11/06/2012;'DISNEY STORE';-18,00 €;13.693,45 €;2536;-18,00;18.217,54 €;'sin fechas';11/06/2012;'DISNEY';'Gastos_Compras';'Ropa';'VARIABLES'
11/06/2012;11/06/2012;'FARMACIA';-24,50 €;13.668,95 €;2537;-24,50;18.193,04 €;'sin fechas';11/06/2012;'FARMACIA';'Gastos_Salud, saber y deporte';'Farmacia';'VARIABLES'
11/06/2012;11/06/2012;'RESTAURANTES';-13,30 €;13.655,65 €;2538;-13,30;18.179,74 €;'sin fechas';11/06/2012;'RESTAURANTES';'Gastos_Ocio y transporte';'Restaurantes';'VARIABLES'
13/06/2012;13/06/2012;'ENDESA ENERG EE_XXI40025545678';-73,90 €;13.581,75 €;2539;-73,90;18.105,84 €;'sin fechas';13/06/2012;'ENDESA';'Gastos_Servicios tipicos';'Electricidad';'FIJO'
14/06/2012;06/06/2012;'AUTOPISTA TERR';-2,39 €;13.579,36 €;2540;-2,39;18.103,45 €;'sin fechas';06/06/2012;'AUTOPISTA';'Gastos_Ocio y transporte';'Parking y peaje';'VARIABLES'
14/06/2012;06/06/2012;'AUTOPISTA TERR';-2,39 €;13.576,97 €;2541;-2,39;18.101,06 €;'sin fechas';06/06/2012;'AUTOPISTA';'Gastos_Ocio y transporte';'Parking y peaje';'VARIABLES'
14/06/2012;13/06/2012;'GASOLINERA';-5,92 €;13.571,05 €;2542;-5,92;18.095,14 €;'sin fechas';13/06/2012;'GASOLINERA';'Gastos_Ocio y transporte';'Gasolina';'VARIABLES'
14/06/2012;12/06/2012;'RESTAURANTES';-43,45 €;13.527,60 €;2543;-43,45;18.051,69 €;'sin fechas';12/06/2012;'RESTAURANTES';'Gastos_Ocio y transporte';'Restaurantes';'VARIABLES'
15/06/2012;15/06/2012;'CCM VIDA Y P SEGURO PRESTAMO';-26,07 €;13.501,53 €;2544;-26,07;18.025,62 €;'sin fechas';15/06/2012;'CCM';'Gastos_Seguros';'Seguro vida';'FIJO'
15/06/2012;15/06/2012;'CCM VIDA Y PENSIO 000000493358';-18,87 €;13.482,66 €;2545;-18,87;18.006,75 €;'sin fechas';15/06/2012;'CCM';'Gastos_Seguros';'Seguro vida';'FIJO'
16/06/2012;16/06/2012;'BON AREA';-2,77 €;13.479,89 €;2546;-2,77;18.003,98 €;'sin fechas';16/06/2012;'BON';'Gastos_Compras';'Supermercado';'VARIABLES'
17/06/2012;09/06/2012;'AUTOPISTA TERR';-1,31 €;13.478,58 €;2547;-1,31;18.002,67 €;'sin fechas';09/06/2012;'AUTOPISTA';'Gastos_Ocio y transporte';'Parking y peaje';'VARIABLES'
17/06/2012;13/06/2012;'AUTOPISTA TERR';-2,39 €;13.476,19 €;2548;-2,39;18.000,28 €;'sin fechas';13/06/2012;'AUTOPISTA';'Gastos_Ocio y transporte';'Parking y peaje';'VARIABLES'
17/06/2012;17/06/2012;'MERCADONA';-207,34 €;13.268,85 €;2549;-207,34;17.792,94 €;'sin fechas';17/06/2012;'MERCADONA';'Gastos_Compras';'Supermercado';'VARIABLES'
18/06/2012;18/06/2012;'BLITZ';-70,80 €;13.198,05 €;2550;-70,80;17.722,14 €;'sin fechas';18/06/2012;'BLITZ';'Gastos_Vivienda y vehiculo';'Alquiler Parking';'FIJO'
18/06/2012;18/06/2012;'BON AREA';-5,02 €;13.193,03 €;2551;-5,02;17.717,12 €;'sin fechas';18/06/2012;'BON';'Gastos_Compras';'Supermercado';'VARIABLES'
18/06/2012;18/06/2012;'CARREFOUR-[COMIDA]';-29,01 €;13.164,02 €;2552;-29,01;17.688,11 €;'sin fechas';18/06/2012;'CARREFOURCOMIDA';'Gastos_Compras';'Supermercado';'VARIABLES'
18/06/2012;11/06/2012;'COCHE&PARKING';-1,80 €;13.162,22 €;2553;-1,80;17.686,31 €;'sin fechas';11/06/2012;'COCHEPARKING';'Gastos_Ocio y transporte';'Parking y peaje';'VARIABLES'
18/06/2012;18/06/2012;'FARMACIA';-40,01 €;13.122,21 €;2554;-40,01;17.646,30 €;'sin fechas';18/06/2012;'FARMACIA';'Gastos_Salud, saber y deporte';'Farmacia';'VARIABLES'
18/06/2012;18/06/2012;'FARMACIA';-6,68 €;13.115,53 €;2555;-6,68;17.639,62 €;'sin fechas';18/06/2012;'FARMACIA';'Gastos_Salud, saber y deporte';'Farmacia';'VARIABLES'
19/06/2012;19/06/2012;'AG.TRIBUT GABRIEL';100,00 €;13.215,53 €;2556;100,00;17.739,62 €;'sin fechas';19/06/2012;'AGTRIBUT';'Ingresos';'Subvenciones';
19/06/2012;19/06/2012;'ONO';-87,75 €;13.127,78 €;2557;-87,75;17.651,87 €;'sin fechas';19/06/2012;'ONO';'Gastos_Servicios tipicos';'Telecomunicaciones';'FIJO'
20/06/2012;20/06/2012;'ALCAMPO';-14,84 €;13.112,94 €;2558;-14,84;17.637,03 €;'sin fechas';20/06/2012;'ALCAMPO';'Gastos_Compras';'Supermercado';'VARIABLES'
20/06/2012;20/06/2012;'FOMENT DE TERRASSA, S.A. FOMEN';1.686,05 €;14.798,99 €;2559;1.686,05;19.323,08 €;'sin fechas';20/06/2012;'FOMENT';'Ingresos';'Nomina';'FIJO'
20/06/2012;20/06/2012;'MINA PUBLICA AIGUES T.01A75789';-43,08 €;14.755,91 €;2560;-43,08;19.280,00 €;'sin fechas';20/06/2012;'MINA';'Gastos_Servicios tipicos';'Agua';'FIJO'
21/06/2012;19/06/2012;'CASAS SABATERS';-5,00 €;14.750,91 €;2561;-5,00;19.275,00 €;'sin fechas';19/06/2012;'CASAS';'Gastos_Compras';'Ropa';'VARIABLES'
21/06/2012;14/06/2012;'COCHE&PARKING';-2,35 €;14.748,56 €;2562;-2,35;19.272,65 €;'sin fechas';14/06/2012;'COCHEPARKING';'Gastos_Ocio y transporte';'Parking y peaje';'VARIABLES'
21/06/2012;21/06/2012;'DIRECCION PROVINCIAL INSS BARC';1.060,16 €;15.808,72 €;2563;1.060,16;20.332,81 €;'sin fechas';21/06/2012;'DIRECCION';'Ingresos';'Nomina';'FIJO'
21/06/2012;21/06/2012;'DIRECCION PROVINCIAL INSS BARC';175,54 €;15.984,26 €;2564;175,54;20.508,35 €;'sin fechas';21/06/2012;'DIRECCION';'Ingresos';'Nomina';'FIJO'
22/06/2012;22/06/2012;'BON AREA';-16,19 €;15.968,07 €;2565;-16,19;20.492,16 €;'sin fechas';22/06/2012;'BON';'Gastos_Compras';'Supermercado';'VARIABLES'
22/06/2012;16/06/2012;'COCHE&PARKING';-4,50 €;15.963,57 €;2566;-4,50;20.487,66 €;'sin fechas';16/06/2012;'COCHEPARKING';'Gastos_Ocio y transporte';'Parking y peaje';'VARIABLES'
22/06/2012;17/06/2012;'COCHE&PARKING';-4,70 €;15.958,87 €;2567;-4,70;20.482,96 €;'sin fechas';17/06/2012;'COCHEPARKING';'Gastos_Ocio y transporte';'Parking y peaje';'VARIABLES'
23/06/2012;23/06/2012;'ALCAMPO';-26,74 €;15.932,13 €;2568;-26,74;20.456,22 €;'sin fechas';23/06/2012;'ALCAMPO';'Gastos_Compras';'Supermercado';'VARIABLES'
23/06/2012;23/06/2012;'GASOLINERA';-50,39 €;15.881,74 €;2569;-50,39;20.405,83 €;'sin fechas';23/06/2012;'GASOLINERA';'Gastos_Ocio y transporte';'Gasolina';'VARIABLES'
24/06/2012;24/06/2012;'TIMBERLAND';-35,75 €;15.845,99 €;2570;-35,75;20.370,08 €;'sin fechas';24/06/2012;'TIMBERLAND';'Gastos_Compras';'Ropa';'VARIABLES'
25/06/2012;18/06/2012;'AUTOPISTA TERR';-1,31 €;15.844,68 €;2571;-1,31;20.368,77 €;'sin fechas';18/06/2012;'AUTOPISTA';'Gastos_Ocio y transporte';'Parking y peaje';'VARIABLES'
25/06/2012;25/06/2012;'AUTOPISTA TERR';-1,31 €;15.843,37 €;2572;-1,31;20.367,46 €;'sin fechas';25/06/2012;'AUTOPISTA';'Gastos_Ocio y transporte';'Parking y peaje';'VARIABLES'
25/06/2012;25/06/2012;'CAFET.C T PRAT';-3,75 €;15.839,62 €;2573;-3,75;20.363,71 €;'sin fechas';25/06/2012;'CAFETC';'Gastos_Ocio y transporte';'Restaurantes';'VARIABLES'
25/06/2012;25/06/2012;'MERCADONA';-216,00 €;15.623,62 €;2574;-216,00;20.147,71 €;'sin fechas';25/06/2012;'MERCADONA';'Gastos_Compras';'Supermercado';'VARIABLES'
26/06/2012;26/06/2012;'CAPIO SANIDAD \\SANT CUGAT D';-78,00 €;15.545,62 €;2575;-78,00;20.069,71 €;'sin fechas';26/06/2012;'CAPIO';'Gastos_Salud, saber y deporte';'Medico';'VARIABLES'
26/06/2012;26/06/2012;'FF.CC.GENERALITAT';-2,70 €;15.542,92 €;2576;-2,70;20.067,01 €;'sin fechas';26/06/2012;'FFCCGENERALITAT';'Gastos_Ocio y transporte';'Transporte';'VARIABLES'
27/06/2012;27/06/2012;'INFORMACIO I TECNOLOGIA DE CAT';827,02 €;16.369,94 €;2577;827,02;20.894,03 €;'sin fechas';27/06/2012;'INFORMACIO';'Ingresos';'Nomina';'FIJO'
28/06/2012;28/06/2012;'LIFECOLOR NASTA S.\\BADALONA';-79,10 €;16.290,84 €;2578;-79,10;20.814,93 €;'sin fechas';28/06/2012;'LIFECOLOR';'Gastos_Compras';'Regalos';'VARIABLES'
28/06/2012;26/06/2012;'TOCINERIES VENTURA';-8,46 €;16.282,38 €;2579;-8,46;20.806,47 €;'sin fechas';26/06/2012;'TOCINERIES';'Gastos_Compras';'Supermercado';'VARIABLES'
29/06/2012;22/06/2012;'AUTOPISTA TERR';-1,31 €;16.281,07 €;2580;-1,31;20.805,16 €;'sin fechas';22/06/2012;'AUTOPISTA';'Gastos_Ocio y transporte';'Parking y peaje';'VARIABLES'
29/06/2012;29/06/2012;'CAFET.C T PRAT';-3,75 €;16.277,32 €;2581;-3,75;20.801,41 €;'sin fechas';29/06/2012;'CAFETC';'Gastos_Ocio y transporte';'Restaurantes';'VARIABLES'
30/06/2012;30/06/2012;'BON AREA';-17,08 €;16.260,24 €;2582;-17,08;20.784,33 €;'sin fechas';30/06/2012;'BON';'Gastos_Compras';'Supermercado';'VARIABLES'
30/06/2012;30/06/2012;'COMUNIDAD';-20,00 €;16.240,24 €;2583;-20,00;20.764,33 €;'sin fechas';30/06/2012;'COMUNIDAD';'Gastos_Vivienda y vehiculo';'Comunidad';'FIJO'
30/06/2012;30/06/2012;'DIRECCION PROVINCIAL INSS BARC';2.546,81 €;18.787,05 €;2584;2.546,81;23.311,14 €;'sin fechas';30/06/2012;'DIRECCION';'Ingresos';'Nomina';'FIJO'
30/06/2012;30/06/2012;'MERCADONA';-56,21 €;18.730,84 €;2585;-56,21;23.254,93 €;'sin fechas';30/06/2012;'MERCADONA';'Gastos_Compras';'Supermercado';'VARIABLES'
30/06/2012;30/06/2012;'RECIBO PTMOS. 3061-0960001518';-583,25 €;18.147,59 €;2586;-583,25;22.671,68 €;'sin fechas';30/06/2012;'RECIBO';'Gastos_Banco y organismos';'Hipoteca';'FIJO'
01/07/2012;01/07/2012;'FARMACIA';-46,00 €;18.101,59 €;2587;-46,00;22.625,68 €;'sin fechas';01/07/2012;'FARMACIA';'Gastos_Salud, saber y deporte';'Farmacia';'VARIABLES'
01/07/2012;01/07/2012;'LLIBR.SANT JORDI';-10,65 €;18.090,94 €;2588;-10,65;22.615,03 €;'sin fechas';01/07/2012;'LLIBRSANT';'Gastos_Compras';'Libreria';'VARIABLES'
01/07/2012;01/07/2012;'MANTENIMIENTO';-2,25 €;18.088,69 €;2589;-2,25;22.612,78 €;'sin fechas';01/07/2012;'MANTENIMIENTO';'Gastos_Banco y organismos';'Cargos banco';'FIJO'
02/07/2012;02/07/2012;'AJUNTAMENT DE TER PAAAAAAPNVWE';-42,95 €;18.045,74 €;2590;-42,95;22.569,83 €;'sin fechas';02/07/2012;'AJUNTAMENT';'Gastos_Banco y organismos';'Ayuntamiento';'FIJO'
02/07/2012;29/05/2012;'AUTOPISTA TERR';-1,05 €;18.044,69 €;2591;-1,05;22.568,78 €;'sin fechas';29/05/2012;'AUTOPISTA';'Gastos_Ocio y transporte';'Parking y peaje';'VARIABLES'
02/07/2012;29/05/2012;'AUTOPISTA TERR';-1,05 €;18.043,64 €;2592;-1,05;22.567,73 €;'sin fechas';29/05/2012;'AUTOPISTA';'Gastos_Ocio y transporte';'Parking y peaje';'VARIABLES'
02/07/2012;30/05/2012;'AUTOPISTA TERR';-1,31 €;18.042,33 €;2593;-1,31;22.566,42 €;'sin fechas';30/05/2012;'AUTOPISTA';'Gastos_Ocio y transporte';'Parking y peaje';'VARIABLES'
02/07/2012;31/05/2012;'AUTOPISTA TERR';-1,05 €;18.041,28 €;2594;-1,05;22.565,37 €;'sin fechas';31/05/2012;'AUTOPISTA';'Gastos_Ocio y transporte';'Parking y peaje';'VARIABLES'
02/07/2012;05/06/2012;'AUTOPISTA TERR';-1,31 €;18.039,97 €;2595;-1,31;22.564,06 €;'sin fechas';05/06/2012;'AUTOPISTA';'Gastos_Ocio y transporte';'Parking y peaje';'VARIABLES'
02/07/2012;07/06/2012;'AUTOPISTA TERR';-1,31 €;18.038,66 €;2596;-1,31;22.562,75 €;'sin fechas';07/06/2012;'AUTOPISTA';'Gastos_Ocio y transporte';'Parking y peaje';'VARIABLES'
02/07/2012;18/06/2012;'AUTOPISTA TERR';-1,31 €;18.037,35 €;2597;-1,31;22.561,44 €;'sin fechas';18/06/2012;'AUTOPISTA';'Gastos_Ocio y transporte';'Parking y peaje';'VARIABLES'
02/07/2012;18/06/2012;'AUTOPISTA TERR';-1,31 €;18.036,04 €;2598;-1,31;22.560,13 €;'sin fechas';18/06/2012;'AUTOPISTA';'Gastos_Ocio y transporte';'Parking y peaje';'VARIABLES'
02/07/2012;20/06/2012;'AUTOPISTA TERR';-1,31 €;18.034,73 €;2599;-1,31;22.558,82 €;'sin fechas';20/06/2012;'AUTOPISTA';'Gastos_Ocio y transporte';'Parking y peaje';'VARIABLES'
02/07/2012;22/06/2012;'AUTOPISTA TERR';-1,31 €;18.033,42 €;2600;-1,31;22.557,51 €;'sin fechas';22/06/2012;'AUTOPISTA';'Gastos_Ocio y transporte';'Parking y peaje';'VARIABLES'
02/07/2012;26/06/2012;'AUTOPISTA TERR';-1,31 €;18.032,11 €;2601;-1,31;22.556,20 €;'sin fechas';26/06/2012;'AUTOPISTA';'Gastos_Ocio y transporte';'Parking y peaje';'VARIABLES'
02/07/2012;28/06/2012;'AUTOPISTA TERR';-1,31 €;18.030,80 €;2602;-1,31;22.554,89 €;'sin fechas';28/06/2012;'AUTOPISTA';'Gastos_Ocio y transporte';'Parking y peaje';'VARIABLES'
02/07/2012;02/07/2012;'LEROY MERLIN';-10,12 €;18.020,68 €;2603;-10,12;22.544,77 €;'sin fechas';02/07/2012;'LEROY';'Gastos_Vivienda y vehiculo';'Mnto. hogar';'VARIABLES'
02/07/2012;02/07/2012;'MERCADONA';-17,05 €;18.003,63 €;2604;-17,05;22.527,72 €;'sin fechas';02/07/2012;'MERCADONA';'Gastos_Compras';'Supermercado';'VARIABLES'
02/07/2012;03/06/2012;'PARKING CAPIO SANIDAD';-4,70 €;17.998,93 €;2605;-4,70;22.523,02 €;'sin fechas';03/06/2012;'PARKING';'Gastos_Ocio y transporte';'Parking y peaje';'VARIABLES'
02/07/2012;05/06/2012;'PARKING CAPIO SANIDAD';-5,95 €;17.992,98 €;2606;-5,95;22.517,07 €;'sin fechas';05/06/2012;'PARKING';'Gastos_Ocio y transporte';'Parking y peaje';'VARIABLES'
02/07/2012;06/06/2012;'PARKING CAPIO SANIDAD';-3,40 €;17.989,58 €;2607;-3,40;22.513,67 €;'sin fechas';06/06/2012;'PARKING';'Gastos_Ocio y transporte';'Parking y peaje';'VARIABLES'
02/07/2012;15/06/2012;'PARKING CAPIO SANIDAD';-2,10 €;17.987,48 €;2608;-2,10;22.511,57 €;'sin fechas';15/06/2012;'PARKING';'Gastos_Ocio y transporte';'Parking y peaje';'VARIABLES'
02/07/2012;21/06/2012;'SATSA PL. VELLA TERRASSA';-4,90 €;17.982,58 €;2609;-4,90;22.506,67 €;'sin fechas';21/06/2012;'SATSA';'Gastos_Ocio y transporte';'Parking y peaje';'VARIABLES'
04/07/2012;04/07/2012;'YOIGO';-41,54 €;17.941,04 €;2610;-41,54;22.465,13 €;'sin fechas';04/07/2012;'YOIGO';'Gastos_Servicios tipicos';'Telecomunicaciones';'FIJO'
05/07/2012;05/07/2012;'ADESLAS CENTRAL 006662671613';-175,00 €;17.766,04 €;2611;-175,00;22.290,13 €;'sin fechas';05/07/2012;'ADESLAS';'Gastos_Salud, saber y deporte';'Medico';'VARIABLES'
05/07/2012;05/07/2012;'ESCOLA BRESSOL EINA';-236,00 €;17.530,04 €;2612;-236,00;22.054,13 €;'sin fechas';05/07/2012;'ESCOLA';'Gastos_Salud, saber y deporte';'Estudios';'VARIABLES'
05/07/2012;05/07/2012;'GAS NATURAL';-10,27 €;17.519,77 €;2613;-10,27;22.043,86 €;'sin fechas';05/07/2012;'GAS';'Gastos_Servicios tipicos';'Gas';'FIJO'
05/07/2012;05/07/2012;'M&S';-31,00 €;17.488,77 €;2614;-31,00;22.012,86 €;'sin fechas';05/07/2012;'MS';'Gastos_Compras';'Ropa';'VARIABLES'
06/07/2012;30/06/2012;'AUTOPISTA TERR';-1,31 €;17.487,46 €;2615;-1,31;22.011,55 €;'sin fechas';30/06/2012;'AUTOPISTA';'Gastos_Ocio y transporte';'Parking y peaje';'VARIABLES'
06/07/2012;30/06/2012;'AUTOPISTA TERR';-1,31 €;17.486,15 €;2616;-1,31;22.010,24 €;'sin fechas';30/06/2012;'AUTOPISTA';'Gastos_Ocio y transporte';'Parking y peaje';'VARIABLES'
06/07/2012;01/07/2012;'AUTOPISTA TERR';-1,31 €;17.484,84 €;2617;-1,31;22.008,93 €;'sin fechas';01/07/2012;'AUTOPISTA';'Gastos_Ocio y transporte';'Parking y peaje';'VARIABLES'
06/07/2012;01/07/2012;'AUTOPISTA TERR';-1,31 €;17.483,53 €;2618;-1,31;22.007,62 €;'sin fechas';01/07/2012;'AUTOPISTA';'Gastos_Ocio y transporte';'Parking y peaje';'VARIABLES'
06/07/2012;01/07/2012;'AUTOPISTA TERR';-1,24 €;17.482,29 €;2619;-1,24;22.006,38 €;'sin fechas';01/07/2012;'AUTOPISTA';'Gastos_Ocio y transporte';'Parking y peaje';'VARIABLES'
06/07/2012;06/07/2012;'BON AREA';-12,26 €;17.470,03 €;2620;-12,26;21.994,12 €;'sin fechas';06/07/2012;'BON';'Gastos_Compras';'Supermercado';'VARIABLES'
06/07/2012;06/07/2012;'FARMACIA';-12,12 €;17.457,91 €;2621;-12,12;21.982,00 €;'sin fechas';06/07/2012;'FARMACIA';'Gastos_Salud, saber y deporte';'Farmacia';'VARIABLES'
07/07/2012;07/07/2012;'MERCADONA';-34,32 €;17.423,59 €;2622;-34,32;21.947,68 €;'sin fechas';07/07/2012;'MERCADONA';'Gastos_Compras';'Supermercado';'VARIABLES'
09/07/2012;09/07/2012;'H&M';-51,80 €;17.371,79 €;2623;-51,80;21.895,88 €;'sin fechas';09/07/2012;'HM';'Gastos_Compras';'Ropa';'VARIABLES'
09/07/2012;09/07/2012;'KIABI';-34,98 €;17.336,81 €;2624;-34,98;21.860,90 €;'sin fechas';09/07/2012;'KIABI';'Gastos_Compras';'Ropa';'VARIABLES'
09/07/2012;09/07/2012;'KIABI';-34,98 €;17.301,83 €;2625;-34,98;21.825,92 €;'sin fechas';09/07/2012;'KIABI';'Gastos_Compras';'Ropa';'VARIABLES'
09/07/2012;09/07/2012;'KIABI';-34,98 €;17.266,85 €;2626;-34,98;21.790,94 €;'sin fechas';09/07/2012;'KIABI';'Gastos_Compras';'Ropa';'VARIABLES'
10/07/2012;04/07/2012;'AUTOPISTA TERR';-1,31 €;17.265,54 €;2627;-1,31;21.789,63 €;'sin fechas';04/07/2012;'AUTOPISTA';'Gastos_Ocio y transporte';'Parking y peaje';'VARIABLES'
10/07/2012;04/07/2012;'AUTOPISTA TERR';-1,31 €;17.264,23 €;2628;-1,31;21.788,32 €;'sin fechas';04/07/2012;'AUTOPISTA';'Gastos_Ocio y transporte';'Parking y peaje';'VARIABLES'
10/07/2012;10/07/2012;'MERCADONA';-97,92 €;17.166,31 €;2629;-97,92;21.690,40 €;'sin fechas';10/07/2012;'MERCADONA';'Gastos_Compras';'Supermercado';'VARIABLES'
12/07/2012;12/07/2012;'C&A';-33,20 €;17.133,11 €;2630;-33,20;21.657,20 €;'sin fechas';12/07/2012;'CA';'Gastos_Compras';'Ropa';'VARIABLES'
12/07/2012;12/07/2012;'GASOLINERA';-13,44 €;17.119,67 €;2631;-13,44;21.643,76 €;'sin fechas';12/07/2012;'GASOLINERA';'Gastos_Ocio y transporte';'Gasolina';'VARIABLES'
12/07/2012;12/07/2012;'MERCADONA';-9,98 €;17.109,69 €;2632;-9,98;21.633,78 €;'sin fechas';12/07/2012;'MERCADONA';'Gastos_Compras';'Supermercado';'VARIABLES'
12/07/2012;12/07/2012;'RESTAURANTES';-21,40 €;17.088,29 €;2633;-21,40;21.612,38 €;'sin fechas';12/07/2012;'RESTAURANTES';'Gastos_Ocio y transporte';'Restaurantes';'VARIABLES'
12/07/2012;12/07/2012;'VIENA';-9,35 €;17.078,94 €;2634;-9,35;21.603,03 €;'sin fechas';12/07/2012;'VIENA';'Gastos_Ocio y transporte';'Restaurantes';'VARIABLES'
13/07/2012;09/07/2012;'AUTOPISTA TERR';-1,31 €;17.077,63 €;2635;-1,31;21.601,72 €;'sin fechas';09/07/2012;'AUTOPISTA';'Gastos_Ocio y transporte';'Parking y peaje';'VARIABLES'
13/07/2012;09/07/2012;'AUTOPISTA TERR';-1,31 €;17.076,32 €;2636;-1,31;21.600,41 €;'sin fechas';09/07/2012;'AUTOPISTA';'Gastos_Ocio y transporte';'Parking y peaje';'VARIABLES'
13/07/2012;13/07/2012;'BLITZ';-70,80 €;17.005,52 €;2637;-70,80;21.529,61 €;'sin fechas';13/07/2012;'BLITZ';'Gastos_Vivienda y vehiculo';'Alquiler Parking';'FIJO'
13/07/2012;13/07/2012;'CAFET.C T PRAT';-4,10 €;17.001,42 €;2638;-4,10;21.525,51 €;'sin fechas';13/07/2012;'CAFETC';'Gastos_Ocio y transporte';'Restaurantes';'VARIABLES'
13/07/2012;13/07/2012;'ENDESA ENERG EE_XXI40025545678';-88,03 €;16.913,39 €;2639;-88,03;21.437,48 €;'sin fechas';13/07/2012;'ENDESA';'Gastos_Servicios tipicos';'Electricidad';'FIJO'
14/07/2012;14/07/2012;'CAFET.C T PRAT';-3,45 €;16.909,94 €;2640;-3,45;21.434,03 €;'sin fechas';14/07/2012;'CAFETC';'Gastos_Ocio y transporte';'Restaurantes';'VARIABLES'
14/07/2012;14/07/2012;'DECATHLON';-45,79 €;16.864,15 €;2641;-45,79;21.388,24 €;'sin fechas';14/07/2012;'DECATHLON';'Gastos_Compras';'Deportivo';'VARIABLES'
14/07/2012;14/07/2012;'GASOLINERA';-50,06 €;16.814,09 €;2642;-50,06;21.338,18 €;'sin fechas';14/07/2012;'GASOLINERA';'Gastos_Ocio y transporte';'Gasolina';'VARIABLES'
14/07/2012;14/07/2012;'MERCADONA';-33,59 €;16.780,50 €;2643;-33,59;21.304,59 €;'sin fechas';14/07/2012;'MERCADONA';'Gastos_Compras';'Supermercado';'VARIABLES'
14/07/2012;14/07/2012;'RESTAURANTES';-21,28 €;16.759,22 €;2644;-21,28;21.283,31 €;'sin fechas';14/07/2012;'RESTAURANTES';'Gastos_Ocio y transporte';'Restaurantes';'VARIABLES'
15/07/2012;15/07/2012;'CAFET.C T PRAT';-3,30 €;16.755,92 €;2645;-3,30;21.280,01 €;'sin fechas';15/07/2012;'CAFETC';'Gastos_Ocio y transporte';'Restaurantes';'VARIABLES'
15/07/2012;15/07/2012;'VIENA';-11,15 €;16.744,77 €;2646;-11,15;21.268,86 €;'sin fechas';15/07/2012;'VIENA';'Gastos_Ocio y transporte';'Restaurantes';'VARIABLES'
16/07/2012;16/07/2012;'BURGUER KING';-7,85 €;16.736,92 €;2647;-7,85;21.261,01 €;'sin fechas';16/07/2012;'BURGUER';'Gastos_Ocio y transporte';'Restaurantes';'VARIABLES'
16/07/2012;16/07/2012;'CAFET.C T PRAT';-3,45 €;16.733,47 €;2648;-3,45;21.257,56 €;'sin fechas';16/07/2012;'CAFETC';'Gastos_Ocio y transporte';'Restaurantes';'VARIABLES'
16/07/2012;16/07/2012;'INFORMACIO I TECNOLOGIA DE CAT';1.666,25 €;18.399,72 €;2649;1.666,25;22.923,81 €;'sin fechas';16/07/2012;'INFORMACIO';'Ingresos';'Nomina';'FIJO'
17/07/2012;16/07/2012;'CCM VIDA Y P SEGURO PRESTAMO';-26,18 €;18.373,54 €;2650;-26,18;22.897,63 €;'sin fechas';16/07/2012;'CCM';'Gastos_Seguros';'Seguro vida';'FIJO'
17/07/2012;16/07/2012;'CCM VIDA Y PENSIO 000000493358';-18,82 €;18.354,72 €;2651;-18,82;22.878,81 €;'sin fechas';16/07/2012;'CCM';'Gastos_Seguros';'Seguro vida';'FIJO'
17/07/2012;17/07/2012;'ONO';-85,75 €;18.268,97 €;2652;-85,75;22.793,06 €;'sin fechas';17/07/2012;'ONO';'Gastos_Servicios tipicos';'Telecomunicaciones';'FIJO'
18/07/2012;18/07/2012;'AG.TRIBUT GABRIEL';100,00 €;18.368,97 €;2653;100,00;22.893,06 €;'sin fechas';18/07/2012;'AGTRIBUT';'Ingresos';'Subvenciones';
20/07/2012;20/07/2012;'GASOLINERA';-34,81 €;18.334,16 €;2654;-34,81;22.858,25 €;'sin fechas';20/07/2012;'GASOLINERA';'Gastos_Ocio y transporte';'Gasolina';'VARIABLES'
21/07/2012;21/07/2012;'CAFET.C T PRAT';-3,90 €;18.330,26 €;2655;-3,90;22.854,35 €;'sin fechas';21/07/2012;'CAFETC';'Gastos_Ocio y transporte';'Restaurantes';'VARIABLES'
22/07/2012;16/07/2012;'AUTOPISTA TERR';-1,31 €;18.328,95 €;2656;-1,31;22.853,04 €;'sin fechas';16/07/2012;'AUTOPISTA';'Gastos_Ocio y transporte';'Parking y peaje';'VARIABLES'
22/07/2012;22/07/2012;'CAFET.C T PRAT';-3,60 €;18.325,35 €;2657;-3,60;22.849,44 €;'sin fechas';22/07/2012;'CAFETC';'Gastos_Ocio y transporte';'Restaurantes';'VARIABLES'
23/07/2012;23/07/2012;'CAFET.C T PRAT';-3,90 €;18.321,45 €;2658;-3,90;22.845,54 €;'sin fechas';23/07/2012;'CAFETC';'Gastos_Ocio y transporte';'Restaurantes';'VARIABLES'
24/07/2012;24/07/2012;'HOGAR&MODA';-32,00 €;18.289,45 €;2659;-32,00;22.813,54 €;'sin fechas';24/07/2012;'HOGARMODA';'Gastos_Compras';'Ropa';'VARIABLES'
24/07/2012;24/07/2012;'HOGAR&MODA';-14,99 €;18.274,46 €;2660;-14,99;22.798,55 €;'sin fechas';24/07/2012;'HOGARMODA';'Gastos_Compras';'Ropa';'VARIABLES'
24/07/2012;24/07/2012;'M&S';-47,99 €;18.226,47 €;2661;-47,99;22.750,56 €;'sin fechas';24/07/2012;'MS';'Gastos_Compras';'Ropa';'VARIABLES'
24/07/2012;24/07/2012;'REINT.CAJERO';-100,00 €;18.126,47 €;2662;-100,00;22.650,56 €;'sin fechas';24/07/2012;'REINTCAJERO';'Gastos_Gastos varios';'Efectivo';'VARIABLES'
26/07/2012;20/07/2012;'AUTOPISTA TERR';-1,31 €;18.125,16 €;2663;-1,31;22.649,25 €;'sin fechas';20/07/2012;'AUTOPISTA';'Gastos_Ocio y transporte';'Parking y peaje';'VARIABLES'
26/07/2012;26/07/2012;'CAFET.C T PRAT';-3,45 €;18.121,71 €;2664;-3,45;22.645,80 €;'sin fechas';26/07/2012;'CAFETC';'Gastos_Ocio y transporte';'Restaurantes';'VARIABLES'
27/07/2012;27/07/2012;'AKI 104 - TERRASSA';-203,95 €;17.917,76 €;2665;-203,95;22.441,85 €;'sin fechas';27/07/2012;'AKI';'Gastos_Vivienda y vehiculo';'Mnto. hogar';'VARIABLES'
27/07/2012;20/07/2012;'AUTOPISTA TERR';-9,20 €;17.908,56 €;2666;-9,20;22.432,65 €;'sin fechas';20/07/2012;'AUTOPISTA';'Gastos_Ocio y transporte';'Parking y peaje';'VARIABLES'
27/07/2012;20/07/2012;'AUTOPISTA TERR';-6,20 €;17.902,36 €;2667;-6,20;22.426,45 €;'sin fechas';20/07/2012;'AUTOPISTA';'Gastos_Ocio y transporte';'Parking y peaje';'VARIABLES'
27/07/2012;23/07/2012;'AUTOPISTA TERR';-6,20 €;17.896,16 €;2668;-6,20;22.420,25 €;'sin fechas';23/07/2012;'AUTOPISTA';'Gastos_Ocio y transporte';'Parking y peaje';'VARIABLES'
27/07/2012;27/07/2012;'CAFET.C T PRAT';-3,70 €;17.892,46 €;2669;-3,70;22.416,55 €;'sin fechas';27/07/2012;'CAFETC';'Gastos_Ocio y transporte';'Restaurantes';'VARIABLES'
27/07/2012;27/07/2012;'INFORMACIO I TECNOLOGIA DE CAT';1.543,24 €;19.435,70 €;2670;1.543,24;23.959,79 €;'sin fechas';27/07/2012;'INFORMACIO';'Ingresos';'Nomina';'FIJO'
28/07/2012;28/07/2012;'AKI 104 - TERRASSA';-47,27 €;19.388,43 €;2671;-47,27;23.912,52 €;'sin fechas';28/07/2012;'AKI';'Gastos_Vivienda y vehiculo';'Mnto. hogar';'VARIABLES'
28/07/2012;23/07/2012;'AUTOPISTA TERR';-4,30 €;19.384,13 €;2672;-4,30;23.908,22 €;'sin fechas';23/07/2012;'AUTOPISTA';'Gastos_Ocio y transporte';'Parking y peaje';'VARIABLES'
28/07/2012;28/07/2012;'CAFET.C T PRAT';-3,45 €;19.380,68 €;2673;-3,45;23.904,77 €;'sin fechas';28/07/2012;'CAFETC';'Gastos_Ocio y transporte';'Restaurantes';'VARIABLES'
28/07/2012;28/07/2012;'HOGAR&OTROS';-58,34 €;19.322,34 €;2674;-58,34;23.846,43 €;'sin fechas';28/07/2012;'HOGAROTROS';'Gastos_Vivienda y vehiculo';'Otros vivienda';'VARIABLES'
28/07/2012;28/07/2012;'MERCADONA';-116,85 €;19.205,49 €;2675;-116,85;23.729,58 €;'sin fechas';28/07/2012;'MERCADONA';'Gastos_Compras';'Supermercado';'VARIABLES'
30/07/2012;21/07/2012;'AUTOPISTA TERR';-1,31 €;19.204,18 €;2676;-1,31;23.728,27 €;'sin fechas';21/07/2012;'AUTOPISTA';'Gastos_Ocio y transporte';'Parking y peaje';'VARIABLES'
30/07/2012;25/07/2012;'AUTOPISTA TERR';-2,39 €;19.201,79 €;2677;-2,39;23.725,88 €;'sin fechas';25/07/2012;'AUTOPISTA';'Gastos_Ocio y transporte';'Parking y peaje';'VARIABLES'
30/07/2012;26/07/2012;'AUTOPISTA TERR';-1,31 €;19.200,48 €;2678;-1,31;23.724,57 €;'sin fechas';26/07/2012;'AUTOPISTA';'Gastos_Ocio y transporte';'Parking y peaje';'VARIABLES'
31/07/2012;31/07/2012;'COMUNIDAD';-20,00 €;19.180,48 €;2679;-20,00;23.704,57 €;'sin fechas';31/07/2012;'COMUNIDAD';'Gastos_Vivienda y vehiculo';'Comunidad';'FIJO'
31/07/2012;31/07/2012;'RECIBO PTMOS. 3061-0960001518';-583,25 €;18.597,23 €;2681;-583,25;23.121,32 €;'sin fechas';31/07/2012;'RECIBO';'Gastos_Banco y organismos';'Hipoteca';'FIJO'
01/08/2012;01/08/2012;'ADESLAS CENTRAL 006662671613';-107,00 €;18.490,23 €;2682;-107,00;23.014,32 €;'sin fechas';01/08/2012;'ADESLAS';'Gastos_Salud, saber y deporte';'Medico';'VARIABLES'
01/08/2012;01/08/2012;'AJUNTAMENT DE TER 850000031046';-47,89 €;18.442,34 €;2683;-47,89;22.966,43 €;'sin fechas';01/08/2012;'AJUNTAMENT';'Gastos_Banco y organismos';'Ayuntamiento';'FIJO'
01/08/2012;31/07/2012;'DIRECCION PROVINCIAL INSS BARC';2.637,46 €;21.079,80 €;2684;2.637,46;25.603,89 €;'sin fechas';31/07/2012;'DIRECCION';'Ingresos';'Nomina';'FIJO'
01/08/2012;01/08/2012;'MANTENIMIENTO';-2,25 €;21.077,55 €;2685;-2,25;25.601,64 €;'sin fechas';01/08/2012;'MANTENIMIENTO';'Gastos_Banco y organismos';'Cargos banco';'FIJO'
02/08/2012;13/07/2012;'A.C.E.S.A B.MART.-L.SAP7S';-9,20 €;21.068,35 €;2686;-9,20;25.592,44 €;'sin fechas';13/07/2012;'ACESA';'Gastos_Ocio y transporte';'Parking y peaje';'VARIABLES'
02/08/2012;22/07/2012;'A.C.E.S.A LSCAP7S.-B.MART';-9,20 €;21.059,15 €;2687;-9,20;25.583,24 €;'sin fechas';22/07/2012;'ACESA';'Gastos_Ocio y transporte';'Parking y peaje';'VARIABLES'
02/08/2012;30/07/2012;'AKI 104 - TERRASSA';-17,74 €;21.041,41 €;2688;-17,74;25.565,50 €;'sin fechas';30/07/2012;'AKI';'Gastos_Vivienda y vehiculo';'Mnto. hogar';'VARIABLES'
02/08/2012;20/07/2012;'AUTOPISTA TERR';-3,62 €;21.037,79 €;2689;-3,62;25.561,88 €;'sin fechas';20/07/2012;'AUTOPISTA';'Gastos_Ocio y transporte';'Parking y peaje';'VARIABLES'
02/08/2012;20/07/2012;'AUTOPISTA TERR';-6,05 €;21.031,74 €;2690;-6,05;25.555,83 €;'sin fechas';20/07/2012;'AUTOPISTA';'Gastos_Ocio y transporte';'Parking y peaje';'VARIABLES'
02/08/2012;13/07/2012;'AUTOPISTA TERR';-6,20 €;21.025,54 €;2691;-6,20;25.549,63 €;'sin fechas';13/07/2012;'AUTOPISTA';'Gastos_Ocio y transporte';'Parking y peaje';'VARIABLES'
02/08/2012;22/07/2012;'AUTOPISTA TERR';-6,20 €;21.019,34 €;2692;-6,20;25.543,43 €;'sin fechas';22/07/2012;'AUTOPISTA';'Gastos_Ocio y transporte';'Parking y peaje';'VARIABLES'
02/08/2012;13/07/2012;'AUTOPISTA TERR';-1,31 €;21.018,03 €;2693;-1,31;25.542,12 €;'sin fechas';13/07/2012;'AUTOPISTA';'Gastos_Ocio y transporte';'Parking y peaje';'VARIABLES'
02/08/2012;18/07/2012;'AUTOPISTA TERR';-1,31 €;21.016,72 €;2694;-1,31;25.540,81 €;'sin fechas';18/07/2012;'AUTOPISTA';'Gastos_Ocio y transporte';'Parking y peaje';'VARIABLES'
02/08/2012;19/07/2012;'AUTOPISTA TERR';-1,31 €;21.015,41 €;2695;-1,31;25.539,50 €;'sin fechas';19/07/2012;'AUTOPISTA';'Gastos_Ocio y transporte';'Parking y peaje';'VARIABLES'
02/08/2012;27/07/2012;'AUTOPISTA TERR';-1,31 €;21.014,10 €;2696;-1,31;25.538,19 €;'sin fechas';27/07/2012;'AUTOPISTA';'Gastos_Ocio y transporte';'Parking y peaje';'VARIABLES'
02/08/2012;26/07/2012;'CAFET.C T PRAT';-4,40 €;21.009,70 €;2697;-4,40;25.533,79 €;'sin fechas';26/07/2012;'CAFETC';'Gastos_Ocio y transporte';'Restaurantes';'VARIABLES'
02/08/2012;26/07/2012;'CAFET.C T PRAT';-3,30 €;21.006,40 €;2698;-3,30;25.530,49 €;'sin fechas';26/07/2012;'CAFETC';'Gastos_Ocio y transporte';'Restaurantes';'VARIABLES'
02/08/2012;31/07/2012;'CAFET.C T PRAT';-4,40 €;21.002,00 €;2699;-4,40;25.526,09 €;'sin fechas';31/07/2012;'CAFETC';'Gastos_Ocio y transporte';'Restaurantes';'VARIABLES'
02/08/2012;31/07/2012;'CAFET.C T PRAT';-3,75 €;20.998,25 €;2700;-3,75;25.522,34 €;'sin fechas';31/07/2012;'CAFETC';'Gastos_Ocio y transporte';'Restaurantes';'VARIABLES'
02/08/2012;28/07/2012;'DECATHLON';-41,85 €;20.956,40 €;2701;-41,85;25.480,49 €;'sin fechas';28/07/2012;'DECATHLON';'Gastos_Compras';'Deportivo';'VARIABLES'
02/08/2012;22/07/2012;'E.S. BAIX EBRE \\TORTOSA';-47,69 €;20.908,71 €;2702;-47,69;25.432,80 €;'sin fechas';22/07/2012;'BAIX';'Gastos_Ocio y transporte';'Gasolina';'VARIABLES'
02/08/2012;26/07/2012;'ES STA. MARGARITA';-39,56 €;20.869,15 €;2703;-39,56;25.393,24 €;'sin fechas';26/07/2012;'STA';'Gastos_Ocio y transporte';'Gasolina';'VARIABLES'
02/08/2012;30/07/2012;'MINI HIPER AMPOST';-16,75 €;20.852,40 €;2704;-16,75;25.376,49 €;'sin fechas';30/07/2012;'MINI';'Gastos_Compras';'Supermercado';'VARIABLES'
02/08/2012;28/06/2012;'PARKING CAPIO SANIDAD';-1,35 €;20.851,05 €;2705;-1,35;25.375,14 €;'sin fechas';28/06/2012;'PARKING';'Gastos_Ocio y transporte';'Parking y peaje';'VARIABLES'
02/08/2012;04/07/2012;'PARKING CAPIO SANIDAD';-5,10 €;20.845,95 €;2706;-5,10;25.370,04 €;'sin fechas';04/07/2012;'PARKING';'Gastos_Ocio y transporte';'Parking y peaje';'VARIABLES'
02/08/2012;13/07/2012;'PARKING CAPIO SANIDAD';-1,40 €;20.844,55 €;2707;-1,40;25.368,64 €;'sin fechas';13/07/2012;'PARKING';'Gastos_Ocio y transporte';'Parking y peaje';'VARIABLES'
03/08/2012;28/07/2012;'AUTOPISTA TERR';-1,31 €;20.843,24 €;2708;-1,31;25.367,33 €;'sin fechas';28/07/2012;'AUTOPISTA';'Gastos_Ocio y transporte';'Parking y peaje';'VARIABLES'
03/08/2012;29/07/2012;'AUTOPISTA TERR';-1,31 €;20.841,93 €;2709;-1,31;25.366,02 €;'sin fechas';29/07/2012;'AUTOPISTA';'Gastos_Ocio y transporte';'Parking y peaje';'VARIABLES'
03/08/2012;30/07/2012;'AUTOPISTA TERR';-9,20 €;20.832,73 €;2710;-9,20;25.356,82 €;'sin fechas';30/07/2012;'AUTOPISTA';'Gastos_Ocio y transporte';'Parking y peaje';'VARIABLES'
03/08/2012;30/07/2012;'AUTOPISTA TERR';-6,20 €;20.826,53 €;2711;-6,20;25.350,62 €;'sin fechas';30/07/2012;'AUTOPISTA';'Gastos_Ocio y transporte';'Parking y peaje';'VARIABLES'
05/08/2012;05/08/2012;'REINT.CAJERO';-20,00 €;20.806,53 €;2712;-20,00;25.330,62 €;'sin fechas';05/08/2012;'REINTCAJERO';'Gastos_Gastos varios';'Efectivo';'VARIABLES'
06/08/2012;30/07/2012;'AUTOPISTA TERR';-1,31 €;20.805,22 €;2713;-1,31;25.329,31 €;'sin fechas';30/07/2012;'AUTOPISTA';'Gastos_Ocio y transporte';'Parking y peaje';'VARIABLES'
06/08/2012;06/08/2012;'GAS NATURAL';-10,27 €;20.794,95 €;2714;-10,27;25.319,04 €;'sin fechas';06/08/2012;'GAS';'Gastos_Servicios tipicos';'Gas';'FIJO'
06/08/2012;06/08/2012;'IBERDROLA GE IBERDRO1011516485';-171,31 €;20.623,64 €;2715;-171,31;25.147,73 €;'sin fechas';06/08/2012;'IBERDROLA';'Gastos_Servicios tipicos';'Electricidad';'FIJO'
06/08/2012;06/08/2012;'REINT.CAJERO';-100,00 €;20.523,64 €;2716;-100,00;25.047,73 €;'sin fechas';06/08/2012;'REINTCAJERO';'Gastos_Gastos varios';'Efectivo';'VARIABLES'
06/08/2012;06/08/2012;'YOIGO';-78,06 €;20.445,58 €;2717;-78,06;24.969,67 €;'sin fechas';06/08/2012;'YOIGO';'Gastos_Servicios tipicos';'Telecomunicaciones';'FIJO'
09/08/2012;09/08/2012;'EMTE SERVICE, S.A.U, 1112298';-69,02 €;20.376,56 €;2718;-69,02;24.900,65 €;'sin fechas';09/08/2012;'EMTE';'Gastos_Servicios tipicos';'Otros servicios';'VARIABLES'
09/08/2012;09/08/2012;'GENERAL DE PINTURAS';-13,96 €;20.362,60 €;2719;-13,96;24.886,69 €;'sin fechas';09/08/2012;'GENERAL';'Gastos_Vivienda y vehiculo';'Mnto. hogar';'VARIABLES'
10/08/2012;10/08/2012;'CAFET.C T PRAT';-4,15 €;20.358,45 €;2720;-4,15;24.882,54 €;'sin fechas';10/08/2012;'CAFETC';'Gastos_Ocio y transporte';'Restaurantes';'VARIABLES'
11/08/2012;11/08/2012;'CAFET.C T PRAT';-3,45 €;20.355,00 €;2721;-3,45;24.879,09 €;'sin fechas';11/08/2012;'CAFETC';'Gastos_Ocio y transporte';'Restaurantes';'VARIABLES'
11/08/2012;11/08/2012;'CINES OSCAR \\ROQUETES';-27,20 €;20.327,80 €;2722;-27,20;24.851,89 €;'sin fechas';11/08/2012;'CINES';'Gastos_Ocio y transporte';'Espectáculos';'VARIABLES'
11/08/2012;11/08/2012;'SABECO';-8,38 €;20.319,42 €;2723;-8,38;24.843,51 €;'sin fechas';11/08/2012;'SABECO';'Gastos_Compras';'Supermercado';'VARIABLES'
12/08/2012;12/08/2012;'CAFET.C T PRAT';-4,40 €;20.315,02 €;2724;-4,40;24.839,11 €;'sin fechas';12/08/2012;'CAFETC';'Gastos_Ocio y transporte';'Restaurantes';'VARIABLES'
12/08/2012;12/08/2012;'CAFET.C T PRAT';-3,45 €;20.311,57 €;2725;-3,45;24.835,66 €;'sin fechas';12/08/2012;'CAFETC';'Gastos_Ocio y transporte';'Restaurantes';'VARIABLES'
12/08/2012;12/08/2012;'GASOLINERA';-55,91 €;20.255,66 €;2726;-55,91;24.779,75 €;'sin fechas';12/08/2012;'GASOLINERA';'Gastos_Ocio y transporte';'Gasolina';'VARIABLES'
12/08/2012;12/08/2012;'RODELAS PERRUQUERS';-13,50 €;20.242,16 €;2727;-13,50;24.766,25 €;'sin fechas';12/08/2012;'RODELAS';'Gastos_Salud, saber y deporte';'Belleza';'VARIABLES'
13/08/2012;13/08/2012;'HOGAR&OTROS';-11,05 €;20.231,11 €;2728;-11,05;24.755,20 €;'sin fechas';13/08/2012;'HOGAROTROS';'Gastos_Vivienda y vehiculo';'Otros vivienda';'VARIABLES'
16/08/2012;05/08/2012;'AUTOPISTA TERR';-6,65 €;20.224,46 €;2729;-6,65;24.748,55 €;'sin fechas';05/08/2012;'AUTOPISTA';'Gastos_Ocio y transporte';'Parking y peaje';'VARIABLES'
16/08/2012;16/08/2012;'CAFET.C T PRAT';-3,45 €;20.221,01 €;2730;-3,45;24.745,10 €;'sin fechas';16/08/2012;'CAFETC';'Gastos_Ocio y transporte';'Restaurantes';'VARIABLES'
16/08/2012;16/08/2012;'CCM VIDA Y P SEGURO PRESTAMO';-26,11 €;20.194,90 €;2731;-26,11;24.718,99 €;'sin fechas';16/08/2012;'CCM';'Gastos_Seguros';'Seguro vida';'FIJO'
16/08/2012;16/08/2012;'CCM VIDA Y PENSIO 000000493358';-18,77 €;20.176,13 €;2732;-18,77;24.700,22 €;'sin fechas';16/08/2012;'CCM';'Gastos_Seguros';'Seguro vida';'FIJO'
16/08/2012;16/08/2012;'GASOLINERA';-55,66 €;20.120,47 €;2733;-55,66;24.644,56 €;'sin fechas';16/08/2012;'GASOLINERA';'Gastos_Ocio y transporte';'Gasolina';'VARIABLES'
16/08/2012;16/08/2012;'IKEA';-19,36 €;20.101,11 €;2734;-19,36;24.625,20 €;'sin fechas';16/08/2012;'IKEA';'Gastos_Vivienda y vehiculo';'Mnto. hogar';'VARIABLES'
16/08/2012;16/08/2012;'IKEA';-10,95 €;20.090,16 €;2735;-10,95;24.614,25 €;'sin fechas';16/08/2012;'IKEA';'Gastos_Vivienda y vehiculo';'Mnto. hogar';'VARIABLES'
17/08/2012;05/08/2012;'AUTOPISTA TERR';-4,65 €;20.085,51 €;2736;-4,65;24.609,60 €;'sin fechas';05/08/2012;'AUTOPISTA';'Gastos_Ocio y transporte';'Parking y peaje';'VARIABLES'
17/08/2012;13/08/2012;'AUTOPISTA TERR';-9,90 €;20.075,61 €;2737;-9,90;24.599,70 €;'sin fechas';13/08/2012;'AUTOPISTA';'Gastos_Ocio y transporte';'Parking y peaje';'VARIABLES'
17/08/2012;13/08/2012;'AUTOPISTA TERR';-6,65 €;20.068,96 €;2738;-6,65;24.593,05 €;'sin fechas';13/08/2012;'AUTOPISTA';'Gastos_Ocio y transporte';'Parking y peaje';'VARIABLES'
17/08/2012;17/08/2012;'CAFET.C T PRAT';-3,45 €;20.065,51 €;2739;-3,45;24.589,60 €;'sin fechas';17/08/2012;'CAFETC';'Gastos_Ocio y transporte';'Restaurantes';'VARIABLES'
17/08/2012;17/08/2012;'FARMACIA';-13,91 €;20.051,60 €;2740;-13,91;24.575,69 €;'sin fechas';17/08/2012;'FARMACIA';'Gastos_Salud, saber y deporte';'Farmacia';'VARIABLES'
17/08/2012;17/08/2012;'MERCADONA';-160,09 €;19.891,51 €;2741;-160,09;24.415,60 €;'sin fechas';17/08/2012;'MERCADONA';'Gastos_Compras';'Supermercado';'VARIABLES'
17/08/2012;17/08/2012;'MERCADONA';-14,31 €;19.877,20 €;2742;-14,31;24.401,29 €;'sin fechas';17/08/2012;'MERCADONA';'Gastos_Compras';'Supermercado';'VARIABLES'
18/08/2012;18/08/2012;'GIFI';-15,13 €;19.862,07 €;2743;-15,13;24.386,16 €;'sin fechas';18/08/2012;'GIFI';'Gastos_Compras';'Hogar';'VARIABLES'
18/08/2012;18/08/2012;'MERCADONA';-25,33 €;19.836,74 €;2744;-25,33;24.360,83 €;'sin fechas';18/08/2012;'MERCADONA';'Gastos_Compras';'Supermercado';'VARIABLES'
19/08/2012;19/08/2012;'CAFET.C T PRAT';-3,45 €;19.833,29 €;2745;-3,45;24.357,38 €;'sin fechas';19/08/2012;'CAFETC';'Gastos_Ocio y transporte';'Restaurantes';'VARIABLES'
19/08/2012;18/08/2012;'FARMACIA';-7,52 €;19.825,77 €;2746;-7,52;24.349,86 €;'sin fechas';18/08/2012;'FARMACIA';'Gastos_Salud, saber y deporte';'Farmacia';'VARIABLES'
19/08/2012;19/08/2012;'FARMACIA';-69,50 €;19.756,27 €;2747;-69,50;24.280,36 €;'sin fechas';19/08/2012;'FARMACIA';'Gastos_Salud, saber y deporte';'Farmacia';'VARIABLES'
20/08/2012;20/08/2012;'CAFET.C T PRAT';-3,45 €;19.752,82 €;2748;-3,45;24.276,91 €;'sin fechas';20/08/2012;'CAFETC';'Gastos_Ocio y transporte';'Restaurantes';'VARIABLES'
20/08/2012;20/08/2012;'ONO';-86,02 €;19.666,80 €;2749;-86,02;24.190,89 €;'sin fechas';20/08/2012;'ONO';'Gastos_Servicios tipicos';'Telecomunicaciones';'FIJO'
23/08/2012;23/08/2012;'CAFET.C T PRAT';-3,45 €;19.663,35 €;2750;-3,45;24.187,44 €;'sin fechas';23/08/2012;'CAFETC';'Gastos_Ocio y transporte';'Restaurantes';'VARIABLES'
23/08/2012;21/08/2012;'FARMACIA';-8,27 €;19.655,08 €;2751;-8,27;24.179,17 €;'sin fechas';21/08/2012;'FARMACIA';'Gastos_Salud, saber y deporte';'Farmacia';'VARIABLES'
23/08/2012;21/08/2012;'VIENA';-12,35 €;19.642,73 €;2752;-12,35;24.166,82 €;'sin fechas';21/08/2012;'VIENA';'Gastos_Ocio y transporte';'Restaurantes';'VARIABLES'
24/08/2012;24/08/2012;'AG.TRIBUT GABRIEL';100,00 €;19.742,73 €;2753;100,00;24.266,82 €;'sin fechas';24/08/2012;'AGTRIBUT';'Ingresos';'Subvenciones';
24/08/2012;24/08/2012;'CAFET.C T PRAT';-2,60 €;19.740,13 €;2754;-2,60;24.264,22 €;'sin fechas';24/08/2012;'CAFETC';'Gastos_Ocio y transporte';'Restaurantes';'VARIABLES'
24/08/2012;24/08/2012;'FOMENT DE TERRASSA, S.A. FOMEN';770,87 €;20.511,00 €;2755;770,87;25.035,09 €;'sin fechas';24/08/2012;'FOMENT';'Ingresos';'Nomina';'FIJO'
25/08/2012;25/08/2012;'CAFET.C T PRAT';-3,75 €;20.507,25 €;2756;-3,75;25.031,34 €;'sin fechas';25/08/2012;'CAFETC';'Gastos_Ocio y transporte';'Restaurantes';'VARIABLES'
25/08/2012;25/08/2012;'CARREFOUR-[COMIDA]';-15,51 €;20.491,74 €;2757;-15,51;25.015,83 €;'sin fechas';25/08/2012;'CARREFOURCOMIDA';'Gastos_Compras';'Supermercado';'VARIABLES'
25/08/2012;25/08/2012;'HOGAR&OTROS';-16,50 €;20.475,24 €;2758;-16,50;24.999,33 €;'sin fechas';25/08/2012;'HOGAROTROS';'Gastos_Vivienda y vehiculo';'Otros vivienda';'VARIABLES'
25/08/2012;25/08/2012;'VIENA';-12,00 €;20.463,24 €;2759;-12,00;24.987,33 €;'sin fechas';25/08/2012;'VIENA';'Gastos_Ocio y transporte';'Restaurantes';'VARIABLES'
26/08/2012;26/08/2012;'CAFET.C T PRAT';-4,25 €;20.458,99 €;2760;-4,25;24.983,08 €;'sin fechas';26/08/2012;'CAFETC';'Gastos_Ocio y transporte';'Restaurantes';'VARIABLES'
27/08/2012;27/08/2012;'ES STA. MARGARITA';-51,64 €;20.407,35 €;2761;-51,64;24.931,44 €;'sin fechas';27/08/2012;'STA';'Gastos_Ocio y transporte';'Gasolina';'VARIABLES'
27/08/2012;27/08/2012;'FF.CC.GENERALITAT';-2,70 €;20.404,65 €;2762;-2,70;24.928,74 €;'sin fechas';27/08/2012;'FFCCGENERALITAT';'Gastos_Ocio y transporte';'Transporte';'VARIABLES'
27/08/2012;27/08/2012;'FF.CC.GENERALITAT';-2,70 €;20.401,95 €;2763;-2,70;24.926,04 €;'sin fechas';27/08/2012;'FFCCGENERALITAT';'Gastos_Ocio y transporte';'Transporte';'VARIABLES'
27/08/2012;27/08/2012;'MERCADONA';-11,12 €;20.390,83 €;2764;-11,12;24.914,92 €;'sin fechas';27/08/2012;'MERCADONA';'Gastos_Compras';'Supermercado';'VARIABLES'
27/08/2012;27/08/2012;'RENFE';-2,20 €;20.388,63 €;2765;-2,20;24.912,72 €;'sin fechas';27/08/2012;'RENFE';'Gastos_Ocio y transporte';'Transporte';'VARIABLES'
28/08/2012;28/08/2012;'INFORMACIO I TECNOLOGIA DE CAT';1.543,62 €;21.932,25 €;2766;1.543,62;26.456,34 €;'sin fechas';28/08/2012;'INFORMACIO';'Ingresos';'Nomina';'FIJO'
28/08/2012;28/08/2012;'TRASP.CTA. 3061.1290015269';-14.000,00 €;7.932,25 €;2767;-14.000,00;12.456,34 €;'sin fechas';28/08/2012;'TRASPCTA';'Gastos_Gastos varios';'Transferencias';'VARIABLES'
29/08/2012;29/08/2012;'ENDESA ENERG EE_XXI40025545678';-69,40 €;7.862,85 €;2768;-69,40;12.386,94 €;'sin fechas';29/08/2012;'ENDESA';'Gastos_Servicios tipicos';'Electricidad';'FIJO'
29/08/2012;29/08/2012;'MEDIA MARKT';-47,99 €;7.814,86 €;2769;-47,99;12.338,95 €;'sin fechas';29/08/2012;'MEDIA';'Gastos_Compras';'Hobbys';'VARIABLES'
30/08/2012;30/08/2012;'BLITZ';-70,80 €;7.744,06 €;2770;-70,80;12.268,15 €;'sin fechas';30/08/2012;'BLITZ';'Gastos_Vivienda y vehiculo';'Alquiler Parking';'FIJO'
30/08/2012;30/08/2012;'DIRECCION PROVINCIAL INSS BARC';2.637,46 €;10.381,52 €;2771;2.637,46;14.905,61 €;'sin fechas';30/08/2012;'DIRECCION';'Ingresos';'Nomina';'FIJO'
30/08/2012;28/08/2012;'MEDIA MARKT';-120,97 €;10.260,55 €;2772;-120,97;14.784,64 €;'sin fechas';28/08/2012;'MEDIA';'Gastos_Compras';'Hobbys';'VARIABLES'
30/08/2012;28/08/2012;'OCIO&RESTAURANTE';-28,30 €;10.232,25 €;2773;-28,30;14.756,34 €;'sin fechas';28/08/2012;'OCIORESTAURANTE';'Gastos_Ocio y transporte';'Restaurantes';'VARIABLES'
30/08/2012;28/08/2012;'OCIO&RESTAURANTE';-3,60 €;10.228,65 €;2774;-3,60;14.752,74 €;'sin fechas';28/08/2012;'OCIORESTAURANTE';'Gastos_Ocio y transporte';'Restaurantes';'VARIABLES'
30/08/2012;28/08/2012;'VIENA';-5,25 €;10.223,40 €;2775;-5,25;14.747,49 €;'sin fechas';28/08/2012;'VIENA';'Gastos_Ocio y transporte';'Restaurantes';'VARIABLES'
31/08/2012;31/08/2012;'CAFET.C T PRAT';-2,45 €;10.220,95 €;2776;-2,45;14.745,04 €;'sin fechas';31/08/2012;'CAFETC';'Gastos_Ocio y transporte';'Restaurantes';'VARIABLES'
31/08/2012;31/08/2012;'COMUNIDAD';-20,00 €;10.200,95 €;2777;-20,00;14.725,04 €;'sin fechas';31/08/2012;'COMUNIDAD';'Gastos_Vivienda y vehiculo';'Comunidad';'FIJO'
31/08/2012;31/08/2012;'MERCADONA';-176,25 €;10.024,70 €;2778;-176,25;14.548,79 €;'sin fechas';31/08/2012;'MERCADONA';'Gastos_Compras';'Supermercado';'VARIABLES'
31/08/2012;31/08/2012;'MERCADONA';-16,86 €;10.007,84 €;2779;-16,86;14.531,93 €;'sin fechas';31/08/2012;'MERCADONA';'Gastos_Compras';'Supermercado';'VARIABLES'
31/08/2012;31/08/2012;'RECIBO PTMOS. 3061-0960001518';-583,25 €;9.424,59 €;2780;-583,25;13.948,68 €;'sin fechas';31/08/2012;'RECIBO';'Gastos_Banco y organismos';'Hipoteca';'FIJO'
01/09/2012;01/09/2012;'CAFET.C T PRAT';-3,15 €;9.421,44 €;2781;-3,15;13.945,53 €;'sin fechas';01/09/2012;'CAFETC';'Gastos_Ocio y transporte';'Restaurantes';'VARIABLES'
01/09/2012;01/09/2012;'EROSKI-[COMIDA]';-44,61 €;9.376,83 €;2782;-44,61;13.900,92 €;'sin fechas';01/09/2012;'EROSKICOMIDA';'Gastos_Compras';'Supermercado';'VARIABLES'
01/09/2012;01/09/2012;'MANTENIMIENTO';-2,25 €;9.374,58 €;2783;-2,25;13.898,67 €;'sin fechas';01/09/2012;'MANTENIMIENTO';'Gastos_Banco y organismos';'Cargos banco';'FIJO'
02/09/2012;30/07/2012;'A.C.E.S.A LSCAP7S.-B.MART';-9,90 €;9.364,68 €;2784;-9,90;13.888,77 €;'sin fechas';30/07/2012;'ACESA';'Gastos_Ocio y transporte';'Parking y peaje';'VARIABLES'
02/09/2012;06/08/2012;'A.C.E.S.A LSCAP7S.-B.MART';-9,90 €;9.354,78 €;2785;-9,90;13.878,87 €;'sin fechas';06/08/2012;'ACESA';'Gastos_Ocio y transporte';'Parking y peaje';'VARIABLES'
02/09/2012;12/08/2012;'A.C.E.S.A LSCAP7S.-B.MART';-9,90 €;9.344,88 €;2786;-9,90;13.868,97 €;'sin fechas';12/08/2012;'ACESA';'Gastos_Ocio y transporte';'Parking y peaje';'VARIABLES'
02/09/2012;02/08/2012;'AUTOPISTA TERR';-3,62 €;9.341,26 €;2787;-3,62;13.865,35 €;'sin fechas';02/08/2012;'AUTOPISTA';'Gastos_Ocio y transporte';'Parking y peaje';'VARIABLES'
02/09/2012;02/08/2012;'AUTOPISTA TERR';-6,05 €;9.335,21 €;2788;-6,05;13.859,30 €;'sin fechas';02/08/2012;'AUTOPISTA';'Gastos_Ocio y transporte';'Parking y peaje';'VARIABLES'
02/09/2012;30/07/2012;'AUTOPISTA TERR';-6,65 €;9.328,56 €;2789;-6,65;13.852,65 €;'sin fechas';30/07/2012;'AUTOPISTA';'Gastos_Ocio y transporte';'Parking y peaje';'VARIABLES'
02/09/2012;06/08/2012;'AUTOPISTA TERR';-6,65 €;9.321,91 €;2790;-6,65;13.846,00 €;'sin fechas';06/08/2012;'AUTOPISTA';'Gastos_Ocio y transporte';'Parking y peaje';'VARIABLES'
02/09/2012;12/08/2012;'AUTOPISTA TERR';-6,65 €;9.315,26 €;2791;-6,65;13.839,35 €;'sin fechas';12/08/2012;'AUTOPISTA';'Gastos_Ocio y transporte';'Parking y peaje';'VARIABLES'
02/09/2012;30/07/2012;'AUTOPISTA TERR';-1,31 €;9.313,95 €;2792;-1,31;13.838,04 €;'sin fechas';30/07/2012;'AUTOPISTA';'Gastos_Ocio y transporte';'Parking y peaje';'VARIABLES'
02/09/2012;31/07/2012;'AUTOPISTA TERR';-1,31 €;9.312,64 €;2793;-1,31;13.836,73 €;'sin fechas';31/07/2012;'AUTOPISTA';'Gastos_Ocio y transporte';'Parking y peaje';'VARIABLES'
02/09/2012;01/08/2012;'AUTOPISTA TERR';-1,31 €;9.311,33 €;2794;-1,31;13.835,42 €;'sin fechas';01/08/2012;'AUTOPISTA';'Gastos_Ocio y transporte';'Parking y peaje';'VARIABLES'
02/09/2012;01/08/2012;'AUTOPISTA TERR';-1,31 €;9.310,02 €;2795;-1,31;13.834,11 €;'sin fechas';01/08/2012;'AUTOPISTA';'Gastos_Ocio y transporte';'Parking y peaje';'VARIABLES'
02/09/2012;02/08/2012;'AUTOPISTA TERR';-1,31 €;9.308,71 €;2796;-1,31;13.832,80 €;'sin fechas';02/08/2012;'AUTOPISTA';'Gastos_Ocio y transporte';'Parking y peaje';'VARIABLES'
02/09/2012;06/08/2012;'AUTOPISTA TERR';-1,31 €;9.307,40 €;2797;-1,31;13.831,49 €;'sin fechas';06/08/2012;'AUTOPISTA';'Gastos_Ocio y transporte';'Parking y peaje';'VARIABLES'
02/09/2012;07/08/2012;'AUTOPISTA TERR';-1,31 €;9.306,09 €;2798;-1,31;13.830,18 €;'sin fechas';07/08/2012;'AUTOPISTA';'Gastos_Ocio y transporte';'Parking y peaje';'VARIABLES'
02/09/2012;07/08/2012;'AUTOPISTA TERR';-1,31 €;9.304,78 €;2799;-1,31;13.828,87 €;'sin fechas';07/08/2012;'AUTOPISTA';'Gastos_Ocio y transporte';'Parking y peaje';'VARIABLES'
02/09/2012;08/08/2012;'AUTOPISTA TERR';-1,31 €;9.303,47 €;2800;-1,31;13.827,56 €;'sin fechas';08/08/2012;'AUTOPISTA';'Gastos_Ocio y transporte';'Parking y peaje';'VARIABLES'
02/09/2012;08/08/2012;'AUTOPISTA TERR';-1,31 €;9.302,16 €;2801;-1,31;13.826,25 €;'sin fechas';08/08/2012;'AUTOPISTA';'Gastos_Ocio y transporte';'Parking y peaje';'VARIABLES'
02/09/2012;09/08/2012;'AUTOPISTA TERR';-1,31 €;9.300,85 €;2802;-1,31;13.824,94 €;'sin fechas';09/08/2012;'AUTOPISTA';'Gastos_Ocio y transporte';'Parking y peaje';'VARIABLES'
02/09/2012;09/08/2012;'AUTOPISTA TERR';-1,31 €;9.299,54 €;2803;-1,31;13.823,63 €;'sin fechas';09/08/2012;'AUTOPISTA';'Gastos_Ocio y transporte';'Parking y peaje';'VARIABLES'
02/09/2012;10/08/2012;'AUTOPISTA TERR';-1,31 €;9.298,23 €;2804;-1,31;13.822,32 €;'sin fechas';10/08/2012;'AUTOPISTA';'Gastos_Ocio y transporte';'Parking y peaje';'VARIABLES'
02/09/2012;13/08/2012;'AUTOPISTA TERR';-1,24 €;9.296,99 €;2805;-1,24;13.821,08 €;'sin fechas';13/08/2012;'AUTOPISTA';'Gastos_Ocio y transporte';'Parking y peaje';'VARIABLES'
02/09/2012;13/08/2012;'AUTOPISTA TERR';-1,24 €;9.295,75 €;2806;-1,24;13.819,84 €;'sin fechas';13/08/2012;'AUTOPISTA';'Gastos_Ocio y transporte';'Parking y peaje';'VARIABLES'
02/09/2012;13/08/2012;'AUTOPISTA TERR';-1,31 €;9.294,44 €;2807;-1,31;13.818,53 €;'sin fechas';13/08/2012;'AUTOPISTA';'Gastos_Ocio y transporte';'Parking y peaje';'VARIABLES'
02/09/2012;14/08/2012;'AUTOPISTA TERR';-1,24 €;9.293,20 €;2808;-1,24;13.817,29 €;'sin fechas';14/08/2012;'AUTOPISTA';'Gastos_Ocio y transporte';'Parking y peaje';'VARIABLES'
02/09/2012;14/08/2012;'AUTOPISTA TERR';-1,31 €;9.291,89 €;2809;-1,31;13.815,98 €;'sin fechas';14/08/2012;'AUTOPISTA';'Gastos_Ocio y transporte';'Parking y peaje';'VARIABLES'
02/09/2012;15/08/2012;'AUTOPISTA TERR';-2,39 €;9.289,50 €;2810;-2,39;13.813,59 €;'sin fechas';15/08/2012;'AUTOPISTA';'Gastos_Ocio y transporte';'Parking y peaje';'VARIABLES'
02/09/2012;16/08/2012;'AUTOPISTA TERR';-1,31 €;9.288,19 €;2811;-1,31;13.812,28 €;'sin fechas';16/08/2012;'AUTOPISTA';'Gastos_Ocio y transporte';'Parking y peaje';'VARIABLES'
02/09/2012;18/08/2012;'AUTOPISTA TERR';-2,39 €;9.285,80 €;2812;-2,39;13.809,89 €;'sin fechas';18/08/2012;'AUTOPISTA';'Gastos_Ocio y transporte';'Parking y peaje';'VARIABLES'
02/09/2012;20/08/2012;'AUTOPISTA TERR';-1,31 €;9.284,49 €;2813;-1,31;13.808,58 €;'sin fechas';20/08/2012;'AUTOPISTA';'Gastos_Ocio y transporte';'Parking y peaje';'VARIABLES'
02/09/2012;21/08/2012;'AUTOPISTA TERR';-1,24 €;9.283,25 €;2814;-1,24;13.807,34 €;'sin fechas';21/08/2012;'AUTOPISTA';'Gastos_Ocio y transporte';'Parking y peaje';'VARIABLES'
02/09/2012;21/08/2012;'AUTOPISTA TERR';-1,31 €;9.281,94 €;2815;-1,31;13.806,03 €;'sin fechas';21/08/2012;'AUTOPISTA';'Gastos_Ocio y transporte';'Parking y peaje';'VARIABLES'
02/09/2012;22/08/2012;'AUTOPISTA TERR';-1,24 €;9.280,70 €;2816;-1,24;13.804,79 €;'sin fechas';22/08/2012;'AUTOPISTA';'Gastos_Ocio y transporte';'Parking y peaje';'VARIABLES'
02/09/2012;23/08/2012;'AUTOPISTA TERR';-1,18 €;9.279,52 €;2817;-1,18;13.803,61 €;'sin fechas';23/08/2012;'AUTOPISTA';'Gastos_Ocio y transporte';'Parking y peaje';'VARIABLES'
02/09/2012;24/08/2012;'AUTOPISTA TERR';-1,18 €;9.278,34 €;2818;-1,18;13.802,43 €;'sin fechas';24/08/2012;'AUTOPISTA';'Gastos_Ocio y transporte';'Parking y peaje';'VARIABLES'
02/09/2012;27/08/2012;'AUTOPISTA TERR';-1,18 €;9.277,16 €;2819;-1,18;13.801,25 €;'sin fechas';27/08/2012;'AUTOPISTA';'Gastos_Ocio y transporte';'Parking y peaje';'VARIABLES'
02/09/2012;27/08/2012;'AUTOPISTA TERR';-1,18 €;9.275,98 €;2820;-1,18;13.800,07 €;'sin fechas';27/08/2012;'AUTOPISTA';'Gastos_Ocio y transporte';'Parking y peaje';'VARIABLES'
02/09/2012;28/08/2012;'AUTOPISTA TERR';-1,18 €;9.274,80 €;2821;-1,18;13.798,89 €;'sin fechas';28/08/2012;'AUTOPISTA';'Gastos_Ocio y transporte';'Parking y peaje';'VARIABLES'
02/09/2012;29/08/2012;'AUTOPISTA TERR';-1,31 €;9.273,49 €;2822;-1,31;13.797,58 €;'sin fechas';29/08/2012;'AUTOPISTA';'Gastos_Ocio y transporte';'Parking y peaje';'VARIABLES'
02/09/2012;01/08/2012;'CAFET.C T PRAT';-3,30 €;9.270,19 €;2823;-3,30;13.794,28 €;'sin fechas';01/08/2012;'CAFETC';'Gastos_Ocio y transporte';'Restaurantes';'VARIABLES'
02/09/2012;02/08/2012;'CAFET.C T PRAT';-3,15 €;9.267,04 €;2824;-3,15;13.791,13 €;'sin fechas';02/08/2012;'CAFETC';'Gastos_Ocio y transporte';'Restaurantes';'VARIABLES'
02/09/2012;02/09/2012;'CAFET.C T PRAT';-3,75 €;9.263,29 €;2825;-3,75;13.787,38 €;'sin fechas';02/09/2012;'CAFETC';'Gastos_Ocio y transporte';'Restaurantes';'VARIABLES'
02/09/2012;01/08/2012;'CARREFOUR-[OTROS]';-59,27 €;9.204,02 €;2826;-59,27;13.728,11 €;'sin fechas';01/08/2012;'CARREFOUROTROS';'Gastos_Compras';'Supermercado';'VARIABLES'
02/09/2012;15/08/2012;'CATALANA DIAG.I CIRUR';-2,40 €;9.201,62 €;2827;-2,40;13.725,71 €;'sin fechas';15/08/2012;'CATALANA';'Gastos_Ocio y transporte';'Parking y peaje';'VARIABLES'
02/09/2012;01/08/2012;'ES STA. MARGARITA';-55,56 €;9.146,06 €;2828;-55,56;13.670,15 €;'sin fechas';01/08/2012;'STA';'Gastos_Ocio y transporte';'Gasolina';'VARIABLES'
02/09/2012;12/08/2012;'HOGAR&OTROS';-3,60 €;9.142,46 €;2829;-3,60;13.666,55 €;'sin fechas';12/08/2012;'HOGAROTROS';'Gastos_Vivienda y vehiculo';'Otros vivienda';'VARIABLES'
02/09/2012;25/08/2012;'LEROY MERLIN';-17,45 €;9.125,01 €;2830;-17,45;13.649,10 €;'sin fechas';25/08/2012;'LEROY';'Gastos_Vivienda y vehiculo';'Mnto. hogar';'VARIABLES'
02/09/2012;02/08/2012;'RESTAURANTES';-9,60 €;9.115,41 €;2831;-9,60;13.639,50 €;'sin fechas';02/08/2012;'RESTAURANTES';'Gastos_Ocio y transporte';'Restaurantes';'VARIABLES'
02/09/2012;16/08/2012;'SATSA PL. VELLA TERRASSA';-7,00 €;9.108,41 €;2832;-7,00;13.632,50 €;'sin fechas';16/08/2012;'SATSA';'Gastos_Ocio y transporte';'Parking y peaje';'VARIABLES'
03/09/2012;03/09/2012;'ADESLAS CENTRAL 006662671613';-107,00 €;9.001,41 €;2833;-107,00;13.525,50 €;'sin fechas';03/09/2012;'ADESLAS';'Gastos_Salud, saber y deporte';'Medico';'VARIABLES'
03/09/2012;03/09/2012;'CAFET.C T PRAT';-3,75 €;8.997,66 €;2834;-3,75;13.521,75 €;'sin fechas';03/09/2012;'CAFETC';'Gastos_Ocio y transporte';'Restaurantes';'VARIABLES'
04/09/2012;04/09/2012;'YOIGO';-44,06 €;8.953,60 €;2835;-44,06;13.477,69 €;'sin fechas';04/09/2012;'YOIGO';'Gastos_Servicios tipicos';'Telecomunicaciones';'FIJO'
05/09/2012;05/09/2012;'COM. MANT. ACTIVAS DE LIQ.';-4,50 €;8.949,10 €;2836;-4,50;13.473,19 €;'sin fechas';05/09/2012;'COM';'Gastos_Banco y organismos';'Cargos banco';'FIJO'
06/09/2012;06/09/2012;'ESCOLA BRESSOL EINA';-218,70 €;8.730,40 €;2837;-218,70;13.254,49 €;'sin fechas';06/09/2012;'ESCOLA';'Gastos_Salud, saber y deporte';'Estudios';'VARIABLES'
06/09/2012;06/09/2012;'ESCOLA BRESSOL EINA';-302,30 €;8.428,10 €;2838;-302,30;12.952,19 €;'sin fechas';06/09/2012;'ESCOLA';'Gastos_Salud, saber y deporte';'Estudios';'VARIABLES'
06/09/2012;06/09/2012;'FARMACIA';-8,27 €;8.419,83 €;2839;-8,27;12.943,92 €;'sin fechas';06/09/2012;'FARMACIA';'Gastos_Salud, saber y deporte';'Farmacia';'VARIABLES'
06/09/2012;06/09/2012;'GAS NATURAL';-10,27 €;8.409,56 €;2840;-10,27;12.933,65 €;'sin fechas';06/09/2012;'GAS';'Gastos_Servicios tipicos';'Gas';'FIJO'
06/09/2012;06/09/2012;'IKEA';-9,15 €;8.400,41 €;2841;-9,15;12.924,50 €;'sin fechas';06/09/2012;'IKEA';'Gastos_Vivienda y vehiculo';'Mnto. hogar';'VARIABLES'
06/09/2012;04/09/2012;'OCIO&RESTAURANTE';-32,40 €;8.368,01 €;2842;-32,40;12.892,10 €;'sin fechas';04/09/2012;'OCIORESTAURANTE';'Gastos_Ocio y transporte';'Restaurantes';'VARIABLES'
06/09/2012;04/09/2012;'VIENA';-15,15 €;8.352,86 €;2843;-15,15;12.876,95 €;'sin fechas';04/09/2012;'VIENA';'Gastos_Ocio y transporte';'Restaurantes';'VARIABLES'
07/09/2012;07/09/2012;'BON AREA';-40,67 €;8.312,19 €;2844;-40,67;12.836,28 €;'sin fechas';07/09/2012;'BON';'Gastos_Compras';'Supermercado';'VARIABLES'
08/09/2012;08/09/2012;'ES STA. MARGARITA';-9,83 €;8.302,36 €;2845;-9,83;12.826,45 €;'sin fechas';08/09/2012;'STA';'Gastos_Ocio y transporte';'Gasolina';'VARIABLES'
09/09/2012;09/09/2012;'IKEA';-18,85 €;8.283,51 €;2846;-18,85;12.807,60 €;'sin fechas';09/09/2012;'IKEA';'Gastos_Vivienda y vehiculo';'Mnto. hogar';'VARIABLES'
09/09/2012;09/09/2012;'IKEA';-39,42 €;8.244,09 €;2847;-39,42;12.768,18 €;'sin fechas';09/09/2012;'IKEA';'Gastos_Vivienda y vehiculo';'Mnto. hogar';'VARIABLES'
10/09/2012;10/09/2012;'OCIO&RESTAURANTE';-17,55 €;8.226,54 €;2848;-17,55;12.750,63 €;'sin fechas';10/09/2012;'OCIORESTAURANTE';'Gastos_Ocio y transporte';'Restaurantes';'VARIABLES'
10/09/2012;10/09/2012;'OCIO&RESTAURANTE';-12,80 €;8.213,74 €;2849;-12,80;12.737,83 €;'sin fechas';10/09/2012;'OCIORESTAURANTE';'Gastos_Ocio y transporte';'Restaurantes';'VARIABLES'
10/09/2012;10/09/2012;'VIENA';-9,30 €;8.204,44 €;2850;-9,30;12.728,53 €;'sin fechas';10/09/2012;'VIENA';'Gastos_Ocio y transporte';'Restaurantes';'VARIABLES'
10/09/2012;10/09/2012;'VIENA';-12,50 €;8.191,94 €;2851;-12,50;12.716,03 €;'sin fechas';10/09/2012;'VIENA';'Gastos_Ocio y transporte';'Restaurantes';'VARIABLES'
10/09/2012;10/09/2012;'VIENA';-1,65 €;8.190,29 €;2852;-1,65;12.714,38 €;'sin fechas';10/09/2012;'VIENA';'Gastos_Ocio y transporte';'Restaurantes';'VARIABLES'
11/09/2012;11/09/2012;'IBERDROLA GE IBERDRO1011516485';-154,20 €;8.036,09 €;2853;-154,20;12.560,18 €;'sin fechas';11/09/2012;'IBERDROLA';'Gastos_Servicios tipicos';'Electricidad';'FIJO'
12/09/2012;12/09/2012;'IBERDROLA GE IBERDRO1011516485';-7,60 €;8.028,49 €;2854;-7,60;12.552,58 €;'sin fechas';12/09/2012;'IBERDROLA';'Gastos_Servicios tipicos';'Electricidad';'FIJO'
13/09/2012;13/09/2012;'BLITZ';-72,50 €;7.955,99 €;2855;-72,50;12.480,08 €;'sin fechas';13/09/2012;'BLITZ';'Gastos_Vivienda y vehiculo';'Alquiler Parking';'FIJO'
13/09/2012;11/09/2012;'EROSKI-[COMIDA]';-17,58 €;7.938,41 €;2856;-17,58;12.462,50 €;'sin fechas';11/09/2012;'EROSKICOMIDA';'Gastos_Compras';'Supermercado';'VARIABLES'
13/09/2012;11/09/2012;'ES STA. MARGARITA';-40,00 €;7.898,41 €;2857;-40,00;12.422,50 €;'sin fechas';11/09/2012;'STA';'Gastos_Ocio y transporte';'Gasolina';'VARIABLES'
13/09/2012;11/09/2012;'HOGAR&OTROS';-25,75 €;7.872,66 €;2858;-25,75;12.396,75 €;'sin fechas';11/09/2012;'HOGAROTROS';'Gastos_Vivienda y vehiculo';'Otros vivienda';'VARIABLES'
14/09/2012;09/09/2012;'AUTOPISTA TERR';-2,45 €;7.870,21 €;2859;-2,45;12.394,30 €;'sin fechas';09/09/2012;'AUTOPISTA';'Gastos_Ocio y transporte';'Parking y peaje';'VARIABLES'
14/09/2012;14/09/2012;'BON AREA';-7,96 €;7.862,25 €;2860;-7,96;12.386,34 €;'sin fechas';14/09/2012;'BON';'Gastos_Compras';'Supermercado';'VARIABLES'
15/09/2012;15/09/2012;'CARREFOUR-[COMIDA]';-115,38 €;7.746,87 €;2861;-115,38;12.270,96 €;'sin fechas';15/09/2012;'CARREFOURCOMIDA';'Gastos_Compras';'Supermercado';'VARIABLES'
15/09/2012;15/09/2012;'COCHE&PARKING';-3,50 €;7.743,37 €;2862;-3,50;12.267,46 €;'sin fechas';15/09/2012;'COCHEPARKING';'Gastos_Ocio y transporte';'Parking y peaje';'VARIABLES'
15/09/2012;15/09/2012;'LIFELINK TECHNOLO';-167,77 €;7.575,60 €;2863;-167,77;12.099,69 €;'sin fechas';15/09/2012;'LIFELINK';'Gastos_Compras';'Hobbys';'VARIABLES'
15/09/2012;15/09/2012;'LIFELINK TECHNOLO';-28,44 €;7.547,16 €;2864;-28,44;12.071,25 €;'sin fechas';15/09/2012;'LIFELINK';'Gastos_Compras';'Hobbys';'VARIABLES'
15/09/2012;15/09/2012;'PC GREEN';-8,97 €;7.538,19 €;2865;-8,97;12.062,28 €;'sin fechas';15/09/2012;'GREEN';'Gastos_Compras';'Hobbys';'VARIABLES'
16/09/2012;16/09/2012;'MERCADONA';-25,11 €;7.513,08 €;2866;-25,11;12.037,17 €;'sin fechas';16/09/2012;'MERCADONA';'Gastos_Compras';'Supermercado';'VARIABLES'
17/09/2012;17/09/2012;'CAFET.C T PRAT';-3,55 €;7.509,53 €;2867;-3,55;12.033,62 €;'sin fechas';17/09/2012;'CAFETC';'Gastos_Ocio y transporte';'Restaurantes';'VARIABLES'
17/09/2012;17/09/2012;'CCM VIDA Y P SEGURO PRESTAMO';-26,04 €;7.483,49 €;2868;-26,04;12.007,58 €;'sin fechas';17/09/2012;'CCM';'Gastos_Seguros';'Seguro vida';'FIJO'
17/09/2012;17/09/2012;'CCM VIDA Y PENSIO 000000493358';-18,72 €;7.464,77 €;2869;-18,72;11.988,86 €;'sin fechas';17/09/2012;'CCM';'Gastos_Seguros';'Seguro vida';'FIJO'
17/09/2012;17/09/2012;'ENDESA ENERG EE_XXI40025545678';-88,88 €;7.375,89 €;2870;-88,88;11.899,98 €;'sin fechas';17/09/2012;'ENDESA';'Gastos_Servicios tipicos';'Electricidad';'FIJO'
17/09/2012;17/09/2012;'ES STA. MARGARITA';-53,24 €;7.322,65 €;2871;-53,24;11.846,74 €;'sin fechas';17/09/2012;'STA';'Gastos_Ocio y transporte';'Gasolina';'VARIABLES'
18/09/2012;18/09/2012;'FF.CC.GENERALITAT';-2,70 €;7.319,95 €;2872;-2,70;11.844,04 €;'sin fechas';18/09/2012;'FFCCGENERALITAT';'Gastos_Ocio y transporte';'Transporte';'VARIABLES'
18/09/2012;18/09/2012;'FF.CC.GENERALITAT';-2,70 €;7.317,25 €;2873;-2,70;11.841,34 €;'sin fechas';18/09/2012;'FFCCGENERALITAT';'Gastos_Ocio y transporte';'Transporte';'VARIABLES'
18/09/2012;18/09/2012;'ONO';-89,42 €;7.227,83 €;2874;-89,42;11.751,92 €;'sin fechas';18/09/2012;'ONO';'Gastos_Servicios tipicos';'Telecomunicaciones';'FIJO'
19/09/2012;19/09/2012;'MINA PUBLICA AIGUES T.01A75789';-35,79 €;7.192,04 €;2875;-35,79;11.716,13 €;'sin fechas';19/09/2012;'MINA';'Gastos_Servicios tipicos';'Agua';'FIJO'
20/09/2012;20/09/2012;'BON AREA';-20,91 €;7.171,13 €;2876;-20,91;11.695,22 €;'sin fechas';20/09/2012;'BON';'Gastos_Compras';'Supermercado';'VARIABLES'
20/09/2012;20/09/2012;'CAFET.C T PRAT';-2,95 €;7.168,18 €;2877;-2,95;11.692,27 €;'sin fechas';20/09/2012;'CAFETC';'Gastos_Ocio y transporte';'Restaurantes';'VARIABLES'
20/09/2012;19/09/2012;'FARMACIA';-3,12 €;7.165,06 €;2878;-3,12;11.689,15 €;'sin fechas';19/09/2012;'FARMACIA';'Gastos_Salud, saber y deporte';'Farmacia';'VARIABLES'
21/09/2012;21/09/2012;'AG.TRIBUT GABRIEL';100,00 €;7.265,06 €;2879;100,00;11.789,15 €;'sin fechas';21/09/2012;'AGTRIBUT';'Ingresos';'Subvenciones';
21/09/2012;13/09/2012;'AUTOPISTA TERR';-1,35 €;7.263,71 €;2880;-1,35;11.787,80 €;'sin fechas';13/09/2012;'AUTOPISTA';'Gastos_Ocio y transporte';'Parking y peaje';'VARIABLES'
21/09/2012;21/09/2012;'CAFET.C T PRAT';-3,80 €;7.259,91 €;2881;-3,80;11.784,00 €;'sin fechas';21/09/2012;'CAFETC';'Gastos_Ocio y transporte';'Restaurantes';'VARIABLES'
21/09/2012;21/09/2012;'MERCADONA';-235,64 €;7.024,27 €;2882;-235,64;11.548,36 €;'sin fechas';21/09/2012;'MERCADONA';'Gastos_Compras';'Supermercado';'VARIABLES'
24/09/2012;17/09/2012;'AUTOPISTA TERR';-1,35 €;7.022,92 €;2883;-1,35;11.547,01 €;'sin fechas';17/09/2012;'AUTOPISTA';'Gastos_Ocio y transporte';'Parking y peaje';'VARIABLES'
24/09/2012;20/09/2012;'AUTOPISTA TERR';-1,35 €;7.021,57 €;2884;-1,35;11.545,66 €;'sin fechas';20/09/2012;'AUTOPISTA';'Gastos_Ocio y transporte';'Parking y peaje';'VARIABLES'
24/09/2012;24/09/2012;'HOGAR&OTROS';-13,40 €;7.008,17 €;2885;-13,40;11.532,26 €;'sin fechas';24/09/2012;'HOGAROTROS';'Gastos_Vivienda y vehiculo';'Otros vivienda';'VARIABLES'
26/09/2012;26/09/2012;'BON AREA';-15,84 €;6.992,33 €;2886;-15,84;11.516,42 €;'sin fechas';26/09/2012;'BON';'Gastos_Compras';'Supermercado';'VARIABLES'
27/09/2012;21/09/2012;'AUTOPISTA TERR';-1,35 €;6.990,98 €;2887;-1,35;11.515,07 €;'sin fechas';21/09/2012;'AUTOPISTA';'Gastos_Ocio y transporte';'Parking y peaje';'VARIABLES'
27/09/2012;26/09/2012;'COCHE&PARKING';-9,45 €;6.981,53 €;2888;-9,45;11.505,62 €;'sin fechas';26/09/2012;'COCHEPARKING';'Gastos_Ocio y transporte';'Parking y peaje';'VARIABLES'
27/09/2012;27/09/2012;'DECATHLON';-17,90 €;6.963,63 €;2889;-17,90;11.487,72 €;'sin fechas';27/09/2012;'DECATHLON';'Gastos_Compras';'Deportivo';'VARIABLES'
27/09/2012;25/09/2012;'EROSKI-[COMIDA]';-39,78 €;6.923,85 €;2890;-39,78;11.447,94 €;'sin fechas';25/09/2012;'EROSKICOMIDA';'Gastos_Compras';'Supermercado';'VARIABLES'
27/09/2012;27/09/2012;'FOMENT DE TERRASSA, S.A. FOMEN';628,04 €;7.551,89 €;2891;628,04;12.075,98 €;'sin fechas';27/09/2012;'FOMENT';'Ingresos';'Nomina';'FIJO'
27/09/2012;27/09/2012;'INFORMACIO I TECNOLOGIA DE CAT';1.543,62 €;9.095,51 €;2892;1.543,62;13.619,60 €;'sin fechas';27/09/2012;'INFORMACIO';'Ingresos';'Nomina';'FIJO'
28/09/2012;22/09/2012;'AUTOPISTA TERR';-1,35 €;9.094,16 €;2893;-1,35;13.618,25 €;'sin fechas';22/09/2012;'AUTOPISTA';'Gastos_Ocio y transporte';'Parking y peaje';'VARIABLES'
28/09/2012;23/09/2012;'AUTOPISTA TERR';-1,35 €;9.092,81 €;2894;-1,35;13.616,90 €;'sin fechas';23/09/2012;'AUTOPISTA';'Gastos_Ocio y transporte';'Parking y peaje';'VARIABLES'
28/09/2012;28/09/2012;'CAPRABO';-10,04 €;9.082,77 €;2895;-10,04;13.606,86 €;'sin fechas';28/09/2012;'CAPRABO';'Gastos_Compras';'Supermercado';'VARIABLES'
28/09/2012;22/09/2012;'COCHE&PARKING';-3,62 €;9.079,15 €;2896;-3,62;13.603,24 €;'sin fechas';22/09/2012;'COCHEPARKING';'Gastos_Ocio y transporte';'Parking y peaje';'VARIABLES'
28/09/2012;28/09/2012;'DIRECCION PROVINCIAL INSS BARC';1.528,09 €;10.607,24 €;2897;1.528,09;15.131,33 €;'sin fechas';28/09/2012;'DIRECCION';'Ingresos';'Nomina';'FIJO'
28/09/2012;28/09/2012;'IMPUESTOS LIBRETA MAX';-3,46 €;10.603,78 €;2898;-3,46;15.127,87 €;'sin fechas';28/09/2012;'IMPUESTOS';'Gastos_Banco y organismos';'Impuestos';'FIJO'
28/09/2012;28/09/2012;'INTERESES LIBRETA MAX';16,48 €;10.620,26 €;2899;16,48;15.144,35 €;'sin fechas';28/09/2012;'INTERESES';'Ingresos';'Rendimientos';
29/09/2012;29/09/2012;'BON AREA';-37,18 €;10.583,08 €;2900;-37,18;15.107,17 €;'sin fechas';29/09/2012;'BON';'Gastos_Compras';'Supermercado';'VARIABLES'
29/09/2012;29/09/2012;'CAPRABO';-11,77 €;10.571,31 €;2901;-11,77;15.095,40 €;'sin fechas';29/09/2012;'CAPRABO';'Gastos_Compras';'Supermercado';'VARIABLES'
30/09/2012;30/09/2012;'CAFET.C T PRAT';-3,80 €;10.567,51 €;2902;-3,80;15.091,60 €;'sin fechas';30/09/2012;'CAFETC';'Gastos_Ocio y transporte';'Restaurantes';'VARIABLES'
30/09/2012;30/09/2012;'COMUNIDAD';-20,00 €;10.547,51 €;2903;-20,00;15.071,60 €;'sin fechas';30/09/2012;'COMUNIDAD';'Gastos_Vivienda y vehiculo';'Comunidad';'FIJO'
01/10/2012;01/10/2012;'ADESLAS CENTRAL 006662671613';-107,00 €;10.440,51 €;2904;-107,00;14.964,60 €;'sin fechas';01/10/2012;'ADESLAS';'Gastos_Salud, saber y deporte';'Medico';'VARIABLES'
01/10/2012;01/10/2012;'AJUNTAMENT DE TER 010000520716';-42,95 €;10.397,56 €;2905;-42,95;14.921,65 €;'sin fechas';01/10/2012;'AJUNTAMENT';'Gastos_Banco y organismos';'Ayuntamiento';'FIJO'
01/10/2012;01/10/2012;'ES STA. MARGARITA';-54,26 €;10.343,30 €;2906;-54,26;14.867,39 €;'sin fechas';01/10/2012;'STA';'Gastos_Ocio y transporte';'Gasolina';'VARIABLES'
01/10/2012;01/10/2012;'MANTENIMIENTO';-2,25 €;10.341,05 €;2907;-2,25;14.865,14 €;'sin fechas';01/10/2012;'MANTENIMIENTO';'Gastos_Banco y organismos';'Cargos banco';'FIJO'
01/10/2012;30/09/2012;'RECIBO PTMOS. 3061-0960001518';-583,25 €;9.757,80 €;2908;-583,25;14.281,89 €;'sin fechas';30/09/2012;'RECIBO';'Gastos_Banco y organismos';'Hipoteca';'FIJO'
01/10/2012;01/10/2012;'RODELAS PERRUQUERS';-10,00 €;9.747,80 €;2909;-10,00;14.271,89 €;'sin fechas';01/10/2012;'RODELAS';'Gastos_Salud, saber y deporte';'Belleza';'VARIABLES'
02/10/2012;30/08/2012;'AUTOPISTA TERR';-1,18 €;9.746,62 €;2910;-1,18;14.270,71 €;'sin fechas';30/08/2012;'AUTOPISTA';'Gastos_Ocio y transporte';'Parking y peaje';'VARIABLES'
02/10/2012;30/08/2012;'AUTOPISTA TERR';-1,18 €;9.745,44 €;2911;-1,18;14.269,53 €;'sin fechas';30/08/2012;'AUTOPISTA';'Gastos_Ocio y transporte';'Parking y peaje';'VARIABLES'
02/10/2012;31/08/2012;'AUTOPISTA TERR';-1,18 €;9.744,26 €;2912;-1,18;14.268,35 €;'sin fechas';31/08/2012;'AUTOPISTA';'Gastos_Ocio y transporte';'Parking y peaje';'VARIABLES'
02/10/2012;31/08/2012;'AUTOPISTA TERR';-1,31 €;9.742,95 €;2913;-1,31;14.267,04 €;'sin fechas';31/08/2012;'AUTOPISTA';'Gastos_Ocio y transporte';'Parking y peaje';'VARIABLES'
02/10/2012;05/09/2012;'AUTOPISTA TERR';-1,35 €;9.741,60 €;2914;-1,35;14.265,69 €;'sin fechas';05/09/2012;'AUTOPISTA';'Gastos_Ocio y transporte';'Parking y peaje';'VARIABLES'
02/10/2012;09/09/2012;'AUTOPISTA TERR';-2,45 €;9.739,15 €;2915;-2,45;14.263,24 €;'sin fechas';09/09/2012;'AUTOPISTA';'Gastos_Ocio y transporte';'Parking y peaje';'VARIABLES'
02/10/2012;10/09/2012;'AUTOPISTA TERR';-1,35 €;9.737,80 €;2916;-1,35;14.261,89 €;'sin fechas';10/09/2012;'AUTOPISTA';'Gastos_Ocio y transporte';'Parking y peaje';'VARIABLES'
02/10/2012;03/09/2012;'CATALANA DIAG.I CIRUR';-3,05 €;9.734,75 €;2917;-3,05;14.258,84 €;'sin fechas';03/09/2012;'CATALANA';'Gastos_Ocio y transporte';'Parking y peaje';'VARIABLES'
02/10/2012;05/09/2012;'CATALANA DIAG.I CIRUR';-1,20 €;9.733,55 €;2918;-1,20;14.257,64 €;'sin fechas';05/09/2012;'CATALANA';'Gastos_Ocio y transporte';'Parking y peaje';'VARIABLES'
02/10/2012;10/09/2012;'COCHE&PARKING';-1,10 €;9.732,45 €;2919;-1,10;14.256,54 €;'sin fechas';10/09/2012;'COCHEPARKING';'Gastos_Ocio y transporte';'Parking y peaje';'VARIABLES'
02/10/2012;10/09/2012;'COCHE&PARKING';-4,07 €;9.728,38 €;2920;-4,07;14.252,47 €;'sin fechas';10/09/2012;'COCHEPARKING';'Gastos_Ocio y transporte';'Parking y peaje';'VARIABLES'
02/10/2012;10/09/2012;'COCHE&PARKING';-1,10 €;9.727,28 €;2921;-1,10;14.251,37 €;'sin fechas';10/09/2012;'COCHEPARKING';'Gastos_Ocio y transporte';'Parking y peaje';'VARIABLES'
02/10/2012;19/09/2012;'MERCADONA';-40,19 €;9.687,09 €;2922;-40,19;14.211,18 €;'sin fechas';19/09/2012;'MERCADONA';'Gastos_Compras';'Supermercado';'VARIABLES'
02/10/2012;11/09/2012;'METRO BARCELONA';-9,45 €;9.677,64 €;2923;-9,45;14.201,73 €;'sin fechas';11/09/2012;'METRO';'Gastos_Ocio y transporte';'Transporte';'VARIABLES'
02/10/2012;02/10/2012;'REINT.CAJERO';-50,00 €;9.627,64 €;2924;-50,00;14.151,73 €;'sin fechas';02/10/2012;'REINTCAJERO';'Gastos_Gastos varios';'Efectivo';'VARIABLES'
02/10/2012;30/08/2012;'WEEKENDESK';-164,00 €;9.463,64 €;2925;-164,00;13.987,73 €;'sin fechas';30/08/2012;'WEEKENDESK';'Gastos_Ocio y transporte';'Vacaciones';'VARIABLES'
03/10/2012;03/10/2012;'SEGUROS CATALANA';-304,93 €;9.158,71 €;2926;-304,93;13.682,80 €;'sin fechas';03/10/2012;'CATALANA';'Gastos_Ocio y transporte';'Parking y peaje';'VARIABLES'
04/10/2012;24/09/2012;'AUTOPISTA TERR';-1,35 €;9.157,36 €;2927;-1,35;13.681,45 €;'sin fechas';24/09/2012;'AUTOPISTA';'Gastos_Ocio y transporte';'Parking y peaje';'VARIABLES'
04/10/2012;28/09/2012;'AUTOPISTA TERR';-1,35 €;9.156,01 €;2928;-1,35;13.680,10 €;'sin fechas';28/09/2012;'AUTOPISTA';'Gastos_Ocio y transporte';'Parking y peaje';'VARIABLES'
04/10/2012;04/10/2012;'CAFET.C T PRAT';-3,55 €;9.152,46 €;2929;-3,55;13.676,55 €;'sin fechas';04/10/2012;'CAFETC';'Gastos_Ocio y transporte';'Restaurantes';'VARIABLES'
04/10/2012;04/10/2012;'YOIGO';-28,94 €;9.123,52 €;2930;-28,94;13.647,61 €;'sin fechas';04/10/2012;'YOIGO';'Gastos_Servicios tipicos';'Telecomunicaciones';'FIJO'
05/10/2012;29/09/2012;'AUTOPISTA TERR';-1,35 €;9.122,17 €;2931;-1,35;13.646,26 €;'sin fechas';29/09/2012;'AUTOPISTA';'Gastos_Ocio y transporte';'Parking y peaje';'VARIABLES'
05/10/2012;30/09/2012;'AUTOPISTA TERR';-1,35 €;9.120,82 €;2932;-1,35;13.644,91 €;'sin fechas';30/09/2012;'AUTOPISTA';'Gastos_Ocio y transporte';'Parking y peaje';'VARIABLES'
05/10/2012;30/09/2012;'AUTOPISTA TERR';-1,28 €;9.119,54 €;2933;-1,28;13.643,63 €;'sin fechas';30/09/2012;'AUTOPISTA';'Gastos_Ocio y transporte';'Parking y peaje';'VARIABLES'
05/10/2012;05/10/2012;'BON AREA';-13,39 €;9.106,15 €;2934;-13,39;13.630,24 €;'sin fechas';05/10/2012;'BON';'Gastos_Compras';'Supermercado';'VARIABLES'
05/10/2012;05/10/2012;'CAFET.C T PRAT';-3,10 €;9.103,05 €;2935;-3,10;13.627,14 €;'sin fechas';05/10/2012;'CAFETC';'Gastos_Ocio y transporte';'Restaurantes';'VARIABLES'
05/10/2012;05/10/2012;'ESCOLA BRESSOL EINA';-255,00 €;8.848,05 €;2936;-255,00;13.372,14 €;'sin fechas';05/10/2012;'ESCOLA';'Gastos_Salud, saber y deporte';'Estudios';'VARIABLES'
05/10/2012;05/10/2012;'ESCOLA BRESSOL EINA';-218,70 €;8.629,35 €;2937;-218,70;13.153,44 €;'sin fechas';05/10/2012;'ESCOLA';'Gastos_Salud, saber y deporte';'Estudios';'VARIABLES'
05/10/2012;05/10/2012;'IBERDROLA GE IBERDRO1011516485';-10,30 €;8.619,05 €;2938;-10,30;13.143,14 €;'sin fechas';05/10/2012;'IBERDROLA';'Gastos_Servicios tipicos';'Electricidad';'FIJO'
05/10/2012;05/10/2012;'QUEVIURES MANUEL S';-13,21 €;8.605,84 €;2939;-13,21;13.129,93 €;'sin fechas';05/10/2012;'QUEVIURES';'Gastos_Compras';'Supermercado';'VARIABLES'
07/10/2012;07/10/2012;'CAFET.C T PRAT';-3,55 €;8.602,29 €;2940;-3,55;13.126,38 €;'sin fechas';07/10/2012;'CAFETC';'Gastos_Ocio y transporte';'Restaurantes';'VARIABLES'
08/10/2012;01/10/2012;'AUTOPISTA TERR';-1,28 €;8.601,01 €;2941;-1,28;13.125,10 €;'sin fechas';01/10/2012;'AUTOPISTA';'Gastos_Ocio y transporte';'Parking y peaje';'VARIABLES'
08/10/2012;01/10/2012;'AUTOPISTA TERR';-1,28 €;8.599,73 €;2942;-1,28;13.123,82 €;'sin fechas';01/10/2012;'AUTOPISTA';'Gastos_Ocio y transporte';'Parking y peaje';'VARIABLES'
08/10/2012;08/10/2012;'CAFET.C T PRAT';-3,55 €;8.596,18 €;2943;-3,55;13.120,27 €;'sin fechas';08/10/2012;'CAFETC';'Gastos_Ocio y transporte';'Restaurantes';'VARIABLES'
08/10/2012;08/10/2012;'MERCADONA';-1,74 €;8.594,44 €;2944;-1,74;13.118,53 €;'sin fechas';08/10/2012;'MERCADONA';'Gastos_Compras';'Supermercado';'VARIABLES'
08/10/2012;08/10/2012;'MERCADONA';-128,92 €;8.465,52 €;2945;-128,92;12.989,61 €;'sin fechas';08/10/2012;'MERCADONA';'Gastos_Compras';'Supermercado';'VARIABLES'
08/10/2012;08/10/2012;'REINT.CAJERO';-100,00 €;8.365,52 €;2946;-100,00;12.889,61 €;'sin fechas';08/10/2012;'REINTCAJERO';'Gastos_Gastos varios';'Efectivo';'VARIABLES'
09/10/2012;09/10/2012;'TOCINERIES VENTURA';-7,61 €;8.357,91 €;2947;-7,61;12.882,00 €;'sin fechas';09/10/2012;'TOCINERIES';'Gastos_Compras';'Supermercado';'VARIABLES'
10/10/2012;10/10/2012;'BON AREA';-15,22 €;8.342,69 €;2948;-15,22;12.866,78 €;'sin fechas';10/10/2012;'BON';'Gastos_Compras';'Supermercado';'VARIABLES'
11/10/2012;11/10/2012;'BLITZ';-72,50 €;8.270,19 €;2949;-72,50;12.794,28 €;'sin fechas';11/10/2012;'BLITZ';'Gastos_Vivienda y vehiculo';'Alquiler Parking';'FIJO'
11/10/2012;11/10/2012;'CAFET.C T PRAT';-3,10 €;8.267,09 €;2950;-3,10;12.791,18 €;'sin fechas';11/10/2012;'CAFETC';'Gastos_Ocio y transporte';'Restaurantes';'VARIABLES'
11/10/2012;09/10/2012;'MEDIA MARKT';-39,99 €;8.227,10 €;2951;-39,99;12.751,19 €;'sin fechas';09/10/2012;'MEDIA';'Gastos_Compras';'Hobbys';'VARIABLES'
11/10/2012;09/10/2012;'RESTAURANTES';-14,40 €;8.212,70 €;2952;-14,40;12.736,79 €;'sin fechas';09/10/2012;'RESTAURANTES';'Gastos_Ocio y transporte';'Restaurantes';'VARIABLES'
11/10/2012;09/10/2012;'RESTAURANTES';-23,65 €;8.189,05 €;2953;-23,65;12.713,14 €;'sin fechas';09/10/2012;'RESTAURANTES';'Gastos_Ocio y transporte';'Restaurantes';'VARIABLES'
11/10/2012;11/10/2012;'RESTAURANTES';-24,38 €;8.164,67 €;2954;-24,38;12.688,76 €;'sin fechas';11/10/2012;'RESTAURANTES';'Gastos_Ocio y transporte';'Restaurantes';'VARIABLES'
11/10/2012;11/10/2012;'TOCINERIES VENTURA';-11,14 €;8.153,53 €;2955;-11,14;12.677,62 €;'sin fechas';11/10/2012;'TOCINERIES';'Gastos_Compras';'Supermercado';'VARIABLES'
12/10/2012;04/10/2012;'AUTOPISTA TERR';-1,35 €;8.152,18 €;2956;-1,35;12.676,27 €;'sin fechas';04/10/2012;'AUTOPISTA';'Gastos_Ocio y transporte';'Parking y peaje';'VARIABLES'
12/10/2012;05/10/2012;'AUTOPISTA TERR';-1,35 €;8.150,83 €;2957;-1,35;12.674,92 €;'sin fechas';05/10/2012;'AUTOPISTA';'Gastos_Ocio y transporte';'Parking y peaje';'VARIABLES'
12/10/2012;05/10/2012;'AUTOPISTA TERR';-1,35 €;8.149,48 €;2958;-1,35;12.673,57 €;'sin fechas';05/10/2012;'AUTOPISTA';'Gastos_Ocio y transporte';'Parking y peaje';'VARIABLES'
12/10/2012;06/10/2012;'AUTOPISTA TERR';-1,35 €;8.148,13 €;2959;-1,35;12.672,22 €;'sin fechas';06/10/2012;'AUTOPISTA';'Gastos_Ocio y transporte';'Parking y peaje';'VARIABLES'
12/10/2012;07/10/2012;'AUTOPISTA TERR';-1,35 €;8.146,78 €;2960;-1,35;12.670,87 €;'sin fechas';07/10/2012;'AUTOPISTA';'Gastos_Ocio y transporte';'Parking y peaje';'VARIABLES'
12/10/2012;12/10/2012;'CAFET.C T PRAT';-3,55 €;8.143,23 €;2961;-3,55;12.667,32 €;'sin fechas';12/10/2012;'CAFETC';'Gastos_Ocio y transporte';'Restaurantes';'VARIABLES'
12/10/2012;12/10/2012;'OCIO&OTROS';-62,20 €;8.081,03 €;2962;-62,20;12.605,12 €;'sin fechas';12/10/2012;'OCIOOTROS';'Gastos_Ocio y transporte';'Otros ocio';'VARIABLES'
13/10/2012;13/10/2012;'TOYOTA ORIENT CARS';-179,82 €;7.901,21 €;2963;-179,82;12.425,30 €;'sin fechas';13/10/2012;'TOYOTA';'Gastos_Vivienda y vehiculo';'Mnto. vehiculo';'VARIABLE'
14/10/2012;08/10/2012;'AUTOPISTA TERR';-1,35 €;7.899,86 €;2964;-1,35;12.423,95 €;'sin fechas';08/10/2012;'AUTOPISTA';'Gastos_Ocio y transporte';'Parking y peaje';'VARIABLES'
14/10/2012;08/10/2012;'AUTOPISTA TERR';-1,35 €;7.898,51 €;2965;-1,35;12.422,60 €;'sin fechas';08/10/2012;'AUTOPISTA';'Gastos_Ocio y transporte';'Parking y peaje';'VARIABLES'
14/10/2012;14/10/2012;'CAFET.C T PRAT';-3,30 €;7.895,21 €;2966;-3,30;12.419,30 €;'sin fechas';14/10/2012;'CAFETC';'Gastos_Ocio y transporte';'Restaurantes';'VARIABLES'
14/10/2012;14/10/2012;'ES STA. MARGARITA';-57,43 €;7.837,78 €;2967;-57,43;12.361,87 €;'sin fechas';14/10/2012;'STA';'Gastos_Ocio y transporte';'Gasolina';'VARIABLES'
15/10/2012;15/10/2012;'BON AREA';-36,62 €;7.801,16 €;2968;-36,62;12.325,25 €;'sin fechas';15/10/2012;'BON';'Gastos_Compras';'Supermercado';'VARIABLES'
15/10/2012;15/10/2012;'CCM VIDA Y P SEGURO PRESTAMO';-25,98 €;7.775,18 €;2969;-25,98;12.299,27 €;'sin fechas';15/10/2012;'CCM';'Gastos_Seguros';'Seguro vida';'FIJO'
15/10/2012;15/10/2012;'CCM VIDA Y PENSIO 000000493358';-18,67 €;7.756,51 €;2970;-18,67;12.280,60 €;'sin fechas';15/10/2012;'CCM';'Gastos_Seguros';'Seguro vida';'FIJO'
17/10/2012;17/10/2012;'FF.CC.GENERALITAT';-3,60 €;7.752,91 €;2971;-3,60;12.277,00 €;'sin fechas';17/10/2012;'FFCCGENERALITAT';'Gastos_Ocio y transporte';'Transporte';'VARIABLES'
17/10/2012;17/10/2012;'ONO';-91,50 €;7.661,41 €;2972;-91,50;12.185,50 €;'sin fechas';17/10/2012;'ONO';'Gastos_Servicios tipicos';'Telecomunicaciones';'FIJO'
18/10/2012;18/10/2012;'AG.TRIBUT GABRIEL';100,00 €;7.761,41 €;2973;100,00;12.285,50 €;'sin fechas';18/10/2012;'AGTRIBUT';'Ingresos';'Subvenciones';
18/10/2012;11/10/2012;'AUTOPISTA TERR';-1,35 €;7.760,06 €;2974;-1,35;12.284,15 €;'sin fechas';11/10/2012;'AUTOPISTA';'Gastos_Ocio y transporte';'Parking y peaje';'VARIABLES'
18/10/2012;18/10/2012;'CAFET.C T PRAT';-3,55 €;7.756,51 €;2975;-3,55;12.280,60 €;'sin fechas';18/10/2012;'CAFETC';'Gastos_Ocio y transporte';'Restaurantes';'VARIABLES'
18/10/2012;16/10/2012;'CARREFOUR-[COMIDA]';-108,64 €;7.647,87 €;2976;-108,64;12.171,96 €;'sin fechas';16/10/2012;'CARREFOURCOMIDA';'Gastos_Compras';'Supermercado';'VARIABLES'
18/10/2012;16/10/2012;'DECATHLON';-64,80 €;7.583,07 €;2977;-64,80;12.107,16 €;'sin fechas';16/10/2012;'DECATHLON';'Gastos_Compras';'Deportivo';'VARIABLES'
18/10/2012;18/10/2012;'FF.CC.GENERALITAT';-7,20 €;7.575,87 €;2978;-7,20;12.099,96 €;'sin fechas';18/10/2012;'FFCCGENERALITAT';'Gastos_Ocio y transporte';'Transporte';'VARIABLES'
18/10/2012;17/10/2012;'RESTAURANTES';-24,10 €;7.551,77 €;2979;-24,10;12.075,86 €;'sin fechas';17/10/2012;'RESTAURANTES';'Gastos_Ocio y transporte';'Restaurantes';'VARIABLES'
18/10/2012;16/10/2012;'VIENA';-10,95 €;7.540,82 €;2980;-10,95;12.064,91 €;'sin fechas';16/10/2012;'VIENA';'Gastos_Ocio y transporte';'Restaurantes';'VARIABLES'
19/10/2012;12/10/2012;'AUTOPISTA TERR';-1,35 €;7.539,47 €;2981;-1,35;12.063,56 €;'sin fechas';12/10/2012;'AUTOPISTA';'Gastos_Ocio y transporte';'Parking y peaje';'VARIABLES'
19/10/2012;13/10/2012;'AUTOPISTA TERR';-1,35 €;7.538,12 €;2982;-1,35;12.062,21 €;'sin fechas';13/10/2012;'AUTOPISTA';'Gastos_Ocio y transporte';'Parking y peaje';'VARIABLES'
19/10/2012;13/10/2012;'AUTOPISTA TERR';-1,35 €;7.536,77 €;2983;-1,35;12.060,86 €;'sin fechas';13/10/2012;'AUTOPISTA';'Gastos_Ocio y transporte';'Parking y peaje';'VARIABLES'
19/10/2012;19/10/2012;'BON AREA';-21,12 €;7.515,65 €;2984;-21,12;12.039,74 €;'sin fechas';19/10/2012;'BON';'Gastos_Compras';'Supermercado';'VARIABLES'
19/10/2012;19/10/2012;'BON AREA';-13,47 €;7.502,18 €;2985;-13,47;12.026,27 €;'sin fechas';19/10/2012;'BON';'Gastos_Compras';'Supermercado';'VARIABLES'
19/10/2012;19/10/2012;'CAFET.C T PRAT';-7,05 €;7.495,13 €;2986;-7,05;12.019,22 €;'sin fechas';19/10/2012;'CAFETC';'Gastos_Ocio y transporte';'Restaurantes';'VARIABLES'
20/10/2012;20/10/2012;'CAFET.C T PRAT';-4,50 €;7.490,63 €;2987;-4,50;12.014,72 €;'sin fechas';20/10/2012;'CAFETC';'Gastos_Ocio y transporte';'Restaurantes';'VARIABLES'
20/10/2012;20/10/2012;'CARREFOUR-[COMIDA]';-3,99 €;7.486,64 €;2988;-3,99;12.010,73 €;'sin fechas';20/10/2012;'CARREFOURCOMIDA';'Gastos_Compras';'Supermercado';'VARIABLES'
21/10/2012;21/10/2012;'CAFET.C T PRAT';-3,55 €;7.483,09 €;2989;-3,55;12.007,18 €;'sin fechas';21/10/2012;'CAFETC';'Gastos_Ocio y transporte';'Restaurantes';'VARIABLES'
22/10/2012;14/10/2012;'AUTOPISTA TERR';-1,28 €;7.481,81 €;2990;-1,28;12.005,90 €;'sin fechas';14/10/2012;'AUTOPISTA';'Gastos_Ocio y transporte';'Parking y peaje';'VARIABLES'
22/10/2012;22/10/2012;'CAFET.C T PRAT';-4,00 €;7.477,81 €;2991;-4,00;12.001,90 €;'sin fechas';22/10/2012;'CAFETC';'Gastos_Ocio y transporte';'Restaurantes';'VARIABLES'
22/10/2012;22/10/2012;'HOGAR&OTROS';-139,99 €;7.337,82 €;2992;-139,99;11.861,91 €;'sin fechas';22/10/2012;'HOGAROTROS';'Gastos_Vivienda y vehiculo';'Otros vivienda';'VARIABLES'
24/10/2012;24/10/2012;'MERCADONA';-21,94 €;7.315,88 €;2993;-21,94;11.839,97 €;'sin fechas';24/10/2012;'MERCADONA';'Gastos_Compras';'Supermercado';'VARIABLES'
24/10/2012;24/10/2012;'REINT.CAJERO';-40,00 €;7.275,88 €;2994;-40,00;11.799,97 €;'sin fechas';24/10/2012;'REINTCAJERO';'Gastos_Gastos varios';'Efectivo';'VARIABLES'
25/10/2012;18/10/2012;'AUTOPISTA TERR';-1,35 €;7.274,53 €;2995;-1,35;11.798,62 €;'sin fechas';18/10/2012;'AUTOPISTA';'Gastos_Ocio y transporte';'Parking y peaje';'VARIABLES'
25/10/2012;25/10/2012;'BON AREA';-14,13 €;7.260,40 €;2996;-14,13;11.784,49 €;'sin fechas';25/10/2012;'BON';'Gastos_Compras';'Supermercado';'VARIABLES'
25/10/2012;24/10/2012;'BURGUER KING';-14,34 €;7.246,06 €;2997;-14,34;11.770,15 €;'sin fechas';24/10/2012;'BURGUER';'Gastos_Ocio y transporte';'Restaurantes';'VARIABLES'
25/10/2012;23/10/2012;'C&A';-87,00 €;7.159,06 €;2998;-87,00;11.683,15 €;'sin fechas';23/10/2012;'CA';'Gastos_Compras';'Ropa';'VARIABLES'
25/10/2012;25/10/2012;'FARMACIA';-4,29 €;7.154,77 €;2999;-4,29;11.678,86 €;'sin fechas';25/10/2012;'FARMACIA';'Gastos_Salud, saber y deporte';'Farmacia';'VARIABLES'
25/10/2012;25/10/2012;'FOMENT DE TERRASSA, S.A. FOMEN';1.570,09 €;8.724,86 €;3000;1.570,09;13.248,95 €;'sin fechas';25/10/2012;'FOMENT';'Ingresos';'Nomina';'FIJO'
25/10/2012;23/10/2012;'RESTAURANTES';-8,80 €;8.716,06 €;3001;-8,80;13.240,15 €;'sin fechas';23/10/2012;'RESTAURANTES';'Gastos_Ocio y transporte';'Restaurantes';'VARIABLES'
25/10/2012;23/10/2012;'VIENA';-16,70 €;8.699,36 €;3002;-16,70;13.223,45 €;'sin fechas';23/10/2012;'VIENA';'Gastos_Ocio y transporte';'Restaurantes';'VARIABLES'
25/10/2012;24/10/2012;'VIENA';-3,90 €;8.695,46 €;3003;-3,90;13.219,55 €;'sin fechas';24/10/2012;'VIENA';'Gastos_Ocio y transporte';'Restaurantes';'VARIABLES'
26/10/2012;19/10/2012;'AUTOPISTA TERR';-1,28 €;8.694,18 €;3004;-1,28;13.218,27 €;'sin fechas';19/10/2012;'AUTOPISTA';'Gastos_Ocio y transporte';'Parking y peaje';'VARIABLES'
26/10/2012;19/10/2012;'AUTOPISTA TERR';-1,35 €;8.692,83 €;3005;-1,35;13.216,92 €;'sin fechas';19/10/2012;'AUTOPISTA';'Gastos_Ocio y transporte';'Parking y peaje';'VARIABLES'
26/10/2012;26/10/2012;'CAFET.C T PRAT';-2,65 €;8.690,18 €;3006;-2,65;13.214,27 €;'sin fechas';26/10/2012;'CAFETC';'Gastos_Ocio y transporte';'Restaurantes';'VARIABLES'
27/10/2012;27/10/2012;'CAFET.C T PRAT';-2,20 €;8.687,98 €;3007;-2,20;13.212,07 €;'sin fechas';27/10/2012;'CAFETC';'Gastos_Ocio y transporte';'Restaurantes';'VARIABLES'
27/10/2012;28/10/2012;'IMPUESTOS LIBRETA MAX';-3,35 €;8.684,63 €;3008;-3,35;13.208,72 €;'sin fechas';28/10/2012;'IMPUESTOS';'Gastos_Banco y organismos';'Impuestos';'FIJO'
27/10/2012;28/10/2012;'INTERESES LIBRETA MAX';15,97 €;8.700,60 €;3009;15,97;13.224,69 €;'sin fechas';28/10/2012;'INTERESES';'Ingresos';'Rendimientos';
28/10/2012;22/10/2012;'AUTOPISTA TERR';-1,28 €;8.699,32 €;3010;-1,28;13.223,41 €;'sin fechas';22/10/2012;'AUTOPISTA';'Gastos_Ocio y transporte';'Parking y peaje';'VARIABLES'
28/10/2012;22/10/2012;'AUTOPISTA TERR';-1,35 €;8.697,97 €;3011;-1,35;13.222,06 €;'sin fechas';22/10/2012;'AUTOPISTA';'Gastos_Ocio y transporte';'Parking y peaje';'VARIABLES'
28/10/2012;28/10/2012;'BON AREA';-11,36 €;8.686,61 €;3012;-11,36;13.210,70 €;'sin fechas';28/10/2012;'BON';'Gastos_Compras';'Supermercado';'VARIABLES'
28/10/2012;28/10/2012;'CAFET.C T PRAT';-3,55 €;8.683,06 €;3013;-3,55;13.207,15 €;'sin fechas';28/10/2012;'CAFETC';'Gastos_Ocio y transporte';'Restaurantes';'VARIABLES'
28/10/2012;28/10/2012;'ES STA. MARGARITA';-15,49 €;8.667,57 €;3014;-15,49;13.191,66 €;'sin fechas';28/10/2012;'STA';'Gastos_Ocio y transporte';'Gasolina';'VARIABLES'
29/10/2012;29/10/2012;'CAFET.C T PRAT';-3,55 €;8.664,02 €;3015;-3,55;13.188,11 €;'sin fechas';29/10/2012;'CAFETC';'Gastos_Ocio y transporte';'Restaurantes';'VARIABLES'
29/10/2012;29/10/2012;'INFORMACIO I TECNOLOGIA DE CAT';1.472,37 €;10.136,39 €;3016;1.472,37;14.660,48 €;'sin fechas';29/10/2012;'INFORMACIO';'Ingresos';'Nomina';'FIJO'
31/10/2012;31/10/2012;'COMUNIDAD';-20,00 €;10.116,39 €;3017;-20,00;14.640,48 €;'sin fechas';31/10/2012;'COMUNIDAD';'Gastos_Vivienda y vehiculo';'Comunidad';'FIJO'
31/10/2012;31/10/2012;'RECIBO PTMOS. 3061-0960001518';-583,25 €;9.533,14 €;3018;-583,25;14.057,23 €;'sin fechas';31/10/2012;'RECIBO';'Gastos_Banco y organismos';'Hipoteca';'FIJO'
01/11/2012;01/11/2012;'MANTENIMIENTO';-2,25 €;9.530,89 €;3020;-2,25;14.054,98 €;'sin fechas';01/11/2012;'MANTENIMIENTO';'Gastos_Banco y organismos';'Cargos banco';'FIJO'
02/11/2012;31/10/2012;'CREDITO';-160,46 €;9.370,43 €;3021;-160,46;13.894,52 €;'sin fechas';31/10/2012;'CREDITO';'No computable';'Recibo Tarjeta';
09/11/2012;09/11/2012;'BLITZ';-72,50 €;9.297,93 €;3022;-72,50;13.822,02 €;'sin fechas';09/11/2012;'BLITZ';'Gastos_Vivienda y vehiculo';'Alquiler Parking';'FIJO'
10/11/2012;10/11/2012;'ESCOLA BRESSOL EINA';-786,73 €;8.511,20 €;3023;-786,73;13.035,29 €;'sin fechas';10/11/2012;'ESCOLA';'Gastos_Salud, saber y deporte';'Estudios';'VARIABLES'
30/11/2012;30/11/2012;'CIA.DE SEGUROS AD 006662671613';-107,00 €;8.404,20 €;3024;-107,00;12.928,29 €;'sin fechas';30/11/2012;'CIADE';'Gastos_Salud, saber y deporte';'Medico';'VARIABLES'
30/11/2012;30/11/2012;'COMUNIDAD';-20,00 €;8.384,20 €;3025;-20,00;12.908,29 €;'sin fechas';30/11/2012;'COMUNIDAD';'Gastos_Vivienda y vehiculo';'Comunidad';'FIJO'
30/11/2012;30/11/2012;'NOMINAS';3.022,30 €;11.406,50 €;3026;3.022,30;15.930,59 €;'sin fechas';30/11/2012;'NOMINAS';'Ingresos';'Nomina';'FIJO'
30/11/2012;30/11/2012;'RECIBO PTMOS. 3061-0960001518';-583,25 €;10.823,25 €;3027;-583,25;15.347,34 €;'sin fechas';30/11/2012;'RECIBO';'Gastos_Banco y organismos';'Hipoteca';'FIJO'
30/11/2012;30/11/2012;'TRASP.CTA. 3061.1290015269';-281,18 €;10.542,07 €;3028;-281,18;15.066,16 €;'sin fechas';30/11/2012;'TRASPCTA';'Gastos_Gastos varios';'Transferencias';'VARIABLES'
01/12/2012;01/12/2012;'MANTENIMIENTO';-2,25 €;10.539,82 €;3029;-2,25;15.063,91 €;'sin fechas';01/12/2012;'MANTENIMIENTO';'Gastos_Banco y organismos';'Cargos banco';'FIJO'
09/12/2012;09/12/2012;'BLITZ';-72,50 €;10.467,32 €;3031;-72,50;14.991,41 €;'sin fechas';09/12/2012;'BLITZ';'Gastos_Vivienda y vehiculo';'Alquiler Parking';'FIJO'
10/12/2012;10/12/2012;'ESCOLA BRESSOL EINA';-786,73 €;9.680,59 €;3032;-786,73;14.204,68 €;'sin fechas';10/12/2012;'ESCOLA';'Gastos_Salud, saber y deporte';'Estudios';'VARIABLES'
31/12/2012;31/12/2012;'CIA.DE SEGUROS AD 006662671613';-107,00 €;9.573,59 €;3033;-107,00;14.097,68 €;'sin fechas';31/12/2012;'CIADE';'Gastos_Salud, saber y deporte';'Medico';'VARIABLES'
31/12/2012;31/12/2012;'COMUNIDAD';-20,00 €;9.553,59 €;3034;-20,00;14.077,68 €;'sin fechas';31/12/2012;'COMUNIDAD';'Gastos_Vivienda y vehiculo';'Comunidad';'FIJO'
31/12/2012;31/12/2012;'ENTREGA PTMO. 3061-0960001518';-3.000,00 €;6.553,59 €;3035;-3.000,00;11.077,68 €;'sin fechas';31/12/2012;'ENTREGA';'Gastos_Banco y organismos';'Hipoteca';'FIJO'
31/12/2012;31/12/2012;'NOMINAS';6.044,60 €;12.598,19 €;3036;6.044,60;17.122,28 €;'sin fechas';31/12/2012;'NOMINAS';'Ingresos';'Nomina';'FIJO'
31/12/2012;31/12/2012;'RECIBO PTMOS. 3061-0960001518';-583,25 €;12.014,94 €;3037;-583,25;16.539,03 €;'sin fechas';31/12/2012;'RECIBO';'Gastos_Banco y organismos';'Hipoteca';'FIJO'
31/12/2012;31/12/2012;'TRASP.CTA. 3061.1290015269';-281,18 €;11.733,76 €;3038;-281,18;16.257,85 €;'sin fechas';31/12/2012;'TRASPCTA';'Gastos_Gastos varios';'Transferencias';'VARIABLES'
31/12/2012;31/12/2012;'YOIGO';-43,23 €;11.690,53 €;3039;-43,23;16.214,62 €;'sin fechas';31/12/2012;'YOIGO';'Gastos_Servicios tipicos';'Telecomunicaciones';'FIJO'
01/01/2013;01/01/2013;'ESCOLA BRESSOL EINA';-393,70 €;11.296,83 €;3042;-393,70;15.820,92 €;'sin fechas';01/01/2013;'ESCOLA';'Gastos_Salud, saber y deporte';'Estudios';'VARIABLES'
01/01/2013;01/01/2013;'ESCOLA BRESSOL EINA';-333,80 €;10.963,03 €;3043;-333,80;15.487,12 €;'sin fechas';01/01/2013;'ESCOLA';'Gastos_Salud, saber y deporte';'Estudios';'VARIABLES'
01/01/2013;01/01/2013;'MANTENIMIENTO';-2,25 €;10.960,78 €;3044;-2,25;15.484,87 €;'sin fechas';01/01/2013;'MANTENIMIENTO';'Gastos_Banco y organismos';'Cargos banco';'FIJO'
02/01/2013;02/01/2013;'AUTOPISTA TERR';-10,15 €;10.950,63 €;3046;-10,15;15.474,72 €;'sin fechas';02/01/2013;'AUTOPISTA';'Gastos_Ocio y transporte';'Parking y peaje';'VARIABLES'
02/01/2013;02/01/2013;'AUTOPISTA TERR';-6,85 €;10.943,78 €;3047;-6,85;15.467,87 €;'sin fechas';02/01/2013;'AUTOPISTA';'Gastos_Ocio y transporte';'Parking y peaje';'VARIABLES'
02/01/2013;02/01/2013;'AUTOPISTA TERR';-2,45 €;10.941,33 €;3048;-2,45;15.465,42 €;'sin fechas';02/01/2013;'AUTOPISTA';'Gastos_Ocio y transporte';'Parking y peaje';'VARIABLES'
02/01/2013;02/01/2013;'MERCADONA';-136,44 €;10.804,89 €;3049;-136,44;15.328,98 €;'sin fechas';02/01/2013;'MERCADONA';'Gastos_Compras';'Supermercado';'VARIABLES'
03/01/2013;03/01/2013;'FOMENT DE TERRASSA, S.A. FOMEN';696,02 €;11.500,91 €;3050;696,02;16.025,00 €;'sin fechas';03/01/2013;'FOMENT';'Ingresos';'Nomina';'FIJO'
03/01/2013;03/01/2013;'GAME';-49,95 €;11.450,96 €;3051;-49,95;15.975,05 €;'sin fechas';03/01/2013;'GAME';'Gastos_Compras';'Hobbys';'VARIABLES'
03/01/2013;01/01/2013;'IKEA';-37,92 €;11.413,04 €;3052;-37,92;15.937,13 €;'sin fechas';01/01/2013;'IKEA';'Gastos_Vivienda y vehiculo';'Mnto. hogar';'VARIABLES'
03/01/2013;03/01/2013;'MERCADONA';-60,76 €;11.352,28 €;3053;-60,76;15.876,37 €;'sin fechas';03/01/2013;'MERCADONA';'Gastos_Compras';'Supermercado';'VARIABLES'
04/01/2013;04/01/2013;'MERCADONA';-9,81 €;11.342,47 €;3054;-9,81;15.866,56 €;'sin fechas';04/01/2013;'MERCADONA';'Gastos_Compras';'Supermercado';'VARIABLES'
05/01/2013;05/01/2013;'AUTOPISTA TERR';-1,35 €;11.341,12 €;3055;-1,35;15.865,21 €;'sin fechas';05/01/2013;'AUTOPISTA';'Gastos_Ocio y transporte';'Parking y peaje';'VARIABLES'
05/01/2013;05/01/2013;'AUTOPISTA TERR';-10,15 €;11.330,97 €;3056;-10,15;15.855,06 €;'sin fechas';05/01/2013;'AUTOPISTA';'Gastos_Ocio y transporte';'Parking y peaje';'VARIABLES'
05/01/2013;05/01/2013;'CAFET.C T PRAT';-4,90 €;11.326,07 €;3057;-4,90;15.850,16 €;'sin fechas';05/01/2013;'CAFETC';'Gastos_Ocio y transporte';'Restaurantes';'VARIABLES'
05/01/2013;04/01/2013;'LA BRASA';-93,67 €;11.232,40 €;3059;-93,67;15.756,49 €;'sin fechas';04/01/2013;'BRASA';'Gastos_Ocio y transporte';'Restaurantes';'VARIABLES'
05/01/2013;04/01/2013;'VIENA';-17,30 €;11.215,10 €;3060;-17,30;15.739,19 €;'sin fechas';04/01/2013;'VIENA';'Gastos_Ocio y transporte';'Restaurantes';'VARIABLES'
06/01/2013;02/01/2013;'AUTOPISTA TERR';-2,45 €;11.212,65 €;3061;-2,45;15.736,74 €;'sin fechas';02/01/2013;'AUTOPISTA';'Gastos_Ocio y transporte';'Parking y peaje';'VARIABLES'
06/01/2013;02/01/2013;'AUTOPISTA TERR';-2,45 €;11.210,20 €;3062;-2,45;15.734,29 €;'sin fechas';02/01/2013;'AUTOPISTA';'Gastos_Ocio y transporte';'Parking y peaje';'VARIABLES'
06/01/2013;06/01/2013;'AUTOPISTA TERR';-1,35 €;11.208,85 €;3063;-1,35;15.732,94 €;'sin fechas';06/01/2013;'AUTOPISTA';'Gastos_Ocio y transporte';'Parking y peaje';'VARIABLES'
06/01/2013;06/01/2013;'AUTOPISTA TERR';-1,35 €;11.207,50 €;3064;-1,35;15.731,59 €;'sin fechas';06/01/2013;'AUTOPISTA';'Gastos_Ocio y transporte';'Parking y peaje';'VARIABLES'
06/01/2013;06/01/2013;'AUTOPISTA TERR';-1,21 €;11.206,29 €;3065;-1,21;15.730,38 €;'sin fechas';06/01/2013;'AUTOPISTA';'Gastos_Ocio y transporte';'Parking y peaje';'VARIABLES'
06/01/2013;06/01/2013;'AUTOPISTA TERR';-1,35 €;11.204,94 €;3066;-1,35;15.729,03 €;'sin fechas';06/01/2013;'AUTOPISTA';'Gastos_Ocio y transporte';'Parking y peaje';'VARIABLES'
06/01/2013;06/01/2013;'CAFET.C T PRAT';-3,60 €;11.201,34 €;3067;-3,60;15.725,43 €;'sin fechas';06/01/2013;'CAFETC';'Gastos_Ocio y transporte';'Restaurantes';'VARIABLES'
07/01/2013;07/01/2013;'CAFET.C T PRAT';-3,60 €;11.197,74 €;3068;-3,60;15.721,83 €;'sin fechas';07/01/2013;'CAFETC';'Gastos_Ocio y transporte';'Restaurantes';'VARIABLES'
07/01/2013;07/01/2013;'M&S';-34,50 €;11.163,24 €;3069;-34,50;15.687,33 €;'sin fechas';07/01/2013;'MS';'Gastos_Compras';'Ropa';'VARIABLES'
09/01/2013;09/01/2013;'BON AREA';-16,53 €;11.146,71 €;3070;-16,53;15.670,80 €;'sin fechas';09/01/2013;'BON';'Gastos_Compras';'Supermercado';'VARIABLES'
10/01/2013;03/01/2013;'AUTOPISTA TERR';-1,35 €;11.145,36 €;3071;-1,35;15.669,45 €;'sin fechas';03/01/2013;'AUTOPISTA';'Gastos_Ocio y transporte';'Parking y peaje';'VARIABLES'
10/01/2013;10/01/2013;'CAFET.C T PRAT';-2,50 €;11.142,86 €;3072;-2,50;15.666,95 €;'sin fechas';10/01/2013;'CAFETC';'Gastos_Ocio y transporte';'Restaurantes';'VARIABLES'
10/01/2013;08/01/2013;'CARREFOUR-[COMIDA]';-5,00 €;11.137,86 €;3073;-5,00;15.661,95 €;'sin fechas';08/01/2013;'CARREFOURCOMIDA';'Gastos_Compras';'Supermercado';'VARIABLES'
10/01/2013;08/01/2013;'DRIM';-88,94 €;11.048,92 €;3074;-88,94;15.573,01 €;'sin fechas';08/01/2013;'DRIM';'Gastos_Compras';'Niños';'VARIABLES'
10/01/2013;08/01/2013;'EROSKI-[COMIDA]';-19,10 €;11.029,82 €;3075;-19,10;15.553,91 €;'sin fechas';08/01/2013;'EROSKICOMIDA';'Gastos_Compras';'Supermercado';'VARIABLES'
10/01/2013;10/01/2013;'ES STA. MARGARITA';-30,00 €;10.999,82 €;3077;-30,00;15.523,91 €;'sin fechas';10/01/2013;'STA';'Gastos_Ocio y transporte';'Gasolina';'VARIABLES'
10/01/2013;08/01/2013;'RESTAURANTES';-28,90 €;10.970,92 €;3078;-28,90;15.495,01 €;'sin fechas';08/01/2013;'RESTAURANTES';'Gastos_Ocio y transporte';'Restaurantes';'VARIABLES'
10/01/2013;10/01/2013;'TOCINERIES VENTURA';-15,34 €;10.955,58 €;3079;-15,34;15.479,67 €;'sin fechas';10/01/2013;'TOCINERIES';'Gastos_Compras';'Supermercado';'VARIABLES'
10/01/2013;10/01/2013;'VIENA';-17,60 €;10.937,98 €;3080;-17,60;15.462,07 €;'sin fechas';10/01/2013;'VIENA';'Gastos_Ocio y transporte';'Restaurantes';'VARIABLES'
10/01/2013;08/01/2013;'VIENA';-19,10 €;10.918,88 €;3081;-19,10;15.442,97 €;'sin fechas';08/01/2013;'VIENA';'Gastos_Ocio y transporte';'Restaurantes';'VARIABLES'
10/01/2013;09/01/2013;'XARCUTERIA VIDAL';-29,80 €;10.889,08 €;3082;-29,80;15.413,17 €;'sin fechas';09/01/2013;'XARCUTERIA';'Gastos_Compras';'Supermercado';'VARIABLES'
11/01/2013;11/01/2013;'ADESLAS CENTRAL 006662671613';-110,65 €;10.778,43 €;3083;-110,65;15.302,52 €;'sin fechas';11/01/2013;'ADESLAS';'Gastos_Salud, saber y deporte';'Medico';'VARIABLES'
11/01/2013;05/01/2013;'AUTOPISTA TERR';-1,39 €;10.777,04 €;3084;-1,39;15.301,13 €;'sin fechas';05/01/2013;'AUTOPISTA';'Gastos_Ocio y transporte';'Parking y peaje';'VARIABLES'
11/01/2013;05/01/2013;'AUTOPISTA TERR';-1,39 €;10.775,65 €;3085;-1,39;15.299,74 €;'sin fechas';05/01/2013;'AUTOPISTA';'Gastos_Ocio y transporte';'Parking y peaje';'VARIABLES'
11/01/2013;11/01/2013;'CAFET.C T PRAT';-3,10 €;10.772,55 €;3086;-3,10;15.296,64 €;'sin fechas';11/01/2013;'CAFETC';'Gastos_Ocio y transporte';'Restaurantes';'VARIABLES'
11/01/2013;11/01/2013;'CARREFOUR-[MODA]';-136,07 €;10.636,48 €;3087;-136,07;15.160,57 €;'sin fechas';11/01/2013;'CARREFOURMODA';'Gastos_Compras';'Supermercado';'VARIABLES'
11/01/2013;11/01/2013;'MC DONALDS';-9,30 €;10.627,18 €;3088;-9,30;15.151,27 €;'sin fechas';11/01/2013;'DONALDS';'Gastos_Ocio y transporte';'Restaurantes';'VARIABLES'
12/01/2013;12/01/2013;'C&A';-34,50 €;10.592,68 €;3089;-34,50;15.116,77 €;'sin fechas';12/01/2013;'CA';'Gastos_Compras';'Ropa';'VARIABLES'
12/01/2013;12/01/2013;'CAFET.C T PRAT';-3,60 €;10.589,08 €;3090;-3,60;15.113,17 €;'sin fechas';12/01/2013;'CAFETC';'Gastos_Ocio y transporte';'Restaurantes';'VARIABLES'
12/01/2013;12/01/2013;'M&S';-15,00 €;10.574,08 €;3091;-15,00;15.098,17 €;'sin fechas';12/01/2013;'MS';'Gastos_Compras';'Ropa';'VARIABLES'
13/01/2013;09/01/2013;'AUTOPISTA TERR';-2,53 €;10.571,55 €;3092;-2,53;15.095,64 €;'sin fechas';09/01/2013;'AUTOPISTA';'Gastos_Ocio y transporte';'Parking y peaje';'VARIABLES'
13/01/2013;09/01/2013;'AUTOPISTA TERR';-2,53 €;10.569,02 €;3093;-2,53;15.093,11 €;'sin fechas';09/01/2013;'AUTOPISTA';'Gastos_Ocio y transporte';'Parking y peaje';'VARIABLES'
13/01/2013;13/01/2013;'VIENA';-15,65 €;10.553,37 €;3094;-15,65;15.077,46 €;'sin fechas';13/01/2013;'VIENA';'Gastos_Ocio y transporte';'Restaurantes';'VARIABLES'
14/01/2013;14/01/2013;'CAFET.C T PRAT';-3,60 €;10.549,77 €;3095;-3,60;15.073,86 €;'sin fechas';14/01/2013;'CAFETC';'Gastos_Ocio y transporte';'Restaurantes';'VARIABLES'
14/01/2013;14/01/2013;'CAPRABO';-14,85 €;10.534,92 €;3096;-14,85;15.059,01 €;'sin fechas';14/01/2013;'CAPRABO';'Gastos_Compras';'Supermercado';'VARIABLES'
14/01/2013;14/01/2013;'VIENA';-22,70 €;10.512,22 €;3097;-22,70;15.036,31 €;'sin fechas';14/01/2013;'VIENA';'Gastos_Ocio y transporte';'Restaurantes';'VARIABLES'
15/01/2013;15/01/2013;'CCM VIDA Y P SEGURO PRESTAMO';-24,86 €;10.487,36 €;3098;-24,86;15.011,45 €;'sin fechas';15/01/2013;'CCM';'Gastos_Seguros';'Seguro vida';'FIJO'
15/01/2013;15/01/2013;'CCM VIDA Y PENSIO 000000493358';-18,57 €;10.468,79 €;3099;-18,57;14.992,88 €;'sin fechas';15/01/2013;'CCM';'Gastos_Seguros';'Seguro vida';'FIJO'
17/01/2013;11/01/2013;'AUTOPISTA TERR';-1,39 €;10.467,40 €;3100;-1,39;14.991,49 €;'sin fechas';11/01/2013;'AUTOPISTA';'Gastos_Ocio y transporte';'Parking y peaje';'VARIABLES'
17/01/2013;11/01/2013;'AUTOPISTA TERR';-1,39 €;10.466,01 €;3101;-1,39;14.990,10 €;'sin fechas';11/01/2013;'AUTOPISTA';'Gastos_Ocio y transporte';'Parking y peaje';'VARIABLES'
17/01/2013;17/01/2013;'CAFET.C T PRAT';-4,35 €;10.461,66 €;3102;-4,35;14.985,75 €;'sin fechas';17/01/2013;'CAFETC';'Gastos_Ocio y transporte';'Restaurantes';'VARIABLES'
17/01/2013;10/01/2013;'COCHE&PARKING';-6,15 €;10.455,51 €;3103;-6,15;14.979,60 €;'sin fechas';10/01/2013;'COCHEPARKING';'Gastos_Ocio y transporte';'Parking y peaje';'VARIABLES'
17/01/2013;16/01/2013;'ES STA. MARGARITA';-52,33 €;10.403,18 €;3104;-52,33;14.927,27 €;'sin fechas';16/01/2013;'STA';'Gastos_Ocio y transporte';'Gasolina';'VARIABLES'
17/01/2013;15/01/2013;'FOREVER 21';-4,99 €;10.398,19 €;3105;-4,99;14.922,28 €;'sin fechas';15/01/2013;'FOREVER';'Gastos_Compras';'Ropa';'VARIABLES'
17/01/2013;16/01/2013;'KIABI';-139,06 €;10.259,13 €;3106;-139,06;14.783,22 €;'sin fechas';16/01/2013;'KIABI';'Gastos_Compras';'Ropa';'VARIABLES'
17/01/2013;15/01/2013;'RESTAURANTES';-35,40 €;10.223,73 €;3108;-35,40;14.747,82 €;'sin fechas';15/01/2013;'RESTAURANTES';'Gastos_Ocio y transporte';'Restaurantes';'VARIABLES'
17/01/2013;17/01/2013;'TACISA';-49,93 €;10.173,80 €;3109;-49,93;14.697,89 €;'sin fechas';17/01/2013;'TACISA';'Gastos_Compras';'Supermercado';'VARIABLES'
18/01/2013;13/01/2013;'AUTOPISTA TERR';-1,32 €;10.172,48 €;3110;-1,32;14.696,57 €;'sin fechas';13/01/2013;'AUTOPISTA';'Gastos_Ocio y transporte';'Parking y peaje';'VARIABLES'
18/01/2013;13/01/2013;'AUTOPISTA TERR';-1,39 €;10.171,09 €;3111;-1,39;14.695,18 €;'sin fechas';13/01/2013;'AUTOPISTA';'Gastos_Ocio y transporte';'Parking y peaje';'VARIABLES'
18/01/2013;12/01/2013;'AUTOPISTA TERR';-1,39 €;10.169,70 €;3112;-1,39;14.693,79 €;'sin fechas';12/01/2013;'AUTOPISTA';'Gastos_Ocio y transporte';'Parking y peaje';'VARIABLES'
18/01/2013;12/01/2013;'AUTOPISTA TERR';-1,39 €;10.168,31 €;3113;-1,39;14.692,40 €;'sin fechas';12/01/2013;'AUTOPISTA';'Gastos_Ocio y transporte';'Parking y peaje';'VARIABLES'
18/01/2013;13/01/2013;'AUTOPISTA TERR';-2,53 €;10.165,78 €;3114;-2,53;14.689,87 €;'sin fechas';13/01/2013;'AUTOPISTA';'Gastos_Ocio y transporte';'Parking y peaje';'VARIABLES'
18/01/2013;18/01/2013;'CAFET.C T PRAT';-3,60 €;10.162,18 €;3115;-3,60;14.686,27 €;'sin fechas';18/01/2013;'CAFETC';'Gastos_Ocio y transporte';'Restaurantes';'VARIABLES'
18/01/2013;18/01/2013;'ONO';-89,99 €;10.072,19 €;3116;-89,99;14.596,28 €;'sin fechas';18/01/2013;'ONO';'Gastos_Servicios tipicos';'Telecomunicaciones';'FIJO'
19/01/2013;19/01/2013;'CAFET.C T PRAT';-3,60 €;10.068,59 €;3117;-3,60;14.592,68 €;'sin fechas';19/01/2013;'CAFETC';'Gastos_Ocio y transporte';'Restaurantes';'VARIABLES'
19/01/2013;19/01/2013;'CARREFOUR-[MODA]';-70,31 €;9.998,28 €;3118;-70,31;14.522,37 €;'sin fechas';19/01/2013;'CARREFOURMODA';'Gastos_Compras';'Supermercado';'VARIABLES'
19/01/2013;19/01/2013;'MC DONALDS';-5,75 €;9.992,53 €;3119;-5,75;14.516,62 €;'sin fechas';19/01/2013;'DONALDS';'Gastos_Ocio y transporte';'Restaurantes';'VARIABLES'
21/01/2013;17/01/2013;'AUTOPISTA TERR';-1,39 €;9.991,14 €;3121;-1,39;14.515,23 €;'sin fechas';17/01/2013;'AUTOPISTA';'Gastos_Ocio y transporte';'Parking y peaje';'VARIABLES'
21/01/2013;17/01/2013;'AUTOPISTA TERR';-1,32 €;9.989,82 €;3122;-1,32;14.513,91 €;'sin fechas';17/01/2013;'AUTOPISTA';'Gastos_Ocio y transporte';'Parking y peaje';'VARIABLES'
21/01/2013;14/01/2013;'AUTOPISTA TERR';-1,32 €;9.988,50 €;3123;-1,32;14.512,59 €;'sin fechas';14/01/2013;'AUTOPISTA';'Gastos_Ocio y transporte';'Parking y peaje';'VARIABLES'
21/01/2013;14/01/2013;'AUTOPISTA TERR';-1,32 €;9.987,18 €;3124;-1,32;14.511,27 €;'sin fechas';14/01/2013;'AUTOPISTA';'Gastos_Ocio y transporte';'Parking y peaje';'VARIABLES'
21/01/2013;09/01/2013;'AUTOPISTA TERR';-3,73 €;9.983,45 €;3125;-3,73;14.507,54 €;'sin fechas';09/01/2013;'AUTOPISTA';'Gastos_Ocio y transporte';'Parking y peaje';'VARIABLES'
21/01/2013;09/01/2013;'AUTOPISTA TERR';-3,73 €;9.979,72 €;3126;-3,73;14.503,81 €;'sin fechas';09/01/2013;'AUTOPISTA';'Gastos_Ocio y transporte';'Parking y peaje';'VARIABLES'
21/01/2013;21/01/2013;'CAFET.C T PRAT';-3,60 €;9.976,12 €;3127;-3,60;14.500,21 €;'sin fechas';21/01/2013;'CAFETC';'Gastos_Ocio y transporte';'Restaurantes';'VARIABLES'
21/01/2013;21/01/2013;'COCHE&PARKING';-1,00 €;9.975,12 €;3128;-1,00;14.499,21 €;'sin fechas';21/01/2013;'COCHEPARKING';'Gastos_Ocio y transporte';'Parking y peaje';'VARIABLES'
21/01/2013;21/01/2013;'MERCADONA';-184,56 €;9.790,56 €;3129;-184,56;14.314,65 €;'sin fechas';21/01/2013;'MERCADONA';'Gastos_Compras';'Supermercado';'VARIABLES'
22/01/2013;22/01/2013;'FRANKFURT LES LLETRES';-7,95 €;9.782,61 €;3130;-7,95;14.306,70 €;'sin fechas';22/01/2013;'FRANKFURT';'Gastos_Ocio y transporte';'Restaurantes';'VARIABLES'
23/01/2013;23/01/2013;'AG.TRIBUT GABRIEL';100,00 €;9.882,61 €;3131;100,00;14.406,70 €;'sin fechas';23/01/2013;'AGTRIBUT';'Ingresos';'Subvenciones';
24/01/2013;18/01/2013;'AUTOPISTA TERR';-1,32 €;9.881,29 €;3132;-1,32;14.405,38 €;'sin fechas';18/01/2013;'AUTOPISTA';'Gastos_Ocio y transporte';'Parking y peaje';'VARIABLES'
24/01/2013;18/01/2013;'AUTOPISTA TERR';-1,39 €;9.879,90 €;3133;-1,39;14.403,99 €;'sin fechas';18/01/2013;'AUTOPISTA';'Gastos_Ocio y transporte';'Parking y peaje';'VARIABLES'
24/01/2013;24/12/2012;'BLITZ';-72,50 €;9.807,40 €;3134;-72,50;14.331,49 €;'sin fechas';24/12/2012;'BLITZ';'Gastos_Vivienda y vehiculo';'Alquiler Parking';'FIJO'
24/01/2013;24/01/2013;'BLITZ';-72,50 €;9.734,90 €;3135;-72,50;14.258,99 €;'sin fechas';24/01/2013;'BLITZ';'Gastos_Vivienda y vehiculo';'Alquiler Parking';'FIJO'
24/01/2013;24/01/2013;'BON AREA';-18,59 €;9.716,31 €;3136;-18,59;14.240,40 €;'sin fechas';24/01/2013;'BON';'Gastos_Compras';'Supermercado';'VARIABLES'
24/01/2013;24/01/2013;'CAFET.C T PRAT';-2,70 €;9.713,61 €;3137;-2,70;14.237,70 €;'sin fechas';24/01/2013;'CAFETC';'Gastos_Ocio y transporte';'Restaurantes';'VARIABLES'
24/01/2013;24/01/2013;'FARMACIA';-79,23 €;9.634,38 €;3138;-79,23;14.158,47 €;'sin fechas';24/01/2013;'FARMACIA';'Gastos_Salud, saber y deporte';'Farmacia';'VARIABLES'
25/01/2013;20/01/2013;'AUTOPISTA TERR';-1,25 €;9.633,13 €;3139;-1,25;14.157,22 €;'sin fechas';20/01/2013;'AUTOPISTA';'Gastos_Ocio y transporte';'Parking y peaje';'VARIABLES'
25/01/2013;20/01/2013;'AUTOPISTA TERR';-1,25 €;9.631,88 €;3140;-1,25;14.155,97 €;'sin fechas';20/01/2013;'AUTOPISTA';'Gastos_Ocio y transporte';'Parking y peaje';'VARIABLES'
25/01/2013;19/01/2013;'AUTOPISTA TERR';-1,25 €;9.630,63 €;3141;-1,25;14.154,72 €;'sin fechas';19/01/2013;'AUTOPISTA';'Gastos_Ocio y transporte';'Parking y peaje';'VARIABLES'
25/01/2013;19/01/2013;'AUTOPISTA TERR';-1,25 €;9.629,38 €;3142;-1,25;14.153,47 €;'sin fechas';19/01/2013;'AUTOPISTA';'Gastos_Ocio y transporte';'Parking y peaje';'VARIABLES'
25/01/2013;25/01/2013;'BON AREA';-26,08 €;9.603,30 €;3143;-26,08;14.127,39 €;'sin fechas';25/01/2013;'BON';'Gastos_Compras';'Supermercado';'VARIABLES'
25/01/2013;25/01/2013;'CAFET.C T PRAT';-1,80 €;9.601,50 €;3144;-1,80;14.125,59 €;'sin fechas';25/01/2013;'CAFETC';'Gastos_Ocio y transporte';'Restaurantes';'VARIABLES'
26/01/2013;26/01/2013;'CAFET.C T PRAT';-2,55 €;9.598,95 €;3145;-2,55;14.123,04 €;'sin fechas';26/01/2013;'CAFETC';'Gastos_Ocio y transporte';'Restaurantes';'VARIABLES'
26/01/2013;26/01/2013;'COCHE&PARKING';-5,65 €;9.593,30 €;3146;-5,65;14.117,39 €;'sin fechas';26/01/2013;'COCHEPARKING';'Gastos_Ocio y transporte';'Parking y peaje';'VARIABLES'
26/01/2013;26/01/2013;'EROSKI-[OTROS]';-52,80 €;9.540,50 €;3147;-52,80;14.064,59 €;'sin fechas';26/01/2013;'EROSKIOTROS';'Gastos_Compras';'Supermercado';'VARIABLES'
26/01/2013;28/01/2013;'FOMENT DE TERRASSA, S.A. FOMEN';1.601,48 €;11.141,98 €;3148;1.601,48;15.666,07 €;'sin fechas';28/01/2013;'FOMENT';'Ingresos';'Nomina';'FIJO'
26/01/2013;26/01/2013;'MC DONALDS';-10,45 €;11.131,53 €;3149;-10,45;15.655,62 €;'sin fechas';26/01/2013;'DONALDS';'Gastos_Ocio y transporte';'Restaurantes';'VARIABLES'
27/01/2013;27/01/2013;'CAFET.C T PRAT';-3,60 €;11.127,93 €;3150;-3,60;15.652,02 €;'sin fechas';27/01/2013;'CAFETC';'Gastos_Ocio y transporte';'Restaurantes';'VARIABLES'
27/01/2013;27/01/2013;'ES STA. MARGARITA';-43,96 €;11.083,97 €;3151;-43,96;15.608,06 €;'sin fechas';27/01/2013;'STA';'Gastos_Ocio y transporte';'Gasolina';'VARIABLES'
28/01/2013;21/01/2013;'AUTOPISTA TERR';-1,25 €;11.082,72 €;3152;-1,25;15.606,81 €;'sin fechas';21/01/2013;'AUTOPISTA';'Gastos_Ocio y transporte';'Parking y peaje';'VARIABLES'
28/01/2013;21/01/2013;'AUTOPISTA TERR';-1,25 €;11.081,47 €;3153;-1,25;15.605,56 €;'sin fechas';21/01/2013;'AUTOPISTA';'Gastos_Ocio y transporte';'Parking y peaje';'VARIABLES'
28/01/2013;28/01/2013;'CAFET.C T PRAT';-3,60 €;11.077,87 €;3154;-3,60;15.601,96 €;'sin fechas';28/01/2013;'CAFETC';'Gastos_Ocio y transporte';'Restaurantes';'VARIABLES'
28/01/2013;28/01/2013;'H&M';-26,00 €;11.051,87 €;3155;-26,00;15.575,96 €;'sin fechas';28/01/2013;'HM';'Gastos_Compras';'Ropa';'VARIABLES'
29/01/2013;29/01/2013;'DEV.COMPRA TJ WEEKENDESK';146,00 €;11.197,87 €;3156;146,00;15.721,96 €;'sin fechas';29/01/2013;'DEVCOMPRA';'Ingresos';'Devoluciones';'VARIABLES'
31/01/2013;25/01/2013;'AUTOPISTA TERR';-1,25 €;11.196,62 €;3157;-1,25;15.720,71 €;'sin fechas';25/01/2013;'AUTOPISTA';'Gastos_Ocio y transporte';'Parking y peaje';'VARIABLES'
31/01/2013;25/01/2013;'AUTOPISTA TERR';-1,25 €;11.195,37 €;3158;-1,25;15.719,46 €;'sin fechas';25/01/2013;'AUTOPISTA';'Gastos_Ocio y transporte';'Parking y peaje';'VARIABLES'
31/01/2013;24/01/2013;'AUTOPISTA TERR';-1,39 €;11.193,98 €;3159;-1,39;15.718,07 €;'sin fechas';24/01/2013;'AUTOPISTA';'Gastos_Ocio y transporte';'Parking y peaje';'VARIABLES'
31/01/2013;24/01/2013;'AUTOPISTA TERR';-1,25 €;11.192,73 €;3160;-1,25;15.716,82 €;'sin fechas';24/01/2013;'AUTOPISTA';'Gastos_Ocio y transporte';'Parking y peaje';'VARIABLES'
31/01/2013;24/01/2013;'COCHE&PARKING';-1,75 €;11.190,98 €;3161;-1,75;15.715,07 €;'sin fechas';24/01/2013;'COCHEPARKING';'Gastos_Ocio y transporte';'Parking y peaje';'VARIABLES'
31/01/2013;31/01/2013;'GAS NATURAL';-227,49 €;10.963,49 €;3163;-227,49;15.487,58 €;'sin fechas';31/01/2013;'GAS';'Gastos_Servicios tipicos';'Gas';'FIJO'
31/01/2013;31/01/2013;'INFORMACIO I TECNOLOGIA DE CAT';1.579,09 €;12.542,58 €;3164;1.579,09;17.066,67 €;'sin fechas';31/01/2013;'INFORMACIO';'Ingresos';'Nomina';'FIJO'
31/01/2013;31/01/2013;'PRIMARK';-53,00 €;12.489,58 €;3165;-53,00;17.013,67 €;'sin fechas';31/01/2013;'PRIMARK';'Gastos_Compras';'Ropa';'VARIABLES'
31/01/2013;31/01/2013;'RECIBO PTMOS. 3061-0960001518';-562,73 €;11.926,85 €;3166;-562,73;16.450,94 €;'sin fechas';31/01/2013;'RECIBO';'Gastos_Banco y organismos';'Hipoteca';'FIJO'
31/01/2013;31/01/2013;'VIENA';-18,50 €;11.908,35 €;3167;-18,50;16.432,44 €;'sin fechas';31/01/2013;'VIENA';'Gastos_Ocio y transporte';'Restaurantes';'VARIABLES'
31/01/2013;29/01/2013;'VIENA';-15,80 €;11.892,55 €;3168;-15,80;16.416,64 €;'sin fechas';29/01/2013;'VIENA';'Gastos_Ocio y transporte';'Restaurantes';'VARIABLES'
01/02/2013;27/01/2013;'AUTOPISTA TERR';-1,39 €;11.891,16 €;3169;-1,39;16.415,25 €;'sin fechas';27/01/2013;'AUTOPISTA';'Gastos_Ocio y transporte';'Parking y peaje';'VARIABLES'
01/02/2013;27/01/2013;'AUTOPISTA TERR';-1,11 €;11.890,05 €;3170;-1,11;16.414,14 €;'sin fechas';27/01/2013;'AUTOPISTA';'Gastos_Ocio y transporte';'Parking y peaje';'VARIABLES'
01/02/2013;26/01/2013;'AUTOPISTA TERR';-1,25 €;11.888,80 €;3171;-1,25;16.412,89 €;'sin fechas';26/01/2013;'AUTOPISTA';'Gastos_Ocio y transporte';'Parking y peaje';'VARIABLES'
01/02/2013;26/01/2013;'AUTOPISTA TERR';-1,11 €;11.887,69 €;3172;-1,11;16.411,78 €;'sin fechas';26/01/2013;'AUTOPISTA';'Gastos_Ocio y transporte';'Parking y peaje';'VARIABLES'
01/02/2013;26/01/2013;'COCHE&PARKING';-8,05 €;11.879,64 €;3173;-8,05;16.403,73 €;'sin fechas';26/01/2013;'COCHEPARKING';'Gastos_Ocio y transporte';'Parking y peaje';'VARIABLES'
01/02/2013;25/01/2013;'COCHE&PARKING';-3,20 €;11.876,44 €;3174;-3,20;16.400,53 €;'sin fechas';25/01/2013;'COCHEPARKING';'Gastos_Ocio y transporte';'Parking y peaje';'VARIABLES'
01/02/2013;01/02/2013;'HOGAR&OTROS';-50,00 €;11.826,44 €;3178;-50,00;16.350,53 €;'sin fechas';01/02/2013;'HOGAROTROS';'Gastos_Vivienda y vehiculo';'Otros vivienda';'VARIABLES'
01/02/2013;01/02/2013;'MANTENIMIENTO';-2,25 €;11.824,19 €;3179;-2,25;16.348,28 €;'sin fechas';01/02/2013;'MANTENIMIENTO';'Gastos_Banco y organismos';'Cargos banco';'FIJO'
02/02/2013;02/02/2013;'CAFET.C T PRAT';-2,55 €;11.821,64 €;3180;-2,55;16.345,73 €;'sin fechas';02/02/2013;'CAFETC';'Gastos_Ocio y transporte';'Restaurantes';'VARIABLES'
02/02/2013;02/02/2013;'CAPRABO';-16,04 €;11.805,60 €;3181;-16,04;16.329,69 €;'sin fechas';02/02/2013;'CAPRABO';'Gastos_Compras';'Supermercado';'VARIABLES'
02/02/2013;02/02/2013;'HOGAR&OTROS';-34,00 €;11.771,60 €;3182;-34,00;16.295,69 €;'sin fechas';02/02/2013;'HOGAROTROS';'Gastos_Vivienda y vehiculo';'Otros vivienda';'VARIABLES'
03/02/2013;28/01/2013;'AUTOPISTA TERR';-1,11 €;11.770,49 €;3183;-1,11;16.294,58 €;'sin fechas';28/01/2013;'AUTOPISTA';'Gastos_Ocio y transporte';'Parking y peaje';'VARIABLES'
03/02/2013;28/01/2013;'AUTOPISTA TERR';-1,11 €;11.769,38 €;3184;-1,11;16.293,47 €;'sin fechas';28/01/2013;'AUTOPISTA';'Gastos_Ocio y transporte';'Parking y peaje';'VARIABLES'
03/02/2013;03/02/2013;'CAFET.C T PRAT';-2,55 €;11.766,83 €;3185;-2,55;16.290,92 €;'sin fechas';03/02/2013;'CAFETC';'Gastos_Ocio y transporte';'Restaurantes';'VARIABLES'
03/02/2013;03/02/2013;'RESTAURANTES';-8,25 €;11.758,58 €;3186;-8,25;16.282,67 €;'sin fechas';03/02/2013;'RESTAURANTES';'Gastos_Ocio y transporte';'Restaurantes';'VARIABLES'
04/02/2013;31/01/2013;'AUTOPISTA TERR';-1,11 €;11.757,47 €;3188;-1,11;16.281,56 €;'sin fechas';31/01/2013;'AUTOPISTA';'Gastos_Ocio y transporte';'Parking y peaje';'VARIABLES'
04/02/2013;31/01/2013;'AUTOPISTA TERR';-1,11 €;11.756,36 €;3189;-1,11;16.280,45 €;'sin fechas';31/01/2013;'AUTOPISTA';'Gastos_Ocio y transporte';'Parking y peaje';'VARIABLES'
04/02/2013;31/01/2013;'AUTOPISTA TERR';-1,11 €;11.755,25 €;3190;-1,11;16.279,34 €;'sin fechas';31/01/2013;'AUTOPISTA';'Gastos_Ocio y transporte';'Parking y peaje';'VARIABLES'
04/02/2013;31/01/2013;'AUTOPISTA TERR';-1,39 €;11.753,86 €;3191;-1,39;16.277,95 €;'sin fechas';31/01/2013;'AUTOPISTA';'Gastos_Ocio y transporte';'Parking y peaje';'VARIABLES'
04/02/2013;04/02/2013;'CAFET.C T PRAT';-2,90 €;11.750,96 €;3192;-2,90;16.275,05 €;'sin fechas';04/02/2013;'CAFETC';'Gastos_Ocio y transporte';'Restaurantes';'VARIABLES'
04/02/2013;04/02/2013;'COCHE&PARKING';-6,40 €;11.744,56 €;3193;-6,40;16.268,65 €;'sin fechas';04/02/2013;'COCHEPARKING';'Gastos_Ocio y transporte';'Parking y peaje';'VARIABLES'
04/02/2013;04/02/2013;'ES STA. MARGARITA';-52,69 €;11.691,87 €;3194;-52,69;16.215,96 €;'sin fechas';04/02/2013;'STA';'Gastos_Ocio y transporte';'Gasolina';'VARIABLES'
04/02/2013;04/02/2013;'ESCOLA BRESSOL EINA';-462,10 €;11.229,77 €;3195;-462,10;15.753,86 €;'sin fechas';04/02/2013;'ESCOLA';'Gastos_Salud, saber y deporte';'Estudios';'VARIABLES'
04/02/2013;04/02/2013;'ESCOLA BRESSOL EINA';-374,70 €;10.855,07 €;3196;-374,70;15.379,16 €;'sin fechas';04/02/2013;'ESCOLA';'Gastos_Salud, saber y deporte';'Estudios';'VARIABLES'
04/02/2013;04/02/2013;'HOGAR&COMIDA';-7,35 €;10.847,72 €;3197;-7,35;15.371,81 €;'sin fechas';04/02/2013;'HOGARCOMIDA';'Gastos_Compras';'Supermercado';'VARIABLES'
05/02/2013;31/01/2013;'YOIGO';-43,07 €;10.804,65 €;3198;-43,07;15.328,74 €;'sin fechas';31/01/2013;'YOIGO';'Gastos_Servicios tipicos';'Telecomunicaciones';'FIJO'
06/02/2013;06/02/2013;'IKEA';-12,55 €;10.792,10 €;3200;-12,55;15.316,19 €;'sin fechas';06/02/2013;'IKEA';'Gastos_Vivienda y vehiculo';'Mnto. hogar';'VARIABLES'
07/02/2013;01/02/2013;'AUTOPISTA TERR';-1,39 €;10.790,71 €;3201;-1,39;15.314,80 €;'sin fechas';01/02/2013;'AUTOPISTA';'Gastos_Ocio y transporte';'Parking y peaje';'VARIABLES'
07/02/2013;01/02/2013;'AUTOPISTA TERR';-1,11 €;10.789,60 €;3202;-1,11;15.313,69 €;'sin fechas';01/02/2013;'AUTOPISTA';'Gastos_Ocio y transporte';'Parking y peaje';'VARIABLES'
07/02/2013;07/02/2013;'CAFET.C T PRAT';-2,60 €;10.787,00 €;3204;-2,60;15.311,09 €;'sin fechas';07/02/2013;'CAFETC';'Gastos_Ocio y transporte';'Restaurantes';'VARIABLES'
07/02/2013;07/02/2013;'COCHE&PARKING';-2,10 €;10.784,90 €;3205;-2,10;15.308,99 €;'sin fechas';07/02/2013;'COCHEPARKING';'Gastos_Ocio y transporte';'Parking y peaje';'VARIABLES'
07/02/2013;07/02/2013;'HOGAR&OTROS';-12,00 €;10.772,90 €;3206;-12,00;15.296,99 €;'sin fechas';07/02/2013;'HOGAROTROS';'Gastos_Vivienda y vehiculo';'Otros vivienda';'VARIABLES'
07/02/2013;07/02/2013;'RESTAURANTES';-19,70 €;10.753,20 €;3207;-19,70;15.277,29 €;'sin fechas';07/02/2013;'RESTAURANTES';'Gastos_Ocio y transporte';'Restaurantes';'VARIABLES'
07/02/2013;06/02/2013;'RESTAURANTES';-17,04 €;10.736,16 €;3208;-17,04;15.260,25 €;'sin fechas';06/02/2013;'RESTAURANTES';'Gastos_Ocio y transporte';'Restaurantes';'VARIABLES'
07/02/2013;05/02/2013;'VIENA';-17,25 €;10.718,91 €;3209;-17,25;15.243,00 €;'sin fechas';05/02/2013;'VIENA';'Gastos_Ocio y transporte';'Restaurantes';'VARIABLES'
08/02/2013;08/02/2013;'CAFET.C T PRAT';-2,60 €;10.716,31 €;3210;-2,60;15.240,40 €;'sin fechas';08/02/2013;'CAFETC';'Gastos_Ocio y transporte';'Restaurantes';'VARIABLES'
08/02/2013;08/02/2013;'RESTAURANTES';-46,25 €;10.670,06 €;3211;-46,25;15.194,15 €;'sin fechas';08/02/2013;'RESTAURANTES';'Gastos_Ocio y transporte';'Restaurantes';'VARIABLES'
09/02/2013;09/02/2013;'BON AREA';-21,01 €;10.649,05 €;3212;-21,01;15.173,14 €;'sin fechas';09/02/2013;'BON';'Gastos_Compras';'Supermercado';'VARIABLES'
09/02/2013;09/02/2013;'CAFET.C T PRAT';-3,60 €;10.645,45 €;3213;-3,60;15.169,54 €;'sin fechas';09/02/2013;'CAFETC';'Gastos_Ocio y transporte';'Restaurantes';'VARIABLES'
09/02/2013;09/02/2013;'DECATHLON';-7,48 €;10.637,97 €;3214;-7,48;15.162,06 €;'sin fechas';09/02/2013;'DECATHLON';'Gastos_Compras';'Deportivo';'VARIABLES'
09/02/2013;09/02/2013;'IKEA';-17,48 €;10.620,49 €;3215;-17,48;15.144,58 €;'sin fechas';09/02/2013;'IKEA';'Gastos_Vivienda y vehiculo';'Mnto. hogar';'VARIABLES'
10/02/2013;10/02/2013;'CAFET.C T PRAT';-2,15 €;10.618,34 €;3216;-2,15;15.142,43 €;'sin fechas';10/02/2013;'CAFETC';'Gastos_Ocio y transporte';'Restaurantes';'VARIABLES'
10/02/2013;10/02/2013;'RESTAURANTES';-6,50 €;10.611,84 €;3218;-6,50;15.135,93 €;'sin fechas';10/02/2013;'RESTAURANTES';'Gastos_Ocio y transporte';'Restaurantes';'VARIABLES'
11/02/2013;07/02/2013;'AUTOPISTA TERR';-1,39 €;10.610,45 €;3219;-1,39;15.134,54 €;'sin fechas';07/02/2013;'AUTOPISTA';'Gastos_Ocio y transporte';'Parking y peaje';'VARIABLES'
11/02/2013;07/02/2013;'AUTOPISTA TERR';-1,39 €;10.609,06 €;3220;-1,39;15.133,15 €;'sin fechas';07/02/2013;'AUTOPISTA';'Gastos_Ocio y transporte';'Parking y peaje';'VARIABLES'
11/02/2013;05/02/2013;'AUTOPISTA TERR';-2,53 €;10.606,53 €;3221;-2,53;15.130,62 €;'sin fechas';05/02/2013;'AUTOPISTA';'Gastos_Ocio y transporte';'Parking y peaje';'VARIABLES'
11/02/2013;04/02/2013;'AUTOPISTA TERR';-1,39 €;10.605,14 €;3222;-1,39;15.129,23 €;'sin fechas';04/02/2013;'AUTOPISTA';'Gastos_Ocio y transporte';'Parking y peaje';'VARIABLES'
11/02/2013;04/02/2013;'AUTOPISTA TERR';-1,39 €;10.603,75 €;3223;-1,39;15.127,84 €;'sin fechas';04/02/2013;'AUTOPISTA';'Gastos_Ocio y transporte';'Parking y peaje';'VARIABLES'
11/02/2013;11/02/2013;'BON AREA';-18,11 €;10.585,64 €;3224;-18,11;15.109,73 €;'sin fechas';11/02/2013;'BON';'Gastos_Compras';'Supermercado';'VARIABLES'
11/02/2013;11/02/2013;'CAFET.C T PRAT';-3,50 €;10.582,14 €;3225;-3,50;15.106,23 €;'sin fechas';11/02/2013;'CAFETC';'Gastos_Ocio y transporte';'Restaurantes';'VARIABLES'
11/02/2013;11/02/2013;'MERCADONA';-2,50 €;10.579,64 €;3226;-2,50;15.103,73 €;'sin fechas';11/02/2013;'MERCADONA';'Gastos_Compras';'Supermercado';'VARIABLES'
11/02/2013;11/02/2013;'MERCADONA';-131,96 €;10.447,68 €;3227;-131,96;14.971,77 €;'sin fechas';11/02/2013;'MERCADONA';'Gastos_Compras';'Supermercado';'VARIABLES'
12/02/2013;12/02/2013;'BLITZ';-72,50 €;10.375,18 €;3228;-72,50;14.899,27 €;'sin fechas';12/02/2013;'BLITZ';'Gastos_Vivienda y vehiculo';'Alquiler Parking';'FIJO'
12/02/2013;12/02/2013;'REINT.CAJERO';-100,00 €;10.275,18 €;3229;-100,00;14.799,27 €;'sin fechas';12/02/2013;'REINTCAJERO';'Gastos_Gastos varios';'Efectivo';'VARIABLES'
13/02/2013;13/02/2013;'ADESLAS CENTRAL 006662671613';-110,65 €;10.164,53 €;3230;-110,65;14.688,62 €;'sin fechas';13/02/2013;'ADESLAS';'Gastos_Salud, saber y deporte';'Medico';'VARIABLES'
13/02/2013;13/02/2013;'HOGAR&OTROS';-35,00 €;10.129,53 €;3231;-35,00;14.653,62 €;'sin fechas';13/02/2013;'HOGAROTROS';'Gastos_Vivienda y vehiculo';'Otros vivienda';'VARIABLES'
14/02/2013;08/02/2013;'AUTOPISTA TERR';-1,39 €;10.128,14 €;3232;-1,39;14.652,23 €;'sin fechas';08/02/2013;'AUTOPISTA';'Gastos_Ocio y transporte';'Parking y peaje';'VARIABLES'
14/02/2013;14/02/2013;'CAFET.C T PRAT';-3,35 €;10.124,79 €;3233;-3,35;14.648,88 €;'sin fechas';14/02/2013;'CAFETC';'Gastos_Ocio y transporte';'Restaurantes';'VARIABLES'
14/02/2013;12/02/2013;'CARREFOUR-[COMIDA]';-24,40 €;10.100,39 €;3234;-24,40;14.624,48 €;'sin fechas';12/02/2013;'CARREFOURCOMIDA';'Gastos_Compras';'Supermercado';'VARIABLES'
14/02/2013;14/02/2013;'ES STA. MARGARITA';-51,76 €;10.048,63 €;3235;-51,76;14.572,72 €;'sin fechas';14/02/2013;'STA';'Gastos_Ocio y transporte';'Gasolina';'VARIABLES'
14/02/2013;13/02/2013;'FARMACIA';-4,75 €;10.043,88 €;3236;-4,75;14.567,97 €;'sin fechas';13/02/2013;'FARMACIA';'Gastos_Salud, saber y deporte';'Farmacia';'VARIABLES'
14/02/2013;14/02/2013;'REINT.CAJERO';-20,00 €;10.023,88 €;3237;-20,00;14.547,97 €;'sin fechas';14/02/2013;'REINTCAJERO';'Gastos_Gastos varios';'Efectivo';'VARIABLES'
15/02/2013;10/02/2013;'AUTOPISTA TERR';-1,39 €;10.022,49 €;3238;-1,39;14.546,58 €;'sin fechas';10/02/2013;'AUTOPISTA';'Gastos_Ocio y transporte';'Parking y peaje';'VARIABLES'
15/02/2013;10/02/2013;'AUTOPISTA TERR';-1,39 €;10.021,10 €;3239;-1,39;14.545,19 €;'sin fechas';10/02/2013;'AUTOPISTA';'Gastos_Ocio y transporte';'Parking y peaje';'VARIABLES'
15/02/2013;15/02/2013;'CAFET.C T PRAT';-5,55 €;10.015,55 €;3240;-5,55;14.539,64 €;'sin fechas';15/02/2013;'CAFETC';'Gastos_Ocio y transporte';'Restaurantes';'VARIABLES'
15/02/2013;15/02/2013;'CCM VIDA Y P SEGURO PRESTAMO';-24,80 €;9.990,75 €;3241;-24,80;14.514,84 €;'sin fechas';15/02/2013;'CCM';'Gastos_Seguros';'Seguro vida';'FIJO'
15/02/2013;15/02/2013;'CCM VIDA Y PENSIO 000000493358';-18,53 €;9.972,22 €;3242;-18,53;14.496,31 €;'sin fechas';15/02/2013;'CCM';'Gastos_Seguros';'Seguro vida';'FIJO'
15/02/2013;15/02/2013;'CRACK';-5,97 €;9.966,25 €;3243;-5,97;14.490,34 €;'sin fechas';15/02/2013;'CRACK';'Gastos_Compras';'Otras compras';'VARIABLES'
15/02/2013;15/02/2013;'MISAKO';-9,00 €;9.957,25 €;3244;-9,00;14.481,34 €;'sin fechas';15/02/2013;'MISAKO';'Gastos_Compras';'Ropa';'VARIABLES'
16/02/2013;16/02/2013;'CAFET.C T PRAT';-2,60 €;9.954,65 €;3245;-2,60;14.478,74 €;'sin fechas';16/02/2013;'CAFETC';'Gastos_Ocio y transporte';'Restaurantes';'VARIABLES'
16/02/2013;16/02/2013;'HOGAR&OTROS';-18,40 €;9.936,25 €;3246;-18,40;14.460,34 €;'sin fechas';16/02/2013;'HOGAROTROS';'Gastos_Vivienda y vehiculo';'Otros vivienda';'VARIABLES'
17/02/2013;17/02/2013;'CAFET.C T PRAT';-3,60 €;9.932,65 €;3247;-3,60;14.456,74 €;'sin fechas';17/02/2013;'CAFETC';'Gastos_Ocio y transporte';'Restaurantes';'VARIABLES'
17/02/2013;17/02/2013;'RESTAURANTES';-7,90 €;9.924,75 €;3249;-7,90;14.448,84 €;'sin fechas';17/02/2013;'RESTAURANTES';'Gastos_Ocio y transporte';'Restaurantes';'VARIABLES'
18/02/2013;18/02/2013;'BON AREA';-23,64 €;9.901,11 €;3250;-23,64;14.425,20 €;'sin fechas';18/02/2013;'BON';'Gastos_Compras';'Supermercado';'VARIABLES'
18/02/2013;18/02/2013;'CAFET.C T PRAT';-3,60 €;9.897,51 €;3251;-3,60;14.421,60 €;'sin fechas';18/02/2013;'CAFETC';'Gastos_Ocio y transporte';'Restaurantes';'VARIABLES'
18/02/2013;18/02/2013;'ONO';-89,60 €;9.807,91 €;3252;-89,60;14.332,00 €;'sin fechas';18/02/2013;'ONO';'Gastos_Servicios tipicos';'Telecomunicaciones';'FIJO'
19/02/2013;19/02/2013;'AG.TRIBUT GABRIEL';100,00 €;9.907,91 €;3253;100,00;14.432,00 €;'sin fechas';19/02/2013;'AGTRIBUT';'Ingresos';'Subvenciones';
21/02/2013;21/02/2013;'CAFET.C T PRAT';-3,45 €;9.904,46 €;3255;-3,45;14.428,55 €;'sin fechas';21/02/2013;'CAFETC';'Gastos_Ocio y transporte';'Restaurantes';'VARIABLES'
21/02/2013;19/02/2013;'CARREFOUR-[COMIDA]';-73,62 €;9.830,84 €;3256;-73,62;14.354,93 €;'sin fechas';19/02/2013;'CARREFOURCOMIDA';'Gastos_Compras';'Supermercado';'VARIABLES'
21/02/2013;19/02/2013;'VIENA';-14,20 €;9.816,64 €;3257;-14,20;14.340,73 €;'sin fechas';19/02/2013;'VIENA';'Gastos_Ocio y transporte';'Restaurantes';'VARIABLES'
22/02/2013;17/02/2013;'AUTOPISTA TERR';-1,32 €;9.815,32 €;3258;-1,32;14.339,41 €;'sin fechas';17/02/2013;'AUTOPISTA';'Gastos_Ocio y transporte';'Parking y peaje';'VARIABLES'
22/02/2013;17/02/2013;'AUTOPISTA TERR';-1,39 €;9.813,93 €;3259;-1,39;14.338,02 €;'sin fechas';17/02/2013;'AUTOPISTA';'Gastos_Ocio y transporte';'Parking y peaje';'VARIABLES'
22/02/2013;13/02/2013;'AUTOPISTA TERR';-2,53 €;9.811,40 €;3260;-2,53;14.335,49 €;'sin fechas';13/02/2013;'AUTOPISTA';'Gastos_Ocio y transporte';'Parking y peaje';'VARIABLES'
22/02/2013;11/02/2013;'AUTOPISTA TERR';-1,39 €;9.810,01 €;3261;-1,39;14.334,10 €;'sin fechas';11/02/2013;'AUTOPISTA';'Gastos_Ocio y transporte';'Parking y peaje';'VARIABLES'
22/02/2013;11/02/2013;'AUTOPISTA TERR';-1,39 €;9.808,62 €;3262;-1,39;14.332,71 €;'sin fechas';11/02/2013;'AUTOPISTA';'Gastos_Ocio y transporte';'Parking y peaje';'VARIABLES'
22/02/2013;22/02/2013;'BON AREA';-37,00 €;9.771,62 €;3263;-37,00;14.295,71 €;'sin fechas';22/02/2013;'BON';'Gastos_Compras';'Supermercado';'VARIABLES'
22/02/2013;22/02/2013;'CAFET.C T PRAT';-4,40 €;9.767,22 €;3264;-4,40;14.291,31 €;'sin fechas';22/02/2013;'CAFETC';'Gastos_Ocio y transporte';'Restaurantes';'VARIABLES'
22/02/2013;05/02/2013;'COCHE&PARKING';-3,73 €;9.763,49 €;3265;-3,73;14.287,58 €;'sin fechas';05/02/2013;'COCHEPARKING';'Gastos_Ocio y transporte';'Parking y peaje';'VARIABLES'
22/02/2013;22/02/2013;'RODELAS PERRUQUERS';-22,00 €;9.741,49 €;3266;-22,00;14.265,58 €;'sin fechas';22/02/2013;'RODELAS';'Gastos_Salud, saber y deporte';'Belleza';'VARIABLES'
23/02/2013;23/02/2013;'CAFET.C T PRAT';-3,60 €;9.737,89 €;3267;-3,60;14.261,98 €;'sin fechas';23/02/2013;'CAFETC';'Gastos_Ocio y transporte';'Restaurantes';'VARIABLES'
23/02/2013;23/02/2013;'CAPRABO';-29,70 €;9.708,19 €;3268;-29,70;14.232,28 €;'sin fechas';23/02/2013;'CAPRABO';'Gastos_Compras';'Supermercado';'VARIABLES'
23/02/2013;25/02/2013;'FOMENT DE TERRASSA, S.A. FOMEN';1.559,53 €;11.267,72 €;3269;1.559,53;15.791,81 €;'sin fechas';25/02/2013;'FOMENT';'Ingresos';'Nomina';'FIJO'
24/02/2013;09/02/2013;'AUTOPISTA TERR';-1,39 €;11.266,33 €;3270;-1,39;15.790,42 €;'sin fechas';09/02/2013;'AUTOPISTA';'Gastos_Ocio y transporte';'Parking y peaje';'VARIABLES'
24/02/2013;09/02/2013;'AUTOPISTA TERR';-1,39 €;11.264,94 €;3271;-1,39;15.789,03 €;'sin fechas';09/02/2013;'AUTOPISTA';'Gastos_Ocio y transporte';'Parking y peaje';'VARIABLES'
24/02/2013;24/02/2013;'CAFET.C T PRAT';-3,35 €;11.261,59 €;3272;-3,35;15.785,68 €;'sin fechas';24/02/2013;'CAFETC';'Gastos_Ocio y transporte';'Restaurantes';'VARIABLES'
24/02/2013;24/02/2013;'RESTAURANTES';-8,20 €;11.253,39 €;3273;-8,20;15.777,48 €;'sin fechas';24/02/2013;'RESTAURANTES';'Gastos_Ocio y transporte';'Restaurantes';'VARIABLES'
25/02/2013;18/02/2013;'AUTOPISTA TERR';-1,32 €;11.252,07 €;3274;-1,32;15.776,16 €;'sin fechas';18/02/2013;'AUTOPISTA';'Gastos_Ocio y transporte';'Parking y peaje';'VARIABLES'
25/02/2013;18/02/2013;'AUTOPISTA TERR';-1,32 €;11.250,75 €;3275;-1,32;15.774,84 €;'sin fechas';18/02/2013;'AUTOPISTA';'Gastos_Ocio y transporte';'Parking y peaje';'VARIABLES'
25/02/2013;25/02/2013;'CAFET.C T PRAT';-4,05 €;11.246,70 €;3276;-4,05;15.770,79 €;'sin fechas';25/02/2013;'CAFETC';'Gastos_Ocio y transporte';'Restaurantes';'VARIABLES'
25/02/2013;25/02/2013;'FARMACIA';-22,62 €;11.224,08 €;3277;-22,62;15.748,17 €;'sin fechas';25/02/2013;'FARMACIA';'Gastos_Salud, saber y deporte';'Farmacia';'VARIABLES'
25/02/2013;25/02/2013;'PISCINA';-159,50 €;11.064,58 €;3278;-159,50;15.588,67 €;'sin fechas';25/02/2013;'PISCINA';'Gastos_Ocio y transporte';'Vacaciones';'VARIABLES'
25/02/2013;25/02/2013;'REINT.CAJERO';-140,50 €;10.924,08 €;3279;-140,50;15.448,17 €;'sin fechas';25/02/2013;'REINTCAJERO';'Gastos_Gastos varios';'Efectivo';'VARIABLES'
25/02/2013;25/02/2013;'REINT.CAJERO';-40,00 €;10.884,08 €;3280;-40,00;15.408,17 €;'sin fechas';25/02/2013;'REINTCAJERO';'Gastos_Gastos varios';'Efectivo';'VARIABLES'
26/02/2013;26/02/2013;'COMISIONES';-9,00 €;10.875,08 €;3281;-9,00;15.399,17 €;'sin fechas';26/02/2013;'COMISIONES';'Gastos_Banco y organismos';'Cargos banco';'FIJO'
26/02/2013;26/02/2013;'COMISIONES';-33,00 €;10.842,08 €;3282;-33,00;15.366,17 €;'sin fechas';26/02/2013;'COMISIONES';'Gastos_Banco y organismos';'Cargos banco';'FIJO'
26/02/2013;26/02/2013;'INFORMACIO I TECNOLOGIA DE CAT';1.579,09 €;12.421,17 €;3283;1.579,09;16.945,26 €;'sin fechas';26/02/2013;'INFORMACIO';'Ingresos';'Nomina';'FIJO'
26/02/2013;26/02/2013;'RESTAURANTES';-16,20 €;12.404,97 €;3284;-16,20;16.929,06 €;'sin fechas';26/02/2013;'RESTAURANTES';'Gastos_Ocio y transporte';'Restaurantes';'VARIABLES'
28/02/2013;22/02/2013;'AUTOPISTA TERR';-1,25 €;12.403,72 €;3285;-1,25;16.927,81 €;'sin fechas';22/02/2013;'AUTOPISTA';'Gastos_Ocio y transporte';'Parking y peaje';'VARIABLES'
28/02/2013;22/02/2013;'AUTOPISTA TERR';-1,32 €;12.402,40 €;3286;-1,32;16.926,49 €;'sin fechas';22/02/2013;'AUTOPISTA';'Gastos_Ocio y transporte';'Parking y peaje';'VARIABLES'
28/02/2013;21/02/2013;'AUTOPISTA TERR';-1,39 €;12.401,01 €;3287;-1,39;16.925,10 €;'sin fechas';21/02/2013;'AUTOPISTA';'Gastos_Ocio y transporte';'Parking y peaje';'VARIABLES'
28/02/2013;21/02/2013;'AUTOPISTA TERR';-1,32 €;12.399,69 €;3288;-1,32;16.923,78 €;'sin fechas';21/02/2013;'AUTOPISTA';'Gastos_Ocio y transporte';'Parking y peaje';'VARIABLES'
28/02/2013;28/02/2013;'CAFET.C T PRAT';-3,60 €;12.396,09 €;3289;-3,60;16.920,18 €;'sin fechas';28/02/2013;'CAFETC';'Gastos_Ocio y transporte';'Restaurantes';'VARIABLES'
28/02/2013;26/02/2013;'ES STA. MARGARITA';-15,07 €;12.381,02 €;3290;-15,07;16.905,11 €;'sin fechas';26/02/2013;'STA';'Gastos_Ocio y transporte';'Gasolina';'VARIABLES'
28/02/2013;26/02/2013;'FARMACIA';-3,12 €;12.377,90 €;3291;-3,12;16.901,99 €;'sin fechas';26/02/2013;'FARMACIA';'Gastos_Salud, saber y deporte';'Farmacia';'VARIABLES'
28/02/2013;28/02/2013;'RECIBO PTMOS. 3061-0960001518';-562,73 €;11.815,17 €;3294;-562,73;16.339,26 €;'sin fechas';28/02/2013;'RECIBO';'Gastos_Banco y organismos';'Hipoteca';'FIJO'
01/03/2013;01/03/2013;'AJUNTAMENT DE TER 010000520716';-44,24 €;11.770,93 €;3295;-44,24;16.295,02 €;'sin fechas';01/03/2013;'AJUNTAMENT';'Gastos_Banco y organismos';'Ayuntamiento';'FIJO'
01/03/2013;24/02/2013;'AUTOPISTA TERR';-4,20 €;11.766,73 €;3296;-4,20;16.290,82 €;'sin fechas';24/02/2013;'AUTOPISTA';'Gastos_Ocio y transporte';'Parking y peaje';'VARIABLES'
01/03/2013;24/02/2013;'AUTOPISTA TERR';-1,39 €;11.765,34 €;3297;-1,39;16.289,43 €;'sin fechas';24/02/2013;'AUTOPISTA';'Gastos_Ocio y transporte';'Parking y peaje';'VARIABLES'
01/03/2013;24/02/2013;'AUTOPISTA TERR';-1,25 €;11.764,09 €;3298;-1,25;16.288,18 €;'sin fechas';24/02/2013;'AUTOPISTA';'Gastos_Ocio y transporte';'Parking y peaje';'VARIABLES'
01/03/2013;23/02/2013;'AUTOPISTA TERR';-1,25 €;11.762,84 €;3299;-1,25;16.286,93 €;'sin fechas';23/02/2013;'AUTOPISTA';'Gastos_Ocio y transporte';'Parking y peaje';'VARIABLES'
01/03/2013;23/02/2013;'AUTOPISTA TERR';-1,25 €;11.761,59 €;3300;-1,25;16.285,68 €;'sin fechas';23/02/2013;'AUTOPISTA';'Gastos_Ocio y transporte';'Parking y peaje';'VARIABLES'
01/03/2013;01/03/2013;'CAFET.C T PRAT';-2,85 €;11.758,74 €;3301;-2,85;16.282,83 €;'sin fechas';01/03/2013;'CAFETC';'Gastos_Ocio y transporte';'Restaurantes';'VARIABLES'
01/03/2013;01/03/2013;'MANTENIMIENTO';-2,25 €;11.756,49 €;3306;-2,25;16.280,58 €;'sin fechas';01/03/2013;'MANTENIMIENTO';'Gastos_Banco y organismos';'Cargos banco';'FIJO'
01/03/2013;01/03/2013;'REINT.CAJERO';-20,00 €;11.736,49 €;3307;-20,00;16.260,58 €;'sin fechas';01/03/2013;'REINTCAJERO';'Gastos_Gastos varios';'Efectivo';'VARIABLES'
01/03/2013;01/03/2013;'RESTAURANTES';-10,10 €;11.726,39 €;3308;-10,10;16.250,48 €;'sin fechas';01/03/2013;'RESTAURANTES';'Gastos_Ocio y transporte';'Restaurantes';'VARIABLES'
01/03/2013;01/03/2013;'RESTAURANTES';-14,90 €;11.711,49 €;3309;-14,90;16.235,58 €;'sin fechas';01/03/2013;'RESTAURANTES';'Gastos_Ocio y transporte';'Restaurantes';'VARIABLES'
02/03/2013;02/03/2013;'CAFET.C T PRAT';-2,55 €;11.708,94 €;3310;-2,55;16.233,03 €;'sin fechas';02/03/2013;'CAFETC';'Gastos_Ocio y transporte';'Restaurantes';'VARIABLES'
02/03/2013;02/03/2013;'ES STA. MARGARITA';-34,05 €;11.674,89 €;3311;-34,05;16.198,98 €;'sin fechas';02/03/2013;'STA';'Gastos_Ocio y transporte';'Gasolina';'VARIABLES'
03/03/2013;03/03/2013;'BON AREA';-20,84 €;11.654,05 €;3312;-20,84;16.178,14 €;'sin fechas';03/03/2013;'BON';'Gastos_Compras';'Supermercado';'VARIABLES'
03/03/2013;03/03/2013;'CAFET.C T PRAT';-3,45 €;11.650,60 €;3313;-3,45;16.174,69 €;'sin fechas';03/03/2013;'CAFETC';'Gastos_Ocio y transporte';'Restaurantes';'VARIABLES'
03/03/2013;03/03/2013;'RESTAURANTES';-8,10 €;11.642,50 €;3314;-8,10;16.166,59 €;'sin fechas';03/03/2013;'RESTAURANTES';'Gastos_Ocio y transporte';'Restaurantes';'VARIABLES'
04/03/2013;04/03/2013;'CAFET.C T PRAT';-3,60 €;11.638,90 €;3315;-3,60;16.162,99 €;'sin fechas';04/03/2013;'CAFETC';'Gastos_Ocio y transporte';'Restaurantes';'VARIABLES'
04/03/2013;04/03/2013;'ESCOLA BRESSOL EINA';-471,75 €;11.167,15 €;3316;-471,75;15.691,24 €;'sin fechas';04/03/2013;'ESCOLA';'Gastos_Salud, saber y deporte';'Estudios';'VARIABLES'
04/03/2013;04/03/2013;'ESCOLA BRESSOL EINA';-413,90 €;10.753,25 €;3317;-413,90;15.277,34 €;'sin fechas';04/03/2013;'ESCOLA';'Gastos_Salud, saber y deporte';'Estudios';'VARIABLES'
04/03/2013;04/03/2013;'MERCADONA';-119,89 €;10.633,36 €;3318;-119,89;15.157,45 €;'sin fechas';04/03/2013;'MERCADONA';'Gastos_Compras';'Supermercado';'VARIABLES'
05/03/2013;05/03/2013;'COM. MANT. ACTIVAS DE LIQ.';-4,50 €;10.628,86 €;3319;-4,50;15.152,95 €;'sin fechas';05/03/2013;'COM';'Gastos_Banco y organismos';'Cargos banco';'FIJO'
05/03/2013;28/02/2013;'YOIGO';-32,17 €;10.596,69 €;3322;-32,17;15.120,78 €;'sin fechas';28/02/2013;'YOIGO';'Gastos_Servicios tipicos';'Telecomunicaciones';'FIJO'
06/03/2013;06/03/2013;'ADESLAS CENTRAL 006662671613';-110,65 €;10.486,04 €;3323;-110,65;15.010,13 €;'sin fechas';06/03/2013;'ADESLAS';'Gastos_Salud, saber y deporte';'Medico';'VARIABLES'
07/03/2013;01/03/2013;'AUTOPISTA TERR';-1,25 €;10.484,79 €;3326;-1,25;15.008,88 €;'sin fechas';01/03/2013;'AUTOPISTA';'Gastos_Ocio y transporte';'Parking y peaje';'VARIABLES'
07/03/2013;01/03/2013;'AUTOPISTA TERR';-1,25 €;10.483,54 €;3327;-1,25;15.007,63 €;'sin fechas';01/03/2013;'AUTOPISTA';'Gastos_Ocio y transporte';'Parking y peaje';'VARIABLES'
07/03/2013;28/02/2013;'AUTOPISTA TERR';-1,25 €;10.482,29 €;3328;-1,25;15.006,38 €;'sin fechas';28/02/2013;'AUTOPISTA';'Gastos_Ocio y transporte';'Parking y peaje';'VARIABLES'
07/03/2013;28/02/2013;'AUTOPISTA TERR';-1,25 €;10.481,04 €;3329;-1,25;15.005,13 €;'sin fechas';28/02/2013;'AUTOPISTA';'Gastos_Ocio y transporte';'Parking y peaje';'VARIABLES'
07/03/2013;25/02/2013;'AUTOPISTA TERR';-1,25 €;10.479,79 €;3330;-1,25;15.003,88 €;'sin fechas';25/02/2013;'AUTOPISTA';'Gastos_Ocio y transporte';'Parking y peaje';'VARIABLES'
07/03/2013;25/02/2013;'AUTOPISTA TERR';-1,39 €;10.478,40 €;3331;-1,39;15.002,49 €;'sin fechas';25/02/2013;'AUTOPISTA';'Gastos_Ocio y transporte';'Parking y peaje';'VARIABLES'
07/03/2013;07/03/2013;'CAFET.C T PRAT';-2,90 €;10.475,50 €;3332;-2,90;14.999,59 €;'sin fechas';07/03/2013;'CAFETC';'Gastos_Ocio y transporte';'Restaurantes';'VARIABLES'
07/03/2013;05/03/2013;'CARREFOUR-[MODA]';-49,75 €;10.425,75 €;3333;-49,75;14.949,84 €;'sin fechas';05/03/2013;'CARREFOURMODA';'Gastos_Compras';'Supermercado';'VARIABLES'
07/03/2013;05/03/2013;'OCIO&CINES';-18,80 €;10.406,95 €;3334;-18,80;14.931,04 €;'sin fechas';05/03/2013;'OCIOCINES';'Gastos_Ocio y transporte';'Espectáculos';'VARIABLES'
07/03/2013;05/03/2013;'RESTAURANTES';-36,20 €;10.370,75 €;3335;-36,20;14.894,84 €;'sin fechas';05/03/2013;'RESTAURANTES';'Gastos_Ocio y transporte';'Restaurantes';'VARIABLES'
07/03/2013;05/03/2013;'VIENA';-17,25 €;10.353,50 €;3336;-17,25;14.877,59 €;'sin fechas';05/03/2013;'VIENA';'Gastos_Ocio y transporte';'Restaurantes';'VARIABLES'
08/03/2013;03/03/2013;'AUTOPISTA TERR';-1,11 €;10.352,39 €;3337;-1,11;14.876,48 €;'sin fechas';03/03/2013;'AUTOPISTA';'Gastos_Ocio y transporte';'Parking y peaje';'VARIABLES'
08/03/2013;03/03/2013;'AUTOPISTA TERR';-1,39 €;10.351,00 €;3338;-1,39;14.875,09 €;'sin fechas';03/03/2013;'AUTOPISTA';'Gastos_Ocio y transporte';'Parking y peaje';'VARIABLES'
08/03/2013;02/03/2013;'AUTOPISTA TERR';-1,11 €;10.349,89 €;3339;-1,11;14.873,98 €;'sin fechas';02/03/2013;'AUTOPISTA';'Gastos_Ocio y transporte';'Parking y peaje';'VARIABLES'
08/03/2013;02/03/2013;'AUTOPISTA TERR';-1,25 €;10.348,64 €;3340;-1,25;14.872,73 €;'sin fechas';02/03/2013;'AUTOPISTA';'Gastos_Ocio y transporte';'Parking y peaje';'VARIABLES'
08/03/2013;08/03/2013;'CAFET.C T PRAT';-3,40 €;10.345,24 €;3341;-3,40;14.869,33 €;'sin fechas';08/03/2013;'CAFETC';'Gastos_Ocio y transporte';'Restaurantes';'VARIABLES'
08/03/2013;01/03/2013;'COCHE&PARKING';-3,25 €;10.341,99 €;3342;-3,25;14.866,08 €;'sin fechas';01/03/2013;'COCHEPARKING';'Gastos_Ocio y transporte';'Parking y peaje';'VARIABLES'
08/03/2013;26/02/2013;'COCHE&PARKING';-5,45 €;10.336,54 €;3343;-5,45;14.860,63 €;'sin fechas';26/02/2013;'COCHEPARKING';'Gastos_Ocio y transporte';'Parking y peaje';'VARIABLES'
08/03/2013;08/03/2013;'ES STA. MARGARITA';-26,80 €;10.309,74 €;3344;-26,80;14.833,83 €;'sin fechas';08/03/2013;'STA';'Gastos_Ocio y transporte';'Gasolina';'VARIABLES'
08/03/2013;08/03/2013;'REINT.CAJERO';-100,00 €;10.209,74 €;3345;-100,00;14.733,83 €;'sin fechas';08/03/2013;'REINTCAJERO';'Gastos_Gastos varios';'Efectivo';'VARIABLES'
09/03/2013;09/03/2013;'CAPRABO';-19,58 €;10.190,16 €;3346;-19,58;14.714,25 €;'sin fechas';09/03/2013;'CAPRABO';'Gastos_Compras';'Supermercado';'VARIABLES'
09/03/2013;09/03/2013;'CARREFOUR-[COMIDA]';-20,16 €;10.170,00 €;3347;-20,16;14.694,09 €;'sin fechas';09/03/2013;'CARREFOURCOMIDA';'Gastos_Compras';'Supermercado';'VARIABLES'
10/03/2013;10/03/2013;'CAFET.C T PRAT';-3,30 €;10.166,70 €;3348;-3,30;14.690,79 €;'sin fechas';10/03/2013;'CAFETC';'Gastos_Ocio y transporte';'Restaurantes';'VARIABLES'
11/03/2013;11/03/2013;'BLITZ';-72,50 €;10.094,20 €;3350;-72,50;14.618,29 €;'sin fechas';11/03/2013;'BLITZ';'Gastos_Vivienda y vehiculo';'Alquiler Parking';'FIJO'
11/03/2013;11/03/2013;'FARMACIA';-8,58 €;10.085,62 €;3351;-8,58;14.609,71 €;'sin fechas';11/03/2013;'FARMACIA';'Gastos_Salud, saber y deporte';'Farmacia';'VARIABLES'
11/03/2013;11/03/2013;'TOCINERIES VENTURA';-18,06 €;10.067,56 €;3352;-18,06;14.591,65 €;'sin fechas';11/03/2013;'TOCINERIES';'Gastos_Compras';'Supermercado';'VARIABLES'
12/03/2013;12/03/2013;'COCHE&PARKING';-1,65 €;10.065,91 €;3353;-1,65;14.590,00 €;'sin fechas';12/03/2013;'COCHEPARKING';'Gastos_Ocio y transporte';'Parking y peaje';'VARIABLES'
13/03/2013;13/03/2013;'MERCADONA';-21,14 €;10.044,77 €;3354;-21,14;14.568,86 €;'sin fechas';13/03/2013;'MERCADONA';'Gastos_Compras';'Supermercado';'VARIABLES'
14/03/2013;07/03/2013;'AUTOPISTA TERR';-4,20 €;10.040,57 €;3355;-4,20;14.564,66 €;'sin fechas';07/03/2013;'AUTOPISTA';'Gastos_Ocio y transporte';'Parking y peaje';'VARIABLES'
14/03/2013;07/03/2013;'AUTOPISTA TERR';-1,39 €;10.039,18 €;3356;-1,39;14.563,27 €;'sin fechas';07/03/2013;'AUTOPISTA';'Gastos_Ocio y transporte';'Parking y peaje';'VARIABLES'
14/03/2013;07/03/2013;'AUTOPISTA TERR';-1,39 €;10.037,79 €;3357;-1,39;14.561,88 €;'sin fechas';07/03/2013;'AUTOPISTA';'Gastos_Ocio y transporte';'Parking y peaje';'VARIABLES'
14/03/2013;04/03/2013;'AUTOPISTA TERR';-1,39 €;10.036,40 €;3358;-1,39;14.560,49 €;'sin fechas';04/03/2013;'AUTOPISTA';'Gastos_Ocio y transporte';'Parking y peaje';'VARIABLES'
14/03/2013;04/03/2013;'AUTOPISTA TERR';-1,39 €;10.035,01 €;3359;-1,39;14.559,10 €;'sin fechas';04/03/2013;'AUTOPISTA';'Gastos_Ocio y transporte';'Parking y peaje';'VARIABLES'
14/03/2013;14/03/2013;'CAFET.C T PRAT';-3,45 €;10.031,56 €;3360;-3,45;14.555,65 €;'sin fechas';14/03/2013;'CAFETC';'Gastos_Ocio y transporte';'Restaurantes';'VARIABLES'
14/03/2013;14/03/2013;'CERTIO ITV VIL\\VILADECAVALL';-45,10 €;9.986,46 €;3361;-45,10;14.510,55 €;'sin fechas';14/03/2013;'CERTIO';'Gastos_Vivienda y vehiculo';'Mnto. vehiculo';'VARIABLE'
14/03/2013;14/03/2013;'ES STA. MARGARITA';-30,00 €;9.956,46 €;3362;-30,00;14.480,55 €;'sin fechas';14/03/2013;'STA';'Gastos_Ocio y transporte';'Gasolina';'VARIABLES'
14/03/2013;14/03/2013;'MERCADONA';-9,32 €;9.947,14 €;3363;-9,32;14.471,23 €;'sin fechas';14/03/2013;'MERCADONA';'Gastos_Compras';'Supermercado';'VARIABLES'
14/03/2013;13/03/2013;'OCIO&CINES';-6,70 €;9.940,44 €;3364;-6,70;14.464,53 €;'sin fechas';13/03/2013;'OCIOCINES';'Gastos_Ocio y transporte';'Espectáculos';'VARIABLES'
14/03/2013;12/03/2013;'RESTAURANTES';-14,20 €;9.926,24 €;3365;-14,20;14.450,33 €;'sin fechas';12/03/2013;'RESTAURANTES';'Gastos_Ocio y transporte';'Restaurantes';'VARIABLES'
15/03/2013;08/03/2013;'AUTOPISTA TERR';-1,39 €;9.924,85 €;3366;-1,39;14.448,94 €;'sin fechas';08/03/2013;'AUTOPISTA';'Gastos_Ocio y transporte';'Parking y peaje';'VARIABLES'
15/03/2013;08/03/2013;'AUTOPISTA TERR';-1,39 €;9.923,46 €;3367;-1,39;14.447,55 €;'sin fechas';08/03/2013;'AUTOPISTA';'Gastos_Ocio y transporte';'Parking y peaje';'VARIABLES'
15/03/2013;15/03/2013;'CAFET.C T PRAT';-4,25 €;9.919,21 €;3368;-4,25;14.443,30 €;'sin fechas';15/03/2013;'CAFETC';'Gastos_Ocio y transporte';'Restaurantes';'VARIABLES'
15/03/2013;15/03/2013;'CCM VIDA Y P SEGURO PRESTAMO';-24,73 €;9.894,48 €;3369;-24,73;14.418,57 €;'sin fechas';15/03/2013;'CCM';'Gastos_Seguros';'Seguro vida';'FIJO'
15/03/2013;15/03/2013;'CCM VIDA Y PENSIO 000000493358';-18,48 €;9.876,00 €;3370;-18,48;14.400,09 €;'sin fechas';15/03/2013;'CCM';'Gastos_Seguros';'Seguro vida';'FIJO'
15/03/2013;15/03/2013;'FARMACIA';-12,67 €;9.863,33 €;3371;-12,67;14.387,42 €;'sin fechas';15/03/2013;'FARMACIA';'Gastos_Salud, saber y deporte';'Farmacia';'VARIABLES'
15/03/2013;15/03/2013;'MERCADONA';-21,50 €;9.841,83 €;3372;-21,50;14.365,92 €;'sin fechas';15/03/2013;'MERCADONA';'Gastos_Compras';'Supermercado';'VARIABLES'
15/03/2013;15/03/2013;'REINT.CAJERO';-40,00 €;9.801,83 €;3373;-40,00;14.325,92 €;'sin fechas';15/03/2013;'REINTCAJERO';'Gastos_Gastos varios';'Efectivo';'VARIABLES'
16/03/2013;16/03/2013;'CAFET.C T PRAT';-3,60 €;9.798,23 €;3374;-3,60;14.322,32 €;'sin fechas';16/03/2013;'CAFETC';'Gastos_Ocio y transporte';'Restaurantes';'VARIABLES'
18/03/2013;14/03/2013;'AUTOPISTA TERR';-1,32 €;9.796,91 €;3375;-1,32;14.321,00 €;'sin fechas';14/03/2013;'AUTOPISTA';'Gastos_Ocio y transporte';'Parking y peaje';'VARIABLES'
18/03/2013;14/03/2013;'AUTOPISTA TERR';-1,39 €;9.795,52 €;3376;-1,39;14.319,61 €;'sin fechas';14/03/2013;'AUTOPISTA';'Gastos_Ocio y transporte';'Parking y peaje';'VARIABLES'
18/03/2013;18/03/2013;'CAFET.C T PRAT';-3,60 €;9.791,92 €;3377;-3,60;14.316,01 €;'sin fechas';18/03/2013;'CAFETC';'Gastos_Ocio y transporte';'Restaurantes';'VARIABLES'
19/03/2013;19/03/2013;'ONO';-89,42 €;9.702,50 €;3378;-89,42;14.226,59 €;'sin fechas';19/03/2013;'ONO';'Gastos_Servicios tipicos';'Telecomunicaciones';'FIJO'
21/03/2013;21/03/2013;'AG.TRIBUT GABRIEL';100,00 €;9.802,50 €;3381;100,00;14.326,59 €;'sin fechas';21/03/2013;'AGTRIBUT';'Ingresos';'Subvenciones';
21/03/2013;14/03/2013;'AUTOPISTA TERR';-4,20 €;9.798,30 €;3382;-4,20;14.322,39 €;'sin fechas';14/03/2013;'AUTOPISTA';'Gastos_Ocio y transporte';'Parking y peaje';'VARIABLES'
21/03/2013;21/03/2013;'CAFET.C T PRAT';-3,45 €;9.794,85 €;3383;-3,45;14.318,94 €;'sin fechas';21/03/2013;'CAFETC';'Gastos_Ocio y transporte';'Restaurantes';'VARIABLES'
21/03/2013;21/03/2013;'ES STA. MARGARITA';-31,70 €;9.763,15 €;3384;-31,70;14.287,24 €;'sin fechas';21/03/2013;'STA';'Gastos_Ocio y transporte';'Gasolina';'VARIABLES'
21/03/2013;21/03/2013;'REINT.CAJERO';-100,00 €;9.663,15 €;3385;-100,00;14.187,24 €;'sin fechas';21/03/2013;'REINTCAJERO';'Gastos_Gastos varios';'Efectivo';'VARIABLES'
22/03/2013;22/03/2013;'CAFET.C T PRAT';-3,00 €;9.660,15 €;3386;-3,00;14.184,24 €;'sin fechas';22/03/2013;'CAFETC';'Gastos_Ocio y transporte';'Restaurantes';'VARIABLES'
22/03/2013;22/03/2013;'COCHE&PARKING';-3,60 €;9.656,55 €;3387;-3,60;14.180,64 €;'sin fechas';22/03/2013;'COCHEPARKING';'Gastos_Ocio y transporte';'Parking y peaje';'VARIABLES'
22/03/2013;22/03/2013;'MINA PUBLICA AIGUES T.01A75789';-43,73 €;9.612,82 €;3388;-43,73;14.136,91 €;'sin fechas';22/03/2013;'MINA';'Gastos_Servicios tipicos';'Agua';'FIJO'
22/03/2013;22/03/2013;'RESTAURANTES';-15,85 €;9.596,97 €;3389;-15,85;14.121,06 €;'sin fechas';22/03/2013;'RESTAURANTES';'Gastos_Ocio y transporte';'Restaurantes';'VARIABLES'
23/03/2013;23/03/2013;'CAFET.C T PRAT';-1,65 €;9.595,32 €;3390;-1,65;14.119,41 €;'sin fechas';23/03/2013;'CAFETC';'Gastos_Ocio y transporte';'Restaurantes';'VARIABLES'
23/03/2013;23/03/2013;'COCHE&PARKING';-0,40 €;9.594,92 €;3391;-0,40;14.119,01 €;'sin fechas';23/03/2013;'COCHEPARKING';'Gastos_Ocio y transporte';'Parking y peaje';'VARIABLES'
23/03/2013;23/03/2013;'MERCADONA';-147,68 €;9.447,24 €;3392;-147,68;13.971,33 €;'sin fechas';23/03/2013;'MERCADONA';'Gastos_Compras';'Supermercado';'VARIABLES'
24/03/2013;24/03/2013;'CAFET.C T PRAT';-1,65 €;9.445,59 €;3393;-1,65;13.969,68 €;'sin fechas';24/03/2013;'CAFETC';'Gastos_Ocio y transporte';'Restaurantes';'VARIABLES'
24/03/2013;24/03/2013;'COCHE&PARKING';-3,75 €;9.441,84 €;3394;-3,75;13.965,93 €;'sin fechas';24/03/2013;'COCHEPARKING';'Gastos_Ocio y transporte';'Parking y peaje';'VARIABLES'
25/03/2013;21/03/2013;'AUTOPISTA TERR';-1,32 €;9.440,52 €;3395;-1,32;13.964,61 €;'sin fechas';21/03/2013;'AUTOPISTA';'Gastos_Ocio y transporte';'Parking y peaje';'VARIABLES'
25/03/2013;21/03/2013;'AUTOPISTA TERR';-1,39 €;9.439,13 €;3396;-1,39;13.963,22 €;'sin fechas';21/03/2013;'AUTOPISTA';'Gastos_Ocio y transporte';'Parking y peaje';'VARIABLES'
25/03/2013;25/03/2013;'CAFET.C T PRAT';-1,65 €;9.437,48 €;3397;-1,65;13.961,57 €;'sin fechas';25/03/2013;'CAFETC';'Gastos_Ocio y transporte';'Restaurantes';'VARIABLES'
25/03/2013;25/03/2013;'COCHE&PARKING';-1,20 €;9.436,28 €;3398;-1,20;13.960,37 €;'sin fechas';25/03/2013;'COCHEPARKING';'Gastos_Ocio y transporte';'Parking y peaje';'VARIABLES'
26/03/2013;26/03/2013;'BIJOU BRIGITTE';-19,80 €;9.416,48 €;3399;-19,80;13.940,57 €;'sin fechas';26/03/2013;'BIJOU';'Gastos_Compras';'Ropa';'VARIABLES'
26/03/2013;26/03/2013;'HOGAR&OTROS';-0,80 €;9.415,68 €;3400;-0,80;13.939,77 €;'sin fechas';26/03/2013;'HOGAROTROS';'Gastos_Vivienda y vehiculo';'Otros vivienda';'VARIABLES'
26/03/2013;26/03/2013;'REINT.CAJERO';-150,00 €;9.265,68 €;3401;-150,00;13.789,77 €;'sin fechas';26/03/2013;'REINTCAJERO';'Gastos_Gastos varios';'Efectivo';'VARIABLES'
26/03/2013;26/03/2013;'VIENA';-13,50 €;9.252,18 €;3402;-13,50;13.776,27 €;'sin fechas';26/03/2013;'VIENA';'Gastos_Ocio y transporte';'Restaurantes';'VARIABLES'
27/03/2013;27/03/2013;'FOMENT DE TERRASSA, S.A. FOMEN';1.559,53 €;10.811,71 €;3403;1.559,53;15.335,80 €;'sin fechas';27/03/2013;'FOMENT';'Ingresos';'Nomina';'FIJO'
27/03/2013;27/03/2013;'INFORMACIO I TECNOLOGIA DE CAT';1.579,09 €;12.390,80 €;3404;1.579,09;16.914,89 €;'sin fechas';27/03/2013;'INFORMACIO';'Ingresos';'Nomina';'FIJO'
28/03/2013;28/03/2013;'AUTOPISTA TERR';-1,25 €;12.389,55 €;3405;-1,25;16.913,64 €;'sin fechas';28/03/2013;'AUTOPISTA';'Gastos_Ocio y transporte';'Parking y peaje';'VARIABLES'
28/03/2013;28/03/2013;'AUTOPISTA TERR';-1,39 €;12.388,16 €;3406;-1,39;16.912,25 €;'sin fechas';28/03/2013;'AUTOPISTA';'Gastos_Ocio y transporte';'Parking y peaje';'VARIABLES'
28/03/2013;28/03/2013;'AUTOPISTA TERR';-4,20 €;12.383,96 €;3407;-4,20;16.908,05 €;'sin fechas';28/03/2013;'AUTOPISTA';'Gastos_Ocio y transporte';'Parking y peaje';'VARIABLES'
28/03/2013;24/03/2013;'AUTOPISTA TERR';-2,53 €;12.381,43 €;3408;-2,53;16.905,52 €;'sin fechas';24/03/2013;'AUTOPISTA';'Gastos_Ocio y transporte';'Parking y peaje';'VARIABLES'
28/03/2013;24/03/2013;'AUTOPISTA TERR';-2,53 €;12.378,90 €;3409;-2,53;16.902,99 €;'sin fechas';24/03/2013;'AUTOPISTA';'Gastos_Ocio y transporte';'Parking y peaje';'VARIABLES'
28/03/2013;28/03/2013;'CAFET.C T PRAT';-3,60 €;12.375,30 €;3410;-3,60;16.899,39 €;'sin fechas';28/03/2013;'CAFETC';'Gastos_Ocio y transporte';'Restaurantes';'VARIABLES'
28/03/2013;28/03/2013;'CAPRABO';-20,66 €;12.354,64 €;3411;-20,66;16.878,73 €;'sin fechas';28/03/2013;'CAPRABO';'Gastos_Compras';'Supermercado';'VARIABLES'
28/03/2013;21/03/2013;'COCHE&PARKING';-4,20 €;12.350,44 €;3412;-4,20;16.874,53 €;'sin fechas';21/03/2013;'COCHEPARKING';'Gastos_Ocio y transporte';'Parking y peaje';'VARIABLES'
28/03/2013;28/03/2013;'COCHE&PARKING';-4,10 €;12.346,34 €;3413;-4,10;16.870,43 €;'sin fechas';28/03/2013;'COCHEPARKING';'Gastos_Ocio y transporte';'Parking y peaje';'VARIABLES'
28/03/2013;28/03/2013;'ES STA. MARGARITA';-48,92 €;12.297,42 €;3414;-48,92;16.821,51 €;'sin fechas';28/03/2013;'STA';'Gastos_Ocio y transporte';'Gasolina';'VARIABLES'
28/03/2013;27/03/2013;'FARMACIA';-19,75 €;12.277,67 €;3415;-19,75;16.801,76 €;'sin fechas';27/03/2013;'FARMACIA';'Gastos_Salud, saber y deporte';'Farmacia';'VARIABLES'
28/03/2013;28/03/2013;'HOGAR&OTROS';-0,81 €;12.276,86 €;3416;-0,81;16.800,95 €;'sin fechas';28/03/2013;'HOGAROTROS';'Gastos_Vivienda y vehiculo';'Otros vivienda';'VARIABLES'
29/03/2013;24/03/2013;'AUTOPISTA TERR';-1,25 €;12.275,61 €;3417;-1,25;16.799,70 €;'sin fechas';24/03/2013;'AUTOPISTA';'Gastos_Ocio y transporte';'Parking y peaje';'VARIABLES'
29/03/2013;24/03/2013;'AUTOPISTA TERR';-1,25 €;12.274,36 €;3418;-1,25;16.798,45 €;'sin fechas';24/03/2013;'AUTOPISTA';'Gastos_Ocio y transporte';'Parking y peaje';'VARIABLES'
29/03/2013;23/03/2013;'AUTOPISTA TERR';-1,32 €;12.273,04 €;3419;-1,32;16.797,13 €;'sin fechas';23/03/2013;'AUTOPISTA';'Gastos_Ocio y transporte';'Parking y peaje';'VARIABLES'
29/03/2013;23/03/2013;'AUTOPISTA TERR';-1,32 €;12.271,72 €;3420;-1,32;16.795,81 €;'sin fechas';23/03/2013;'AUTOPISTA';'Gastos_Ocio y transporte';'Parking y peaje';'VARIABLES'
29/03/2013;22/03/2013;'AUTOPISTA TERR';-1,32 €;12.270,40 €;3421;-1,32;16.794,49 €;'sin fechas';22/03/2013;'AUTOPISTA';'Gastos_Ocio y transporte';'Parking y peaje';'VARIABLES'
29/03/2013;29/03/2013;'AUTOPISTA TERR';-1,25 €;12.269,15 €;3422;-1,25;16.793,24 €;'sin fechas';29/03/2013;'AUTOPISTA';'Gastos_Ocio y transporte';'Parking y peaje';'VARIABLES'
29/03/2013;29/03/2013;'AUTOPISTA TERR';-1,25 €;12.267,90 €;3423;-1,25;16.791,99 €;'sin fechas';29/03/2013;'AUTOPISTA';'Gastos_Ocio y transporte';'Parking y peaje';'VARIABLES'
29/03/2013;29/03/2013;'CAFET.C T PRAT';-3,75 €;12.264,15 €;3424;-3,75;16.788,24 €;'sin fechas';29/03/2013;'CAFETC';'Gastos_Ocio y transporte';'Restaurantes';'VARIABLES'
29/03/2013;29/03/2013;'H&M';-33,90 €;12.230,25 €;3425;-33,90;16.754,34 €;'sin fechas';29/03/2013;'HM';'Gastos_Compras';'Ropa';'VARIABLES'
29/03/2013;29/03/2013;'VIENA';-12,25 €;12.218,00 €;3426;-12,25;16.742,09 €;'sin fechas';29/03/2013;'VIENA';'Gastos_Ocio y transporte';'Restaurantes';'VARIABLES'
30/03/2013;30/03/2013;'AUTOPISTA TERR';-1,39 €;12.216,61 €;3427;-1,39;16.740,70 €;'sin fechas';30/03/2013;'AUTOPISTA';'Gastos_Ocio y transporte';'Parking y peaje';'VARIABLES'
30/03/2013;30/03/2013;'AUTOPISTA TERR';-1,25 €;12.215,36 €;3428;-1,25;16.739,45 €;'sin fechas';30/03/2013;'AUTOPISTA';'Gastos_Ocio y transporte';'Parking y peaje';'VARIABLES'
30/03/2013;30/03/2013;'CAFET.C T PRAT';-3,60 €;12.211,76 €;3429;-3,60;16.735,85 €;'sin fechas';30/03/2013;'CAFETC';'Gastos_Ocio y transporte';'Restaurantes';'VARIABLES'
30/03/2013;30/03/2013;'CARREFOUR-[COMIDA]';-121,70 €;12.090,06 €;3430;-121,70;16.614,15 €;'sin fechas';30/03/2013;'CARREFOURCOMIDA';'Gastos_Compras';'Supermercado';'VARIABLES'
30/03/2013;30/03/2013;'COCHE&PARKING';-3,00 €;12.087,06 €;3431;-3,00;16.611,15 €;'sin fechas';30/03/2013;'COCHEPARKING';'Gastos_Ocio y transporte';'Parking y peaje';'VARIABLES'
30/03/2013;30/03/2013;'DECATHLON';-62,80 €;12.024,26 €;3432;-62,80;16.548,35 €;'sin fechas';30/03/2013;'DECATHLON';'Gastos_Compras';'Deportivo';'VARIABLES'
30/03/2013;30/03/2013;'HOGAR&COMIDA';-25,64 €;11.998,62 €;3433;-25,64;16.522,71 €;'sin fechas';30/03/2013;'HOGARCOMIDA';'Gastos_Compras';'Supermercado';'VARIABLES'
31/03/2013;25/03/2013;'AUTOPISTA TERR';-1,39 €;11.997,23 €;3434;-1,39;16.521,32 €;'sin fechas';25/03/2013;'AUTOPISTA';'Gastos_Ocio y transporte';'Parking y peaje';'VARIABLES'
31/03/2013;25/03/2013;'AUTOPISTA TERR';-1,25 €;11.995,98 €;3435;-1,25;16.520,07 €;'sin fechas';25/03/2013;'AUTOPISTA';'Gastos_Ocio y transporte';'Parking y peaje';'VARIABLES'
31/03/2013;31/03/2013;'AUTOPISTA TERR';-1,25 €;11.994,73 €;3436;-1,25;16.518,82 €;'sin fechas';31/03/2013;'AUTOPISTA';'Gastos_Ocio y transporte';'Parking y peaje';'VARIABLES'
31/03/2013;31/03/2013;'AUTOPISTA TERR';-1,25 €;11.993,48 €;3437;-1,25;16.517,57 €;'sin fechas';31/03/2013;'AUTOPISTA';'Gastos_Ocio y transporte';'Parking y peaje';'VARIABLES'
31/03/2013;31/03/2013;'AUTOPISTA TERR';-1,39 €;11.992,09 €;3438;-1,39;16.516,18 €;'sin fechas';31/03/2013;'AUTOPISTA';'Gastos_Ocio y transporte';'Parking y peaje';'VARIABLES'
31/03/2013;31/03/2013;'CAFET.C T PRAT';-3,60 €;11.988,49 €;3439;-3,60;16.512,58 €;'sin fechas';31/03/2013;'CAFETC';'Gastos_Ocio y transporte';'Restaurantes';'VARIABLES'
31/03/2013;31/03/2013;'RECIBO PTMOS. 3061-0960001518';-562,73 €;11.425,76 €;3442;-562,73;15.949,85 €;'sin fechas';31/03/2013;'RECIBO';'Gastos_Banco y organismos';'Hipoteca';'FIJO'
31/03/2013;31/03/2013;'RESTAURANTES';-25,20 €;11.400,56 €;3443;-25,20;15.924,65 €;'sin fechas';31/03/2013;'RESTAURANTES';'Gastos_Ocio y transporte';'Restaurantes';'VARIABLES'
31/03/2013;31/03/2013;'RESTAURANTES';-15,10 €;11.385,46 €;3444;-15,10;15.909,55 €;'sin fechas';31/03/2013;'RESTAURANTES';'Gastos_Ocio y transporte';'Restaurantes';'VARIABLES'
01/04/2013;01/04/2013;'ESCOLA BRESSOL EINA';-433,65 €;10.951,81 €;3448;-433,65;15.475,90 €;'sin fechas';01/04/2013;'ESCOLA';'Gastos_Salud, saber y deporte';'Estudios';'VARIABLES'
01/04/2013;01/04/2013;'ESCOLA BRESSOL EINA';-397,55 €;10.554,26 €;3449;-397,55;15.078,35 €;'sin fechas';01/04/2013;'ESCOLA';'Gastos_Salud, saber y deporte';'Estudios';'VARIABLES'
01/04/2013;01/04/2013;'MANTENIMIENTO';-2,25 €;10.552,01 €;3450;-2,25;15.076,10 €;'sin fechas';01/04/2013;'MANTENIMIENTO';'Gastos_Banco y organismos';'Cargos banco';'FIJO'
02/04/2013;02/04/2013;'ADESLAS CENTRAL 006662671613';-110,65 €;10.441,36 €;3451;-110,65;14.965,45 €;'sin fechas';02/04/2013;'ADESLAS';'Gastos_Salud, saber y deporte';'Medico';'VARIABLES'
03/04/2013;03/04/2013;'GAS NATURAL';-9,67 €;10.431,69 €;3452;-9,67;14.955,78 €;'sin fechas';03/04/2013;'GAS';'Gastos_Servicios tipicos';'Gas';'FIJO'
03/04/2013;03/04/2013;'MERCADONA';-4,48 €;10.427,21 €;3453;-4,48;14.951,30 €;'sin fechas';03/04/2013;'MERCADONA';'Gastos_Compras';'Supermercado';'VARIABLES'
03/04/2013;03/04/2013;'SEGUROS CATALANA';-305,06 €;10.122,15 €;3454;-305,06;14.646,24 €;'sin fechas';03/04/2013;'CATALANA';'Gastos_Ocio y transporte';'Parking y peaje';'VARIABLES'
04/04/2013;04/04/2013;'VIENA';-14,05 €;10.108,10 €;3456;-14,05;14.632,19 €;'sin fechas';04/04/2013;'VIENA';'Gastos_Ocio y transporte';'Restaurantes';'VARIABLES'
04/04/2013;31/03/2013;'YOIGO';-50,27 €;10.057,83 €;3458;-50,27;14.581,92 €;'sin fechas';31/03/2013;'YOIGO';'Gastos_Servicios tipicos';'Telecomunicaciones';'FIJO'
05/04/2013;05/04/2013;'CAFET.C T PRAT';-3,45 €;10.054,38 €;3459;-3,45;14.578,47 €;'sin fechas';05/04/2013;'CAFETC';'Gastos_Ocio y transporte';'Restaurantes';'VARIABLES'
05/04/2013;05/04/2013;'GAS NATURAL';-441,32 €;9.613,06 €;3461;-441,32;14.137,15 €;'sin fechas';05/04/2013;'GAS';'Gastos_Servicios tipicos';'Gas';'FIJO'
05/04/2013;05/04/2013;'REINT.CAJERO';-20,00 €;9.593,06 €;3462;-20,00;14.117,15 €;'sin fechas';05/04/2013;'REINTCAJERO';'Gastos_Gastos varios';'Efectivo';'VARIABLES'
05/04/2013;05/04/2013;'TACISA';-71,49 €;9.521,57 €;3463;-71,49;14.045,66 €;'sin fechas';05/04/2013;'TACISA';'Gastos_Compras';'Supermercado';'VARIABLES'
06/04/2013;06/04/2013;'CAFET.C T PRAT';-3,45 €;9.518,12 €;3464;-3,45;14.042,21 €;'sin fechas';06/04/2013;'CAFETC';'Gastos_Ocio y transporte';'Restaurantes';'VARIABLES'
06/04/2013;06/04/2013;'MERCADONA';-142,55 €;9.375,57 €;3465;-142,55;13.899,66 €;'sin fechas';06/04/2013;'MERCADONA';'Gastos_Compras';'Supermercado';'VARIABLES'
06/04/2013;06/04/2013;'RESTAURANTES';-37,65 €;9.337,92 €;3466;-37,65;13.862,01 €;'sin fechas';06/04/2013;'RESTAURANTES';'Gastos_Ocio y transporte';'Restaurantes';'VARIABLES'
07/04/2013;02/04/2013;'AUTOPISTA TERR';-2,53 €;9.335,39 €;3467;-2,53;13.859,48 €;'sin fechas';02/04/2013;'AUTOPISTA';'Gastos_Ocio y transporte';'Parking y peaje';'VARIABLES'
07/04/2013;07/04/2013;'HOGAR&MODA';-64,26 €;9.271,13 €;3468;-64,26;13.795,22 €;'sin fechas';07/04/2013;'HOGARMODA';'Gastos_Compras';'Ropa';'VARIABLES'
08/04/2013;08/04/2013;'ES STA. MARGARITA';-30,00 €;9.241,13 €;3469;-30,00;13.765,22 €;'sin fechas';08/04/2013;'STA';'Gastos_Ocio y transporte';'Gasolina';'VARIABLES'
09/04/2013;09/04/2013;'BLITZ';-72,50 €;9.168,63 €;3471;-72,50;13.692,72 €;'sin fechas';09/04/2013;'BLITZ';'Gastos_Vivienda y vehiculo';'Alquiler Parking';'FIJO'
10/04/2013;10/04/2013;'COCHE&PARKING';-3,40 €;9.165,23 €;3473;-3,40;13.689,32 €;'sin fechas';10/04/2013;'COCHEPARKING';'Gastos_Ocio y transporte';'Parking y peaje';'VARIABLES'
10/04/2013;10/04/2013;'MERCADONA';-27,07 €;9.138,16 €;3475;-27,07;13.662,25 €;'sin fechas';10/04/2013;'MERCADONA';'Gastos_Compras';'Supermercado';'VARIABLES'
11/04/2013;11/04/2013;'CAFET.C T PRAT';-4,50 €;9.133,66 €;3476;-4,50;13.657,75 €;'sin fechas';11/04/2013;'CAFETC';'Gastos_Ocio y transporte';'Restaurantes';'VARIABLES'
11/04/2013;11/04/2013;'CARREFOUR-[COMIDA]';-87,40 €;9.046,26 €;3477;-87,40;13.570,35 €;'sin fechas';11/04/2013;'CARREFOURCOMIDA';'Gastos_Compras';'Supermercado';'VARIABLES'
11/04/2013;02/04/2013;'COCHE&PARKING';-3,45 €;9.042,81 €;3478;-3,45;13.566,90 €;'sin fechas';02/04/2013;'COCHEPARKING';'Gastos_Ocio y transporte';'Parking y peaje';'VARIABLES'
11/04/2013;09/04/2013;'HOGAR&MODA';-19,97 €;9.022,84 €;3479;-19,97;13.546,93 €;'sin fechas';09/04/2013;'HOGARMODA';'Gastos_Compras';'Ropa';'VARIABLES'
11/04/2013;10/04/2013;'HOGAR&OTROS';-7,90 €;9.014,94 €;3480;-7,90;13.539,03 €;'sin fechas';10/04/2013;'HOGAROTROS';'Gastos_Vivienda y vehiculo';'Otros vivienda';'VARIABLES'
11/04/2013;09/04/2013;'MEDIA MARKT';-62,02 €;8.952,92 €;3481;-62,02;13.477,01 €;'sin fechas';09/04/2013;'MEDIA';'Gastos_Compras';'Hobbys';'VARIABLES'
11/04/2013;10/04/2013;'OCIO&CINES';-6,70 €;8.946,22 €;3482;-6,70;13.470,31 €;'sin fechas';10/04/2013;'OCIOCINES';'Gastos_Ocio y transporte';'Espectáculos';'VARIABLES'
11/04/2013;09/04/2013;'VIENA';-3,10 €;8.943,12 €;3483;-3,10;13.467,21 €;'sin fechas';09/04/2013;'VIENA';'Gastos_Ocio y transporte';'Restaurantes';'VARIABLES'
12/04/2013;06/04/2013;'AUTOPISTA TERR';-1,39 €;8.941,73 €;3484;-1,39;13.465,82 €;'sin fechas';06/04/2013;'AUTOPISTA';'Gastos_Ocio y transporte';'Parking y peaje';'VARIABLES'
12/04/2013;06/04/2013;'AUTOPISTA TERR';-1,39 €;8.940,34 €;3485;-1,39;13.464,43 €;'sin fechas';06/04/2013;'AUTOPISTA';'Gastos_Ocio y transporte';'Parking y peaje';'VARIABLES'
12/04/2013;05/04/2013;'AUTOPISTA TERR';-1,39 €;8.938,95 €;3486;-1,39;13.463,04 €;'sin fechas';05/04/2013;'AUTOPISTA';'Gastos_Ocio y transporte';'Parking y peaje';'VARIABLES'
12/04/2013;05/04/2013;'AUTOPISTA TERR';-1,39 €;8.937,56 €;3487;-1,39;13.461,65 €;'sin fechas';05/04/2013;'AUTOPISTA';'Gastos_Ocio y transporte';'Parking y peaje';'VARIABLES'
12/04/2013;04/04/2013;'AUTOPISTA TERR';-2,53 €;8.935,03 €;3488;-2,53;13.459,12 €;'sin fechas';04/04/2013;'AUTOPISTA';'Gastos_Ocio y transporte';'Parking y peaje';'VARIABLES'
12/04/2013;04/04/2013;'AUTOPISTA TERR';-2,53 €;8.932,50 €;3489;-2,53;13.456,59 €;'sin fechas';04/04/2013;'AUTOPISTA';'Gastos_Ocio y transporte';'Parking y peaje';'VARIABLES'
13/04/2013;15/04/2013;'AG.TRIBUT GABRIEL';100,00 €;9.032,50 €;3490;100,00;13.556,59 €;'sin fechas';15/04/2013;'AGTRIBUT';'Ingresos';'Subvenciones';
13/04/2013;13/04/2013;'MERCADONA';-18,36 €;9.014,14 €;3491;-18,36;13.538,23 €;'sin fechas';13/04/2013;'MERCADONA';'Gastos_Compras';'Supermercado';'VARIABLES'
13/04/2013;13/04/2013;'REINT.CAJERO';-100,00 €;8.914,14 €;3492;-100,00;13.438,23 €;'sin fechas';13/04/2013;'REINTCAJERO';'Gastos_Gastos varios';'Efectivo';'VARIABLES'
14/04/2013;14/04/2013;'ES STA. MARGARITA';-30,00 €;8.884,14 €;3493;-30,00;13.408,23 €;'sin fechas';14/04/2013;'STA';'Gastos_Ocio y transporte';'Gasolina';'VARIABLES'
14/04/2013;14/04/2013;'FARMACIA';-7,91 €;8.876,23 €;3494;-7,91;13.400,32 €;'sin fechas';14/04/2013;'FARMACIA';'Gastos_Salud, saber y deporte';'Farmacia';'VARIABLES'
14/04/2013;14/04/2013;'HOGAR&OTROS';-21,85 €;8.854,38 €;3495;-21,85;13.378,47 €;'sin fechas';14/04/2013;'HOGAROTROS';'Gastos_Vivienda y vehiculo';'Otros vivienda';'VARIABLES'
15/04/2013;09/04/2013;'AUTOPISTA TERR';-2,53 €;8.851,85 €;3496;-2,53;13.375,94 €;'sin fechas';09/04/2013;'AUTOPISTA';'Gastos_Ocio y transporte';'Parking y peaje';'VARIABLES'
15/04/2013;08/04/2013;'AUTOPISTA TERR';-3,73 €;8.848,12 €;3497;-3,73;13.372,21 €;'sin fechas';08/04/2013;'AUTOPISTA';'Gastos_Ocio y transporte';'Parking y peaje';'VARIABLES'
15/04/2013;08/04/2013;'AUTOPISTA TERR';-1,32 €;8.846,80 €;3498;-1,32;13.370,89 €;'sin fechas';08/04/2013;'AUTOPISTA';'Gastos_Ocio y transporte';'Parking y peaje';'VARIABLES'
15/04/2013;08/04/2013;'AUTOPISTA TERR';-1,39 €;8.845,41 €;3499;-1,39;13.369,50 €;'sin fechas';08/04/2013;'AUTOPISTA';'Gastos_Ocio y transporte';'Parking y peaje';'VARIABLES'
15/04/2013;07/04/2013;'AUTOPISTA TERR';-1,39 €;8.844,02 €;3500;-1,39;13.368,11 €;'sin fechas';07/04/2013;'AUTOPISTA';'Gastos_Ocio y transporte';'Parking y peaje';'VARIABLES'
15/04/2013;07/04/2013;'AUTOPISTA TERR';-1,39 €;8.842,63 €;3501;-1,39;13.366,72 €;'sin fechas';07/04/2013;'AUTOPISTA';'Gastos_Ocio y transporte';'Parking y peaje';'VARIABLES'
15/04/2013;15/04/2013;'CCM VIDA Y P SEGURO PRESTAMO';-24,66 €;8.817,97 €;3502;-24,66;13.342,06 €;'sin fechas';15/04/2013;'CCM';'Gastos_Seguros';'Seguro vida';'FIJO'
15/04/2013;15/04/2013;'CCM VIDA Y PENSIO 000000493358';-18,42 €;8.799,55 €;3503;-18,42;13.323,64 €;'sin fechas';15/04/2013;'CCM';'Gastos_Seguros';'Seguro vida';'FIJO'
15/04/2013;15/04/2013;'HOGAR&MODA';-19,99 €;8.779,56 €;3504;-19,99;13.303,65 €;'sin fechas';15/04/2013;'HOGARMODA';'Gastos_Compras';'Ropa';'VARIABLES'
16/04/2013;16/04/2013;'COCHE&PARKING';-3,15 €;8.776,41 €;3505;-3,15;13.300,50 €;'sin fechas';16/04/2013;'COCHEPARKING';'Gastos_Ocio y transporte';'Parking y peaje';'VARIABLES'
17/04/2013;17/04/2013;'ONO';-89,42 €;8.686,99 €;3507;-89,42;13.211,08 €;'sin fechas';17/04/2013;'ONO';'Gastos_Servicios tipicos';'Telecomunicaciones';'FIJO'
18/04/2013;11/04/2013;'AUTOPISTA TERR';-4,20 €;8.682,79 €;3508;-4,20;13.206,88 €;'sin fechas';11/04/2013;'AUTOPISTA';'Gastos_Ocio y transporte';'Parking y peaje';'VARIABLES'
18/04/2013;18/04/2013;'CAFET.C T PRAT';-2,15 €;8.680,64 €;3509;-2,15;13.204,73 €;'sin fechas';18/04/2013;'CAFETC';'Gastos_Ocio y transporte';'Restaurantes';'VARIABLES'
18/04/2013;18/04/2013;'CARREFOUR-[COMIDA]';-119,26 €;8.561,38 €;3510;-119,26;13.085,47 €;'sin fechas';18/04/2013;'CARREFOURCOMIDA';'Gastos_Compras';'Supermercado';'VARIABLES'
18/04/2013;16/04/2013;'FARMACIA';-9,00 €;8.552,38 €;3511;-9,00;13.076,47 €;'sin fechas';16/04/2013;'FARMACIA';'Gastos_Salud, saber y deporte';'Farmacia';'VARIABLES'
18/04/2013;16/04/2013;'IMAGINARIUM';-14,95 €;8.537,43 €;3512;-14,95;13.061,52 €;'sin fechas';16/04/2013;'IMAGINARIUM';'Gastos_Compras';'Niños';'VARIABLES'
18/04/2013;18/04/2013;'NORAUTO';-84,90 €;8.452,53 €;3513;-84,90;12.976,62 €;'sin fechas';18/04/2013;'NORAUTO';'Gastos_Vivienda y vehiculo';'Mnto. vehiculo';'VARIABLE'
18/04/2013;16/04/2013;'RESTAURANTES';-34,76 €;8.417,77 €;3514;-34,76;12.941,86 €;'sin fechas';16/04/2013;'RESTAURANTES';'Gastos_Ocio y transporte';'Restaurantes';'VARIABLES'
19/04/2013;14/04/2013;'AUTOPISTA TERR';-1,25 €;8.416,52 €;3515;-1,25;12.940,61 €;'sin fechas';14/04/2013;'AUTOPISTA';'Gastos_Ocio y transporte';'Parking y peaje';'VARIABLES'
19/04/2013;14/04/2013;'AUTOPISTA TERR';-1,25 €;8.415,27 €;3516;-1,25;12.939,36 €;'sin fechas';14/04/2013;'AUTOPISTA';'Gastos_Ocio y transporte';'Parking y peaje';'VARIABLES'
19/04/2013;13/04/2013;'AUTOPISTA TERR';-1,25 €;8.414,02 €;3517;-1,25;12.938,11 €;'sin fechas';13/04/2013;'AUTOPISTA';'Gastos_Ocio y transporte';'Parking y peaje';'VARIABLES'
19/04/2013;13/04/2013;'AUTOPISTA TERR';-1,32 €;8.412,70 €;3518;-1,32;12.936,79 €;'sin fechas';13/04/2013;'AUTOPISTA';'Gastos_Ocio y transporte';'Parking y peaje';'VARIABLES'
19/04/2013;13/04/2013;'AUTOPISTA TERR';-1,39 €;8.411,31 €;3519;-1,39;12.935,40 €;'sin fechas';13/04/2013;'AUTOPISTA';'Gastos_Ocio y transporte';'Parking y peaje';'VARIABLES'
19/04/2013;13/04/2013;'AUTOPISTA TERR';-1,25 €;8.410,06 €;3520;-1,25;12.934,15 €;'sin fechas';13/04/2013;'AUTOPISTA';'Gastos_Ocio y transporte';'Parking y peaje';'VARIABLES'
19/04/2013;12/04/2013;'AUTOPISTA TERR';-1,32 €;8.408,74 €;3521;-1,32;12.932,83 €;'sin fechas';12/04/2013;'AUTOPISTA';'Gastos_Ocio y transporte';'Parking y peaje';'VARIABLES'
19/04/2013;12/04/2013;'AUTOPISTA TERR';-1,32 €;8.407,42 €;3522;-1,32;12.931,51 €;'sin fechas';12/04/2013;'AUTOPISTA';'Gastos_Ocio y transporte';'Parking y peaje';'VARIABLES'
19/04/2013;11/04/2013;'AUTOPISTA TERR';-1,32 €;8.406,10 €;3523;-1,32;12.930,19 €;'sin fechas';11/04/2013;'AUTOPISTA';'Gastos_Ocio y transporte';'Parking y peaje';'VARIABLES'
19/04/2013;11/04/2013;'AUTOPISTA TERR';-1,39 €;8.404,71 €;3524;-1,39;12.928,80 €;'sin fechas';11/04/2013;'AUTOPISTA';'Gastos_Ocio y transporte';'Parking y peaje';'VARIABLES'
21/04/2013;21/04/2013;'CAFET.C T PRAT';-4,50 €;8.400,21 €;3526;-4,50;12.924,30 €;'sin fechas';21/04/2013;'CAFETC';'Gastos_Ocio y transporte';'Restaurantes';'VARIABLES'
21/04/2013;21/04/2013;'ES STA. MARGARITA';-30,00 €;8.370,21 €;3527;-30,00;12.894,30 €;'sin fechas';21/04/2013;'STA';'Gastos_Ocio y transporte';'Gasolina';'VARIABLES'
22/04/2013;22/04/2013;'CAPRABO';-30,02 €;8.340,19 €;3528;-30,02;12.864,28 €;'sin fechas';22/04/2013;'CAPRABO';'Gastos_Compras';'Supermercado';'VARIABLES'
23/04/2013;23/04/2013;'COCHE&PARKING';-3,60 €;8.336,59 €;3529;-3,60;12.860,68 €;'sin fechas';23/04/2013;'COCHEPARKING';'Gastos_Ocio y transporte';'Parking y peaje';'VARIABLES'
23/04/2013;23/04/2013;'CRACK';-9,01 €;8.327,58 €;3530;-9,01;12.851,67 €;'sin fechas';23/04/2013;'CRACK';'Gastos_Compras';'Otras compras';'VARIABLES'
23/04/2013;23/04/2013;'RESTAURANTES';-7,60 €;8.319,98 €;3531;-7,60;12.844,07 €;'sin fechas';23/04/2013;'RESTAURANTES';'Gastos_Ocio y transporte';'Restaurantes';'VARIABLES'
25/04/2013;19/04/2013;'AUTOPISTA TERR';-1,39 €;8.318,59 €;3532;-1,39;12.842,68 €;'sin fechas';19/04/2013;'AUTOPISTA';'Gastos_Ocio y transporte';'Parking y peaje';'VARIABLES'
25/04/2013;19/04/2013;'AUTOPISTA TERR';-1,25 €;8.317,34 €;3533;-1,25;12.841,43 €;'sin fechas';19/04/2013;'AUTOPISTA';'Gastos_Ocio y transporte';'Parking y peaje';'VARIABLES'
25/04/2013;19/04/2013;'AUTOPISTA TERR';-1,25 €;8.316,09 €;3534;-1,25;12.840,18 €;'sin fechas';19/04/2013;'AUTOPISTA';'Gastos_Ocio y transporte';'Parking y peaje';'VARIABLES'
25/04/2013;19/04/2013;'AUTOPISTA TERR';-1,25 €;8.314,84 €;3535;-1,25;12.838,93 €;'sin fechas';19/04/2013;'AUTOPISTA';'Gastos_Ocio y transporte';'Parking y peaje';'VARIABLES'
25/04/2013;18/04/2013;'AUTOPISTA TERR';-4,20 €;8.310,64 €;3536;-4,20;12.834,73 €;'sin fechas';18/04/2013;'AUTOPISTA';'Gastos_Ocio y transporte';'Parking y peaje';'VARIABLES'
25/04/2013;18/04/2013;'AUTOPISTA TERR';-1,39 €;8.309,25 €;3537;-1,39;12.833,34 €;'sin fechas';18/04/2013;'AUTOPISTA';'Gastos_Ocio y transporte';'Parking y peaje';'VARIABLES'
25/04/2013;18/04/2013;'AUTOPISTA TERR';-1,25 €;8.308,00 €;3538;-1,25;12.832,09 €;'sin fechas';18/04/2013;'AUTOPISTA';'Gastos_Ocio y transporte';'Parking y peaje';'VARIABLES'
25/04/2013;15/04/2013;'AUTOPISTA TERR';-1,25 €;8.306,75 €;3539;-1,25;12.830,84 €;'sin fechas';15/04/2013;'AUTOPISTA';'Gastos_Ocio y transporte';'Parking y peaje';'VARIABLES'
25/04/2013;15/04/2013;'AUTOPISTA TERR';-1,25 €;8.305,50 €;3540;-1,25;12.829,59 €;'sin fechas';15/04/2013;'AUTOPISTA';'Gastos_Ocio y transporte';'Parking y peaje';'VARIABLES'
25/04/2013;23/04/2013;'EROSKI-[COMIDA]';-32,68 €;8.272,82 €;3541;-32,68;12.796,91 €;'sin fechas';23/04/2013;'EROSKICOMIDA';'Gastos_Compras';'Supermercado';'VARIABLES'
25/04/2013;24/04/2013;'FARMACIA';-9,86 €;8.262,96 €;3542;-9,86;12.787,05 €;'sin fechas';24/04/2013;'FARMACIA';'Gastos_Salud, saber y deporte';'Farmacia';'VARIABLES'
25/04/2013;24/04/2013;'HOGAR&OTROS';-12,45 €;8.250,51 €;3543;-12,45;12.774,60 €;'sin fechas';24/04/2013;'HOGAROTROS';'Gastos_Vivienda y vehiculo';'Otros vivienda';'VARIABLES'
25/04/2013;23/04/2013;'MEDIA MARKT';-23,98 €;8.226,53 €;3544;-23,98;12.750,62 €;'sin fechas';23/04/2013;'MEDIA';'Gastos_Compras';'Hobbys';'VARIABLES'
25/04/2013;23/04/2013;'RESTAURANTES';-17,60 €;8.208,93 €;3545;-17,60;12.733,02 €;'sin fechas';23/04/2013;'RESTAURANTES';'Gastos_Ocio y transporte';'Restaurantes';'VARIABLES'
25/04/2013;23/04/2013;'RESTAURANTES';-4,00 €;8.204,93 €;3546;-4,00;12.729,02 €;'sin fechas';23/04/2013;'RESTAURANTES';'Gastos_Ocio y transporte';'Restaurantes';'VARIABLES'
25/04/2013;23/04/2013;'VIENA';-16,45 €;8.188,48 €;3547;-16,45;12.712,57 €;'sin fechas';23/04/2013;'VIENA';'Gastos_Ocio y transporte';'Restaurantes';'VARIABLES'
26/04/2013;21/04/2013;'AUTOPISTA TERR';-1,11 €;8.187,37 €;3548;-1,11;12.711,46 €;'sin fechas';21/04/2013;'AUTOPISTA';'Gastos_Ocio y transporte';'Parking y peaje';'VARIABLES'
26/04/2013;21/04/2013;'AUTOPISTA TERR';-1,11 €;8.186,26 €;3549;-1,11;12.710,35 €;'sin fechas';21/04/2013;'AUTOPISTA';'Gastos_Ocio y transporte';'Parking y peaje';'VARIABLES'
26/04/2013;20/04/2013;'AUTOPISTA TERR';-4,20 €;8.182,06 €;3550;-4,20;12.706,15 €;'sin fechas';20/04/2013;'AUTOPISTA';'Gastos_Ocio y transporte';'Parking y peaje';'VARIABLES'
26/04/2013;20/04/2013;'AUTOPISTA TERR';-1,39 €;8.180,67 €;3551;-1,39;12.704,76 €;'sin fechas';20/04/2013;'AUTOPISTA';'Gastos_Ocio y transporte';'Parking y peaje';'VARIABLES'
26/04/2013;20/04/2013;'AUTOPISTA TERR';-1,11 €;8.179,56 €;3552;-1,11;12.703,65 €;'sin fechas';20/04/2013;'AUTOPISTA';'Gastos_Ocio y transporte';'Parking y peaje';'VARIABLES'
26/04/2013;20/04/2013;'AUTOPISTA TERR';-2,53 €;8.177,03 €;3553;-2,53;12.701,12 €;'sin fechas';20/04/2013;'AUTOPISTA';'Gastos_Ocio y transporte';'Parking y peaje';'VARIABLES'
26/04/2013;26/04/2013;'FOMENT DE TERRASSA, S.A. FOMEN';1.554,54 €;9.731,57 €;3554;1.554,54;14.255,66 €;'sin fechas';26/04/2013;'FOMENT';'Ingresos';'Nomina';'FIJO'
26/04/2013;26/04/2013;'INFORMACIO I TECNOLOGIA DE CAT';1.579,09 €;11.310,66 €;3555;1.579,09;15.834,75 €;'sin fechas';26/04/2013;'INFORMACIO';'Ingresos';'Nomina';'FIJO'
26/04/2013;26/04/2013;'REINT.CAJERO';-110,00 €;11.200,66 €;3556;-110,00;15.724,75 €;'sin fechas';26/04/2013;'REINTCAJERO';'Gastos_Gastos varios';'Efectivo';'VARIABLES'
27/04/2013;27/04/2013;'CAFET.C T PRAT';-4,50 €;11.196,16 €;3557;-4,50;15.720,25 €;'sin fechas';27/04/2013;'CAFETC';'Gastos_Ocio y transporte';'Restaurantes';'VARIABLES'
28/04/2013;28/04/2013;'COCHE&PARKING';-0,90 €;11.195,26 €;3558;-0,90;15.719,35 €;'sin fechas';28/04/2013;'COCHEPARKING';'Gastos_Ocio y transporte';'Parking y peaje';'VARIABLES'
28/04/2013;28/04/2013;'ES STA. MARGARITA';-30,01 €;11.165,25 €;3559;-30,01;15.689,34 €;'sin fechas';28/04/2013;'STA';'Gastos_Ocio y transporte';'Gasolina';'VARIABLES'
28/04/2013;28/04/2013;'MERCADONA';-117,05 €;11.048,20 €;3560;-117,05;15.572,29 €;'sin fechas';28/04/2013;'MERCADONA';'Gastos_Compras';'Supermercado';'VARIABLES'
28/04/2013;28/04/2013;'RESTAURANTES';-20,90 €;11.027,30 €;3561;-20,90;15.551,39 €;'sin fechas';28/04/2013;'RESTAURANTES';'Gastos_Ocio y transporte';'Restaurantes';'VARIABLES'
29/04/2013;25/04/2013;'AUTOPISTA TERR';-1,11 €;11.026,19 €;3562;-1,11;15.550,28 €;'sin fechas';25/04/2013;'AUTOPISTA';'Gastos_Ocio y transporte';'Parking y peaje';'VARIABLES'
29/04/2013;25/04/2013;'AUTOPISTA TERR';-1,39 €;11.024,80 €;3563;-1,39;15.548,89 €;'sin fechas';25/04/2013;'AUTOPISTA';'Gastos_Ocio y transporte';'Parking y peaje';'VARIABLES'
29/04/2013;23/04/2013;'AUTOPISTA TERR';-2,53 €;11.022,27 €;3564;-2,53;15.546,36 €;'sin fechas';23/04/2013;'AUTOPISTA';'Gastos_Ocio y transporte';'Parking y peaje';'VARIABLES'
29/04/2013;23/04/2013;'AUTOPISTA TERR';-2,53 €;11.019,74 €;3565;-2,53;15.543,83 €;'sin fechas';23/04/2013;'AUTOPISTA';'Gastos_Ocio y transporte';'Parking y peaje';'VARIABLES'
29/04/2013;23/04/2013;'AUTOPISTA TERR';-2,53 €;11.017,21 €;3566;-2,53;15.541,30 €;'sin fechas';23/04/2013;'AUTOPISTA';'Gastos_Ocio y transporte';'Parking y peaje';'VARIABLES'
29/04/2013;22/04/2013;'AUTOPISTA TERR';-1,11 €;11.016,10 €;3567;-1,11;15.540,19 €;'sin fechas';22/04/2013;'AUTOPISTA';'Gastos_Ocio y transporte';'Parking y peaje';'VARIABLES'
29/04/2013;22/04/2013;'AUTOPISTA TERR';-1,11 €;11.014,99 €;3568;-1,11;15.539,08 €;'sin fechas';22/04/2013;'AUTOPISTA';'Gastos_Ocio y transporte';'Parking y peaje';'VARIABLES'
29/04/2013;29/04/2013;'CAFET.C T PRAT';-0,90 €;11.014,09 €;3569;-0,90;15.538,18 €;'sin fechas';29/04/2013;'CAFETC';'Gastos_Ocio y transporte';'Restaurantes';'VARIABLES'
30/04/2013;30/04/2013;'CAFET.C T PRAT';-3,35 €;11.010,74 €;3570;-3,35;15.534,83 €;'sin fechas';30/04/2013;'CAFETC';'Gastos_Ocio y transporte';'Restaurantes';'VARIABLES'
30/04/2013;30/04/2013;'RECIBO PTMOS. 3061-0960001518';-562,73 €;10.448,01 €;3573;-562,73;14.972,10 €;'sin fechas';30/04/2013;'RECIBO';'Gastos_Banco y organismos';'Hipoteca';'FIJO'
01/05/2013;01/05/2013;'MANTENIMIENTO';-2,25 €;10.445,76 €;3577;-2,25;14.969,85 €;'sin fechas';01/05/2013;'MANTENIMIENTO';'Gastos_Banco y organismos';'Cargos banco';'FIJO'
01/05/2013;01/05/2013;'RESTAURANTES';-27,80 €;10.417,96 €;3578;-27,80;14.942,05 €;'sin fechas';01/05/2013;'RESTAURANTES';'Gastos_Ocio y transporte';'Restaurantes';'VARIABLES'
02/05/2013;02/05/2013;'AJUNTAMENT DE TER 010000520716';-44,24 €;10.373,72 €;3579;-44,24;14.897,81 €;'sin fechas';02/05/2013;'AJUNTAMENT';'Gastos_Banco y organismos';'Ayuntamiento';'FIJO'
02/05/2013;30/04/2013;'HOGAR&COMIDA';-12,38 €;10.361,34 €;3580;-12,38;14.885,43 €;'sin fechas';30/04/2013;'HOGARCOMIDA';'Gastos_Compras';'Supermercado';'VARIABLES'
02/05/2013;01/05/2013;'HOGAR&OTROS';-19,90 €;10.341,44 €;3581;-19,90;14.865,53 €;'sin fechas';01/05/2013;'HOGAROTROS';'Gastos_Vivienda y vehiculo';'Otros vivienda';'VARIABLES'
03/05/2013;03/05/2013;'AJUNTAMENT BARCELON 0332641FMY';-62,78 €;10.278,66 €;3582;-62,78;14.802,75 €;'sin fechas';03/05/2013;'AJUNTAMENT';'Gastos_Banco y organismos';'Ayuntamiento';'FIJO'
03/05/2013;28/04/2013;'AUTOPISTA TERR';-1,11 €;10.277,55 €;3583;-1,11;14.801,64 €;'sin fechas';28/04/2013;'AUTOPISTA';'Gastos_Ocio y transporte';'Parking y peaje';'VARIABLES'
03/05/2013;28/04/2013;'AUTOPISTA TERR';-1,11 €;10.276,44 €;3584;-1,11;14.800,53 €;'sin fechas';28/04/2013;'AUTOPISTA';'Gastos_Ocio y transporte';'Parking y peaje';'VARIABLES'
03/05/2013;03/05/2013;'ESCOLA BRESSOL EINA';-469,30 €;9.807,14 €;3585;-469,30;14.331,23 €;'sin fechas';03/05/2013;'ESCOLA';'Gastos_Salud, saber y deporte';'Estudios';'VARIABLES'
03/05/2013;03/05/2013;'ESCOLA BRESSOL EINA';-419,65 €;9.387,49 €;3586;-419,65;13.911,58 €;'sin fechas';03/05/2013;'ESCOLA';'Gastos_Salud, saber y deporte';'Estudios';'VARIABLES'
03/05/2013;03/05/2013;'MERCADONA';-21,41 €;9.366,08 €;3587;-21,41;13.890,17 €;'sin fechas';03/05/2013;'MERCADONA';'Gastos_Compras';'Supermercado';'VARIABLES'
03/05/2013;03/05/2013;'OCIO&CINES';-14,40 €;9.351,68 €;3588;-14,40;13.875,77 €;'sin fechas';03/05/2013;'OCIOCINES';'Gastos_Ocio y transporte';'Espectáculos';'VARIABLES'
03/05/2013;03/05/2013;'REINT.CAJERO';-40,00 €;9.311,68 €;3589;-40,00;13.835,77 €;'sin fechas';03/05/2013;'REINTCAJERO';'Gastos_Gastos varios';'Efectivo';'VARIABLES'
03/05/2013;03/05/2013;'VIENA';-15,65 €;9.296,03 €;3590;-15,65;13.820,12 €;'sin fechas';03/05/2013;'VIENA';'Gastos_Ocio y transporte';'Restaurantes';'VARIABLES'
04/05/2013;04/05/2013;'REINT.CAJERO';-100,00 €;9.196,03 €;3591;-100,00;13.720,12 €;'sin fechas';04/05/2013;'REINTCAJERO';'Gastos_Gastos varios';'Efectivo';'VARIABLES'
05/05/2013;05/05/2013;'CAFET.C T PRAT';-3,80 €;9.192,23 €;3592;-3,80;13.716,32 €;'sin fechas';05/05/2013;'CAFETC';'Gastos_Ocio y transporte';'Restaurantes';'VARIABLES'
05/05/2013;05/05/2013;'HOGAR&COMIDA';-22,96 €;9.169,27 €;3593;-22,96;13.693,36 €;'sin fechas';05/05/2013;'HOGARCOMIDA';'Gastos_Compras';'Supermercado';'VARIABLES'
06/05/2013;29/04/2013;'AUTOPISTA TERR';-1,11 €;9.168,16 €;3594;-1,11;13.692,25 €;'sin fechas';29/04/2013;'AUTOPISTA';'Gastos_Ocio y transporte';'Parking y peaje';'VARIABLES'
06/05/2013;29/04/2013;'AUTOPISTA TERR';-1,11 €;9.167,05 €;3595;-1,11;13.691,14 €;'sin fechas';29/04/2013;'AUTOPISTA';'Gastos_Ocio y transporte';'Parking y peaje';'VARIABLES'
06/05/2013;06/05/2013;'CAFET.C T PRAT';-3,35 €;9.163,70 €;3596;-3,35;13.687,79 €;'sin fechas';06/05/2013;'CAFETC';'Gastos_Ocio y transporte';'Restaurantes';'VARIABLES'
06/05/2013;30/04/2013;'YOIGO';-35,71 €;9.127,99 €;3598;-35,71;13.652,08 €;'sin fechas';30/04/2013;'YOIGO';'Gastos_Servicios tipicos';'Telecomunicaciones';'FIJO'
07/05/2013;07/05/2013;'CATALANA DIAG.I CIRUR';-3,40 €;9.124,59 €;3599;-3,40;13.648,68 €;'sin fechas';07/05/2013;'CATALANA';'Gastos_Ocio y transporte';'Parking y peaje';'VARIABLES'
08/05/2013;08/05/2013;'BLITZ';-72,50 €;9.052,09 €;3601;-72,50;13.576,18 €;'sin fechas';08/05/2013;'BLITZ';'Gastos_Vivienda y vehiculo';'Alquiler Parking';'FIJO'
08/05/2013;08/05/2013;'VIENA';-7,05 €;9.045,04 €;3603;-7,05;13.569,13 €;'sin fechas';08/05/2013;'VIENA';'Gastos_Ocio y transporte';'Restaurantes';'VARIABLES'
09/05/2013;09/05/2013;'ADESLAS CENTRAL 006662671613';-110,65 €;8.934,39 €;3604;-110,65;13.458,48 €;'sin fechas';09/05/2013;'ADESLAS';'Gastos_Salud, saber y deporte';'Medico';'VARIABLES'
09/05/2013;02/05/2013;'AUTOPISTA TERR';-4,20 €;8.930,19 €;3605;-4,20;13.454,28 €;'sin fechas';02/05/2013;'AUTOPISTA';'Gastos_Ocio y transporte';'Parking y peaje';'VARIABLES'
09/05/2013;02/05/2013;'AUTOPISTA TERR';-1,39 €;8.928,80 €;3606;-1,39;13.452,89 €;'sin fechas';02/05/2013;'AUTOPISTA';'Gastos_Ocio y transporte';'Parking y peaje';'VARIABLES'
09/05/2013;02/05/2013;'AUTOPISTA TERR';-0,97 €;8.927,83 €;3607;-0,97;13.451,92 €;'sin fechas';02/05/2013;'AUTOPISTA';'Gastos_Ocio y transporte';'Parking y peaje';'VARIABLES'
09/05/2013;09/05/2013;'AUTOPISTA TERR';-1,39 €;8.926,44 €;3608;-1,39;13.450,53 €;'sin fechas';09/05/2013;'AUTOPISTA';'Gastos_Ocio y transporte';'Parking y peaje';'VARIABLES'
09/05/2013;09/05/2013;'AUTOPISTA TERR';-1,39 €;8.925,05 €;3609;-1,39;13.449,14 €;'sin fechas';09/05/2013;'AUTOPISTA';'Gastos_Ocio y transporte';'Parking y peaje';'VARIABLES'
09/05/2013;09/05/2013;'CARREFOUR-[COMIDA]';-16,11 €;8.908,94 €;3610;-16,11;13.433,03 €;'sin fechas';09/05/2013;'CARREFOURCOMIDA';'Gastos_Compras';'Supermercado';'VARIABLES'
09/05/2013;07/05/2013;'ES STA. MARGARITA';-52,34 €;8.856,60 €;3611;-52,34;13.380,69 €;'sin fechas';07/05/2013;'STA';'Gastos_Ocio y transporte';'Gasolina';'VARIABLES'
09/05/2013;09/05/2013;'MERCADONA';-20,85 €;8.835,75 €;3612;-20,85;13.359,84 €;'sin fechas';09/05/2013;'MERCADONA';'Gastos_Compras';'Supermercado';'VARIABLES'
09/05/2013;09/05/2013;'RESTAURANTES';-14,60 €;8.821,15 €;3613;-14,60;13.345,24 €;'sin fechas';09/05/2013;'RESTAURANTES';'Gastos_Ocio y transporte';'Restaurantes';'VARIABLES'
10/05/2013;03/05/2013;'AUTOPISTA TERR';-1,39 €;8.819,76 €;3614;-1,39;13.343,85 €;'sin fechas';03/05/2013;'AUTOPISTA';'Gastos_Ocio y transporte';'Parking y peaje';'VARIABLES'
10/05/2013;03/05/2013;'AUTOPISTA TERR';-0,97 €;8.818,79 €;3615;-0,97;13.342,88 €;'sin fechas';03/05/2013;'AUTOPISTA';'Gastos_Ocio y transporte';'Parking y peaje';'VARIABLES'
10/05/2013;10/05/2013;'AUTOPISTA TERR';-1,39 €;8.817,40 €;3616;-1,39;13.341,49 €;'sin fechas';10/05/2013;'AUTOPISTA';'Gastos_Ocio y transporte';'Parking y peaje';'VARIABLES'
10/05/2013;10/05/2013;'AUTOPISTA TERR';-1,39 €;8.816,01 €;3617;-1,39;13.340,10 €;'sin fechas';10/05/2013;'AUTOPISTA';'Gastos_Ocio y transporte';'Parking y peaje';'VARIABLES'
10/05/2013;10/05/2013;'RESTAURANTES';-8,05 €;8.807,96 €;3619;-8,05;13.332,05 €;'sin fechas';10/05/2013;'RESTAURANTES';'Gastos_Ocio y transporte';'Restaurantes';'VARIABLES'
11/05/2013;11/05/2013;'CAFET.C T PRAT';-3,35 €;8.804,61 €;3620;-3,35;13.328,70 €;'sin fechas';11/05/2013;'CAFETC';'Gastos_Ocio y transporte';'Restaurantes';'VARIABLES'
11/05/2013;11/05/2013;'EROSKI-[COMIDA]';-11,98 €;8.792,63 €;3621;-11,98;13.316,72 €;'sin fechas';11/05/2013;'EROSKICOMIDA';'Gastos_Compras';'Supermercado';'VARIABLES'
11/05/2013;11/05/2013;'HOGAR&OTROS';-11,80 €;8.780,83 €;3622;-11,80;13.304,92 €;'sin fechas';11/05/2013;'HOGAROTROS';'Gastos_Vivienda y vehiculo';'Otros vivienda';'VARIABLES'
11/05/2013;11/05/2013;'MEDIA MARKT';-678,00 €;8.102,83 €;3623;-678,00;12.626,92 €;'sin fechas';11/05/2013;'MEDIA';'Gastos_Compras';'Hobbys';'VARIABLES'
11/05/2013;11/05/2013;'VIENA';-6,50 €;8.096,33 €;3624;-6,50;12.620,42 €;'sin fechas';11/05/2013;'VIENA';'Gastos_Ocio y transporte';'Restaurantes';'VARIABLES'
11/05/2013;11/05/2013;'VIENA';-9,05 €;8.087,28 €;3625;-9,05;12.611,37 €;'sin fechas';11/05/2013;'VIENA';'Gastos_Ocio y transporte';'Restaurantes';'VARIABLES'
12/05/2013;06/05/2013;'AUTOPISTA TERR';-1,39 €;8.085,89 €;3626;-1,39;12.609,98 €;'sin fechas';06/05/2013;'AUTOPISTA';'Gastos_Ocio y transporte';'Parking y peaje';'VARIABLES'
12/05/2013;06/05/2013;'AUTOPISTA TERR';-1,39 €;8.084,50 €;3627;-1,39;12.608,59 €;'sin fechas';06/05/2013;'AUTOPISTA';'Gastos_Ocio y transporte';'Parking y peaje';'VARIABLES'
12/05/2013;12/05/2013;'AUTOPISTA TERR';-2,53 €;8.081,97 €;3628;-2,53;12.606,06 €;'sin fechas';12/05/2013;'AUTOPISTA';'Gastos_Ocio y transporte';'Parking y peaje';'VARIABLES'
12/05/2013;12/05/2013;'CAFET.C T PRAT';-2,85 €;8.079,12 €;3629;-2,85;12.603,21 €;'sin fechas';12/05/2013;'CAFETC';'Gastos_Ocio y transporte';'Restaurantes';'VARIABLES'
12/05/2013;12/05/2013;'REINT.CAJERO';-100,00 €;7.979,12 €;3630;-100,00;12.503,21 €;'sin fechas';12/05/2013;'REINTCAJERO';'Gastos_Gastos varios';'Efectivo';'VARIABLES'
13/05/2013;09/05/2013;'AUTOPISTA TERR';-1,39 €;7.977,73 €;3631;-1,39;12.501,82 €;'sin fechas';09/05/2013;'AUTOPISTA';'Gastos_Ocio y transporte';'Parking y peaje';'VARIABLES'
13/05/2013;09/05/2013;'AUTOPISTA TERR';-1,39 €;7.976,34 €;3632;-1,39;12.500,43 €;'sin fechas';09/05/2013;'AUTOPISTA';'Gastos_Ocio y transporte';'Parking y peaje';'VARIABLES'
13/05/2013;13/05/2013;'BON AREA';-14,55 €;7.961,79 €;3633;-14,55;12.485,88 €;'sin fechas';13/05/2013;'BON';'Gastos_Compras';'Supermercado';'VARIABLES'
13/05/2013;13/05/2013;'CAFET.C T PRAT';-4,05 €;7.957,74 €;3634;-4,05;12.481,83 €;'sin fechas';13/05/2013;'CAFETC';'Gastos_Ocio y transporte';'Restaurantes';'VARIABLES'
14/05/2013;08/05/2013;'AUTOPISTA TERR';-1,39 €;7.956,35 €;3635;-1,39;12.480,44 €;'sin fechas';08/05/2013;'AUTOPISTA';'Gastos_Ocio y transporte';'Parking y peaje';'VARIABLES'
14/05/2013;14/05/2013;'HOGAR&COMIDA';-7,85 €;7.948,50 €;3636;-7,85;12.472,59 €;'sin fechas';14/05/2013;'HOGARCOMIDA';'Gastos_Compras';'Supermercado';'VARIABLES'
15/05/2013;15/05/2013;'AG.TRIBUT GABRIEL';100,00 €;8.048,50 €;3637;100,00;12.572,59 €;'sin fechas';15/05/2013;'AGTRIBUT';'Ingresos';'Subvenciones';
15/05/2013;15/05/2013;'CCM VIDA Y P SEGURO PRESTAMO';-24,59 €;8.023,91 €;3638;-24,59;12.548,00 €;'sin fechas';15/05/2013;'CCM';'Gastos_Seguros';'Seguro vida';'FIJO'
15/05/2013;15/05/2013;'CCM VIDA Y PENSIO 000000493358';-18,37 €;8.005,54 €;3639;-18,37;12.529,63 €;'sin fechas';15/05/2013;'CCM';'Gastos_Seguros';'Seguro vida';'FIJO'
15/05/2013;15/05/2013;'RESTAURANTES';-12,41 €;7.993,13 €;3640;-12,41;12.517,22 €;'sin fechas';15/05/2013;'RESTAURANTES';'Gastos_Ocio y transporte';'Restaurantes';'VARIABLES'
16/05/2013;10/05/2013;'AUTOPISTA TERR';-1,32 €;7.991,81 €;3641;-1,32;12.515,90 €;'sin fechas';10/05/2013;'AUTOPISTA';'Gastos_Ocio y transporte';'Parking y peaje';'VARIABLES'
16/05/2013;10/05/2013;'AUTOPISTA TERR';-1,32 €;7.990,49 €;3642;-1,32;12.514,58 €;'sin fechas';10/05/2013;'AUTOPISTA';'Gastos_Ocio y transporte';'Parking y peaje';'VARIABLES'
16/05/2013;10/05/2013;'AUTOPISTA TERR';-1,32 €;7.989,17 €;3643;-1,32;12.513,26 €;'sin fechas';10/05/2013;'AUTOPISTA';'Gastos_Ocio y transporte';'Parking y peaje';'VARIABLES'
16/05/2013;10/05/2013;'AUTOPISTA TERR';-1,32 €;7.987,85 €;3644;-1,32;12.511,94 €;'sin fechas';10/05/2013;'AUTOPISTA';'Gastos_Ocio y transporte';'Parking y peaje';'VARIABLES'
16/05/2013;15/05/2013;'FARMACIA';-5,94 €;7.981,91 €;3645;-5,94;12.506,00 €;'sin fechas';15/05/2013;'FARMACIA';'Gastos_Salud, saber y deporte';'Farmacia';'VARIABLES'
17/05/2013;11/05/2013;'AUTOPISTA TERR';-1,25 €;7.980,66 €;3646;-1,25;12.504,75 €;'sin fechas';11/05/2013;'AUTOPISTA';'Gastos_Ocio y transporte';'Parking y peaje';'VARIABLES'
17/05/2013;11/05/2013;'AUTOPISTA TERR';-1,32 €;7.979,34 €;3647;-1,32;12.503,43 €;'sin fechas';11/05/2013;'AUTOPISTA';'Gastos_Ocio y transporte';'Parking y peaje';'VARIABLES'
17/05/2013;05/05/2013;'AUTOPISTA TERR';-1,39 €;7.977,95 €;3648;-1,39;12.502,04 €;'sin fechas';05/05/2013;'AUTOPISTA';'Gastos_Ocio y transporte';'Parking y peaje';'VARIABLES'
17/05/2013;05/05/2013;'AUTOPISTA TERR';-1,39 €;7.976,56 €;3649;-1,39;12.500,65 €;'sin fechas';05/05/2013;'AUTOPISTA';'Gastos_Ocio y transporte';'Parking y peaje';'VARIABLES'
17/05/2013;17/05/2013;'MERCADONA';-6,79 €;7.969,77 €;3650;-6,79;12.493,86 €;'sin fechas';17/05/2013;'MERCADONA';'Gastos_Compras';'Supermercado';'VARIABLES'
17/05/2013;17/05/2013;'MERCADONA';-175,18 €;7.794,59 €;3651;-175,18;12.318,68 €;'sin fechas';17/05/2013;'MERCADONA';'Gastos_Compras';'Supermercado';'VARIABLES'
17/05/2013;17/05/2013;'ONO';-89,42 €;7.705,17 €;3652;-89,42;12.229,26 €;'sin fechas';17/05/2013;'ONO';'Gastos_Servicios tipicos';'Telecomunicaciones';'FIJO'
19/05/2013;19/05/2013;'AUTOPISTA TERR';-2,53 €;7.702,64 €;3654;-2,53;12.226,73 €;'sin fechas';19/05/2013;'AUTOPISTA';'Gastos_Ocio y transporte';'Parking y peaje';'VARIABLES'
19/05/2013;19/05/2013;'AUTOPISTA TERR';-2,53 €;7.700,11 €;3655;-2,53;12.224,20 €;'sin fechas';19/05/2013;'AUTOPISTA';'Gastos_Ocio y transporte';'Parking y peaje';'VARIABLES'
19/05/2013;19/05/2013;'FARMACIA';-17,56 €;7.682,55 €;3656;-17,56;12.206,64 €;'sin fechas';19/05/2013;'FARMACIA';'Gastos_Salud, saber y deporte';'Farmacia';'VARIABLES'
19/05/2013;19/05/2013;'HOGAR&MODA';-6,30 €;7.676,25 €;3657;-6,30;12.200,34 €;'sin fechas';19/05/2013;'HOGARMODA';'Gastos_Compras';'Ropa';'VARIABLES'
19/05/2013;19/05/2013;'VIENA';-8,10 €;7.668,15 €;3658;-8,10;12.192,24 €;'sin fechas';19/05/2013;'VIENA';'Gastos_Ocio y transporte';'Restaurantes';'VARIABLES'
21/05/2013;21/05/2013;'CARREFOUR-[MODA]';-18,77 €;7.649,38 €;3660;-18,77;12.173,47 €;'sin fechas';21/05/2013;'CARREFOURMODA';'Gastos_Compras';'Supermercado';'VARIABLES'
22/05/2013;22/05/2013;'AUTOPISTA TERR';-1,39 €;7.647,99 €;3661;-1,39;12.172,08 €;'sin fechas';22/05/2013;'AUTOPISTA';'Gastos_Ocio y transporte';'Parking y peaje';'VARIABLES'
22/05/2013;22/05/2013;'AUTOPISTA TERR';-1,39 €;7.646,60 €;3662;-1,39;12.170,69 €;'sin fechas';22/05/2013;'AUTOPISTA';'Gastos_Ocio y transporte';'Parking y peaje';'VARIABLES'
22/05/2013;22/05/2013;'FOMENT DE TERRASSA, S.A. FOMEN';1.554,54 €;9.201,14 €;3663;1.554,54;13.725,23 €;'sin fechas';22/05/2013;'FOMENT';'Ingresos';'Nomina';'FIJO'
22/05/2013;22/05/2013;'MERCADONA';-15,84 €;9.185,30 €;3665;-15,84;13.709,39 €;'sin fechas';22/05/2013;'MERCADONA';'Gastos_Compras';'Supermercado';'VARIABLES'
23/05/2013;22/05/2013;'ES STA. MARGARITA';-37,39 €;9.147,91 €;3666;-37,39;13.672,00 €;'sin fechas';22/05/2013;'STA';'Gastos_Ocio y transporte';'Gasolina';'VARIABLES'
23/05/2013;23/05/2013;'HOGAR&OTROS';-12,45 €;9.135,46 €;3667;-12,45;13.659,55 €;'sin fechas';23/05/2013;'HOGAROTROS';'Gastos_Vivienda y vehiculo';'Otros vivienda';'VARIABLES'
23/05/2013;23/05/2013;'IKEA';-71,49 €;9.063,97 €;3668;-71,49;13.588,06 €;'sin fechas';23/05/2013;'IKEA';'Gastos_Vivienda y vehiculo';'Mnto. hogar';'VARIABLES'
23/05/2013;22/05/2013;'OCIO&CINES';-15,40 €;9.048,57 €;3669;-15,40;13.572,66 €;'sin fechas';22/05/2013;'OCIOCINES';'Gastos_Ocio y transporte';'Espectáculos';'VARIABLES'
23/05/2013;23/05/2013;'VIENA';-18,40 €;9.030,17 €;3670;-18,40;13.554,26 €;'sin fechas';23/05/2013;'VIENA';'Gastos_Ocio y transporte';'Restaurantes';'VARIABLES'
23/05/2013;22/05/2013;'VIENA';-13,05 €;9.017,12 €;3671;-13,05;13.541,21 €;'sin fechas';22/05/2013;'VIENA';'Gastos_Ocio y transporte';'Restaurantes';'VARIABLES'
24/05/2013;24/05/2013;'CARREFOUR-[COMIDA]';-3,49 €;9.013,63 €;3672;-3,49;13.537,72 €;'sin fechas';24/05/2013;'CARREFOURCOMIDA';'Gastos_Compras';'Supermercado';'VARIABLES'
24/05/2013;24/05/2013;'DECATHLON';-37,87 €;8.975,76 €;3673;-37,87;13.499,85 €;'sin fechas';24/05/2013;'DECATHLON';'Gastos_Compras';'Deportivo';'VARIABLES'
24/05/2013;24/05/2013;'RESTAURANTES';-17,80 €;8.957,96 €;3674;-17,80;13.482,05 €;'sin fechas';24/05/2013;'RESTAURANTES';'Gastos_Ocio y transporte';'Restaurantes';'VARIABLES'
25/05/2013;25/05/2013;'FARMACIA';-29,95 €;8.928,01 €;3675;-29,95;13.452,10 €;'sin fechas';25/05/2013;'FARMACIA';'Gastos_Salud, saber y deporte';'Farmacia';'VARIABLES'
25/05/2013;25/05/2013;'HOGAR&OTROS';-2,47 €;8.925,54 €;3676;-2,47;13.449,63 €;'sin fechas';25/05/2013;'HOGAROTROS';'Gastos_Vivienda y vehiculo';'Otros vivienda';'VARIABLES'
28/05/2013;28/05/2013;'HOGAR&COMIDA';-10,12 €;8.915,42 €;3677;-10,12;13.439,51 €;'sin fechas';28/05/2013;'HOGARCOMIDA';'Gastos_Compras';'Supermercado';'VARIABLES'
28/05/2013;28/05/2013;'INFORMACIO I TECNOLOGIA DE CAT';1.579,09 €;10.494,51 €;3678;1.579,09;15.018,60 €;'sin fechas';28/05/2013;'INFORMACIO';'Ingresos';'Nomina';'FIJO'
29/05/2013;29/05/2013;'MERCADONA';-23,38 €;10.471,13 €;3679;-23,38;14.995,22 €;'sin fechas';29/05/2013;'MERCADONA';'Gastos_Compras';'Supermercado';'VARIABLES'
30/05/2013;30/05/2013;'A.E.A.T. DEVOLUCIONES TRIBUTAR';178,80 €;10.649,93 €;3680;178,80;15.174,02 €;'sin fechas';30/05/2013;'AEAT';'Ingresos';'Devoluciones';'VARIABLES'
30/05/2013;30/05/2013;'A.E.A.T. DEVOLUCIONES TRIBUTAR';333,41 €;10.983,34 €;3681;333,41;15.507,43 €;'sin fechas';30/05/2013;'AEAT';'Ingresos';'Devoluciones';'VARIABLES'
30/05/2013;30/05/2013;'CAFET.C T PRAT';-3,60 €;10.979,74 €;3682;-3,60;15.503,83 €;'sin fechas';30/05/2013;'CAFETC';'Gastos_Ocio y transporte';'Restaurantes';'VARIABLES'
30/05/2013;29/05/2013;'FARMACIA';-5,41 €;10.974,33 €;3683;-5,41;15.498,42 €;'sin fechas';29/05/2013;'FARMACIA';'Gastos_Salud, saber y deporte';'Farmacia';'VARIABLES'
30/05/2013;29/05/2013;'HOGAR&OTROS';-20,25 €;10.954,08 €;3684;-20,25;15.478,17 €;'sin fechas';29/05/2013;'HOGAROTROS';'Gastos_Vivienda y vehiculo';'Otros vivienda';'VARIABLES'
30/05/2013;28/05/2013;'IKEA';-24,55 €;10.929,53 €;3685;-24,55;15.453,62 €;'sin fechas';28/05/2013;'IKEA';'Gastos_Vivienda y vehiculo';'Mnto. hogar';'VARIABLES'
30/05/2013;28/05/2013;'IKEA';-54,00 €;10.875,53 €;3686;-54,00;15.399,62 €;'sin fechas';28/05/2013;'IKEA';'Gastos_Vivienda y vehiculo';'Mnto. hogar';'VARIABLES'
30/05/2013;28/05/2013;'IKEA';-918,35 €;9.957,18 €;3687;-918,35;14.481,27 €;'sin fechas';28/05/2013;'IKEA';'Gastos_Vivienda y vehiculo';'Mnto. hogar';'VARIABLES'
30/05/2013;28/05/2013;'IKEA';-4,45 €;9.952,73 €;3688;-4,45;14.476,82 €;'sin fechas';28/05/2013;'IKEA';'Gastos_Vivienda y vehiculo';'Mnto. hogar';'VARIABLES'
30/05/2013;28/05/2013;'LEROY MERLIN';-22,95 €;9.929,78 €;3689;-22,95;14.453,87 €;'sin fechas';28/05/2013;'LEROY';'Gastos_Vivienda y vehiculo';'Mnto. hogar';'VARIABLES'
30/05/2013;30/05/2013;'RESTAURANTES';-6,00 €;9.923,78 €;3690;-6,00;14.447,87 €;'sin fechas';30/05/2013;'RESTAURANTES';'Gastos_Ocio y transporte';'Restaurantes';'VARIABLES'
30/05/2013;28/05/2013;'VIENA';-15,05 €;9.908,73 €;3691;-15,05;14.432,82 €;'sin fechas';28/05/2013;'VIENA';'Gastos_Ocio y transporte';'Restaurantes';'VARIABLES'
31/05/2013;31/05/2013;'AUTOPISTA TERR';-1,39 €;9.907,34 €;3692;-1,39;14.431,43 €;'sin fechas';31/05/2013;'AUTOPISTA';'Gastos_Ocio y transporte';'Parking y peaje';'VARIABLES'
31/05/2013;31/05/2013;'AUTOPISTA TERR';-1,39 €;9.905,95 €;3693;-1,39;14.430,04 €;'sin fechas';31/05/2013;'AUTOPISTA';'Gastos_Ocio y transporte';'Parking y peaje';'VARIABLES'
31/05/2013;31/05/2013;'CAFET.C T PRAT';-2,20 €;9.903,75 €;3694;-2,20;14.427,84 €;'sin fechas';31/05/2013;'CAFETC';'Gastos_Ocio y transporte';'Restaurantes';'VARIABLES'
31/05/2013;31/05/2013;'LEROY MERLIN';-59,09 €;9.844,66 €;3696;-59,09;14.368,75 €;'sin fechas';31/05/2013;'LEROY';'Gastos_Vivienda y vehiculo';'Mnto. hogar';'VARIABLES'
31/05/2013;31/05/2013;'RECIBO PTMOS. 3061-0960001518';-562,73 €;9.281,93 €;3697;-562,73;13.806,02 €;'sin fechas';31/05/2013;'RECIBO';'Gastos_Banco y organismos';'Hipoteca';'FIJO'
01/06/2013;01/06/2013;'CATALANA DIAG.I CIRUR';-1,95 €;9.279,98 €;3698;-1,95;13.804,07 €;'sin fechas';01/06/2013;'CATALANA';'Gastos_Ocio y transporte';'Parking y peaje';'VARIABLES'
01/06/2013;01/06/2013;'MANTENIMIENTO';-2,25 €;9.277,73 €;3700;-2,25;13.801,82 €;'sin fechas';01/06/2013;'MANTENIMIENTO';'Gastos_Banco y organismos';'Cargos banco';'FIJO'
02/06/2013;29/05/2013;'AUTOPISTA TERR';-2,53 €;9.275,20 €;3701;-2,53;13.799,29 €;'sin fechas';29/05/2013;'AUTOPISTA';'Gastos_Ocio y transporte';'Parking y peaje';'VARIABLES'
02/06/2013;02/06/2013;'CAFET.C T PRAT';-5,55 €;9.269,65 €;3702;-5,55;13.793,74 €;'sin fechas';02/06/2013;'CAFETC';'Gastos_Ocio y transporte';'Restaurantes';'VARIABLES'
02/06/2013;02/06/2013;'REINT.CAJERO';-80,00 €;9.189,65 €;3703;-80,00;13.713,74 €;'sin fechas';02/06/2013;'REINTCAJERO';'Gastos_Gastos varios';'Efectivo';'VARIABLES'
03/06/2013;03/06/2013;'ADESLAS CENTRAL 006662671613';-110,65 €;9.079,00 €;3704;-110,65;13.603,09 €;'sin fechas';03/06/2013;'ADESLAS';'Gastos_Salud, saber y deporte';'Medico';'VARIABLES'
03/06/2013;03/06/2013;'BON AREA';-15,64 €;9.063,36 €;3705;-15,64;13.587,45 €;'sin fechas';03/06/2013;'BON';'Gastos_Compras';'Supermercado';'VARIABLES'
03/06/2013;03/06/2013;'CAFET.C T PRAT';-3,55 €;9.059,81 €;3706;-3,55;13.583,90 €;'sin fechas';03/06/2013;'CAFETC';'Gastos_Ocio y transporte';'Restaurantes';'VARIABLES'
03/06/2013;03/06/2013;'HOGAR&COMIDA';-6,09 €;9.053,72 €;3707;-6,09;13.577,81 €;'sin fechas';03/06/2013;'HOGARCOMIDA';'Gastos_Compras';'Supermercado';'VARIABLES'
04/06/2013;04/06/2013;'AUTOPISTA TERR';-1,39 €;9.052,33 €;3708;-1,39;13.576,42 €;'sin fechas';04/06/2013;'AUTOPISTA';'Gastos_Ocio y transporte';'Parking y peaje';'VARIABLES'
04/06/2013;04/06/2013;'AUTOPISTA TERR';-1,39 €;9.050,94 €;3709;-1,39;13.575,03 €;'sin fechas';04/06/2013;'AUTOPISTA';'Gastos_Ocio y transporte';'Parking y peaje';'VARIABLES'
04/06/2013;04/06/2013;'REINT.CAJERO';-110,00 €;8.940,94 €;3710;-110,00;13.465,03 €;'sin fechas';04/06/2013;'REINTCAJERO';'Gastos_Gastos varios';'Efectivo';'VARIABLES'
04/06/2013;31/05/2013;'YOIGO';-48,18 €;8.892,76 €;3711;-48,18;13.416,85 €;'sin fechas';31/05/2013;'YOIGO';'Gastos_Servicios tipicos';'Telecomunicaciones';'FIJO'
05/06/2013;05/06/2013;'AUTOPISTA TERR';-1,39 €;8.891,37 €;3712;-1,39;13.415,46 €;'sin fechas';05/06/2013;'AUTOPISTA';'Gastos_Ocio y transporte';'Parking y peaje';'VARIABLES'
05/06/2013;05/06/2013;'AUTOPISTA TERR';-1,39 €;8.889,98 €;3713;-1,39;13.414,07 €;'sin fechas';05/06/2013;'AUTOPISTA';'Gastos_Ocio y transporte';'Parking y peaje';'VARIABLES'
05/06/2013;05/06/2013;'COM. MANT. ACTIVAS DE LIQ.';-4,50 €;8.885,48 €;3714;-4,50;13.409,57 €;'sin fechas';05/06/2013;'COM';'Gastos_Banco y organismos';'Cargos banco';'FIJO'
06/06/2013;06/06/2013;'AUTOPISTA TERR';-4,20 €;8.881,28 €;3716;-4,20;13.405,37 €;'sin fechas';06/06/2013;'AUTOPISTA';'Gastos_Ocio y transporte';'Parking y peaje';'VARIABLES'
06/06/2013;06/06/2013;'AUTOPISTA TERR';-1,39 €;8.879,89 €;3717;-1,39;13.403,98 €;'sin fechas';06/06/2013;'AUTOPISTA';'Gastos_Ocio y transporte';'Parking y peaje';'VARIABLES'
06/06/2013;04/06/2013;'CARREFOUR-[COMIDA]';-43,20 €;8.836,69 €;3718;-43,20;13.360,78 €;'sin fechas';04/06/2013;'CARREFOURCOMIDA';'Gastos_Compras';'Supermercado';'VARIABLES'
06/06/2013;06/06/2013;'ES STA. MARGARITA';-45,47 €;8.791,22 €;3719;-45,47;13.315,31 €;'sin fechas';06/06/2013;'STA';'Gastos_Ocio y transporte';'Gasolina';'VARIABLES'
06/06/2013;04/06/2013;'FARMACIA';-7,52 €;8.783,70 €;3720;-7,52;13.307,79 €;'sin fechas';04/06/2013;'FARMACIA';'Gastos_Salud, saber y deporte';'Farmacia';'VARIABLES'
06/06/2013;05/06/2013;'HOGAR&OTROS';-12,45 €;8.771,25 €;3721;-12,45;13.295,34 €;'sin fechas';05/06/2013;'HOGAROTROS';'Gastos_Vivienda y vehiculo';'Otros vivienda';'VARIABLES'
07/06/2013;07/06/2013;'AUTOPISTA TERR';-4,20 €;8.767,05 €;3722;-4,20;13.291,14 €;'sin fechas';07/06/2013;'AUTOPISTA';'Gastos_Ocio y transporte';'Parking y peaje';'VARIABLES'
07/06/2013;07/06/2013;'AUTOPISTA TERR';-1,39 €;8.765,66 €;3723;-1,39;13.289,75 €;'sin fechas';07/06/2013;'AUTOPISTA';'Gastos_Ocio y transporte';'Parking y peaje';'VARIABLES'
07/06/2013;07/06/2013;'AUTOPISTA TERR';-1,39 €;8.764,27 €;3724;-1,39;13.288,36 €;'sin fechas';07/06/2013;'AUTOPISTA';'Gastos_Ocio y transporte';'Parking y peaje';'VARIABLES'
07/06/2013;07/06/2013;'BON AREA';-9,29 €;8.754,98 €;3725;-9,29;13.279,07 €;'sin fechas';07/06/2013;'BON';'Gastos_Compras';'Supermercado';'VARIABLES'
08/06/2013;08/06/2013;'RESTAURANTES';-24,90 €;8.730,08 €;3726;-24,90;13.254,17 €;'sin fechas';08/06/2013;'RESTAURANTES';'Gastos_Ocio y transporte';'Restaurantes';'VARIABLES'
09/06/2013;09/06/2013;'CAFET.C T PRAT';-3,60 €;8.726,48 €;3727;-3,60;13.250,57 €;'sin fechas';09/06/2013;'CAFETC';'Gastos_Ocio y transporte';'Restaurantes';'VARIABLES'
10/06/2013;10/06/2013;'AUTOPISTA TERR';-1,39 €;8.725,09 €;3728;-1,39;13.249,18 €;'sin fechas';10/06/2013;'AUTOPISTA';'Gastos_Ocio y transporte';'Parking y peaje';'VARIABLES'
10/06/2013;10/06/2013;'AUTOPISTA TERR';-1,39 €;8.723,70 €;3729;-1,39;13.247,79 €;'sin fechas';10/06/2013;'AUTOPISTA';'Gastos_Ocio y transporte';'Parking y peaje';'VARIABLES'
10/06/2013;10/06/2013;'CAFET.C T PRAT';-3,80 €;8.719,90 €;3730;-3,80;13.243,99 €;'sin fechas';10/06/2013;'CAFETC';'Gastos_Ocio y transporte';'Restaurantes';'VARIABLES'
10/06/2013;10/06/2013;'RESTAURANTES';-17,00 €;8.702,90 €;3732;-17,00;13.226,99 €;'sin fechas';10/06/2013;'RESTAURANTES';'Gastos_Ocio y transporte';'Restaurantes';'VARIABLES'
10/06/2013;10/06/2013;'RODELAS PERRUQUERS';-35,00 €;8.667,90 €;3733;-35,00;13.191,99 €;'sin fechas';10/06/2013;'RODELAS';'Gastos_Salud, saber y deporte';'Belleza';'VARIABLES'
11/06/2013;11/06/2013;'AUTOPISTA TERR';-4,20 €;8.663,70 €;3734;-4,20;13.187,79 €;'sin fechas';11/06/2013;'AUTOPISTA';'Gastos_Ocio y transporte';'Parking y peaje';'VARIABLES'
11/06/2013;11/06/2013;'AUTOPISTA TERR';-1,32 €;8.662,38 €;3735;-1,32;13.186,47 €;'sin fechas';11/06/2013;'AUTOPISTA';'Gastos_Ocio y transporte';'Parking y peaje';'VARIABLES'
11/06/2013;11/06/2013;'AUTOPISTA TERR';-1,39 €;8.660,99 €;3736;-1,39;13.185,08 €;'sin fechas';11/06/2013;'AUTOPISTA';'Gastos_Ocio y transporte';'Parking y peaje';'VARIABLES'
11/06/2013;11/06/2013;'BLITZ';-72,50 €;8.588,49 €;3737;-72,50;13.112,58 €;'sin fechas';11/06/2013;'BLITZ';'Gastos_Vivienda y vehiculo';'Alquiler Parking';'FIJO'
12/06/2013;12/06/2013;'AUTOPISTA TERR';-4,20 €;8.584,29 €;3739;-4,20;13.108,38 €;'sin fechas';12/06/2013;'AUTOPISTA';'Gastos_Ocio y transporte';'Parking y peaje';'VARIABLES'
12/06/2013;12/06/2013;'AUTOPISTA TERR';-1,39 €;8.582,90 €;3740;-1,39;13.106,99 €;'sin fechas';12/06/2013;'AUTOPISTA';'Gastos_Ocio y transporte';'Parking y peaje';'VARIABLES'
13/06/2013;13/06/2013;'AUTOPISTA TERR';-4,20 €;8.578,70 €;3741;-4,20;13.102,79 €;'sin fechas';13/06/2013;'AUTOPISTA';'Gastos_Ocio y transporte';'Parking y peaje';'VARIABLES'
13/06/2013;13/06/2013;'AUTOPISTA TERR';-1,32 €;8.577,38 €;3742;-1,32;13.101,47 €;'sin fechas';13/06/2013;'AUTOPISTA';'Gastos_Ocio y transporte';'Parking y peaje';'VARIABLES'
13/06/2013;13/06/2013;'AUTOPISTA TERR';-1,39 €;8.575,99 €;3743;-1,39;13.100,08 €;'sin fechas';13/06/2013;'AUTOPISTA';'Gastos_Ocio y transporte';'Parking y peaje';'VARIABLES'
13/06/2013;13/06/2013;'CAFET.C T PRAT';-3,60 €;8.572,39 €;3744;-3,60;13.096,48 €;'sin fechas';13/06/2013;'CAFETC';'Gastos_Ocio y transporte';'Restaurantes';'VARIABLES'
13/06/2013;11/06/2013;'CARREFOUR-[COMIDA]';-102,51 €;8.469,88 €;3745;-102,51;12.993,97 €;'sin fechas';11/06/2013;'CARREFOURCOMIDA';'Gastos_Compras';'Supermercado';'VARIABLES'
13/06/2013;13/06/2013;'HOGAR&OTROS';-13,45 €;8.456,43 €;3746;-13,45;12.980,52 €;'sin fechas';13/06/2013;'HOGAROTROS';'Gastos_Vivienda y vehiculo';'Otros vivienda';'VARIABLES'
13/06/2013;13/06/2013;'HOGAR&OTROS';-10,00 €;8.446,43 €;3747;-10,00;12.970,52 €;'sin fechas';13/06/2013;'HOGAROTROS';'Gastos_Vivienda y vehiculo';'Otros vivienda';'VARIABLES'
13/06/2013;13/06/2013;'REINT.CAJERO';-50,00 €;8.396,43 €;3748;-50,00;12.920,52 €;'sin fechas';13/06/2013;'REINTCAJERO';'Gastos_Gastos varios';'Efectivo';'VARIABLES'
13/06/2013;13/06/2013;'SATSA PL. VELLA TERRASSA';-2,35 €;8.394,08 €;3749;-2,35;12.918,17 €;'sin fechas';13/06/2013;'SATSA';'Gastos_Ocio y transporte';'Parking y peaje';'VARIABLES'
13/06/2013;13/06/2013;'TOYOTA ORIENT CARS';-295,34 €;8.098,74 €;3750;-295,34;12.622,83 €;'sin fechas';13/06/2013;'TOYOTA';'Gastos_Vivienda y vehiculo';'Mnto. vehiculo';'VARIABLE'
14/06/2013;14/06/2013;'AKI 104 - TERRASSA';-2,90 €;8.095,84 €;3751;-2,90;12.619,93 €;'sin fechas';14/06/2013;'AKI';'Gastos_Vivienda y vehiculo';'Mnto. hogar';'VARIABLES'
14/06/2013;14/06/2013;'AUTOPISTA TERR';-4,20 €;8.091,64 €;3752;-4,20;12.615,73 €;'sin fechas';14/06/2013;'AUTOPISTA';'Gastos_Ocio y transporte';'Parking y peaje';'VARIABLES'
14/06/2013;14/06/2013;'AUTOPISTA TERR';-1,32 €;8.090,32 €;3753;-1,32;12.614,41 €;'sin fechas';14/06/2013;'AUTOPISTA';'Gastos_Ocio y transporte';'Parking y peaje';'VARIABLES'
14/06/2013;14/06/2013;'CAFET.C T PRAT';-3,60 €;8.086,72 €;3754;-3,60;12.610,81 €;'sin fechas';14/06/2013;'CAFETC';'Gastos_Ocio y transporte';'Restaurantes';'VARIABLES'
14/06/2013;14/06/2013;'CARREFOUR-[COMIDA]';-11,20 €;8.075,52 €;3755;-11,20;12.599,61 €;'sin fechas';14/06/2013;'CARREFOURCOMIDA';'Gastos_Compras';'Supermercado';'VARIABLES'
14/06/2013;14/06/2013;'CCM VIDA Y P SEGURO PRESTAMO';-24,52 €;8.051,00 €;3756;-24,52;12.575,09 €;'sin fechas';14/06/2013;'CCM';'Gastos_Seguros';'Seguro vida';'FIJO'
14/06/2013;14/06/2013;'CCM VIDA Y PENSIO 000000493358';-18,32 €;8.032,68 €;3757;-18,32;12.556,77 €;'sin fechas';14/06/2013;'CCM';'Gastos_Seguros';'Seguro vida';'FIJO'
15/06/2013;15/06/2013;'AKI 104 - TERRASSA';-23,89 €;8.008,79 €;3758;-23,89;12.532,88 €;'sin fechas';15/06/2013;'AKI';'Gastos_Vivienda y vehiculo';'Mnto. hogar';'VARIABLES'
15/06/2013;15/06/2013;'BON AREA';-13,82 €;7.994,97 €;3759;-13,82;12.519,06 €;'sin fechas';15/06/2013;'BON';'Gastos_Compras';'Supermercado';'VARIABLES'
15/06/2013;15/06/2013;'CAFET.C T PRAT';-3,45 €;7.991,52 €;3760;-3,45;12.515,61 €;'sin fechas';15/06/2013;'CAFETC';'Gastos_Ocio y transporte';'Restaurantes';'VARIABLES'
15/06/2013;15/06/2013;'FARMACIA';-71,81 €;7.919,71 €;3761;-71,81;12.443,80 €;'sin fechas';15/06/2013;'FARMACIA';'Gastos_Salud, saber y deporte';'Farmacia';'VARIABLES'
15/06/2013;15/06/2013;'KIKO';-15,80 €;7.903,91 €;3762;-15,80;12.428,00 €;'sin fechas';15/06/2013;'KIKO';'Gastos_Salud, saber y deporte';'Belleza';'VARIABLES'
16/06/2013;16/06/2013;'CAFET.C T PRAT';-3,85 €;7.900,06 €;3763;-3,85;12.424,15 €;'sin fechas';16/06/2013;'CAFETC';'Gastos_Ocio y transporte';'Restaurantes';'VARIABLES'
17/06/2013;17/06/2013;'AKI 104 - TERRASSA';-2,90 €;7.897,16 €;3764;-2,90;12.421,25 €;'sin fechas';17/06/2013;'AKI';'Gastos_Vivienda y vehiculo';'Mnto. hogar';'VARIABLES'
17/06/2013;17/06/2013;'AUTOPISTA TERR';-4,20 €;7.892,96 €;3765;-4,20;12.417,05 €;'sin fechas';17/06/2013;'AUTOPISTA';'Gastos_Ocio y transporte';'Parking y peaje';'VARIABLES'
17/06/2013;17/06/2013;'AUTOPISTA TERR';-1,32 €;7.891,64 €;3766;-1,32;12.415,73 €;'sin fechas';17/06/2013;'AUTOPISTA';'Gastos_Ocio y transporte';'Parking y peaje';'VARIABLES'
17/06/2013;17/06/2013;'AUTOPISTA TERR';-1,39 €;7.890,25 €;3767;-1,39;12.414,34 €;'sin fechas';17/06/2013;'AUTOPISTA';'Gastos_Ocio y transporte';'Parking y peaje';'VARIABLES'
17/06/2013;17/06/2013;'CAFET.C T PRAT';-3,60 €;7.886,65 €;3768;-3,60;12.410,74 €;'sin fechas';17/06/2013;'CAFETC';'Gastos_Ocio y transporte';'Restaurantes';'VARIABLES'
17/06/2013;17/06/2013;'CARREFOUR-[COMIDA]';-15,25 €;7.871,40 €;3769;-15,25;12.395,49 €;'sin fechas';17/06/2013;'CARREFOURCOMIDA';'Gastos_Compras';'Supermercado';'VARIABLES'
17/06/2013;17/06/2013;'ES STA. MARGARITA';-33,19 €;7.838,21 €;3770;-33,19;12.362,30 €;'sin fechas';17/06/2013;'STA';'Gastos_Ocio y transporte';'Gasolina';'VARIABLES'
17/06/2013;17/06/2013;'GAS NATURAL';-407,16 €;7.431,05 €;3772;-407,16;11.955,14 €;'sin fechas';17/06/2013;'GAS';'Gastos_Servicios tipicos';'Gas';'FIJO'
17/06/2013;17/06/2013;'HOGAR&COMIDA';-3,65 €;7.427,40 €;3773;-3,65;11.951,49 €;'sin fechas';17/06/2013;'HOGARCOMIDA';'Gastos_Compras';'Supermercado';'VARIABLES'
17/06/2013;17/06/2013;'REINT.CAJERO';-9,30 €;7.418,10 €;3774;-9,30;11.942,19 €;'sin fechas';17/06/2013;'REINTCAJERO';'Gastos_Gastos varios';'Efectivo';'VARIABLES'
18/06/2013;18/06/2013;'AG.TRIBUT GABRIEL';100,00 €;7.518,10 €;3775;100,00;12.042,19 €;'sin fechas';18/06/2013;'AGTRIBUT';'Ingresos';'Subvenciones';
18/06/2013;18/06/2013;'AUTOPISTA TERR';-1,32 €;7.516,78 €;3776;-1,32;12.040,87 €;'sin fechas';18/06/2013;'AUTOPISTA';'Gastos_Ocio y transporte';'Parking y peaje';'VARIABLES'
18/06/2013;18/06/2013;'ONO';-89,42 €;7.427,36 €;3777;-89,42;11.951,45 €;'sin fechas';18/06/2013;'ONO';'Gastos_Servicios tipicos';'Telecomunicaciones';'FIJO'
19/06/2013;19/06/2013;'AUTOPISTA TERR';-4,20 €;7.423,16 €;3779;-4,20;11.947,25 €;'sin fechas';19/06/2013;'AUTOPISTA';'Gastos_Ocio y transporte';'Parking y peaje';'VARIABLES'
19/06/2013;19/06/2013;'AUTOPISTA TERR';-1,39 €;7.421,77 €;3780;-1,39;11.945,86 €;'sin fechas';19/06/2013;'AUTOPISTA';'Gastos_Ocio y transporte';'Parking y peaje';'VARIABLES'
19/06/2013;19/06/2013;'MINA PUBLICA AIGUES T.01A75789';-43,93 €;7.377,84 €;3781;-43,93;11.901,93 €;'sin fechas';19/06/2013;'MINA';'Gastos_Servicios tipicos';'Agua';'FIJO'
20/06/2013;20/06/2013;'AUTOPISTA TERR';-4,20 €;7.373,64 €;3782;-4,20;11.897,73 €;'sin fechas';20/06/2013;'AUTOPISTA';'Gastos_Ocio y transporte';'Parking y peaje';'VARIABLES'
20/06/2013;20/06/2013;'AUTOPISTA TERR';-1,25 €;7.372,39 €;3783;-1,25;11.896,48 €;'sin fechas';20/06/2013;'AUTOPISTA';'Gastos_Ocio y transporte';'Parking y peaje';'VARIABLES'
20/06/2013;20/06/2013;'AUTOPISTA TERR';-1,39 €;7.371,00 €;3784;-1,39;11.895,09 €;'sin fechas';20/06/2013;'AUTOPISTA';'Gastos_Ocio y transporte';'Parking y peaje';'VARIABLES'
20/06/2013;18/06/2013;'C&A';-28,60 €;7.342,40 €;3785;-28,60;11.866,49 €;'sin fechas';18/06/2013;'CA';'Gastos_Compras';'Ropa';'VARIABLES'
20/06/2013;19/06/2013;'ES STA. MARGARITA';-34,47 €;7.307,93 €;3787;-34,47;11.832,02 €;'sin fechas';19/06/2013;'STA';'Gastos_Ocio y transporte';'Gasolina';'VARIABLES'
20/06/2013;18/06/2013;'H&M';-30,75 €;7.277,18 €;3788;-30,75;11.801,27 €;'sin fechas';18/06/2013;'HM';'Gastos_Compras';'Ropa';'VARIABLES'
20/06/2013;19/06/2013;'HOGAR&OTROS';-12,45 €;7.264,73 €;3789;-12,45;11.788,82 €;'sin fechas';19/06/2013;'HOGAROTROS';'Gastos_Vivienda y vehiculo';'Otros vivienda';'VARIABLES'
20/06/2013;20/06/2013;'MERCADONA';-3,59 €;7.261,14 €;3790;-3,59;11.785,23 €;'sin fechas';20/06/2013;'MERCADONA';'Gastos_Compras';'Supermercado';'VARIABLES'
20/06/2013;20/06/2013;'MERCADONA';-179,79 €;7.081,35 €;3791;-179,79;11.605,44 €;'sin fechas';20/06/2013;'MERCADONA';'Gastos_Compras';'Supermercado';'VARIABLES'
20/06/2013;18/06/2013;'MERKALZADOS TARRAS';-30,48 €;7.050,87 €;3792;-30,48;11.574,96 €;'sin fechas';18/06/2013;'MERKALZADOS';'Gastos_Compras';'Ropa';'VARIABLES'
20/06/2013;18/06/2013;'OCIO&CINES';-18,80 €;7.032,07 €;3793;-18,80;11.556,16 €;'sin fechas';18/06/2013;'OCIOCINES';'Gastos_Ocio y transporte';'Espectáculos';'VARIABLES'
20/06/2013;20/06/2013;'REINT.CAJERO';-110,00 €;6.922,07 €;3794;-110,00;11.446,16 €;'sin fechas';20/06/2013;'REINTCAJERO';'Gastos_Gastos varios';'Efectivo';'VARIABLES'
20/06/2013;19/06/2013;'RESTAURANTES';-25,44 €;6.896,63 €;3795;-25,44;11.420,72 €;'sin fechas';19/06/2013;'RESTAURANTES';'Gastos_Ocio y transporte';'Restaurantes';'VARIABLES'
20/06/2013;18/06/2013;'RESTAURANTES';-41,60 €;6.855,03 €;3796;-41,60;11.379,12 €;'sin fechas';18/06/2013;'RESTAURANTES';'Gastos_Ocio y transporte';'Restaurantes';'VARIABLES'
21/06/2013;21/06/2013;'AUTOPISTA TERR';-1,39 €;6.853,64 €;3797;-1,39;11.377,73 €;'sin fechas';21/06/2013;'AUTOPISTA';'Gastos_Ocio y transporte';'Parking y peaje';'VARIABLES'
21/06/2013;21/06/2013;'AUTOPISTA TERR';-1,25 €;6.852,39 €;3798;-1,25;11.376,48 €;'sin fechas';21/06/2013;'AUTOPISTA';'Gastos_Ocio y transporte';'Parking y peaje';'VARIABLES'
21/06/2013;21/06/2013;'AUTOPISTA TERR';-1,25 €;6.851,14 €;3799;-1,25;11.375,23 €;'sin fechas';21/06/2013;'AUTOPISTA';'Gastos_Ocio y transporte';'Parking y peaje';'VARIABLES'
21/06/2013;21/06/2013;'AUTOPISTA TERR';-1,25 €;6.849,89 €;3800;-1,25;11.373,98 €;'sin fechas';21/06/2013;'AUTOPISTA';'Gastos_Ocio y transporte';'Parking y peaje';'VARIABLES'
21/06/2013;21/06/2013;'CATALANA DIAG.I CIRUR';-1,85 €;6.848,04 €;3801;-1,85;11.372,13 €;'sin fechas';21/06/2013;'CATALANA';'Gastos_Ocio y transporte';'Parking y peaje';'VARIABLES'
21/06/2013;21/06/2013;'FOMENT DE TERRASSA, S.A. FOMEN';3.167,30 €;10.015,34 €;3802;3.167,30;14.539,43 €;'sin fechas';21/06/2013;'FOMENT';'Ingresos';'Nomina';'FIJO'
21/06/2013;21/06/2013;'HOGAR&COMIDA';-5,35 €;10.009,99 €;3804;-5,35;14.534,08 €;'sin fechas';21/06/2013;'HOGARCOMIDA';'Gastos_Compras';'Supermercado';'VARIABLES'
21/06/2013;21/06/2013;'LEROY MERLIN';-22,95 €;9.987,04 €;3805;-22,95;14.511,13 €;'sin fechas';21/06/2013;'LEROY';'Gastos_Vivienda y vehiculo';'Mnto. hogar';'VARIABLES'
21/06/2013;21/06/2013;'VIENA';-12,15 €;9.974,89 €;3806;-12,15;14.498,98 €;'sin fechas';21/06/2013;'VIENA';'Gastos_Ocio y transporte';'Restaurantes';'VARIABLES'
22/06/2013;22/06/2013;'CAFET.C T PRAT';-3,45 €;9.971,44 €;3807;-3,45;14.495,53 €;'sin fechas';22/06/2013;'CAFETC';'Gastos_Ocio y transporte';'Restaurantes';'VARIABLES'
22/06/2013;22/06/2013;'VIENA';-23,55 €;9.947,89 €;3808;-23,55;14.471,98 €;'sin fechas';22/06/2013;'VIENA';'Gastos_Ocio y transporte';'Restaurantes';'VARIABLES'
23/06/2013;23/06/2013;'CAFET.C T PRAT';-3,40 €;9.944,49 €;3809;-3,40;14.468,58 €;'sin fechas';23/06/2013;'CAFETC';'Gastos_Ocio y transporte';'Restaurantes';'VARIABLES'
23/06/2013;23/06/2013;'HOGAR&COMIDA';-5,20 €;9.939,29 €;3810;-5,20;14.463,38 €;'sin fechas';23/06/2013;'HOGARCOMIDA';'Gastos_Compras';'Supermercado';'VARIABLES'
24/06/2013;24/06/2013;'AKI 104 - TERRASSA';-27,45 €;9.911,84 €;3811;-27,45;14.435,93 €;'sin fechas';24/06/2013;'AKI';'Gastos_Vivienda y vehiculo';'Mnto. hogar';'VARIABLES'
24/06/2013;24/06/2013;'CAFET.C T PRAT';-3,60 €;9.908,24 €;3812;-3,60;14.432,33 €;'sin fechas';24/06/2013;'CAFETC';'Gastos_Ocio y transporte';'Restaurantes';'VARIABLES'
24/06/2013;24/06/2013;'ESCOLA BRESSOL EINA';-525,75 €;9.382,49 €;3815;-525,75;13.906,58 €;'sin fechas';24/06/2013;'ESCOLA';'Gastos_Salud, saber y deporte';'Estudios';'VARIABLES'
24/06/2013;24/06/2013;'ESCOLA BRESSOL EINA';-650,10 €;8.732,39 €;3816;-650,10;13.256,48 €;'sin fechas';24/06/2013;'ESCOLA';'Gastos_Salud, saber y deporte';'Estudios';'VARIABLES'
24/06/2013;24/06/2013;'FARMACIA';-23,07 €;8.709,32 €;3817;-23,07;13.233,41 €;'sin fechas';24/06/2013;'FARMACIA';'Gastos_Salud, saber y deporte';'Farmacia';'VARIABLES'
24/06/2013;24/06/2013;'RESTAURANTES';-45,80 €;8.663,52 €;3818;-45,80;13.187,61 €;'sin fechas';24/06/2013;'RESTAURANTES';'Gastos_Ocio y transporte';'Restaurantes';'VARIABLES'
25/06/2013;25/06/2013;'AUTOPISTA TERR';-4,20 €;8.659,32 €;3819;-4,20;13.183,41 €;'sin fechas';25/06/2013;'AUTOPISTA';'Gastos_Ocio y transporte';'Parking y peaje';'VARIABLES'
25/06/2013;25/06/2013;'AUTOPISTA TERR';-1,25 €;8.658,07 €;3820;-1,25;13.182,16 €;'sin fechas';25/06/2013;'AUTOPISTA';'Gastos_Ocio y transporte';'Parking y peaje';'VARIABLES'
25/06/2013;25/06/2013;'MERCADONA';-21,03 €;8.637,04 €;3821;-21,03;13.161,13 €;'sin fechas';25/06/2013;'MERCADONA';'Gastos_Compras';'Supermercado';'VARIABLES'
26/06/2013;26/06/2013;'AUTOPISTA TERR';-1,25 €;8.635,79 €;3822;-1,25;13.159,88 €;'sin fechas';26/06/2013;'AUTOPISTA';'Gastos_Ocio y transporte';'Parking y peaje';'VARIABLES'
26/06/2013;26/06/2013;'IKEA';-12,80 €;8.622,99 €;3823;-12,80;13.147,08 €;'sin fechas';26/06/2013;'IKEA';'Gastos_Vivienda y vehiculo';'Mnto. hogar';'VARIABLES'
27/06/2013;27/06/2013;'AUTOPISTA TERR';-4,20 €;8.618,79 €;3824;-4,20;13.142,88 €;'sin fechas';27/06/2013;'AUTOPISTA';'Gastos_Ocio y transporte';'Parking y peaje';'VARIABLES'
27/06/2013;27/06/2013;'AUTOPISTA TERR';-1,25 €;8.617,54 €;3825;-1,25;13.141,63 €;'sin fechas';27/06/2013;'AUTOPISTA';'Gastos_Ocio y transporte';'Parking y peaje';'VARIABLES'
27/06/2013;27/06/2013;'AUTOPISTA TERR';-1,39 €;8.616,15 €;3826;-1,39;13.140,24 €;'sin fechas';27/06/2013;'AUTOPISTA';'Gastos_Ocio y transporte';'Parking y peaje';'VARIABLES'
27/06/2013;27/06/2013;'AUTOPISTA TERR';-1,25 €;8.614,90 €;3827;-1,25;13.138,99 €;'sin fechas';27/06/2013;'AUTOPISTA';'Gastos_Ocio y transporte';'Parking y peaje';'VARIABLES'
27/06/2013;27/06/2013;'AUTOPISTA TERR';-1,39 €;8.613,51 €;3828;-1,39;13.137,60 €;'sin fechas';27/06/2013;'AUTOPISTA';'Gastos_Ocio y transporte';'Parking y peaje';'VARIABLES'
27/06/2013;27/06/2013;'HOGAR&OTROS';-14,25 €;8.599,26 €;3829;-14,25;13.123,35 €;'sin fechas';27/06/2013;'HOGAROTROS';'Gastos_Vivienda y vehiculo';'Otros vivienda';'VARIABLES'
28/06/2013;28/06/2013;'AJUNTAMENT DE TER 850000031046';-44,24 €;8.555,02 €;3830;-44,24;13.079,11 €;'sin fechas';28/06/2013;'AJUNTAMENT';'Gastos_Banco y organismos';'Ayuntamiento';'FIJO'
28/06/2013;28/06/2013;'AUTOPISTA TERR';-4,20 €;8.550,82 €;3831;-4,20;13.074,91 €;'sin fechas';28/06/2013;'AUTOPISTA';'Gastos_Ocio y transporte';'Parking y peaje';'VARIABLES'
28/06/2013;28/06/2013;'AUTOPISTA TERR';-1,25 €;8.549,57 €;3832;-1,25;13.073,66 €;'sin fechas';28/06/2013;'AUTOPISTA';'Gastos_Ocio y transporte';'Parking y peaje';'VARIABLES'
28/06/2013;28/06/2013;'AUTOPISTA TERR';-1,39 €;8.548,18 €;3833;-1,39;13.072,27 €;'sin fechas';28/06/2013;'AUTOPISTA';'Gastos_Ocio y transporte';'Parking y peaje';'VARIABLES'
28/06/2013;28/06/2013;'CAFET.C T PRAT';-3,60 €;8.544,58 €;3834;-3,60;13.068,67 €;'sin fechas';28/06/2013;'CAFETC';'Gastos_Ocio y transporte';'Restaurantes';'VARIABLES'
28/06/2013;28/06/2013;'INFORMACIO I TECNOLOGIA DE CAT';1.579,09 €;10.123,67 €;3835;1.579,09;14.647,76 €;'sin fechas';28/06/2013;'INFORMACIO';'Ingresos';'Nomina';'FIJO'
28/06/2013;28/06/2013;'REINT.CAJERO';-110,00 €;10.013,67 €;3837;-110,00;14.537,76 €;'sin fechas';28/06/2013;'REINTCAJERO';'Gastos_Gastos varios';'Efectivo';'VARIABLES'
28/06/2013;28/06/2013;'SATSA PL. VELLA TERRASSA';-1,10 €;10.012,57 €;3838;-1,10;14.536,66 €;'sin fechas';28/06/2013;'SATSA';'Gastos_Ocio y transporte';'Parking y peaje';'VARIABLES'
29/06/2013;29/06/2013;'CAPRABO';-31,93 €;9.980,64 €;3839;-31,93;14.504,73 €;'sin fechas';29/06/2013;'CAPRABO';'Gastos_Compras';'Supermercado';'VARIABLES'
29/06/2013;29/06/2013;'ES STA. MARGARITA';-51,05 €;9.929,59 €;3840;-51,05;14.453,68 €;'sin fechas';29/06/2013;'STA';'Gastos_Ocio y transporte';'Gasolina';'VARIABLES'
29/06/2013;29/06/2013;'IKEA';-5,29 €;9.924,30 €;3841;-5,29;14.448,39 €;'sin fechas';29/06/2013;'IKEA';'Gastos_Vivienda y vehiculo';'Mnto. hogar';'VARIABLES'
30/06/2013;30/06/2013;'AKI 104 - TERRASSA';-17,95 €;9.906,35 €;3842;-17,95;14.430,44 €;'sin fechas';30/06/2013;'AKI';'Gastos_Vivienda y vehiculo';'Mnto. hogar';'VARIABLES'
30/06/2013;30/06/2013;'CARREFOUR-[OTROS]';-25,55 €;9.880,80 €;3843;-25,55;14.404,89 €;'sin fechas';30/06/2013;'CARREFOUROTROS';'Gastos_Compras';'Supermercado';'VARIABLES'
30/06/2013;30/06/2013;'RECIBO PTMOS. 3061-0960001518';-562,73 €;9.318,07 €;3844;-562,73;13.842,16 €;'sin fechas';30/06/2013;'RECIBO';'Gastos_Banco y organismos';'Hipoteca';'FIJO'
01/07/2013;01/07/2013;'ADESLAS CENTRAL 006662671613';-110,65 €;9.207,42 €;3845;-110,65;13.731,51 €;'sin fechas';01/07/2013;'ADESLAS';'Gastos_Salud, saber y deporte';'Medico';'VARIABLES'
01/07/2013;01/07/2013;'CARREFOUR-[MODA]';-36,19 €;9.171,23 €;3846;-36,19;13.695,32 €;'sin fechas';01/07/2013;'CARREFOURMODA';'Gastos_Compras';'Supermercado';'VARIABLES'
01/07/2013;01/07/2013;'RESTAURANTES';-43,20 €;9.128,03 €;3849;-43,20;13.652,12 €;'sin fechas';01/07/2013;'RESTAURANTES';'Gastos_Ocio y transporte';'Restaurantes';'VARIABLES'
01/07/2013;01/07/2013;'RESTAURANTES';-17,50 €;9.110,53 €;3850;-17,50;13.634,62 €;'sin fechas';01/07/2013;'RESTAURANTES';'Gastos_Ocio y transporte';'Restaurantes';'VARIABLES'
01/07/2013;01/07/2013;'RESTAURANTES';-11,45 €;9.099,08 €;3851;-11,45;13.623,17 €;'sin fechas';01/07/2013;'RESTAURANTES';'Gastos_Ocio y transporte';'Restaurantes';'VARIABLES'
02/07/2013;02/07/2013;'AUTOPISTA TERR';-4,20 €;9.094,88 €;3852;-4,20;13.618,97 €;'sin fechas';02/07/2013;'AUTOPISTA';'Gastos_Ocio y transporte';'Parking y peaje';'VARIABLES'
02/07/2013;02/07/2013;'AUTOPISTA TERR';-1,39 €;9.093,49 €;3853;-1,39;13.617,58 €;'sin fechas';02/07/2013;'AUTOPISTA';'Gastos_Ocio y transporte';'Parking y peaje';'VARIABLES'
02/07/2013;02/07/2013;'AUTOPISTA TERR';-1,39 €;9.092,10 €;3854;-1,39;13.616,19 €;'sin fechas';02/07/2013;'AUTOPISTA';'Gastos_Ocio y transporte';'Parking y peaje';'VARIABLES'
02/07/2013;02/07/2013;'BON AREA';-23,81 €;9.068,29 €;3855;-23,81;13.592,38 €;'sin fechas';02/07/2013;'BON';'Gastos_Compras';'Supermercado';'VARIABLES'
02/07/2013;02/07/2013;'MERCADONA';-8,68 €;9.059,61 €;3856;-8,68;13.583,70 €;'sin fechas';02/07/2013;'MERCADONA';'Gastos_Compras';'Supermercado';'VARIABLES'
02/07/2013;02/07/2013;'MERCADONA';-153,08 €;8.906,53 €;3857;-153,08;13.430,62 €;'sin fechas';02/07/2013;'MERCADONA';'Gastos_Compras';'Supermercado';'VARIABLES'
03/07/2013;03/07/2013;'AUTOPISTA TERR';-1,39 €;8.905,14 €;3858;-1,39;13.429,23 €;'sin fechas';03/07/2013;'AUTOPISTA';'Gastos_Ocio y transporte';'Parking y peaje';'VARIABLES'
03/07/2013;03/07/2013;'KIABI.COM';-164,95 €;8.740,19 €;3859;-164,95;13.264,28 €;'sin fechas';03/07/2013;'KIABICOM';'Gastos_Compras';'Ropa';'VARIABLES'
04/07/2013;04/07/2013;'AUTOPISTA TERR';-4,20 €;8.735,99 €;3860;-4,20;13.260,08 €;'sin fechas';04/07/2013;'AUTOPISTA';'Gastos_Ocio y transporte';'Parking y peaje';'VARIABLES'
04/07/2013;04/07/2013;'AUTOPISTA TERR';-1,39 €;8.734,60 €;3861;-1,39;13.258,69 €;'sin fechas';04/07/2013;'AUTOPISTA';'Gastos_Ocio y transporte';'Parking y peaje';'VARIABLES'
04/07/2013;04/07/2013;'AUTOPISTA TERR';-1,39 €;8.733,21 €;3862;-1,39;13.257,30 €;'sin fechas';04/07/2013;'AUTOPISTA';'Gastos_Ocio y transporte';'Parking y peaje';'VARIABLES'
04/07/2013;04/07/2013;'CAFET.C T PRAT';-3,60 €;8.729,61 €;3863;-3,60;13.253,70 €;'sin fechas';04/07/2013;'CAFETC';'Gastos_Ocio y transporte';'Restaurantes';'VARIABLES'
04/07/2013;02/07/2013;'CARREFOUR-[COMIDA]';-3,25 €;8.726,36 €;3864;-3,25;13.250,45 €;'sin fechas';02/07/2013;'CARREFOURCOMIDA';'Gastos_Compras';'Supermercado';'VARIABLES'
04/07/2013;02/07/2013;'CARREFOUR-[OTROS]';-38,90 €;8.687,46 €;3865;-38,90;13.211,55 €;'sin fechas';02/07/2013;'CARREFOUROTROS';'Gastos_Compras';'Supermercado';'VARIABLES'
04/07/2013;02/07/2013;'COCHE&PARKING';-3,70 €;8.683,76 €;3866;-3,70;13.207,85 €;'sin fechas';02/07/2013;'COCHEPARKING';'Gastos_Ocio y transporte';'Parking y peaje';'VARIABLES'
04/07/2013;03/07/2013;'HOGAR&OTROS';-17,25 €;8.666,51 €;3867;-17,25;13.190,60 €;'sin fechas';03/07/2013;'HOGAROTROS';'Gastos_Vivienda y vehiculo';'Otros vivienda';'VARIABLES'
04/07/2013;03/07/2013;'RESTAURANTES';-16,75 €;8.649,76 €;3868;-16,75;13.173,85 €;'sin fechas';03/07/2013;'RESTAURANTES';'Gastos_Ocio y transporte';'Restaurantes';'VARIABLES'
04/07/2013;02/07/2013;'RESTAURANTES';-61,80 €;8.587,96 €;3869;-61,80;13.112,05 €;'sin fechas';02/07/2013;'RESTAURANTES';'Gastos_Ocio y transporte';'Restaurantes';'VARIABLES'
04/07/2013;02/07/2013;'VIENA';-15,05 €;8.572,91 €;3870;-15,05;13.097,00 €;'sin fechas';02/07/2013;'VIENA';'Gastos_Ocio y transporte';'Restaurantes';'VARIABLES'
04/07/2013;30/06/2013;'YOIGO';-44,91 €;8.528,00 €;3872;-44,91;13.052,09 €;'sin fechas';30/06/2013;'YOIGO';'Gastos_Servicios tipicos';'Telecomunicaciones';'FIJO'
05/07/2013;05/07/2013;'AUTOPISTA TERR';-1,39 €;8.526,61 €;3873;-1,39;13.050,70 €;'sin fechas';05/07/2013;'AUTOPISTA';'Gastos_Ocio y transporte';'Parking y peaje';'VARIABLES'
05/07/2013;05/07/2013;'AUTOPISTA TERR';-1,39 €;8.525,22 €;3874;-1,39;13.049,31 €;'sin fechas';05/07/2013;'AUTOPISTA';'Gastos_Ocio y transporte';'Parking y peaje';'VARIABLES'
05/07/2013;05/07/2013;'COCHE&OTROS';-70,00 €;8.455,22 €;3875;-70,00;12.979,31 €;'sin fechas';05/07/2013;'COCHEOTROS';'Gastos_Vivienda y vehiculo';'Otros vehiculo';'VARIABLE'
05/07/2013;05/07/2013;'COCHE&OTROS';-22,90 €;8.432,32 €;3876;-22,90;12.956,41 €;'sin fechas';05/07/2013;'COCHEOTROS';'Gastos_Vivienda y vehiculo';'Otros vehiculo';'VARIABLE'
05/07/2013;05/07/2013;'COCHE&PARKING';-1,70 €;8.430,62 €;3877;-1,70;12.954,71 €;'sin fechas';05/07/2013;'COCHEPARKING';'Gastos_Ocio y transporte';'Parking y peaje';'VARIABLES'
05/07/2013;05/07/2013;'HOGAR&OTROS';-20,00 €;8.410,62 €;3879;-20,00;12.934,71 €;'sin fechas';05/07/2013;'HOGAROTROS';'Gastos_Vivienda y vehiculo';'Otros vivienda';'VARIABLES'
06/07/2013;06/07/2013;'CARREFOUR-[MODA]';-65,05 €;8.345,57 €;3880;-65,05;12.869,66 €;'sin fechas';06/07/2013;'CARREFOURMODA';'Gastos_Compras';'Supermercado';'VARIABLES'
06/07/2013;06/07/2013;'DECATHLON';-20,89 €;8.324,68 €;3881;-20,89;12.848,77 €;'sin fechas';06/07/2013;'DECATHLON';'Gastos_Compras';'Deportivo';'VARIABLES'
06/07/2013;06/07/2013;'RESTAURANTES';-5,65 €;8.319,03 €;3882;-5,65;12.843,12 €;'sin fechas';06/07/2013;'RESTAURANTES';'Gastos_Ocio y transporte';'Restaurantes';'VARIABLES'
07/07/2013;07/07/2013;'BON AREA';-1,83 €;8.317,20 €;3883;-1,83;12.841,29 €;'sin fechas';07/07/2013;'BON';'Gastos_Compras';'Supermercado';'VARIABLES'
07/07/2013;07/07/2013;'CAFET.C T PRAT';-4,25 €;8.312,95 €;3884;-4,25;12.837,04 €;'sin fechas';07/07/2013;'CAFETC';'Gastos_Ocio y transporte';'Restaurantes';'VARIABLES'
08/07/2013;08/07/2013;'AUTOPISTA TERR';-1,32 €;8.311,63 €;3885;-1,32;12.835,72 €;'sin fechas';08/07/2013;'AUTOPISTA';'Gastos_Ocio y transporte';'Parking y peaje';'VARIABLES'
08/07/2013;08/07/2013;'AUTOPISTA TERR';-1,32 €;8.310,31 €;3886;-1,32;12.834,40 €;'sin fechas';08/07/2013;'AUTOPISTA';'Gastos_Ocio y transporte';'Parking y peaje';'VARIABLES'
08/07/2013;08/07/2013;'CAFET.C T PRAT';-3,60 €;8.306,71 €;3887;-3,60;12.830,80 €;'sin fechas';08/07/2013;'CAFETC';'Gastos_Ocio y transporte';'Restaurantes';'VARIABLES'
08/07/2013;08/07/2013;'CAFET.C T PRAT';-3,60 €;8.303,11 €;3888;-3,60;12.827,20 €;'sin fechas';08/07/2013;'CAFETC';'Gastos_Ocio y transporte';'Restaurantes';'VARIABLES'
08/07/2013;08/07/2013;'M&S';-20,00 €;8.283,11 €;3889;-20,00;12.807,20 €;'sin fechas';08/07/2013;'MS';'Gastos_Compras';'Ropa';'VARIABLES'
08/07/2013;08/07/2013;'REINT.CAJERO';-110,00 €;8.173,11 €;3890;-110,00;12.697,20 €;'sin fechas';08/07/2013;'REINTCAJERO';'Gastos_Gastos varios';'Efectivo';'VARIABLES'
09/07/2013;09/07/2013;'AUTOPISTA TERR';-1,32 €;8.171,79 €;3891;-1,32;12.695,88 €;'sin fechas';09/07/2013;'AUTOPISTA';'Gastos_Ocio y transporte';'Parking y peaje';'VARIABLES'
09/07/2013;09/07/2013;'AUTOPISTA TERR';-1,32 €;8.170,47 €;3892;-1,32;12.694,56 €;'sin fechas';09/07/2013;'AUTOPISTA';'Gastos_Ocio y transporte';'Parking y peaje';'VARIABLES'
09/07/2013;09/07/2013;'ESCOLA BRESSOL EINA';-333,97 €;7.836,50 €;3895;-333,97;12.360,59 €;'sin fechas';09/07/2013;'ESCOLA';'Gastos_Salud, saber y deporte';'Estudios';'VARIABLES'
09/07/2013;09/07/2013;'ESCOLA BRESSOL EINA';-303,07 €;7.533,43 €;3896;-303,07;12.057,52 €;'sin fechas';09/07/2013;'ESCOLA';'Gastos_Salud, saber y deporte';'Estudios';'VARIABLES'
10/07/2013;10/07/2013;'AUTOPISTA TERR';-1,32 €;7.532,11 €;3897;-1,32;12.056,20 €;'sin fechas';10/07/2013;'AUTOPISTA';'Gastos_Ocio y transporte';'Parking y peaje';'VARIABLES'
11/07/2013;11/07/2013;'AUTOPISTA TERR';-1,25 €;7.530,86 €;3899;-1,25;12.054,95 €;'sin fechas';11/07/2013;'AUTOPISTA';'Gastos_Ocio y transporte';'Parking y peaje';'VARIABLES'
11/07/2013;11/07/2013;'AUTOPISTA TERR';-1,25 €;7.529,61 €;3900;-1,25;12.053,70 €;'sin fechas';11/07/2013;'AUTOPISTA';'Gastos_Ocio y transporte';'Parking y peaje';'VARIABLES'
11/07/2013;09/07/2013;'ES STA. MARGARITA';-49,88 €;7.479,73 €;3901;-49,88;12.003,82 €;'sin fechas';09/07/2013;'STA';'Gastos_Ocio y transporte';'Gasolina';'VARIABLES'
11/07/2013;10/07/2013;'HOGAR&OTROS';-15,95 €;7.463,78 €;3902;-15,95;11.987,87 €;'sin fechas';10/07/2013;'HOGAROTROS';'Gastos_Vivienda y vehiculo';'Otros vivienda';'VARIABLES'
11/07/2013;10/07/2013;'LA BRASA';-7,50 €;7.456,28 €;3903;-7,50;11.980,37 €;'sin fechas';10/07/2013;'BRASA';'Gastos_Ocio y transporte';'Restaurantes';'VARIABLES'
11/07/2013;11/07/2013;'RESTAURANTES';-4,65 €;7.451,63 €;3904;-4,65;11.975,72 €;'sin fechas';11/07/2013;'RESTAURANTES';'Gastos_Ocio y transporte';'Restaurantes';'VARIABLES'
11/07/2013;09/07/2013;'RESTAURANTES';-31,20 €;7.420,43 €;3905;-31,20;11.944,52 €;'sin fechas';09/07/2013;'RESTAURANTES';'Gastos_Ocio y transporte';'Restaurantes';'VARIABLES'
11/07/2013;11/07/2013;'TOCINERIES VENTURA';-11,28 €;7.409,15 €;3906;-11,28;11.933,24 €;'sin fechas';11/07/2013;'TOCINERIES';'Gastos_Compras';'Supermercado';'VARIABLES'
11/07/2013;11/07/2013;'VIENA';-16,15 €;7.393,00 €;3907;-16,15;11.917,09 €;'sin fechas';11/07/2013;'VIENA';'Gastos_Ocio y transporte';'Restaurantes';'VARIABLES'
12/07/2013;12/07/2013;'AUTOPISTA TERR';-1,25 €;7.391,75 €;3908;-1,25;11.915,84 €;'sin fechas';12/07/2013;'AUTOPISTA';'Gastos_Ocio y transporte';'Parking y peaje';'VARIABLES'
12/07/2013;12/07/2013;'CAFET.C T PRAT';-4,75 €;7.387,00 €;3909;-4,75;11.911,09 €;'sin fechas';12/07/2013;'CAFETC';'Gastos_Ocio y transporte';'Restaurantes';'VARIABLES'
12/07/2013;12/07/2013;'MERCADONA';-5,79 €;7.381,21 €;3910;-5,79;11.905,30 €;'sin fechas';12/07/2013;'MERCADONA';'Gastos_Compras';'Supermercado';'VARIABLES'
12/07/2013;12/07/2013;'RESTAURANTES';-17,00 €;7.364,21 €;3911;-17,00;11.888,30 €;'sin fechas';12/07/2013;'RESTAURANTES';'Gastos_Ocio y transporte';'Restaurantes';'VARIABLES'
12/07/2013;12/07/2013;'RESTAURANTES';-10,00 €;7.354,21 €;3912;-10,00;11.878,30 €;'sin fechas';12/07/2013;'RESTAURANTES';'Gastos_Ocio y transporte';'Restaurantes';'VARIABLES'
13/07/2013;13/07/2013;'A.C.E.S.A B.MART.-L.SAP7S';-10,45 €;7.343,76 €;3913;-10,45;11.867,85 €;'sin fechas';13/07/2013;'ACESA';'Gastos_Ocio y transporte';'Parking y peaje';'VARIABLES'
13/07/2013;13/07/2013;'AUTOPISTA TERR';-7,00 €;7.336,76 €;3914;-7,00;11.860,85 €;'sin fechas';13/07/2013;'AUTOPISTA';'Gastos_Ocio y transporte';'Parking y peaje';'VARIABLES'
13/07/2013;13/07/2013;'AUTOPISTA TERR';-2,53 €;7.334,23 €;3915;-2,53;11.858,32 €;'sin fechas';13/07/2013;'AUTOPISTA';'Gastos_Ocio y transporte';'Parking y peaje';'VARIABLES'
13/07/2013;13/07/2013;'CAFET.C T PRAT';-3,60 €;7.330,63 €;3916;-3,60;11.854,72 €;'sin fechas';13/07/2013;'CAFETC';'Gastos_Ocio y transporte';'Restaurantes';'VARIABLES'
13/07/2013;13/07/2013;'ES STA. MARGARITA';-31,16 €;7.299,47 €;3917;-31,16;11.823,56 €;'sin fechas';13/07/2013;'STA';'Gastos_Ocio y transporte';'Gasolina';'VARIABLES'
14/07/2013;14/07/2013;'A.C.E.S.A LSCAP7S.-B.MART';-10,45 €;7.289,02 €;3918;-10,45;11.813,11 €;'sin fechas';14/07/2013;'ACESA';'Gastos_Ocio y transporte';'Parking y peaje';'VARIABLES'
14/07/2013;14/07/2013;'AUTOPISTA TERR';-7,00 €;7.282,02 €;3919;-7,00;11.806,11 €;'sin fechas';14/07/2013;'AUTOPISTA';'Gastos_Ocio y transporte';'Parking y peaje';'VARIABLES'
14/07/2013;14/07/2013;'AUTOPISTA TERR';-2,53 €;7.279,49 €;3920;-2,53;11.803,58 €;'sin fechas';14/07/2013;'AUTOPISTA';'Gastos_Ocio y transporte';'Parking y peaje';'VARIABLES'
14/07/2013;14/07/2013;'CAFET.C T PRAT';-4,75 €;7.274,74 €;3921;-4,75;11.798,83 €;'sin fechas';14/07/2013;'CAFETC';'Gastos_Ocio y transporte';'Restaurantes';'VARIABLES'
15/07/2013;15/07/2013;'AUTOPISTA TERR';-1,25 €;7.273,49 €;3922;-1,25;11.797,58 €;'sin fechas';15/07/2013;'AUTOPISTA';'Gastos_Ocio y transporte';'Parking y peaje';'VARIABLES'
15/07/2013;15/07/2013;'AUTOPISTA TERR';-1,39 €;7.272,10 €;3923;-1,39;11.796,19 €;'sin fechas';15/07/2013;'AUTOPISTA';'Gastos_Ocio y transporte';'Parking y peaje';'VARIABLES'
15/07/2013;15/07/2013;'CAFET.C T PRAT';-3,85 €;7.268,25 €;3924;-3,85;11.792,34 €;'sin fechas';15/07/2013;'CAFETC';'Gastos_Ocio y transporte';'Restaurantes';'VARIABLES'
15/07/2013;15/07/2013;'CCM VIDA Y P SEGURO PRESTAMO';-24,72 €;7.243,53 €;3925;-24,72;11.767,62 €;'sin fechas';15/07/2013;'CCM';'Gastos_Seguros';'Seguro vida';'FIJO'
15/07/2013;15/07/2013;'CCM VIDA Y PENSIO 000000493358';-18,27 €;7.225,26 €;3926;-18,27;11.749,35 €;'sin fechas';15/07/2013;'CCM';'Gastos_Seguros';'Seguro vida';'FIJO'
15/07/2013;15/07/2013;'REINT.CAJERO';-100,00 €;7.125,26 €;3927;-100,00;11.649,35 €;'sin fechas';15/07/2013;'REINTCAJERO';'Gastos_Gastos varios';'Efectivo';'VARIABLES'
16/07/2013;16/07/2013;'AUTOPISTA TERR';-1,25 €;7.124,01 €;3928;-1,25;11.648,10 €;'sin fechas';16/07/2013;'AUTOPISTA';'Gastos_Ocio y transporte';'Parking y peaje';'VARIABLES'
16/07/2013;16/07/2013;'AUTOPISTA TERR';-1,39 €;7.122,62 €;3929;-1,39;11.646,71 €;'sin fechas';16/07/2013;'AUTOPISTA';'Gastos_Ocio y transporte';'Parking y peaje';'VARIABLES'
16/07/2013;16/07/2013;'BLITZ';-72,50 €;7.050,12 €;3931;-72,50;11.574,21 €;'sin fechas';16/07/2013;'BLITZ';'Gastos_Vivienda y vehiculo';'Alquiler Parking';'FIJO'
16/07/2013;16/07/2013;'INFORMACIO I TECNOLOGIA DE CAT';1.724,25 €;8.774,37 €;3932;1.724,25;13.298,46 €;'sin fechas';16/07/2013;'INFORMACIO';'Ingresos';'Nomina';'FIJO'
16/07/2013;16/07/2013;'REINT.CAJERO';-100,00 €;8.674,37 €;3934;-100,00;13.198,46 €;'sin fechas';16/07/2013;'REINTCAJERO';'Gastos_Gastos varios';'Efectivo';'VARIABLES'
16/07/2013;16/07/2013;'TABASA BCN SUD C:2T';-4,20 €;8.670,17 €;3935;-4,20;13.194,26 €;'sin fechas';16/07/2013;'TABASA';'Gastos_Ocio y transporte';'Parking y peaje';'VARIABLES'
17/07/2013;17/07/2013;'AUTOPISTA TERR';-1,39 €;8.668,78 €;3936;-1,39;13.192,87 €;'sin fechas';17/07/2013;'AUTOPISTA';'Gastos_Ocio y transporte';'Parking y peaje';'VARIABLES'
17/07/2013;17/07/2013;'TABASA BCN SUD C:2T';-4,20 €;8.664,58 €;3937;-4,20;13.188,67 €;'sin fechas';17/07/2013;'TABASA';'Gastos_Ocio y transporte';'Parking y peaje';'VARIABLES'
18/07/2013;18/07/2013;'AUTOPISTA TERR';-1,25 €;8.663,33 €;3938;-1,25;13.187,42 €;'sin fechas';18/07/2013;'AUTOPISTA';'Gastos_Ocio y transporte';'Parking y peaje';'VARIABLES'
18/07/2013;18/07/2013;'AUTOPISTA TERR';-1,39 €;8.661,94 €;3939;-1,39;13.186,03 €;'sin fechas';18/07/2013;'AUTOPISTA';'Gastos_Ocio y transporte';'Parking y peaje';'VARIABLES'
18/07/2013;18/07/2013;'CAFET.C T PRAT';-3,85 €;8.658,09 €;3940;-3,85;13.182,18 €;'sin fechas';18/07/2013;'CAFETC';'Gastos_Ocio y transporte';'Restaurantes';'VARIABLES'
18/07/2013;18/07/2013;'ONO';-89,42 €;8.568,67 €;3942;-89,42;13.092,76 €;'sin fechas';18/07/2013;'ONO';'Gastos_Servicios tipicos';'Telecomunicaciones';'FIJO'
19/07/2013;19/07/2013;'A.C.E.S.A A.VENDR.-LSAP7S';-4,90 €;8.563,77 €;3943;-4,90;13.087,86 €;'sin fechas';19/07/2013;'ACESA';'Gastos_Ocio y transporte';'Parking y peaje';'VARIABLES'
19/07/2013;19/07/2013;'AUTOPISTA TERR';-3,84 €;8.559,93 €;3944;-3,84;13.084,02 €;'sin fechas';19/07/2013;'AUTOPISTA';'Gastos_Ocio y transporte';'Parking y peaje';'VARIABLES'
19/07/2013;19/07/2013;'AUTOPISTA TERR';-6,42 €;8.553,51 €;3945;-6,42;13.077,60 €;'sin fechas';19/07/2013;'AUTOPISTA';'Gastos_Ocio y transporte';'Parking y peaje';'VARIABLES'
19/07/2013;19/07/2013;'AUTOPISTA TERR';-7,00 €;8.546,51 €;3946;-7,00;13.070,60 €;'sin fechas';19/07/2013;'AUTOPISTA';'Gastos_Ocio y transporte';'Parking y peaje';'VARIABLES'
19/07/2013;19/07/2013;'AUTOPISTA TERR';-1,39 €;8.545,12 €;3947;-1,39;13.069,21 €;'sin fechas';19/07/2013;'AUTOPISTA';'Gastos_Ocio y transporte';'Parking y peaje';'VARIABLES'
19/07/2013;19/07/2013;'CAFET.C T PRAT';-3,40 €;8.541,72 €;3948;-3,40;13.065,81 €;'sin fechas';19/07/2013;'CAFETC';'Gastos_Ocio y transporte';'Restaurantes';'VARIABLES'
19/07/2013;19/07/2013;'TABASA BCN SUD C:2T';-4,20 €;8.537,52 €;3949;-4,20;13.061,61 €;'sin fechas';19/07/2013;'TABASA';'Gastos_Ocio y transporte';'Parking y peaje';'VARIABLES'
20/07/2013;20/07/2013;'CAFET.C T PRAT';-3,80 €;8.533,72 €;3950;-3,80;13.057,81 €;'sin fechas';20/07/2013;'CAFETC';'Gastos_Ocio y transporte';'Restaurantes';'VARIABLES'
20/07/2013;20/07/2013;'MERCADONA';-154,98 €;8.378,74 €;3952;-154,98;12.902,83 €;'sin fechas';20/07/2013;'MERCADONA';'Gastos_Compras';'Supermercado';'VARIABLES'
20/07/2013;20/07/2013;'REINT.CAJERO';-100,00 €;8.278,74 €;3953;-100,00;12.802,83 €;'sin fechas';20/07/2013;'REINTCAJERO';'Gastos_Gastos varios';'Efectivo';'VARIABLES'
21/07/2013;21/07/2013;'CAFET.C T PRAT';-3,85 €;8.274,89 €;3954;-3,85;12.798,98 €;'sin fechas';21/07/2013;'CAFETC';'Gastos_Ocio y transporte';'Restaurantes';'VARIABLES'
21/07/2013;21/07/2013;'ES STA. MARGARITA';-48,22 €;8.226,67 €;3955;-48,22;12.750,76 €;'sin fechas';21/07/2013;'STA';'Gastos_Ocio y transporte';'Gasolina';'VARIABLES'
22/07/2013;22/07/2013;'CAFET.C T PRAT';-3,60 €;8.223,07 €;3956;-3,60;12.747,16 €;'sin fechas';22/07/2013;'CAFETC';'Gastos_Ocio y transporte';'Restaurantes';'VARIABLES'
24/07/2013;24/07/2013;'DECATHLON';-41,82 €;8.181,25 €;3957;-41,82;12.705,34 €;'sin fechas';24/07/2013;'DECATHLON';'Gastos_Compras';'Deportivo';'VARIABLES'
24/07/2013;24/07/2013;'MERCADONA';-42,89 €;8.138,36 €;3958;-42,89;12.662,45 €;'sin fechas';24/07/2013;'MERCADONA';'Gastos_Compras';'Supermercado';'VARIABLES'
24/07/2013;24/07/2013;'PERRUQUERIA';-27,54 €;8.110,82 €;3959;-27,54;12.634,91 €;'sin fechas';24/07/2013;'PERRUQUERIA';'Gastos_Salud, saber y deporte';'Belleza';'VARIABLES'
24/07/2013;24/07/2013;'REINT.CAJERO';-300,00 €;7.810,82 €;3960;-300,00;12.334,91 €;'sin fechas';24/07/2013;'REINTCAJERO';'Gastos_Gastos varios';'Efectivo';'VARIABLES'
25/07/2013;25/07/2013;'OCIO&CINES';-23,20 €;7.787,62 €;3961;-23,20;12.311,71 €;'sin fechas';25/07/2013;'OCIOCINES';'Gastos_Ocio y transporte';'Espectáculos';'VARIABLES'
25/07/2013;25/07/2013;'SABECO';-6,86 €;7.780,76 €;3962;-6,86;12.304,85 €;'sin fechas';25/07/2013;'SABECO';'Gastos_Compras';'Supermercado';'VARIABLES'
26/07/2013;26/07/2013;'FOMENT DE TERRASSA, S.A. FOMEN';1.549,91 €;9.330,67 €;3963;1.549,91;13.854,76 €;'sin fechas';26/07/2013;'FOMENT';'Ingresos';'Nomina';'FIJO'
27/07/2013;29/07/2013;'INFORMACIO I TECNOLOGIA DE CAT';1.579,09 €;10.909,76 €;3964;1.579,09;15.433,85 €;'sin fechas';29/07/2013;'INFORMACIO';'Ingresos';'Nomina';'FIJO'
31/07/2013;31/07/2013;'AJUNTAMENT DE TER 850000031046';-49,40 €;10.860,36 €;3965;-49,40;15.384,45 €;'sin fechas';31/07/2013;'AJUNTAMENT';'Gastos_Banco y organismos';'Ayuntamiento';'FIJO'
31/07/2013;31/07/2013;'MERCADONA';-133,30 €;10.727,06 €;3969;-133,30;15.251,15 €;'sin fechas';31/07/2013;'MERCADONA';'Gastos_Compras';'Supermercado';'VARIABLES'
31/07/2013;31/07/2013;'RECIBO PTMOS. 3061-0960001518';-562,73 €;10.164,33 €;3970;-562,73;14.688,42 €;'sin fechas';31/07/2013;'RECIBO';'Gastos_Banco y organismos';'Hipoteca';'FIJO'
31/07/2013;31/07/2013;'SALA BADRINAS - AMPA';-30,00 €;10.134,33 €;3971;-30,00;14.658,42 €;'sin fechas';31/07/2013;'SALA';'Gastos_Salud, saber y deporte';'Estudios';'VARIABLES'
01/08/2013;01/08/2013;'ADESLAS CENTRAL 006662671613';-110,65 €;10.023,68 €;3972;-110,65;14.547,77 €;'sin fechas';01/08/2013;'ADESLAS';'Gastos_Salud, saber y deporte';'Medico';'VARIABLES'
01/08/2013;01/08/2013;'GAS NATURAL';-170,94 €;9.852,74 €;3977;-170,94;14.376,83 €;'sin fechas';01/08/2013;'GAS';'Gastos_Servicios tipicos';'Gas';'FIJO'
01/08/2013;01/08/2013;'OCIO&CINES';-17,40 €;9.835,34 €;3980;-17,40;14.359,43 €;'sin fechas';01/08/2013;'OCIOCINES';'Gastos_Ocio y transporte';'Espectáculos';'VARIABLES'
01/08/2013;30/07/2013;'OCIO&CINES';-16,20 €;9.819,14 €;3981;-16,20;14.343,23 €;'sin fechas';30/07/2013;'OCIOCINES';'Gastos_Ocio y transporte';'Espectáculos';'VARIABLES'
04/08/2013;04/08/2013;'FARMACIA';-11,71 €;9.807,43 €;3982;-11,71;14.331,52 €;'sin fechas';04/08/2013;'FARMACIA';'Gastos_Salud, saber y deporte';'Farmacia';'VARIABLES'
05/08/2013;05/08/2013;'BLITZ';-72,50 €;9.734,93 €;3983;-72,50;14.259,02 €;'sin fechas';05/08/2013;'BLITZ';'Gastos_Vivienda y vehiculo';'Alquiler Parking';'FIJO'
06/08/2013;31/07/2013;'YOIGO';-45,04 €;9.689,89 €;3986;-45,04;14.213,98 €;'sin fechas';31/07/2013;'YOIGO';'Gastos_Servicios tipicos';'Telecomunicaciones';'FIJO'
07/08/2013;07/08/2013;'DECATHLON';-20,73 €;9.669,16 €;3987;-20,73;14.193,25 €;'sin fechas';07/08/2013;'DECATHLON';'Gastos_Compras';'Deportivo';'VARIABLES'
07/08/2013;07/08/2013;'REINT.CAJERO';-100,00 €;9.569,16 €;3988;-100,00;14.093,25 €;'sin fechas';07/08/2013;'REINTCAJERO';'Gastos_Gastos varios';'Efectivo';'VARIABLES'
08/08/2013;07/08/2013;'FARMACIA';-28,95 €;9.540,21 €;3989;-28,95;14.064,30 €;'sin fechas';07/08/2013;'FARMACIA';'Gastos_Salud, saber y deporte';'Farmacia';'VARIABLES'
10/08/2013;10/08/2013;'ES STA. MARGARITA';-52,01 €;9.488,20 €;3991;-52,01;14.012,29 €;'sin fechas';10/08/2013;'STA';'Gastos_Ocio y transporte';'Gasolina';'VARIABLES'
11/08/2013;11/08/2013;'A.C.E.S.A LSCAP7S.-B.MART';-10,45 €;9.477,75 €;3992;-10,45;14.001,84 €;'sin fechas';11/08/2013;'ACESA';'Gastos_Ocio y transporte';'Parking y peaje';'VARIABLES'
11/08/2013;11/08/2013;'AUTOPISTA TERR';-7,00 €;9.470,75 €;3993;-7,00;13.994,84 €;'sin fechas';11/08/2013;'AUTOPISTA';'Gastos_Ocio y transporte';'Parking y peaje';'VARIABLES'
11/08/2013;11/08/2013;'AUTOPISTA TERR';-2,53 €;9.468,22 €;3994;-2,53;13.992,31 €;'sin fechas';11/08/2013;'AUTOPISTA';'Gastos_Ocio y transporte';'Parking y peaje';'VARIABLES'
11/08/2013;11/08/2013;'SABECO';-42,83 €;9.425,39 €;3995;-42,83;13.949,48 €;'sin fechas';11/08/2013;'SABECO';'Gastos_Compras';'Supermercado';'VARIABLES'
11/08/2013;11/08/2013;'WWW.JUST-EAT.ES';-20,75 €;9.404,64 €;3996;-20,75;13.928,73 €;'sin fechas';11/08/2013;'WWWJUSTEATES';'Gastos_Ocio y transporte';'Restaurantes';'VARIABLES'
12/08/2013;12/08/2013;'AUTOPISTA TERR';-1,39 €;9.403,25 €;3997;-1,39;13.927,34 €;'sin fechas';12/08/2013;'AUTOPISTA';'Gastos_Ocio y transporte';'Parking y peaje';'VARIABLES'
12/08/2013;12/08/2013;'AUTOPISTA TERR';-1,39 €;9.401,86 €;3998;-1,39;13.925,95 €;'sin fechas';12/08/2013;'AUTOPISTA';'Gastos_Ocio y transporte';'Parking y peaje';'VARIABLES'
12/08/2013;12/08/2013;'EMTE SERVICE, S.A.U, 1112298';-73,33 €;9.328,53 €;3999;-73,33;13.852,62 €;'sin fechas';12/08/2013;'EMTE';'Gastos_Servicios tipicos';'Otros servicios';'VARIABLES'
12/08/2013;12/08/2013;'MERCADONA';-222,26 €;9.106,27 €;4000;-222,26;13.630,36 €;'sin fechas';12/08/2013;'MERCADONA';'Gastos_Compras';'Supermercado';'VARIABLES'
13/08/2013;13/08/2013;'AUTOPISTA TERR';-1,39 €;9.104,88 €;4001;-1,39;13.628,97 €;'sin fechas';13/08/2013;'AUTOPISTA';'Gastos_Ocio y transporte';'Parking y peaje';'VARIABLES'
13/08/2013;13/08/2013;'AUTOPISTA TERR';-1,39 €;9.103,49 €;4002;-1,39;13.627,58 €;'sin fechas';13/08/2013;'AUTOPISTA';'Gastos_Ocio y transporte';'Parking y peaje';'VARIABLES'
14/08/2013;14/08/2013;'AUTOPISTA TERR';-1,39 €;9.102,10 €;4003;-1,39;13.626,19 €;'sin fechas';14/08/2013;'AUTOPISTA';'Gastos_Ocio y transporte';'Parking y peaje';'VARIABLES'
14/08/2013;14/08/2013;'AUTOPISTA TERR';-1,39 €;9.100,71 €;4004;-1,39;13.624,80 €;'sin fechas';14/08/2013;'AUTOPISTA';'Gastos_Ocio y transporte';'Parking y peaje';'VARIABLES'
15/08/2013;15/08/2013;'CAFET.C T PRAT';-3,50 €;9.097,21 €;4005;-3,50;13.621,30 €;'sin fechas';15/08/2013;'CAFETC';'Gastos_Ocio y transporte';'Restaurantes';'VARIABLES'
16/08/2013;16/08/2013;'AKI 104 - TERRASSA';-6,95 €;9.090,26 €;4006;-6,95;13.614,35 €;'sin fechas';16/08/2013;'AKI';'Gastos_Vivienda y vehiculo';'Mnto. hogar';'VARIABLES'
16/08/2013;16/08/2013;'AUTOPISTA TERR';-1,39 €;9.088,87 €;4007;-1,39;13.612,96 €;'sin fechas';16/08/2013;'AUTOPISTA';'Gastos_Ocio y transporte';'Parking y peaje';'VARIABLES'
16/08/2013;16/08/2013;'AUTOPISTA TERR';-1,39 €;9.087,48 €;4008;-1,39;13.611,57 €;'sin fechas';16/08/2013;'AUTOPISTA';'Gastos_Ocio y transporte';'Parking y peaje';'VARIABLES'
16/08/2013;16/08/2013;'CAFET.C T PRAT';-3,55 €;9.083,93 €;4009;-3,55;13.608,02 €;'sin fechas';16/08/2013;'CAFETC';'Gastos_Ocio y transporte';'Restaurantes';'VARIABLES'
16/08/2013;16/08/2013;'CCM VIDA Y P SEGURO PRESTAMO';-24,65 €;9.059,28 €;4010;-24,65;13.583,37 €;'sin fechas';16/08/2013;'CCM';'Gastos_Seguros';'Seguro vida';'FIJO'
16/08/2013;16/08/2013;'CCM VIDA Y PENSIO 000000493358';-18,22 €;9.041,06 €;4011;-18,22;13.565,15 €;'sin fechas';16/08/2013;'CCM';'Gastos_Seguros';'Seguro vida';'FIJO'
16/08/2013;16/08/2013;'FARMACIA';-3,48 €;9.037,58 €;4012;-3,48;13.561,67 €;'sin fechas';16/08/2013;'FARMACIA';'Gastos_Salud, saber y deporte';'Farmacia';'VARIABLES'
16/08/2013;16/08/2013;'REINT.CAJERO';-60,00 €;8.977,58 €;4013;-60,00;13.501,67 €;'sin fechas';16/08/2013;'REINTCAJERO';'Gastos_Gastos varios';'Efectivo';'VARIABLES'
16/08/2013;16/08/2013;'TRANSPORTS MUNICIP';-18,00 €;8.959,58 €;4014;-18,00;13.483,67 €;'sin fechas';16/08/2013;'TRANSPORTS';'Gastos_Ocio y transporte';'Transporte';'VARIABLES'
17/08/2013;17/08/2013;'CAFET.C T PRAT';-3,50 €;8.956,08 €;4015;-3,50;13.480,17 €;'sin fechas';17/08/2013;'CAFETC';'Gastos_Ocio y transporte';'Restaurantes';'VARIABLES'
17/08/2013;17/08/2013;'ES STA. MARGARITA';-30,00 €;8.926,08 €;4016;-30,00;13.450,17 €;'sin fechas';17/08/2013;'STA';'Gastos_Ocio y transporte';'Gasolina';'VARIABLES'
17/08/2013;17/08/2013;'GIFI';-13,49 €;8.912,59 €;4017;-13,49;13.436,68 €;'sin fechas';17/08/2013;'GIFI';'Gastos_Compras';'Hogar';'VARIABLES'
17/08/2013;17/08/2013;'VIENA';-11,25 €;8.901,34 €;4018;-11,25;13.425,43 €;'sin fechas';17/08/2013;'VIENA';'Gastos_Ocio y transporte';'Restaurantes';'VARIABLES'
18/08/2013;18/08/2013;'REINT.CAJERO';-100,00 €;8.801,34 €;4019;-100,00;13.325,43 €;'sin fechas';18/08/2013;'REINTCAJERO';'Gastos_Gastos varios';'Efectivo';'VARIABLES'
19/08/2013;19/08/2013;'AUTOPISTA TERR';-1,39 €;8.799,95 €;4020;-1,39;13.324,04 €;'sin fechas';19/08/2013;'AUTOPISTA';'Gastos_Ocio y transporte';'Parking y peaje';'VARIABLES'
19/08/2013;19/08/2013;'AUTOPISTA TERR';-1,39 €;8.798,56 €;4021;-1,39;13.322,65 €;'sin fechas';19/08/2013;'AUTOPISTA';'Gastos_Ocio y transporte';'Parking y peaje';'VARIABLES'
19/08/2013;19/08/2013;'CAFET.C T PRAT';-2,70 €;8.795,86 €;4022;-2,70;13.319,95 €;'sin fechas';19/08/2013;'CAFETC';'Gastos_Ocio y transporte';'Restaurantes';'VARIABLES'
19/08/2013;18/08/2013;'HOGAR&OTROS';-62,25 €;8.733,61 €;4023;-62,25;13.257,70 €;'sin fechas';18/08/2013;'HOGAROTROS';'Gastos_Vivienda y vehiculo';'Otros vivienda';'VARIABLES'
19/08/2013;19/08/2013;'ONO';-89,42 €;8.644,19 €;4024;-89,42;13.168,28 €;'sin fechas';19/08/2013;'ONO';'Gastos_Servicios tipicos';'Telecomunicaciones';'FIJO'
20/08/2013;20/08/2013;'AUTOPISTA TERR';-1,32 €;8.642,87 €;4025;-1,32;13.166,96 €;'sin fechas';20/08/2013;'AUTOPISTA';'Gastos_Ocio y transporte';'Parking y peaje';'VARIABLES'
20/08/2013;20/08/2013;'AUTOPISTA TERR';-1,39 €;8.641,48 €;4026;-1,39;13.165,57 €;'sin fechas';20/08/2013;'AUTOPISTA';'Gastos_Ocio y transporte';'Parking y peaje';'VARIABLES'
20/08/2013;20/08/2013;'FARMACIA';-7,91 €;8.633,57 €;4028;-7,91;13.157,66 €;'sin fechas';20/08/2013;'FARMACIA';'Gastos_Salud, saber y deporte';'Farmacia';'VARIABLES'
21/08/2013;21/08/2013;'AUTOPISTA TERR';-1,32 €;8.632,25 €;4030;-1,32;13.156,34 €;'sin fechas';21/08/2013;'AUTOPISTA';'Gastos_Ocio y transporte';'Parking y peaje';'VARIABLES'
21/08/2013;21/08/2013;'AUTOPISTA TERR';-1,39 €;8.630,86 €;4031;-1,39;13.154,95 €;'sin fechas';21/08/2013;'AUTOPISTA';'Gastos_Ocio y transporte';'Parking y peaje';'VARIABLES'
22/08/2013;22/08/2013;'AUTOPISTA TERR';-1,32 €;8.629,54 €;4032;-1,32;13.153,63 €;'sin fechas';22/08/2013;'AUTOPISTA';'Gastos_Ocio y transporte';'Parking y peaje';'VARIABLES'
22/08/2013;22/08/2013;'AUTOPISTA TERR';-1,39 €;8.628,15 €;4033;-1,39;13.152,24 €;'sin fechas';22/08/2013;'AUTOPISTA';'Gastos_Ocio y transporte';'Parking y peaje';'VARIABLES'
22/08/2013;17/08/2013;'AUTOPISTA TERR';-2,53 €;8.625,62 €;4034;-2,53;13.149,71 €;'sin fechas';17/08/2013;'AUTOPISTA';'Gastos_Ocio y transporte';'Parking y peaje';'VARIABLES'
22/08/2013;20/08/2013;'BURGUER KING';-14,80 €;8.610,82 €;4035;-14,80;13.134,91 €;'sin fechas';20/08/2013;'BURGUER';'Gastos_Ocio y transporte';'Restaurantes';'VARIABLES'
22/08/2013;22/08/2013;'CAFET.C T PRAT';-4,80 €;8.606,02 €;4036;-4,80;13.130,11 €;'sin fechas';22/08/2013;'CAFETC';'Gastos_Ocio y transporte';'Restaurantes';'VARIABLES'
22/08/2013;20/08/2013;'FARMACIA';-33,08 €;8.572,94 €;4037;-33,08;13.097,03 €;'sin fechas';20/08/2013;'FARMACIA';'Gastos_Salud, saber y deporte';'Farmacia';'VARIABLES'
22/08/2013;20/08/2013;'IKEA';-142,85 €;8.430,09 €;4038;-142,85;12.954,18 €;'sin fechas';20/08/2013;'IKEA';'Gastos_Vivienda y vehiculo';'Mnto. hogar';'VARIABLES'
22/08/2013;20/08/2013;'MERCADONA';-29,33 €;8.400,76 €;4039;-29,33;12.924,85 €;'sin fechas';20/08/2013;'MERCADONA';'Gastos_Compras';'Supermercado';'VARIABLES'
22/08/2013;20/08/2013;'VIENA';-15,45 €;8.385,31 €;4040;-15,45;12.909,40 €;'sin fechas';20/08/2013;'VIENA';'Gastos_Ocio y transporte';'Restaurantes';'VARIABLES'
23/08/2013;23/08/2013;'AUTOPISTA TERR';-1,32 €;8.383,99 €;4041;-1,32;12.908,08 €;'sin fechas';23/08/2013;'AUTOPISTA';'Gastos_Ocio y transporte';'Parking y peaje';'VARIABLES'
23/08/2013;23/08/2013;'AUTOPISTA TERR';-1,39 €;8.382,60 €;4042;-1,39;12.906,69 €;'sin fechas';23/08/2013;'AUTOPISTA';'Gastos_Ocio y transporte';'Parking y peaje';'VARIABLES'
23/08/2013;23/08/2013;'CAFET.C T PRAT';-3,50 €;8.379,10 €;4043;-3,50;12.903,19 €;'sin fechas';23/08/2013;'CAFETC';'Gastos_Ocio y transporte';'Restaurantes';'VARIABLES'
23/08/2013;23/08/2013;'ES STA. MARGARITA';-30,00 €;8.349,10 €;4044;-30,00;12.873,19 €;'sin fechas';23/08/2013;'STA';'Gastos_Ocio y transporte';'Gasolina';'VARIABLES'
24/08/2013;24/08/2013;'CAFET.C T PRAT';-4,20 €;8.344,90 €;4045;-4,20;12.868,99 €;'sin fechas';24/08/2013;'CAFETC';'Gastos_Ocio y transporte';'Restaurantes';'VARIABLES'
25/08/2013;25/08/2013;'CAFET.C T PRAT';-3,90 €;8.341,00 €;4046;-3,90;12.865,09 €;'sin fechas';25/08/2013;'CAFETC';'Gastos_Ocio y transporte';'Restaurantes';'VARIABLES'
26/08/2013;26/08/2013;'AUTOPISTA TERR';-1,32 €;8.339,68 €;4047;-1,32;12.863,77 €;'sin fechas';26/08/2013;'AUTOPISTA';'Gastos_Ocio y transporte';'Parking y peaje';'VARIABLES'
26/08/2013;26/08/2013;'AUTOPISTA TERR';-1,39 €;8.338,29 €;4048;-1,39;12.862,38 €;'sin fechas';26/08/2013;'AUTOPISTA';'Gastos_Ocio y transporte';'Parking y peaje';'VARIABLES'
26/08/2013;26/08/2013;'CAFET.C T PRAT';-4,95 €;8.333,34 €;4049;-4,95;12.857,43 €;'sin fechas';26/08/2013;'CAFETC';'Gastos_Ocio y transporte';'Restaurantes';'VARIABLES'
26/08/2013;26/08/2013;'ES STA. MARGARITA';-50,17 €;8.283,17 €;4050;-50,17;12.807,26 €;'sin fechas';26/08/2013;'STA';'Gastos_Ocio y transporte';'Gasolina';'VARIABLES'
26/08/2013;26/08/2013;'MERCADONA';-21,56 €;8.261,61 €;4051;-21,56;12.785,70 €;'sin fechas';26/08/2013;'MERCADONA';'Gastos_Compras';'Supermercado';'VARIABLES'
27/08/2013;27/08/2013;'AUTOPISTA TERR';-1,39 €;8.260,22 €;4052;-1,39;12.784,31 €;'sin fechas';27/08/2013;'AUTOPISTA';'Gastos_Ocio y transporte';'Parking y peaje';'VARIABLES'
28/08/2013;28/08/2013;'AUTOPISTA TERR';-1,25 €;8.258,97 €;4053;-1,25;12.783,06 €;'sin fechas';28/08/2013;'AUTOPISTA';'Gastos_Ocio y transporte';'Parking y peaje';'VARIABLES'
28/08/2013;28/08/2013;'AUTOPISTA TERR';-1,39 €;8.257,58 €;4054;-1,39;12.781,67 €;'sin fechas';28/08/2013;'AUTOPISTA';'Gastos_Ocio y transporte';'Parking y peaje';'VARIABLES'
28/08/2013;28/08/2013;'FOMENT DE TERRASSA, S.A. FOMEN';1.554,85 €;9.812,43 €;4055;1.554,85;14.336,52 €;'sin fechas';28/08/2013;'FOMENT';'Ingresos';'Nomina';'FIJO'
29/08/2013;29/08/2013;'AUTOPISTA TERR';-1,25 €;9.811,18 €;4056;-1,25;14.335,27 €;'sin fechas';29/08/2013;'AUTOPISTA';'Gastos_Ocio y transporte';'Parking y peaje';'VARIABLES'
29/08/2013;29/08/2013;'AUTOPISTA TERR';-1,39 €;9.809,79 €;4057;-1,39;14.333,88 €;'sin fechas';29/08/2013;'AUTOPISTA';'Gastos_Ocio y transporte';'Parking y peaje';'VARIABLES'
29/08/2013;29/08/2013;'CAFET.C T PRAT';-4,10 €;9.805,69 €;4058;-4,10;14.329,78 €;'sin fechas';29/08/2013;'CAFETC';'Gastos_Ocio y transporte';'Restaurantes';'VARIABLES'
29/08/2013;28/08/2013;'HOGAR&OTROS';-19,60 €;9.786,09 €;4059;-19,60;14.310,18 €;'sin fechas';28/08/2013;'HOGAROTROS';'Gastos_Vivienda y vehiculo';'Otros vivienda';'VARIABLES'
29/08/2013;27/08/2013;'IKEA';-99,40 €;9.686,69 €;4060;-99,40;14.210,78 €;'sin fechas';27/08/2013;'IKEA';'Gastos_Vivienda y vehiculo';'Mnto. hogar';'VARIABLES'
29/08/2013;29/08/2013;'INFORMACIO I TECNOLOGIA DE CAT';1.579,09 €;11.265,78 €;4061;1.579,09;15.789,87 €;'sin fechas';29/08/2013;'INFORMACIO';'Ingresos';'Nomina';'FIJO'
29/08/2013;29/08/2013;'MERCADONA';-3,92 €;11.261,86 €;4063;-3,92;15.785,95 €;'sin fechas';29/08/2013;'MERCADONA';'Gastos_Compras';'Supermercado';'VARIABLES'
29/08/2013;29/08/2013;'MERCADONA';-145,22 €;11.116,64 €;4064;-145,22;15.640,73 €;'sin fechas';29/08/2013;'MERCADONA';'Gastos_Compras';'Supermercado';'VARIABLES'
30/08/2013;30/08/2013;'AKI 104 - TERRASSA';-45,05 €;11.071,59 €;4065;-45,05;15.595,68 €;'sin fechas';30/08/2013;'AKI';'Gastos_Vivienda y vehiculo';'Mnto. hogar';'VARIABLES'
30/08/2013;30/08/2013;'AUTOPISTA TERR';-1,25 €;11.070,34 €;4066;-1,25;15.594,43 €;'sin fechas';30/08/2013;'AUTOPISTA';'Gastos_Ocio y transporte';'Parking y peaje';'VARIABLES'
30/08/2013;30/08/2013;'AUTOPISTA TERR';-1,39 €;11.068,95 €;4067;-1,39;15.593,04 €;'sin fechas';30/08/2013;'AUTOPISTA';'Gastos_Ocio y transporte';'Parking y peaje';'VARIABLES'
30/08/2013;30/08/2013;'CAFET.C T PRAT';-4,90 €;11.064,05 €;4068;-4,90;15.588,14 €;'sin fechas';30/08/2013;'CAFETC';'Gastos_Ocio y transporte';'Restaurantes';'VARIABLES'
30/08/2013;30/08/2013;'CARREFOUR-[OTROS]';-64,00 €;11.000,05 €;4069;-64,00;15.524,14 €;'sin fechas';30/08/2013;'CARREFOUROTROS';'Gastos_Compras';'Supermercado';'VARIABLES'
30/08/2013;23/08/2013;'COCHE&PARKING';-4,00 €;10.996,05 €;4070;-4,00;15.520,14 €;'sin fechas';23/08/2013;'COCHEPARKING';'Gastos_Ocio y transporte';'Parking y peaje';'VARIABLES'
30/08/2013;30/08/2013;'REINT.CAJERO';-40,00 €;10.956,05 €;4071;-40,00;15.480,14 €;'sin fechas';30/08/2013;'REINTCAJERO';'Gastos_Gastos varios';'Efectivo';'VARIABLES'
31/08/2013;31/08/2013;'CAFET.C T PRAT';-4,35 €;10.951,70 €;4072;-4,35;15.475,79 €;'sin fechas';31/08/2013;'CAFETC';'Gastos_Ocio y transporte';'Restaurantes';'VARIABLES'
31/08/2013;31/08/2013;'RECIBO PTMOS. 3061-0960001518';-562,73 €;10.388,97 €;4074;-562,73;14.913,06 €;'sin fechas';31/08/2013;'RECIBO';'Gastos_Banco y organismos';'Hipoteca';'FIJO'
31/08/2013;31/08/2013;'TOCINERIES VENTURA';-19,43 €;10.369,54 €;4075;-19,43;14.893,63 €;'sin fechas';31/08/2013;'TOCINERIES';'Gastos_Compras';'Supermercado';'VARIABLES'
31/08/2013;31/08/2013;'VIENA';-15,30 €;10.354,24 €;4076;-15,30;14.878,33 €;'sin fechas';31/08/2013;'VIENA';'Gastos_Ocio y transporte';'Restaurantes';'VARIABLES'
01/09/2013;01/09/2013;'CAFET.C T PRAT';-4,20 €;10.350,04 €;4077;-4,20;14.874,13 €;'sin fechas';01/09/2013;'CAFETC';'Gastos_Ocio y transporte';'Restaurantes';'VARIABLES'
02/09/2013;02/09/2013;'AUTOPISTA TERR';-1,39 €;10.348,65 €;4082;-1,39;14.872,74 €;'sin fechas';02/09/2013;'AUTOPISTA';'Gastos_Ocio y transporte';'Parking y peaje';'VARIABLES'
02/09/2013;02/09/2013;'AUTOPISTA TERR';-1,39 €;10.347,26 €;4083;-1,39;14.871,35 €;'sin fechas';02/09/2013;'AUTOPISTA';'Gastos_Ocio y transporte';'Parking y peaje';'VARIABLES'
02/09/2013;02/09/2013;'CAFET.C T PRAT';-4,45 €;10.342,81 €;4084;-4,45;14.866,90 €;'sin fechas';02/09/2013;'CAFETC';'Gastos_Ocio y transporte';'Restaurantes';'VARIABLES'
02/09/2013;02/09/2013;'ES STA. MARGARITA';-31,00 €;10.311,81 €;4085;-31,00;14.835,90 €;'sin fechas';02/09/2013;'STA';'Gastos_Ocio y transporte';'Gasolina';'VARIABLES'
02/09/2013;02/09/2013;'HOGAR&OTROS';-512,99 €;9.798,82 €;4086;-512,99;14.322,91 €;'sin fechas';02/09/2013;'HOGAROTROS';'Gastos_Vivienda y vehiculo';'Otros vivienda';'VARIABLES'
03/09/2013;03/09/2013;'AUTOPISTA TERR';-4,20 €;9.794,62 €;4087;-4,20;14.318,71 €;'sin fechas';03/09/2013;'AUTOPISTA';'Gastos_Ocio y transporte';'Parking y peaje';'VARIABLES'
03/09/2013;03/09/2013;'AUTOPISTA TERR';-1,39 €;9.793,23 €;4088;-1,39;14.317,32 €;'sin fechas';03/09/2013;'AUTOPISTA';'Gastos_Ocio y transporte';'Parking y peaje';'VARIABLES'
03/09/2013;03/09/2013;'CAFET.C T PRAT';-4,70 €;9.788,53 €;4089;-4,70;14.312,62 €;'sin fechas';03/09/2013;'CAFETC';'Gastos_Ocio y transporte';'Restaurantes';'VARIABLES'
03/09/2013;03/09/2013;'VIENA';-17,55 €;9.770,98 €;4090;-17,55;14.295,07 €;'sin fechas';03/09/2013;'VIENA';'Gastos_Ocio y transporte';'Restaurantes';'VARIABLES'
04/09/2013;04/09/2013;'AUTOPISTA TERR';-1,39 €;9.769,59 €;4091;-1,39;14.293,68 €;'sin fechas';04/09/2013;'AUTOPISTA';'Gastos_Ocio y transporte';'Parking y peaje';'VARIABLES'
04/09/2013;04/09/2013;'AUTOPISTA TERR';-1,39 €;9.768,20 €;4092;-1,39;14.292,29 €;'sin fechas';04/09/2013;'AUTOPISTA';'Gastos_Ocio y transporte';'Parking y peaje';'VARIABLES'
04/09/2013;31/08/2013;'YOIGO';-44,21 €;9.723,99 €;4094;-44,21;14.248,08 €;'sin fechas';31/08/2013;'YOIGO';'Gastos_Servicios tipicos';'Telecomunicaciones';'FIJO'
05/09/2013;05/09/2013;'AUTOPISTA TERR';-4,20 €;9.719,79 €;4095;-4,20;14.243,88 €;'sin fechas';05/09/2013;'AUTOPISTA';'Gastos_Ocio y transporte';'Parking y peaje';'VARIABLES'
05/09/2013;05/09/2013;'AUTOPISTA TERR';-1,39 €;9.718,40 €;4096;-1,39;14.242,49 €;'sin fechas';05/09/2013;'AUTOPISTA';'Gastos_Ocio y transporte';'Parking y peaje';'VARIABLES'
05/09/2013;05/09/2013;'AUTOPISTA TERR';-1,39 €;9.717,01 €;4097;-1,39;14.241,10 €;'sin fechas';05/09/2013;'AUTOPISTA';'Gastos_Ocio y transporte';'Parking y peaje';'VARIABLES'
05/09/2013;05/09/2013;'CAFET.C T PRAT';-4,85 €;9.712,16 €;4098;-4,85;14.236,25 €;'sin fechas';05/09/2013;'CAFETC';'Gastos_Ocio y transporte';'Restaurantes';'VARIABLES'
05/09/2013;05/09/2013;'COM. MANT. ACTIVAS DE LIQ.';-4,50 €;9.707,66 €;4099;-4,50;14.231,75 €;'sin fechas';05/09/2013;'COM';'Gastos_Banco y organismos';'Cargos banco';'FIJO'
05/09/2013;04/09/2013;'HOGAR&OTROS';-12,45 €;9.695,21 €;4100;-12,45;14.219,30 €;'sin fechas';04/09/2013;'HOGAROTROS';'Gastos_Vivienda y vehiculo';'Otros vivienda';'VARIABLES'
06/09/2013;06/09/2013;'AUTOPISTA TERR';-4,20 €;9.691,01 €;4101;-4,20;14.215,10 €;'sin fechas';06/09/2013;'AUTOPISTA';'Gastos_Ocio y transporte';'Parking y peaje';'VARIABLES'
06/09/2013;06/09/2013;'AUTOPISTA TERR';-1,39 €;9.689,62 €;4102;-1,39;14.213,71 €;'sin fechas';06/09/2013;'AUTOPISTA';'Gastos_Ocio y transporte';'Parking y peaje';'VARIABLES'
06/09/2013;06/09/2013;'AUTOPISTA TERR';-1,39 €;9.688,23 €;4103;-1,39;14.212,32 €;'sin fechas';06/09/2013;'AUTOPISTA';'Gastos_Ocio y transporte';'Parking y peaje';'VARIABLES'
06/09/2013;06/09/2013;'MERCADONA';-22,14 €;9.666,09 €;4105;-22,14;14.190,18 €;'sin fechas';06/09/2013;'MERCADONA';'Gastos_Compras';'Supermercado';'VARIABLES'
06/09/2013;06/09/2013;'PERRUQUERIA';-36,50 €;9.629,59 €;4106;-36,50;14.153,68 €;'sin fechas';06/09/2013;'PERRUQUERIA';'Gastos_Salud, saber y deporte';'Belleza';'VARIABLES'
07/09/2013;07/09/2013;'CAFET.C T PRAT';-4,90 €;9.624,69 €;4107;-4,90;14.148,78 €;'sin fechas';07/09/2013;'CAFETC';'Gastos_Ocio y transporte';'Restaurantes';'VARIABLES'
07/09/2013;01/09/2013;'COCHE&PARKING';-2,40 €;9.622,29 €;4108;-2,40;14.146,38 €;'sin fechas';01/09/2013;'COCHEPARKING';'Gastos_Ocio y transporte';'Parking y peaje';'VARIABLES'
08/09/2013;08/09/2013;'ES STA. MARGARITA';-33,25 €;9.589,04 €;4109;-33,25;14.113,13 €;'sin fechas';08/09/2013;'STA';'Gastos_Ocio y transporte';'Gasolina';'VARIABLES'
08/09/2013;08/09/2013;'RESTAURANTES';-36,10 €;9.552,94 €;4110;-36,10;14.077,03 €;'sin fechas';08/09/2013;'RESTAURANTES';'Gastos_Ocio y transporte';'Restaurantes';'VARIABLES'
09/09/2013;09/09/2013;'AUTOPISTA TERR';-4,20 €;9.548,74 €;4111;-4,20;14.072,83 €;'sin fechas';09/09/2013;'AUTOPISTA';'Gastos_Ocio y transporte';'Parking y peaje';'VARIABLES'
09/09/2013;09/09/2013;'AUTOPISTA TERR';-1,39 €;9.547,35 €;4112;-1,39;14.071,44 €;'sin fechas';09/09/2013;'AUTOPISTA';'Gastos_Ocio y transporte';'Parking y peaje';'VARIABLES'
09/09/2013;09/09/2013;'AUTOPISTA TERR';-1,39 €;9.545,96 €;4113;-1,39;14.070,05 €;'sin fechas';09/09/2013;'AUTOPISTA';'Gastos_Ocio y transporte';'Parking y peaje';'VARIABLES'
09/09/2013;09/09/2013;'BON AREA';-10,98 €;9.534,98 €;4114;-10,98;14.059,07 €;'sin fechas';09/09/2013;'BON';'Gastos_Compras';'Supermercado';'VARIABLES'
09/09/2013;09/09/2013;'CAFET.C T PRAT';-4,15 €;9.530,83 €;4115;-4,15;14.054,92 €;'sin fechas';09/09/2013;'CAFETC';'Gastos_Ocio y transporte';'Restaurantes';'VARIABLES'
10/09/2013;10/09/2013;'ESCOLA BRESSOL EINA';-405,70 €;9.125,13 €;4118;-405,70;13.649,22 €;'sin fechas';10/09/2013;'ESCOLA';'Gastos_Salud, saber y deporte';'Estudios';'VARIABLES'
10/09/2013;10/09/2013;'FARMACIA';-30,90 €;9.094,23 €;4119;-30,90;13.618,32 €;'sin fechas';10/09/2013;'FARMACIA';'Gastos_Salud, saber y deporte';'Farmacia';'VARIABLES'
10/09/2013;10/09/2013;'HOGAR&COMIDA';-9,69 €;9.084,54 €;4120;-9,69;13.608,63 €;'sin fechas';10/09/2013;'HOGARCOMIDA';'Gastos_Compras';'Supermercado';'VARIABLES'
10/09/2013;10/09/2013;'REINT.CAJERO';-100,00 €;8.984,54 €;4121;-100,00;13.508,63 €;'sin fechas';10/09/2013;'REINTCAJERO';'Gastos_Gastos varios';'Efectivo';'VARIABLES'
10/09/2013;10/09/2013;'SALA BADRINAS - UNIFORME';-59,20 €;8.925,34 €;4122;-59,20;13.449,43 €;'sin fechas';10/09/2013;'SALA';'Gastos_Salud, saber y deporte';'Estudios';'VARIABLES'
12/09/2013;12/09/2013;'AUTOPISTA TERR';-1,39 €;8.923,95 €;4123;-1,39;13.448,04 €;'sin fechas';12/09/2013;'AUTOPISTA';'Gastos_Ocio y transporte';'Parking y peaje';'VARIABLES'
12/09/2013;12/09/2013;'CAFET.C T PRAT';-4,95 €;8.919,00 €;4124;-4,95;13.443,09 €;'sin fechas';12/09/2013;'CAFETC';'Gastos_Ocio y transporte';'Restaurantes';'VARIABLES'
12/09/2013;12/09/2013;'CARREFOUR-[OTROS]';-36,65 €;8.882,35 €;4125;-36,65;13.406,44 €;'sin fechas';12/09/2013;'CARREFOUROTROS';'Gastos_Compras';'Supermercado';'VARIABLES'
12/09/2013;11/09/2013;'HOGAR&OTROS';-26,35 €;8.856,00 €;4126;-26,35;13.380,09 €;'sin fechas';11/09/2013;'HOGAROTROS';'Gastos_Vivienda y vehiculo';'Otros vivienda';'VARIABLES'
12/09/2013;12/09/2013;'COMUNIDAD PAGO 4-3 DE ENERO A DICIEMBRE';-240,00 €;8.616,00 €;4127;-240,00;13.140,09 €;'sin fechas';12/09/2013;'COMUNIDAD';'Gastos_Vivienda y vehiculo';'Comunidad';'FIJO'
12/09/2013;12/09/2013;'REINT.CAJERO';-100,00 €;8.516,00 €;4128;-100,00;13.040,09 €;'sin fechas';12/09/2013;'REINTCAJERO';'Gastos_Gastos varios';'Efectivo';'VARIABLES'
12/09/2013;12/09/2013;'SALA BADRINAS - QUOTA';-85,00 €;8.431,00 €;4129;-85,00;12.955,09 €;'sin fechas';12/09/2013;'SALA';'Gastos_Salud, saber y deporte';'Estudios';'VARIABLES'
12/09/2013;12/09/2013;'COMISIONES';-1,50 €;8.429,50 €;4130;-1,50;12.953,59 €;'sin fechas';12/09/2013;'COMISIONES';'Gastos_Banco y organismos';'Cargos banco';'FIJO'
12/09/2013;12/09/2013;'COMISIONES';-1,50 €;8.428,00 €;4131;-1,50;12.952,09 €;'sin fechas';12/09/2013;'COMISIONES';'Gastos_Banco y organismos';'Cargos banco';'FIJO'
12/09/2013;12/09/2013;'VIENA';-20,05 €;8.407,95 €;4132;-20,05;12.932,04 €;'sin fechas';12/09/2013;'VIENA';'Gastos_Ocio y transporte';'Restaurantes';'VARIABLES'
13/09/2013;13/09/2013;'ADESLAS CENTRAL 006662671613';-110,65 €;8.297,30 €;4133;-110,65;12.821,39 €;'sin fechas';13/09/2013;'ADESLAS';'Gastos_Salud, saber y deporte';'Medico';'VARIABLES'
13/09/2013;13/09/2013;'AUTOPISTA TERR';-4,20 €;8.293,10 €;4134;-4,20;12.817,19 €;'sin fechas';13/09/2013;'AUTOPISTA';'Gastos_Ocio y transporte';'Parking y peaje';'VARIABLES'
13/09/2013;13/09/2013;'AUTOPISTA TERR';-1,32 €;8.291,78 €;4135;-1,32;12.815,87 €;'sin fechas';13/09/2013;'AUTOPISTA';'Gastos_Ocio y transporte';'Parking y peaje';'VARIABLES'
13/09/2013;13/09/2013;'AUTOPISTA TERR';-1,39 €;8.290,39 €;4136;-1,39;12.814,48 €;'sin fechas';13/09/2013;'AUTOPISTA';'Gastos_Ocio y transporte';'Parking y peaje';'VARIABLES'
13/09/2013;13/09/2013;'CCM VIDA Y P SEGURO PRESTAMO';-24,58 €;8.265,81 €;4137;-24,58;12.789,90 €;'sin fechas';13/09/2013;'CCM';'Gastos_Seguros';'Seguro vida';'FIJO'
13/09/2013;13/09/2013;'CCM VIDA Y PENSIO 000000493358';-18,17 €;8.247,64 €;4138;-18,17;12.771,73 €;'sin fechas';13/09/2013;'CCM';'Gastos_Seguros';'Seguro vida';'FIJO'
13/09/2013;13/09/2013;'FARMACIA';-6,50 €;8.241,14 €;4139;-6,50;12.765,23 €;'sin fechas';13/09/2013;'FARMACIA';'Gastos_Salud, saber y deporte';'Farmacia';'VARIABLES'
14/09/2013;14/09/2013;'HOGAR&OTROS';-12,45 €;8.228,69 €;4140;-12,45;12.752,78 €;'sin fechas';14/09/2013;'HOGAROTROS';'Gastos_Vivienda y vehiculo';'Otros vivienda';'VARIABLES'
14/09/2013;14/09/2013;'LA BRASA';-16,00 €;8.212,69 €;4141;-16,00;12.736,78 €;'sin fechas';14/09/2013;'BRASA';'Gastos_Ocio y transporte';'Restaurantes';'VARIABLES'
15/09/2013;15/09/2013;'BON AREA';-9,22 €;8.203,47 €;4142;-9,22;12.727,56 €;'sin fechas';15/09/2013;'BON';'Gastos_Compras';'Supermercado';'VARIABLES'
15/09/2013;15/09/2013;'CAFET.C T PRAT';-3,60 €;8.199,87 €;4143;-3,60;12.723,96 €;'sin fechas';15/09/2013;'CAFETC';'Gastos_Ocio y transporte';'Restaurantes';'VARIABLES'
15/09/2013;15/09/2013;'ES STA. MARGARITA';-31,30 €;8.168,57 €;4144;-31,30;12.692,66 €;'sin fechas';15/09/2013;'STA';'Gastos_Ocio y transporte';'Gasolina';'VARIABLES'
16/09/2013;16/09/2013;'CAFET.C T PRAT';-3,60 €;8.164,97 €;4145;-3,60;12.689,06 €;'sin fechas';16/09/2013;'CAFETC';'Gastos_Ocio y transporte';'Restaurantes';'VARIABLES'
16/09/2013;16/09/2013;'MERCADONA';-45,59 €;8.119,38 €;4146;-45,59;12.643,47 €;'sin fechas';16/09/2013;'MERCADONA';'Gastos_Compras';'Supermercado';'VARIABLES'
16/09/2013;16/09/2013;'MERCADONA';-4,63 €;8.114,75 €;4147;-4,63;12.638,84 €;'sin fechas';16/09/2013;'MERCADONA';'Gastos_Compras';'Supermercado';'VARIABLES'
16/09/2013;16/09/2013;'MERCADONA';-85,77 €;8.028,98 €;4148;-85,77;12.553,07 €;'sin fechas';16/09/2013;'MERCADONA';'Gastos_Compras';'Supermercado';'VARIABLES'
17/09/2013;17/09/2013;'AUTOPISTA TERR';-4,20 €;8.024,78 €;4149;-4,20;12.548,87 €;'sin fechas';17/09/2013;'AUTOPISTA';'Gastos_Ocio y transporte';'Parking y peaje';'VARIABLES'
17/09/2013;17/09/2013;'AUTOPISTA TERR';-1,39 €;8.023,39 €;4150;-1,39;12.547,48 €;'sin fechas';17/09/2013;'AUTOPISTA';'Gastos_Ocio y transporte';'Parking y peaje';'VARIABLES'
17/09/2013;17/09/2013;'AUTOPISTA TERR';-1,32 €;8.022,07 €;4151;-1,32;12.546,16 €;'sin fechas';17/09/2013;'AUTOPISTA';'Gastos_Ocio y transporte';'Parking y peaje';'VARIABLES'
17/09/2013;17/09/2013;'AUTOPISTA TERR';-1,32 €;8.020,75 €;4152;-1,32;12.544,84 €;'sin fechas';17/09/2013;'AUTOPISTA';'Gastos_Ocio y transporte';'Parking y peaje';'VARIABLES'
17/09/2013;17/09/2013;'AUTOPISTA TERR';-1,32 €;8.019,43 €;4153;-1,32;12.543,52 €;'sin fechas';17/09/2013;'AUTOPISTA';'Gastos_Ocio y transporte';'Parking y peaje';'VARIABLES'
17/09/2013;17/09/2013;'BLITZ';-72,50 €;7.946,93 €;4155;-72,50;12.471,02 €;'sin fechas';17/09/2013;'BLITZ';'Gastos_Vivienda y vehiculo';'Alquiler Parking';'FIJO'
17/09/2013;17/09/2013;'ONO';-135,62 €;7.811,31 €;4156;-135,62;12.335,40 €;'sin fechas';17/09/2013;'ONO';'Gastos_Servicios tipicos';'Telecomunicaciones';'FIJO'
19/09/2013;19/09/2013;'AUTOPISTA TERR';-4,20 €;7.807,11 €;4158;-4,20;12.331,20 €;'sin fechas';19/09/2013;'AUTOPISTA';'Gastos_Ocio y transporte';'Parking y peaje';'VARIABLES'
19/09/2013;19/09/2013;'AUTOPISTA TERR';-1,39 €;7.805,72 €;4159;-1,39;12.329,81 €;'sin fechas';19/09/2013;'AUTOPISTA';'Gastos_Ocio y transporte';'Parking y peaje';'VARIABLES'
19/09/2013;19/09/2013;'AUTOPISTA TERR';-1,32 €;7.804,40 €;4160;-1,32;12.328,49 €;'sin fechas';19/09/2013;'AUTOPISTA';'Gastos_Ocio y transporte';'Parking y peaje';'VARIABLES'
19/09/2013;19/09/2013;'AUTOPISTA TERR';-1,39 €;7.803,01 €;4161;-1,39;12.327,10 €;'sin fechas';19/09/2013;'AUTOPISTA';'Gastos_Ocio y transporte';'Parking y peaje';'VARIABLES'
19/09/2013;17/09/2013;'FARMACIA';-8,50 €;7.794,51 €;4162;-8,50;12.318,60 €;'sin fechas';17/09/2013;'FARMACIA';'Gastos_Salud, saber y deporte';'Farmacia';'VARIABLES'
19/09/2013;19/09/2013;'HOGAR&OTROS';-13,55 €;7.780,96 €;4163;-13,55;12.305,05 €;'sin fechas';19/09/2013;'HOGAROTROS';'Gastos_Vivienda y vehiculo';'Otros vivienda';'VARIABLES'
19/09/2013;17/09/2013;'MERCADONA';-40,90 €;7.740,06 €;4164;-40,90;12.264,15 €;'sin fechas';17/09/2013;'MERCADONA';'Gastos_Compras';'Supermercado';'VARIABLES'
19/09/2013;19/09/2013;'MINA PUBLICA AIGUES T.01A75789';-33,95 €;7.706,11 €;4165;-33,95;12.230,20 €;'sin fechas';19/09/2013;'MINA';'Gastos_Servicios tipicos';'Agua';'FIJO'
20/09/2013;20/09/2013;'AUTOPISTA TERR';-4,20 €;7.701,91 €;4166;-4,20;12.226,00 €;'sin fechas';20/09/2013;'AUTOPISTA';'Gastos_Ocio y transporte';'Parking y peaje';'VARIABLES'
20/09/2013;20/09/2013;'AUTOPISTA TERR';-1,25 €;7.700,66 €;4167;-1,25;12.224,75 €;'sin fechas';20/09/2013;'AUTOPISTA';'Gastos_Ocio y transporte';'Parking y peaje';'VARIABLES'
20/09/2013;20/09/2013;'AUTOPISTA TERR';-1,39 €;7.699,27 €;4168;-1,39;12.223,36 €;'sin fechas';20/09/2013;'AUTOPISTA';'Gastos_Ocio y transporte';'Parking y peaje';'VARIABLES'
21/09/2013;21/09/2013;'M&S';-69,97 €;7.629,30 €;4170;-69,97;12.153,39 €;'sin fechas';21/09/2013;'MS';'Gastos_Compras';'Ropa';'VARIABLES'
22/09/2013;22/09/2013;'AUTOPISTA TERR';-3,73 €;7.625,57 €;4171;-3,73;12.149,66 €;'sin fechas';22/09/2013;'AUTOPISTA';'Gastos_Ocio y transporte';'Parking y peaje';'VARIABLES'
22/09/2013;22/09/2013;'AUTOPISTA TERR';-2,53 €;7.623,04 €;4172;-2,53;12.147,13 €;'sin fechas';22/09/2013;'AUTOPISTA';'Gastos_Ocio y transporte';'Parking y peaje';'VARIABLES'
22/09/2013;22/09/2013;'ES STA. MARGARITA';-3,90 €;7.619,14 €;4173;-3,90;12.143,23 €;'sin fechas';22/09/2013;'STA';'Gastos_Ocio y transporte';'Gasolina';'VARIABLES'
23/09/2013;23/09/2013;'AUTOPISTA TERR';-1,25 €;7.617,89 €;4174;-1,25;12.141,98 €;'sin fechas';23/09/2013;'AUTOPISTA';'Gastos_Ocio y transporte';'Parking y peaje';'VARIABLES'
23/09/2013;23/09/2013;'ES STA. MARGARITA';-31,50 €;7.586,39 €;4175;-31,50;12.110,48 €;'sin fechas';23/09/2013;'STA';'Gastos_Ocio y transporte';'Gasolina';'VARIABLES'
24/09/2013;19/09/2013;'AUTOPISTA TERR';-1,39 €;7.585,00 €;4176;-1,39;12.109,09 €;'sin fechas';19/09/2013;'AUTOPISTA';'Gastos_Ocio y transporte';'Parking y peaje';'VARIABLES'
25/09/2013;25/09/2013;'AUTOPISTA TERR';-4,20 €;7.580,80 €;4177;-4,20;12.104,89 €;'sin fechas';25/09/2013;'AUTOPISTA';'Gastos_Ocio y transporte';'Parking y peaje';'VARIABLES'
25/09/2013;25/09/2013;'AUTOPISTA TERR';-1,25 €;7.579,55 €;4178;-1,25;12.103,64 €;'sin fechas';25/09/2013;'AUTOPISTA';'Gastos_Ocio y transporte';'Parking y peaje';'VARIABLES'
25/09/2013;25/09/2013;'AUTOPISTA TERR';-1,39 €;7.578,16 €;4179;-1,39;12.102,25 €;'sin fechas';25/09/2013;'AUTOPISTA';'Gastos_Ocio y transporte';'Parking y peaje';'VARIABLES'
25/09/2013;25/09/2013;'MERCADONA';-24,23 €;7.553,93 €;4180;-24,23;12.078,02 €;'sin fechas';25/09/2013;'MERCADONA';'Gastos_Compras';'Supermercado';'VARIABLES'
25/09/2013;25/09/2013;'RESTAURANTES';-9,25 €;7.544,68 €;4181;-9,25;12.068,77 €;'sin fechas';25/09/2013;'RESTAURANTES';'Gastos_Ocio y transporte';'Restaurantes';'VARIABLES'
26/09/2013;26/09/2013;'AUTOPISTA TERR';-1,25 €;7.543,43 €;4182;-1,25;12.067,52 €;'sin fechas';26/09/2013;'AUTOPISTA';'Gastos_Ocio y transporte';'Parking y peaje';'VARIABLES'
26/09/2013;26/09/2013;'AUTOPISTA TERR';-1,25 €;7.542,18 €;4183;-1,25;12.066,27 €;'sin fechas';26/09/2013;'AUTOPISTA';'Gastos_Ocio y transporte';'Parking y peaje';'VARIABLES'
26/09/2013;26/09/2013;'BON AREA';-20,58 €;7.521,60 €;4184;-20,58;12.045,69 €;'sin fechas';26/09/2013;'BON';'Gastos_Compras';'Supermercado';'VARIABLES'
26/09/2013;24/09/2013;'H&M';-32,90 €;7.488,70 €;4185;-32,90;12.012,79 €;'sin fechas';24/09/2013;'HM';'Gastos_Compras';'Ropa';'VARIABLES'
26/09/2013;25/09/2013;'HOGAR&OTROS';-168,50 €;7.320,20 €;4186;-168,50;11.844,29 €;'sin fechas';25/09/2013;'HOGAROTROS';'Gastos_Vivienda y vehiculo';'Otros vivienda';'VARIABLES'
26/09/2013;26/09/2013;'RESTAURANTES';-10,00 €;7.310,20 €;4187;-10,00;11.834,29 €;'sin fechas';26/09/2013;'RESTAURANTES';'Gastos_Ocio y transporte';'Restaurantes';'VARIABLES'
26/09/2013;26/09/2013;'SALA BADRINAS - MENJADOR';-59,64 €;7.250,56 €;4188;-59,64;11.774,65 €;'sin fechas';26/09/2013;'SALA';'Gastos_Salud, saber y deporte';'Estudios';'VARIABLES'
27/09/2013;27/09/2013;'AUTOPISTA TERR';-1,25 €;7.249,31 €;4189;-1,25;11.773,40 €;'sin fechas';27/09/2013;'AUTOPISTA';'Gastos_Ocio y transporte';'Parking y peaje';'VARIABLES'
27/09/2013;27/09/2013;'AUTOPISTA TERR';-1,25 €;7.248,06 €;4190;-1,25;11.772,15 €;'sin fechas';27/09/2013;'AUTOPISTA';'Gastos_Ocio y transporte';'Parking y peaje';'VARIABLES'
27/09/2013;27/09/2013;'FOMENT DE TERRASSA, S.A. FOMEN';1.555,05 €;8.803,11 €;4191;1.555,05;13.327,20 €;'sin fechas';27/09/2013;'FOMENT';'Ingresos';'Nomina';'FIJO'
27/09/2013;27/09/2013;'INFORMACIO I TECNOLOGIA DE CAT';1.579,09 €;10.382,20 €;4193;1.579,09;14.906,29 €;'sin fechas';27/09/2013;'INFORMACIO';'Ingresos';'Nomina';'FIJO'
27/09/2013;27/09/2013;'RESTAURANTES';-22,20 €;10.360,00 €;4195;-22,20;14.884,09 €;'sin fechas';27/09/2013;'RESTAURANTES';'Gastos_Ocio y transporte';'Restaurantes';'VARIABLES'
28/09/2013;28/09/2013;'HOGAR&COMIDA';-2,74 €;10.357,26 €;4196;-2,74;14.881,35 €;'sin fechas';28/09/2013;'HOGARCOMIDA';'Gastos_Compras';'Supermercado';'VARIABLES'
28/09/2013;28/09/2013;'PRIMARK';-28,00 €;10.329,26 €;4197;-28,00;14.853,35 €;'sin fechas';28/09/2013;'PRIMARK';'Gastos_Compras';'Ropa';'VARIABLES'
28/09/2013;28/09/2013;'WWW.JUST-EAT.ES';-18,15 €;10.311,11 €;4198;-18,15;14.835,20 €;'sin fechas';28/09/2013;'WWWJUSTEATES';'Gastos_Ocio y transporte';'Restaurantes';'VARIABLES'
29/09/2013;29/09/2013;'CAFET.C T PRAT';-2,60 €;10.308,51 €;4199;-2,60;14.832,60 €;'sin fechas';29/09/2013;'CAFETC';'Gastos_Ocio y transporte';'Restaurantes';'VARIABLES'
29/09/2013;29/09/2013;'REINT.CAJERO';-100,00 €;10.208,51 €;4200;-100,00;14.732,60 €;'sin fechas';29/09/2013;'REINTCAJERO';'Gastos_Gastos varios';'Efectivo';'VARIABLES'
30/09/2013;30/09/2013;'AJUNTAMENT DE TER 010000520716';-44,24 €;10.164,27 €;4201;-44,24;14.688,36 €;'sin fechas';30/09/2013;'AJUNTAMENT';'Gastos_Banco y organismos';'Ayuntamiento';'FIJO'
30/09/2013;30/09/2013;'AUTOPISTA TERR';-1,25 €;10.163,02 €;4202;-1,25;14.687,11 €;'sin fechas';30/09/2013;'AUTOPISTA';'Gastos_Ocio y transporte';'Parking y peaje';'VARIABLES'
30/09/2013;30/09/2013;'AUTOPISTA TERR';-1,25 €;10.161,77 €;4203;-1,25;14.685,86 €;'sin fechas';30/09/2013;'AUTOPISTA';'Gastos_Ocio y transporte';'Parking y peaje';'VARIABLES'
30/09/2013;23/09/2013;'AUTOPISTA TERR';-1,39 €;10.160,38 €;4204;-1,39;14.684,47 €;'sin fechas';23/09/2013;'AUTOPISTA';'Gastos_Ocio y transporte';'Parking y peaje';'VARIABLES'
30/09/2013;30/09/2013;'ES STA. MARGARITA';-50,67 €;10.109,71 €;4205;-50,67;14.633,80 €;'sin fechas';30/09/2013;'STA';'Gastos_Ocio y transporte';'Gasolina';'VARIABLES'
30/09/2013;30/09/2013;'HOGAR&COMIDA';-9,87 €;10.099,84 €;4206;-9,87;14.623,93 €;'sin fechas';30/09/2013;'HOGARCOMIDA';'Gastos_Compras';'Supermercado';'VARIABLES'
30/09/2013;30/09/2013;'MERCADONA';-164,18 €;9.935,66 €;4207;-164,18;14.459,75 €;'sin fechas';30/09/2013;'MERCADONA';'Gastos_Compras';'Supermercado';'VARIABLES'
30/09/2013;30/09/2013;'RECIBO PTMOS. 3061-0960001518';-562,73 €;9.372,93 €;4208;-562,73;13.897,02 €;'sin fechas';30/09/2013;'RECIBO';'Gastos_Banco y organismos';'Hipoteca';'FIJO'
30/09/2013;30/09/2013;'TABASA VALLVI S. C:2T';-3,73 €;9.369,20 €;4209;-3,73;13.893,29 €;'sin fechas';30/09/2013;'TABASA';'Gastos_Ocio y transporte';'Parking y peaje';'VARIABLES'
01/10/2013;01/10/2013;'AUTOPISTA TERR';-1,39 €;9.367,81 €;4210;-1,39;13.891,90 €;'sin fechas';01/10/2013;'AUTOPISTA';'Gastos_Ocio y transporte';'Parking y peaje';'VARIABLES'
01/10/2013;01/10/2013;'AUTOPISTA TERR';-1,39 €;9.366,42 €;4211;-1,39;13.890,51 €;'sin fechas';01/10/2013;'AUTOPISTA';'Gastos_Ocio y transporte';'Parking y peaje';'VARIABLES'
01/10/2013;01/10/2013;'TABASA VALLVI S. C:2T';-3,73 €;9.362,69 €;4215;-3,73;13.886,78 €;'sin fechas';01/10/2013;'TABASA';'Gastos_Ocio y transporte';'Parking y peaje';'VARIABLES'
02/10/2013;02/10/2013;'AUTOPISTA TERR';-1,39 €;9.361,30 €;4216;-1,39;13.885,39 €;'sin fechas';02/10/2013;'AUTOPISTA';'Gastos_Ocio y transporte';'Parking y peaje';'VARIABLES'
02/10/2013;02/10/2013;'AUTOPISTA TERR';-1,39 €;9.359,91 €;4217;-1,39;13.884,00 €;'sin fechas';02/10/2013;'AUTOPISTA';'Gastos_Ocio y transporte';'Parking y peaje';'VARIABLES'
02/10/2013;02/10/2013;'RESTAURANTES';-9,90 €;9.350,01 €;4218;-9,90;13.874,10 €;'sin fechas';02/10/2013;'RESTAURANTES';'Gastos_Ocio y transporte';'Restaurantes';'VARIABLES'
02/10/2013;02/10/2013;'TABASA VALLVI S. C:2T';-4,20 €;9.345,81 €;4219;-4,20;13.869,90 €;'sin fechas';02/10/2013;'TABASA';'Gastos_Ocio y transporte';'Parking y peaje';'VARIABLES'
03/10/2013;03/10/2013;'AUTOPISTA TERR';-1,39 €;9.344,42 €;4220;-1,39;13.868,51 €;'sin fechas';03/10/2013;'AUTOPISTA';'Gastos_Ocio y transporte';'Parking y peaje';'VARIABLES'
03/10/2013;01/10/2013;'C&A';-80,50 €;9.263,92 €;4221;-80,50;13.788,01 €;'sin fechas';01/10/2013;'CA';'Gastos_Compras';'Ropa';'VARIABLES'
03/10/2013;03/10/2013;'CAFET.C T PRAT';-4,05 €;9.259,87 €;4222;-4,05;13.783,96 €;'sin fechas';03/10/2013;'CAFETC';'Gastos_Ocio y transporte';'Restaurantes';'VARIABLES'
03/10/2013;03/10/2013;'ESCOLA BRESSOL EINA';-419,94 €;8.839,93 €;4224;-419,94;13.364,02 €;'sin fechas';03/10/2013;'ESCOLA';'Gastos_Salud, saber y deporte';'Estudios';'VARIABLES'
03/10/2013;03/10/2013;'GIFI';-72,46 €;8.767,47 €;4225;-72,46;13.291,56 €;'sin fechas';03/10/2013;'GIFI';'Gastos_Compras';'Hogar';'VARIABLES'
03/10/2013;01/10/2013;'H&M';-56,82 €;8.710,65 €;4226;-56,82;13.234,74 €;'sin fechas';01/10/2013;'HM';'Gastos_Compras';'Ropa';'VARIABLES'
03/10/2013;01/10/2013;'H&M';-39,95 €;8.670,70 €;4227;-39,95;13.194,79 €;'sin fechas';01/10/2013;'HM';'Gastos_Compras';'Ropa';'VARIABLES'
03/10/2013;01/10/2013;'HOGAR&MODA';-49,65 €;8.621,05 €;4228;-49,65;13.145,14 €;'sin fechas';01/10/2013;'HOGARMODA';'Gastos_Compras';'Ropa';'VARIABLES'
03/10/2013;02/10/2013;'HOGAR&OTROS';-15,65 €;8.605,40 €;4229;-15,65;13.129,49 €;'sin fechas';02/10/2013;'HOGAROTROS';'Gastos_Vivienda y vehiculo';'Otros vivienda';'VARIABLES'
03/10/2013;01/10/2013;'IMAGINARIUM';-22,90 €;8.582,50 €;4230;-22,90;13.106,59 €;'sin fechas';01/10/2013;'IMAGINARIUM';'Gastos_Compras';'Niños';'VARIABLES'
03/10/2013;01/10/2013;'MERCADONA';-15,95 €;8.566,55 €;4231;-15,95;13.090,64 €;'sin fechas';01/10/2013;'MERCADONA';'Gastos_Compras';'Supermercado';'VARIABLES'
03/10/2013;01/10/2013;'RESTAURANTES';-33,25 €;8.533,30 €;4232;-33,25;13.057,39 €;'sin fechas';01/10/2013;'RESTAURANTES';'Gastos_Ocio y transporte';'Restaurantes';'VARIABLES'
03/10/2013;03/10/2013;'RESTAURANTES';-7,50 €;8.525,80 €;4233;-7,50;13.049,89 €;'sin fechas';03/10/2013;'RESTAURANTES';'Gastos_Ocio y transporte';'Restaurantes';'VARIABLES'
03/10/2013;03/10/2013;'SEGUROS CATALANA';-305,29 €;8.220,51 €;4235;-305,29;12.744,60 €;'sin fechas';03/10/2013;'CATALANA';'Gastos_Ocio y transporte';'Parking y peaje';'VARIABLES'
03/10/2013;01/10/2013;'VIENA';-11,00 €;8.209,51 €;4236;-11,00;12.733,60 €;'sin fechas';01/10/2013;'VIENA';'Gastos_Ocio y transporte';'Restaurantes';'VARIABLES'
04/10/2013;04/10/2013;'ADESLAS CENTRAL 006662671613';-110,65 €;8.098,86 €;4237;-110,65;12.622,95 €;'sin fechas';04/10/2013;'ADESLAS';'Gastos_Salud, saber y deporte';'Medico';'VARIABLES'
04/10/2013;04/10/2013;'AUTOPISTA TERR';-1,32 €;8.097,54 €;4238;-1,32;12.621,63 €;'sin fechas';04/10/2013;'AUTOPISTA';'Gastos_Ocio y transporte';'Parking y peaje';'VARIABLES'
04/10/2013;04/10/2013;'AUTOPISTA TERR';-1,39 €;8.096,15 €;4239;-1,39;12.620,24 €;'sin fechas';04/10/2013;'AUTOPISTA';'Gastos_Ocio y transporte';'Parking y peaje';'VARIABLES'
04/10/2013;04/10/2013;'CAFET.C T PRAT';-2,10 €;8.094,05 €;4240;-2,10;12.618,14 €;'sin fechas';04/10/2013;'CAFETC';'Gastos_Ocio y transporte';'Restaurantes';'VARIABLES'
04/10/2013;04/10/2013;'HOGAR&COMIDA';-1,85 €;8.092,20 €;4241;-1,85;12.616,29 €;'sin fechas';04/10/2013;'HOGARCOMIDA';'Gastos_Compras';'Supermercado';'VARIABLES'
04/10/2013;30/09/2013;'YOIGO';-19,36 €;8.072,84 €;4243;-19,36;12.596,93 €;'sin fechas';30/09/2013;'YOIGO';'Gastos_Servicios tipicos';'Telecomunicaciones';'FIJO'
05/10/2013;05/10/2013;'CAFET.C T PRAT';-3,60 €;8.069,24 €;4244;-3,60;12.593,33 €;'sin fechas';05/10/2013;'CAFETC';'Gastos_Ocio y transporte';'Restaurantes';'VARIABLES'
05/10/2013;05/10/2013;'REINT.CAJERO';-100,00 €;7.969,24 €;4245;-100,00;12.493,33 €;'sin fechas';05/10/2013;'REINTCAJERO';'Gastos_Gastos varios';'Efectivo';'VARIABLES'
05/10/2013;05/10/2013;'WWW.JUST-EAT.ES';-31,80 €;7.937,44 €;4246;-31,80;12.461,53 €;'sin fechas';05/10/2013;'WWWJUSTEATES';'Gastos_Ocio y transporte';'Restaurantes';'VARIABLES'
06/10/2013;06/10/2013;'CAFET.C T PRAT';-3,40 €;7.934,04 €;4247;-3,40;12.458,13 €;'sin fechas';06/10/2013;'CAFETC';'Gastos_Ocio y transporte';'Restaurantes';'VARIABLES'
06/10/2013;06/10/2013;'CARREFOUR-[COMIDA]';-42,90 €;7.891,14 €;4248;-42,90;12.415,23 €;'sin fechas';06/10/2013;'CARREFOURCOMIDA';'Gastos_Compras';'Supermercado';'VARIABLES'
07/10/2013;07/10/2013;'AUTOPISTA TERR';-1,32 €;7.889,82 €;4249;-1,32;12.413,91 €;'sin fechas';07/10/2013;'AUTOPISTA';'Gastos_Ocio y transporte';'Parking y peaje';'VARIABLES'
07/10/2013;07/10/2013;'AUTOPISTA TERR';-1,39 €;7.888,43 €;4250;-1,39;12.412,52 €;'sin fechas';07/10/2013;'AUTOPISTA';'Gastos_Ocio y transporte';'Parking y peaje';'VARIABLES'
07/10/2013;07/10/2013;'CAFET.C T PRAT';-3,60 €;7.884,83 €;4251;-3,60;12.408,92 €;'sin fechas';07/10/2013;'CAFETC';'Gastos_Ocio y transporte';'Restaurantes';'VARIABLES'
07/10/2013;07/10/2013;'RESTAURANTES';-6,45 €;7.878,38 €;4252;-6,45;12.402,47 €;'sin fechas';07/10/2013;'RESTAURANTES';'Gastos_Ocio y transporte';'Restaurantes';'VARIABLES'
07/10/2013;07/10/2013;'TABASA VALLVI S. C:2T';-4,20 €;7.874,18 €;4253;-4,20;12.398,27 €;'sin fechas';07/10/2013;'TABASA';'Gastos_Ocio y transporte';'Parking y peaje';'VARIABLES'
07/10/2013;07/10/2013;'TOCINERIES VENTURA';-10,10 €;7.864,08 €;4254;-10,10;12.388,17 €;'sin fechas';07/10/2013;'TOCINERIES';'Gastos_Compras';'Supermercado';'VARIABLES'
08/10/2013;08/10/2013;'AUTOPISTA TERR';-1,32 €;7.862,76 €;4255;-1,32;12.386,85 €;'sin fechas';08/10/2013;'AUTOPISTA';'Gastos_Ocio y transporte';'Parking y peaje';'VARIABLES'
08/10/2013;08/10/2013;'AUTOPISTA TERR';-1,32 €;7.861,44 €;4256;-1,32;12.385,53 €;'sin fechas';08/10/2013;'AUTOPISTA';'Gastos_Ocio y transporte';'Parking y peaje';'VARIABLES'
08/10/2013;08/10/2013;'GAS NATURAL';-150,13 €;7.711,31 €;4258;-150,13;12.235,40 €;'sin fechas';08/10/2013;'GAS';'Gastos_Servicios tipicos';'Gas';'FIJO'
08/10/2013;08/10/2013;'GOOGLE *Midas';-1,79 €;7.709,52 €;4259;-1,79;12.233,61 €;'sin fechas';08/10/2013;'GOOGLE';'Gastos_Compras';'Hobbys';'VARIABLES'
08/10/2013;08/10/2013;'RESTAURANTES';-9,90 €;7.699,62 €;4260;-9,90;12.223,71 €;'sin fechas';08/10/2013;'RESTAURANTES';'Gastos_Ocio y transporte';'Restaurantes';'VARIABLES'
09/10/2013;09/10/2013;'AUTOPISTA TERR';-1,32 €;7.698,30 €;4261;-1,32;12.222,39 €;'sin fechas';09/10/2013;'AUTOPISTA';'Gastos_Ocio y transporte';'Parking y peaje';'VARIABLES'
09/10/2013;09/10/2013;'AUTOPISTA TERR';-1,39 €;7.696,91 €;4262;-1,39;12.221,00 €;'sin fechas';09/10/2013;'AUTOPISTA';'Gastos_Ocio y transporte';'Parking y peaje';'VARIABLES'
09/10/2013;09/10/2013;'MERKALZADOS TARRAS';-24,99 €;7.671,92 €;4263;-24,99;12.196,01 €;'sin fechas';09/10/2013;'MERKALZADOS';'Gastos_Compras';'Ropa';'VARIABLES'
09/10/2013;09/10/2013;'SALA BADRINAS - MENJADOR';-142,60 €;7.529,32 €;4265;-142,60;12.053,41 €;'sin fechas';09/10/2013;'SALA';'Gastos_Salud, saber y deporte';'Estudios';'VARIABLES'
09/10/2013;09/10/2013;'TABASA VALLVI S. C:2T';-4,20 €;7.525,12 €;4266;-4,20;12.049,21 €;'sin fechas';09/10/2013;'TABASA';'Gastos_Ocio y transporte';'Parking y peaje';'VARIABLES'
10/10/2013;10/10/2013;'AUTOPISTA TERR';-1,25 €;7.523,87 €;4267;-1,25;12.047,96 €;'sin fechas';10/10/2013;'AUTOPISTA';'Gastos_Ocio y transporte';'Parking y peaje';'VARIABLES'
10/10/2013;10/10/2013;'AUTOPISTA TERR';-1,25 €;7.522,62 €;4268;-1,25;12.046,71 €;'sin fechas';10/10/2013;'AUTOPISTA';'Gastos_Ocio y transporte';'Parking y peaje';'VARIABLES'
10/10/2013;10/10/2013;'BLITZ';-72,50 €;7.450,12 €;4269;-72,50;11.974,21 €;'sin fechas';10/10/2013;'BLITZ';'Gastos_Vivienda y vehiculo';'Alquiler Parking';'FIJO'
10/10/2013;10/10/2013;'CARREFOUR-[COMIDA]';-26,05 €;7.424,07 €;4271;-26,05;11.948,16 €;'sin fechas';10/10/2013;'CARREFOURCOMIDA';'Gastos_Compras';'Supermercado';'VARIABLES'
10/10/2013;09/10/2013;'HOGAR&OTROS';-18,40 €;7.405,67 €;4273;-18,40;11.929,76 €;'sin fechas';09/10/2013;'HOGAROTROS';'Gastos_Vivienda y vehiculo';'Otros vivienda';'VARIABLES'
10/10/2013;10/10/2013;'TABASA VALLVI S. C:2T';-3,73 €;7.401,94 €;4274;-3,73;11.926,03 €;'sin fechas';10/10/2013;'TABASA';'Gastos_Ocio y transporte';'Parking y peaje';'VARIABLES'
11/10/2013;11/10/2013;'AUTOPISTA TERR';-1,25 €;7.400,69 €;4275;-1,25;11.924,78 €;'sin fechas';11/10/2013;'AUTOPISTA';'Gastos_Ocio y transporte';'Parking y peaje';'VARIABLES'
11/10/2013;11/10/2013;'AUTOPISTA TERR';-1,25 €;7.399,44 €;4276;-1,25;11.923,53 €;'sin fechas';11/10/2013;'AUTOPISTA';'Gastos_Ocio y transporte';'Parking y peaje';'VARIABLES'
11/10/2013;11/10/2013;'EROSKI-[COMIDA]';-32,92 €;7.366,52 €;4277;-32,92;11.890,61 €;'sin fechas';11/10/2013;'EROSKICOMIDA';'Gastos_Compras';'Supermercado';'VARIABLES'
11/10/2013;11/10/2013;'ES STA. MARGARITA';-30,00 €;7.336,52 €;4278;-30,00;11.860,61 €;'sin fechas';11/10/2013;'STA';'Gastos_Ocio y transporte';'Gasolina';'VARIABLES'
11/10/2013;11/10/2013;'HOGAR&OTROS';-35,00 €;7.301,52 €;4279;-35,00;11.825,61 €;'sin fechas';11/10/2013;'HOGAROTROS';'Gastos_Vivienda y vehiculo';'Otros vivienda';'VARIABLES'
11/10/2013;11/10/2013;'MERCADONA';-6,91 €;7.294,61 €;4280;-6,91;11.818,70 €;'sin fechas';11/10/2013;'MERCADONA';'Gastos_Compras';'Supermercado';'VARIABLES'
11/10/2013;11/10/2013;'TABASA VALLVI S. C:2T';-3,73 €;7.290,88 €;4281;-3,73;11.814,97 €;'sin fechas';11/10/2013;'TABASA';'Gastos_Ocio y transporte';'Parking y peaje';'VARIABLES'
12/10/2013;12/10/2013;'EROSKI-[COMIDA]';-39,97 €;7.250,91 €;4282;-39,97;11.775,00 €;'sin fechas';12/10/2013;'EROSKICOMIDA';'Gastos_Compras';'Supermercado';'VARIABLES'
12/10/2013;12/10/2013;'WWW.JUST-EAT.ES';-12,15 €;7.238,76 €;4283;-12,15;11.762,85 €;'sin fechas';12/10/2013;'WWWJUSTEATES';'Gastos_Ocio y transporte';'Restaurantes';'VARIABLES'
13/10/2013;13/10/2013;'CAFET.C T PRAT';-3,00 €;7.235,76 €;4284;-3,00;11.759,85 €;'sin fechas';13/10/2013;'CAFETC';'Gastos_Ocio y transporte';'Restaurantes';'VARIABLES'
13/10/2013;13/10/2013;'RESTAURANTES';-13,35 €;7.222,41 €;4285;-13,35;11.746,50 €;'sin fechas';13/10/2013;'RESTAURANTES';'Gastos_Ocio y transporte';'Restaurantes';'VARIABLES'
14/10/2013;14/10/2013;'AUTOPISTA TERR';-1,25 €;7.221,16 €;4287;-1,25;11.745,25 €;'sin fechas';14/10/2013;'AUTOPISTA';'Gastos_Ocio y transporte';'Parking y peaje';'VARIABLES'
14/10/2013;14/10/2013;'CAFET.C T PRAT';-3,60 €;7.217,56 €;4288;-3,60;11.741,65 €;'sin fechas';14/10/2013;'CAFETC';'Gastos_Ocio y transporte';'Restaurantes';'VARIABLES'
14/10/2013;14/10/2013;'FARMACIA';-25,73 €;7.191,83 €;4289;-25,73;11.715,92 €;'sin fechas';14/10/2013;'FARMACIA';'Gastos_Salud, saber y deporte';'Farmacia';'VARIABLES'
15/10/2013;15/10/2013;'AUTOPISTA TERR';-1,25 €;7.190,58 €;4290;-1,25;11.714,67 €;'sin fechas';15/10/2013;'AUTOPISTA';'Gastos_Ocio y transporte';'Parking y peaje';'VARIABLES'
15/10/2013;15/10/2013;'AUTOPISTA TERR';-1,25 €;7.189,33 €;4291;-1,25;11.713,42 €;'sin fechas';15/10/2013;'AUTOPISTA';'Gastos_Ocio y transporte';'Parking y peaje';'VARIABLES'
15/10/2013;15/10/2013;'BON AREA';-20,84 €;7.168,49 €;4292;-20,84;11.692,58 €;'sin fechas';15/10/2013;'BON';'Gastos_Compras';'Supermercado';'VARIABLES'
15/10/2013;15/10/2013;'CCM VIDA Y P SEGURO PRESTAMO';-24,51 €;7.143,98 €;4293;-24,51;11.668,07 €;'sin fechas';15/10/2013;'CCM';'Gastos_Seguros';'Seguro vida';'FIJO'
15/10/2013;15/10/2013;'CCM VIDA Y PENSIO 000000493358';-18,12 €;7.125,86 €;4294;-18,12;11.649,95 €;'sin fechas';15/10/2013;'CCM';'Gastos_Seguros';'Seguro vida';'FIJO'
15/10/2013;15/10/2013;'TABASA VALLVI S. C:2T';-3,73 €;7.122,13 €;4295;-3,73;11.646,22 €;'sin fechas';15/10/2013;'TABASA';'Gastos_Ocio y transporte';'Parking y peaje';'VARIABLES'
16/10/2013;16/10/2013;'AUTOPISTA TERR';-1,25 €;7.120,88 €;4296;-1,25;11.644,97 €;'sin fechas';16/10/2013;'AUTOPISTA';'Gastos_Ocio y transporte';'Parking y peaje';'VARIABLES'
16/10/2013;16/10/2013;'AUTOPISTA TERR';-1,25 €;7.119,63 €;4297;-1,25;11.643,72 €;'sin fechas';16/10/2013;'AUTOPISTA';'Gastos_Ocio y transporte';'Parking y peaje';'VARIABLES'
17/10/2013;17/10/2013;'AUTOPISTA TERR';-1,25 €;7.118,38 €;4298;-1,25;11.642,47 €;'sin fechas';17/10/2013;'AUTOPISTA';'Gastos_Ocio y transporte';'Parking y peaje';'VARIABLES'
17/10/2013;17/10/2013;'AUTOPISTA TERR';-1,39 €;7.116,99 €;4299;-1,39;11.641,08 €;'sin fechas';17/10/2013;'AUTOPISTA';'Gastos_Ocio y transporte';'Parking y peaje';'VARIABLES'
17/10/2013;17/10/2013;'CAFET.C T PRAT';-2,60 €;7.114,39 €;4300;-2,60;11.638,48 €;'sin fechas';17/10/2013;'CAFETC';'Gastos_Ocio y transporte';'Restaurantes';'VARIABLES'
17/10/2013;17/10/2013;'CAFET.C T PRAT';-4,30 €;7.110,09 €;4301;-4,30;11.634,18 €;'sin fechas';17/10/2013;'CAFETC';'Gastos_Ocio y transporte';'Restaurantes';'VARIABLES'
17/10/2013;17/10/2013;'COCHE&PARKING';-1,75 €;7.108,34 €;4302;-1,75;11.632,43 €;'sin fechas';17/10/2013;'COCHEPARKING';'Gastos_Ocio y transporte';'Parking y peaje';'VARIABLES'
17/10/2013;16/10/2013;'HOGAR&OTROS';-12,45 €;7.095,89 €;4303;-12,45;11.619,98 €;'sin fechas';16/10/2013;'HOGAROTROS';'Gastos_Vivienda y vehiculo';'Otros vivienda';'VARIABLES'
17/10/2013;16/10/2013;'HOGAR&OTROS';-50,00 €;7.045,89 €;4304;-50,00;11.569,98 €;'sin fechas';16/10/2013;'HOGAROTROS';'Gastos_Vivienda y vehiculo';'Otros vivienda';'VARIABLES'
17/10/2013;15/10/2013;'IKEA';-92,14 €;6.953,75 €;4305;-92,14;11.477,84 €;'sin fechas';15/10/2013;'IKEA';'Gastos_Vivienda y vehiculo';'Mnto. hogar';'VARIABLES'
17/10/2013;15/10/2013;'IKEA';-25,45 €;6.928,30 €;4306;-25,45;11.452,39 €;'sin fechas';15/10/2013;'IKEA';'Gastos_Vivienda y vehiculo';'Mnto. hogar';'VARIABLES'
17/10/2013;17/10/2013;'ONO';-112,63 €;6.815,67 €;4308;-112,63;11.339,76 €;'sin fechas';17/10/2013;'ONO';'Gastos_Servicios tipicos';'Telecomunicaciones';'FIJO'
17/10/2013;17/10/2013;'RESTAURANTES';-10,10 €;6.805,57 €;4309;-10,10;11.329,66 €;'sin fechas';17/10/2013;'RESTAURANTES';'Gastos_Ocio y transporte';'Restaurantes';'VARIABLES'
17/10/2013;17/10/2013;'TABASA VALLVI S. C:2T';-4,20 €;6.801,37 €;4310;-4,20;11.325,46 €;'sin fechas';17/10/2013;'TABASA';'Gastos_Ocio y transporte';'Parking y peaje';'VARIABLES'
17/10/2013;17/10/2013;'TOCINERIES VENTURA';-14,38 €;6.786,99 €;4311;-14,38;11.311,08 €;'sin fechas';17/10/2013;'TOCINERIES';'Gastos_Compras';'Supermercado';'VARIABLES'
17/10/2013;15/10/2013;'VIENA';-14,70 €;6.772,29 €;4312;-14,70;11.296,38 €;'sin fechas';15/10/2013;'VIENA';'Gastos_Ocio y transporte';'Restaurantes';'VARIABLES'
17/10/2013;15/10/2013;'VIENA';-2,20 €;6.770,09 €;4313;-2,20;11.294,18 €;'sin fechas';15/10/2013;'VIENA';'Gastos_Ocio y transporte';'Restaurantes';'VARIABLES'
18/10/2013;18/10/2013;'AUTOPISTA TERR';-1,11 €;6.768,98 €;4314;-1,11;11.293,07 €;'sin fechas';18/10/2013;'AUTOPISTA';'Gastos_Ocio y transporte';'Parking y peaje';'VARIABLES'
18/10/2013;18/10/2013;'AUTOPISTA TERR';-1,11 €;6.767,87 €;4315;-1,11;11.291,96 €;'sin fechas';18/10/2013;'AUTOPISTA';'Gastos_Ocio y transporte';'Parking y peaje';'VARIABLES'
18/10/2013;18/10/2013;'BON AREA';-15,31 €;6.752,56 €;4316;-15,31;11.276,65 €;'sin fechas';18/10/2013;'BON';'Gastos_Compras';'Supermercado';'VARIABLES'
18/10/2013;18/10/2013;'CAFET.C T PRAT';-3,35 €;6.749,21 €;4317;-3,35;11.273,30 €;'sin fechas';18/10/2013;'CAFETC';'Gastos_Ocio y transporte';'Restaurantes';'VARIABLES'
18/10/2013;18/10/2013;'ES STA. MARGARITA';-30,65 €;6.718,56 €;4318;-30,65;11.242,65 €;'sin fechas';18/10/2013;'STA';'Gastos_Ocio y transporte';'Gasolina';'VARIABLES'
18/10/2013;18/10/2013;'TABASA VALLVI S. C:2T';-3,73 €;6.714,83 €;4319;-3,73;11.238,92 €;'sin fechas';18/10/2013;'TABASA';'Gastos_Ocio y transporte';'Parking y peaje';'VARIABLES'
18/10/2013;18/10/2013;'VIENA';-9,35 €;6.705,48 €;4320;-9,35;11.229,57 €;'sin fechas';18/10/2013;'VIENA';'Gastos_Ocio y transporte';'Restaurantes';'VARIABLES'
19/10/2013;19/10/2013;'CAFET.C T PRAT';-2,70 €;6.702,78 €;4321;-2,70;11.226,87 €;'sin fechas';19/10/2013;'CAFETC';'Gastos_Ocio y transporte';'Restaurantes';'VARIABLES'
19/10/2013;19/10/2013;'EL CORTE INGLES';-5,00 €;6.697,78 €;4322;-5,00;11.221,87 €;'sin fechas';19/10/2013;'CORTE';'Gastos_Compras';'Supermercado';'VARIABLES'
19/10/2013;19/10/2013;'HOGAR&COMIDA';-1,00 €;6.696,78 €;4323;-1,00;11.220,87 €;'sin fechas';19/10/2013;'HOGARCOMIDA';'Gastos_Compras';'Supermercado';'VARIABLES'
19/10/2013;19/10/2013;'HOGAR&MODA';-49,90 €;6.646,88 €;4324;-49,90;11.170,97 €;'sin fechas';19/10/2013;'HOGARMODA';'Gastos_Compras';'Ropa';'VARIABLES'
21/10/2013;21/10/2013;'CAFET.C T PRAT';-4,05 €;6.642,83 €;4326;-4,05;11.166,92 €;'sin fechas';21/10/2013;'CAFETC';'Gastos_Ocio y transporte';'Restaurantes';'VARIABLES'
21/10/2013;21/10/2013;'MERCADONA';-161,82 €;6.481,01 €;4327;-161,82;11.005,10 €;'sin fechas';21/10/2013;'MERCADONA';'Gastos_Compras';'Supermercado';'VARIABLES'
23/10/2013;23/10/2013;'MERCADONA';-45,51 €;6.435,50 €;4328;-45,51;10.959,59 €;'sin fechas';23/10/2013;'MERCADONA';'Gastos_Compras';'Supermercado';'VARIABLES'
24/10/2013;24/10/2013;'CAFET.C T PRAT';-2,55 €;6.432,95 €;4329;-2,55;10.957,04 €;'sin fechas';24/10/2013;'CAFETC';'Gastos_Ocio y transporte';'Restaurantes';'VARIABLES'
24/10/2013;24/10/2013;'CAPRABO';-17,47 €;6.415,48 €;4330;-17,47;10.939,57 €;'sin fechas';24/10/2013;'CAPRABO';'Gastos_Compras';'Supermercado';'VARIABLES'
24/10/2013;22/10/2013;'CAPRABO';-6,15 €;6.409,33 €;4331;-6,15;10.933,42 €;'sin fechas';22/10/2013;'CAPRABO';'Gastos_Compras';'Supermercado';'VARIABLES'
24/10/2013;24/10/2013;'ES STA. MARGARITA';-30,00 €;6.379,33 €;4332;-30,00;10.903,42 €;'sin fechas';24/10/2013;'STA';'Gastos_Ocio y transporte';'Gasolina';'VARIABLES'
24/10/2013;22/10/2013;'HOGAR&COMIDA';-4,00 €;6.375,33 €;4333;-4,00;10.899,42 €;'sin fechas';22/10/2013;'HOGARCOMIDA';'Gastos_Compras';'Supermercado';'VARIABLES'
24/10/2013;23/10/2013;'HOGAR&OTROS';-16,40 €;6.358,93 €;4334;-16,40;10.883,02 €;'sin fechas';23/10/2013;'HOGAROTROS';'Gastos_Vivienda y vehiculo';'Otros vivienda';'VARIABLES'
24/10/2013;22/10/2013;'VIENA';-7,50 €;6.351,43 €;4335;-7,50;10.875,52 €;'sin fechas';22/10/2013;'VIENA';'Gastos_Ocio y transporte';'Restaurantes';'VARIABLES'
25/10/2013;25/10/2013;'CAFET.C T PRAT';-1,65 €;6.349,78 €;4336;-1,65;10.873,87 €;'sin fechas';25/10/2013;'CAFETC';'Gastos_Ocio y transporte';'Restaurantes';'VARIABLES'
25/10/2013;18/10/2013;'COCHE&PARKING';-4,80 €;6.344,98 €;4337;-4,80;10.869,07 €;'sin fechas';18/10/2013;'COCHEPARKING';'Gastos_Ocio y transporte';'Parking y peaje';'VARIABLES'
25/10/2013;25/10/2013;'GIFI';-89,73 €;6.255,25 €;4338;-89,73;10.779,34 €;'sin fechas';25/10/2013;'GIFI';'Gastos_Compras';'Hogar';'VARIABLES'
26/10/2013;28/10/2013;'A* CUOTA TARJETA PRINCIPAL';-18,00 €;6.237,25 €;4339;-18,00;10.761,34 €;'sin fechas';28/10/2013;'CUOTA';'Gastos_Banco y organismos';'Cargos banco';'FIJO'
26/10/2013;28/10/2013;'FOMENT DE TERRASSA, S.A. FOMEN';1.555,25 €;7.792,50 €;4340;1.555,25;12.316,59 €;'sin fechas';28/10/2013;'FOMENT';'Ingresos';'Nomina';'FIJO'
26/10/2013;26/10/2013;'HOGAR&OTROS';-10,00 €;7.782,50 €;4341;-10,00;12.306,59 €;'sin fechas';26/10/2013;'HOGAROTROS';'Gastos_Vivienda y vehiculo';'Otros vivienda';'VARIABLES'
26/10/2013;26/10/2013;'METRO BARCELONA';-4,00 €;7.778,50 €;4342;-4,00;12.302,59 €;'sin fechas';26/10/2013;'METRO';'Gastos_Ocio y transporte';'Transporte';'VARIABLES'
28/10/2013;28/10/2013;'AUTOPISTA TERR';-1,11 €;7.777,39 €;4343;-1,11;12.301,48 €;'sin fechas';28/10/2013;'AUTOPISTA';'Gastos_Ocio y transporte';'Parking y peaje';'VARIABLES'
28/10/2013;28/10/2013;'AUTOPISTA TERR';-1,11 €;7.776,28 €;4344;-1,11;12.300,37 €;'sin fechas';28/10/2013;'AUTOPISTA';'Gastos_Ocio y transporte';'Parking y peaje';'VARIABLES'
28/10/2013;28/10/2013;'CAFET.C T PRAT';-1,80 €;7.774,48 €;4345;-1,80;12.298,57 €;'sin fechas';28/10/2013;'CAFETC';'Gastos_Ocio y transporte';'Restaurantes';'VARIABLES'
28/10/2013;28/10/2013;'RESTAURANTES';-9,90 €;7.764,58 €;4346;-9,90;12.288,67 €;'sin fechas';28/10/2013;'RESTAURANTES';'Gastos_Ocio y transporte';'Restaurantes';'VARIABLES'
28/10/2013;28/10/2013;'VIENA';-21,75 €;7.742,83 €;4347;-21,75;12.266,92 €;'sin fechas';28/10/2013;'VIENA';'Gastos_Ocio y transporte';'Restaurantes';'VARIABLES'
29/10/2013;29/10/2013;'AUTOPISTA TERR';-1,11 €;7.741,72 €;4348;-1,11;12.265,81 €;'sin fechas';29/10/2013;'AUTOPISTA';'Gastos_Ocio y transporte';'Parking y peaje';'VARIABLES'
29/10/2013;29/10/2013;'AUTOPISTA TERR';-1,11 €;7.740,61 €;4349;-1,11;12.264,70 €;'sin fechas';29/10/2013;'AUTOPISTA';'Gastos_Ocio y transporte';'Parking y peaje';'VARIABLES'
29/10/2013;29/10/2013;'CAPRABO';-8,27 €;7.732,34 €;4350;-8,27;12.256,43 €;'sin fechas';29/10/2013;'CAPRABO';'Gastos_Compras';'Supermercado';'VARIABLES'
29/10/2013;29/10/2013;'INFORMACIO I TECNOLOGIA DE CAT';1.579,09 €;9.311,43 €;4351;1.579,09;13.835,52 €;'sin fechas';29/10/2013;'INFORMACIO';'Ingresos';'Nomina';'FIJO'
29/10/2013;29/10/2013;'JUGUETILANDIA TERR';-23,85 €;9.287,58 €;4352;-23,85;13.811,67 €;'sin fechas';29/10/2013;'JUGUETILANDIA';'Gastos_Compras';'Niños';'VARIABLES'
29/10/2013;29/10/2013;'RESTAURANTES';-11,75 €;9.275,83 €;4353;-11,75;13.799,92 €;'sin fechas';29/10/2013;'RESTAURANTES';'Gastos_Ocio y transporte';'Restaurantes';'VARIABLES'
30/10/2013;30/10/2013;'AUTOPISTA TERR';-1,11 €;9.274,72 €;4354;-1,11;13.798,81 €;'sin fechas';30/10/2013;'AUTOPISTA';'Gastos_Ocio y transporte';'Parking y peaje';'VARIABLES'
30/10/2013;30/10/2013;'AUTOPISTA TERR';-1,11 €;9.273,61 €;4355;-1,11;13.797,70 €;'sin fechas';30/10/2013;'AUTOPISTA';'Gastos_Ocio y transporte';'Parking y peaje';'VARIABLES'
30/10/2013;30/10/2013;'FRUITES I VERDURES';-7,94 €;9.265,67 €;4356;-7,94;13.789,76 €;'sin fechas';30/10/2013;'FRUITES';'Gastos_Compras';'Supermercado';'VARIABLES'
30/10/2013;30/10/2013;'TABASA VALLVI S. C:2T';-3,73 €;9.261,94 €;4357;-3,73;13.786,03 €;'sin fechas';30/10/2013;'TABASA';'Gastos_Ocio y transporte';'Parking y peaje';'VARIABLES'
31/10/2013;31/10/2013;'A.C.E.S.A B.MART.-L.SAP7S';-10,45 €;9.251,49 €;4358;-10,45;13.775,58 €;'sin fechas';31/10/2013;'ACESA';'Gastos_Ocio y transporte';'Parking y peaje';'VARIABLES'
31/10/2013;31/10/2013;'AUTOPISTA TERR';-7,00 €;9.244,49 €;4359;-7,00;13.768,58 €;'sin fechas';31/10/2013;'AUTOPISTA';'Gastos_Ocio y transporte';'Parking y peaje';'VARIABLES'
31/10/2013;31/10/2013;'AUTOPISTA TERR';-1,39 €;9.243,10 €;4360;-1,39;13.767,19 €;'sin fechas';31/10/2013;'AUTOPISTA';'Gastos_Ocio y transporte';'Parking y peaje';'VARIABLES'
31/10/2013;31/10/2013;'AUTOPISTA TERR';-1,11 €;9.241,99 €;4361;-1,11;13.766,08 €;'sin fechas';31/10/2013;'AUTOPISTA';'Gastos_Ocio y transporte';'Parking y peaje';'VARIABLES'
31/10/2013;31/10/2013;'AUTOPISTA TERR';-1,11 €;9.240,88 €;4362;-1,11;13.764,97 €;'sin fechas';31/10/2013;'AUTOPISTA';'Gastos_Ocio y transporte';'Parking y peaje';'VARIABLES'
31/10/2013;31/10/2013;'CAFET.C T PRAT';-2,60 €;9.238,28 €;4363;-2,60;13.762,37 €;'sin fechas';31/10/2013;'CAFETC';'Gastos_Ocio y transporte';'Restaurantes';'VARIABLES'
31/10/2013;29/10/2013;'CAPRABO';-11,72 €;9.226,56 €;4364;-11,72;13.750,65 €;'sin fechas';29/10/2013;'CAPRABO';'Gastos_Compras';'Supermercado';'VARIABLES'
31/10/2013;31/10/2013;'ES STA. MARGARITA';-50,54 €;9.176,02 €;4365;-50,54;13.700,11 €;'sin fechas';31/10/2013;'STA';'Gastos_Ocio y transporte';'Gasolina';'VARIABLES'
31/10/2013;29/10/2013;'FF.CC.GENERALITAT';-26,40 €;9.149,62 €;4366;-26,40;13.673,71 €;'sin fechas';29/10/2013;'FFCCGENERALITAT';'Gastos_Ocio y transporte';'Transporte';'VARIABLES'
31/10/2013;29/10/2013;'HOGAR&OTROS';-2,90 €;9.146,72 €;4368;-2,90;13.670,81 €;'sin fechas';29/10/2013;'HOGAROTROS';'Gastos_Vivienda y vehiculo';'Otros vivienda';'VARIABLES'
31/10/2013;31/10/2013;'MERCADONA';-22,68 €;9.124,04 €;4370;-22,68;13.648,13 €;'sin fechas';31/10/2013;'MERCADONA';'Gastos_Compras';'Supermercado';'VARIABLES'
31/10/2013;30/10/2013;'OCIO&CINES';-13,40 €;9.110,64 €;4371;-13,40;13.634,73 €;'sin fechas';30/10/2013;'OCIOCINES';'Gastos_Ocio y transporte';'Espectáculos';'VARIABLES'
31/10/2013;31/10/2013;'RECIBO PTMOS. 3061-0960001518';-562,73 €;8.547,91 €;4372;-562,73;13.072,00 €;'sin fechas';31/10/2013;'RECIBO';'Gastos_Banco y organismos';'Hipoteca';'FIJO'
31/10/2013;31/10/2013;'REINT.CAJERO';-110,00 €;8.437,91 €;4373;-110,00;12.962,00 €;'sin fechas';31/10/2013;'REINTCAJERO';'Gastos_Gastos varios';'Efectivo';'VARIABLES'
31/10/2013;30/10/2013;'RESTAURANTES';-18,00 €;8.419,91 €;4374;-18,00;12.944,00 €;'sin fechas';30/10/2013;'RESTAURANTES';'Gastos_Ocio y transporte';'Restaurantes';'VARIABLES'
31/10/2013;29/10/2013;'RESTAURANTES';-6,95 €;8.412,96 €;4375;-6,95;12.937,05 €;'sin fechas';29/10/2013;'RESTAURANTES';'Gastos_Ocio y transporte';'Restaurantes';'VARIABLES'
31/10/2013;29/10/2013;'RESTAURANTES';-2,20 €;8.410,76 €;4376;-2,20;12.934,85 €;'sin fechas';29/10/2013;'RESTAURANTES';'Gastos_Ocio y transporte';'Restaurantes';'VARIABLES'
31/10/2013;29/10/2013;'RESTAURANTES';-4,00 €;8.406,76 €;4377;-4,00;12.930,85 €;'sin fechas';29/10/2013;'RESTAURANTES';'Gastos_Ocio y transporte';'Restaurantes';'VARIABLES'
31/10/2013;30/10/2013;'VIENA';-9,35 €;8.397,41 €;4378;-9,35;12.921,50 €;'sin fechas';30/10/2013;'VIENA';'Gastos_Ocio y transporte';'Restaurantes';'VARIABLES'
01/11/2013;01/11/2013;'CAFET.C T PRAT';-0,90 €;8.396,51 €;4379;-0,90;12.920,60 €;'sin fechas';01/11/2013;'CAFETC';'Gastos_Ocio y transporte';'Restaurantes';'VARIABLES'
01/11/2013;01/11/2013;'CAFET.C T PRAT';-1,80 €;8.394,71 €;4380;-1,80;12.918,80 €;'sin fechas';01/11/2013;'CAFETC';'Gastos_Ocio y transporte';'Restaurantes';'VARIABLES'
01/11/2013;01/11/2013;'RESTAURANTES';-8,75 €;8.385,96 €;4384;-8,75;12.910,05 €;'sin fechas';01/11/2013;'RESTAURANTES';'Gastos_Ocio y transporte';'Restaurantes';'VARIABLES'
01/11/2013;01/11/2013;'VIENA';-10,05 €;8.375,91 €;4385;-10,05;12.900,00 €;'sin fechas';01/11/2013;'VIENA';'Gastos_Ocio y transporte';'Restaurantes';'VARIABLES'
02/11/2013;02/11/2013;'COMISIONES';-4,00 €;8.371,91 €;4386;-4,00;12.896,00 €;'sin fechas';02/11/2013;'COMISIONES';'Gastos_Banco y organismos';'Cargos banco';'FIJO'
02/11/2013;02/11/2013;'CAFET.C T PRAT';-3,20 €;8.368,71 €;4387;-3,20;12.892,80 €;'sin fechas';02/11/2013;'CAFETC';'Gastos_Ocio y transporte';'Restaurantes';'VARIABLES'
02/11/2013;02/11/2013;'REINT.CAJERO';-100,00 €;8.268,71 €;4388;-100,00;12.792,80 €;'sin fechas';02/11/2013;'REINTCAJERO';'Gastos_Gastos varios';'Efectivo';'VARIABLES'
02/11/2013;02/11/2013;'RESTAURANTES';-22,15 €;8.246,56 €;4389;-22,15;12.770,65 €;'sin fechas';02/11/2013;'RESTAURANTES';'Gastos_Ocio y transporte';'Restaurantes';'VARIABLES'
03/11/2013;03/11/2013;'A.C.E.S.A LSCAP7S.-B.MART';-10,45 €;8.236,11 €;4390;-10,45;12.760,20 €;'sin fechas';03/11/2013;'ACESA';'Gastos_Ocio y transporte';'Parking y peaje';'VARIABLES'
03/11/2013;03/11/2013;'AUTOPISTA TERR';-7,00 €;8.229,11 €;4391;-7,00;12.753,20 €;'sin fechas';03/11/2013;'AUTOPISTA';'Gastos_Ocio y transporte';'Parking y peaje';'VARIABLES'
03/11/2013;03/11/2013;'AUTOPISTA TERR';-2,53 €;8.226,58 €;4392;-2,53;12.750,67 €;'sin fechas';03/11/2013;'AUTOPISTA';'Gastos_Ocio y transporte';'Parking y peaje';'VARIABLES'
03/11/2013;03/11/2013;'CAFET.C T PRAT';-1,80 €;8.224,78 €;4393;-1,80;12.748,87 €;'sin fechas';03/11/2013;'CAFETC';'Gastos_Ocio y transporte';'Restaurantes';'VARIABLES'
03/11/2013;03/11/2013;'VIENA';-21,90 €;8.202,88 €;4394;-21,90;12.726,97 €;'sin fechas';03/11/2013;'VIENA';'Gastos_Ocio y transporte';'Restaurantes';'VARIABLES'
05/11/2013;05/11/2013;'AUTOPISTA TERR';-1,39 €;8.201,49 €;4395;-1,39;12.725,58 €;'sin fechas';05/11/2013;'AUTOPISTA';'Gastos_Ocio y transporte';'Parking y peaje';'VARIABLES'
05/11/2013;05/11/2013;'AUTOPISTA TERR';-1,39 €;8.200,10 €;4396;-1,39;12.724,19 €;'sin fechas';05/11/2013;'AUTOPISTA';'Gastos_Ocio y transporte';'Parking y peaje';'VARIABLES'
06/11/2013;06/11/2013;'AUTOPISTA TERR';-1,39 €;8.198,71 €;4398;-1,39;12.722,80 €;'sin fechas';06/11/2013;'AUTOPISTA';'Gastos_Ocio y transporte';'Parking y peaje';'VARIABLES'
06/11/2013;06/11/2013;'AUTOPISTA TERR';-1,39 €;8.197,32 €;4399;-1,39;12.721,41 €;'sin fechas';06/11/2013;'AUTOPISTA';'Gastos_Ocio y transporte';'Parking y peaje';'VARIABLES'
06/11/2013;06/11/2013;'TABASA VALLVI S. C:2T';-4,20 €;8.193,12 €;4400;-4,20;12.717,21 €;'sin fechas';06/11/2013;'TABASA';'Gastos_Ocio y transporte';'Parking y peaje';'VARIABLES'
07/11/2013;07/11/2013;'AUTOPISTA TERR';-1,39 €;8.191,73 €;4401;-1,39;12.715,82 €;'sin fechas';07/11/2013;'AUTOPISTA';'Gastos_Ocio y transporte';'Parking y peaje';'VARIABLES'
07/11/2013;07/11/2013;'AUTOPISTA TERR';-1,39 €;8.190,34 €;4402;-1,39;12.714,43 €;'sin fechas';07/11/2013;'AUTOPISTA';'Gastos_Ocio y transporte';'Parking y peaje';'VARIABLES'
07/11/2013;07/11/2013;'BLITZ';-72,50 €;8.117,84 €;4403;-72,50;12.641,93 €;'sin fechas';07/11/2013;'BLITZ';'Gastos_Vivienda y vehiculo';'Alquiler Parking';'FIJO'
07/11/2013;07/11/2013;'CITY HOGAR';-15,50 €;8.102,34 €;4404;-15,50;12.626,43 €;'sin fechas';07/11/2013;'CITY';'Gastos_Compras';'Otras compras';'VARIABLES'
07/11/2013;06/11/2013;'ES STA. MARGARITA';-15,00 €;8.087,34 €;4405;-15,00;12.611,43 €;'sin fechas';06/11/2013;'STA';'Gastos_Ocio y transporte';'Gasolina';'VARIABLES'
07/11/2013;07/11/2013;'GIFI';-31,12 €;8.056,22 €;4406;-31,12;12.580,31 €;'sin fechas';07/11/2013;'GIFI';'Gastos_Compras';'Hogar';'VARIABLES'
07/11/2013;07/11/2013;'TOT A 100 I MES';-20,00 €;8.036,22 €;4407;-20,00;12.560,31 €;'sin fechas';07/11/2013;'TOT';'Gastos_Compras';'Hogar';'VARIABLES'
07/11/2013;07/11/2013;'VIENA';-16,25 €;8.019,97 €;4408;-16,25;12.544,06 €;'sin fechas';07/11/2013;'VIENA';'Gastos_Ocio y transporte';'Restaurantes';'VARIABLES'
08/11/2013;08/11/2013;'AUTOPISTA TERR';-1,32 €;8.018,65 €;4409;-1,32;12.542,74 €;'sin fechas';08/11/2013;'AUTOPISTA';'Gastos_Ocio y transporte';'Parking y peaje';'VARIABLES'
08/11/2013;08/11/2013;'AUTOPISTA TERR';-1,32 €;8.017,33 €;4410;-1,32;12.541,42 €;'sin fechas';08/11/2013;'AUTOPISTA';'Gastos_Ocio y transporte';'Parking y peaje';'VARIABLES'
08/11/2013;08/11/2013;'CAFET.C T PRAT';-3,50 €;8.013,83 €;4412;-3,50;12.537,92 €;'sin fechas';08/11/2013;'CAFETC';'Gastos_Ocio y transporte';'Restaurantes';'VARIABLES'
08/11/2013;08/11/2013;'CARREFOUR-[OTROS]';-36,46 €;7.977,37 €;4413;-36,46;12.501,46 €;'sin fechas';08/11/2013;'CARREFOUROTROS';'Gastos_Compras';'Supermercado';'VARIABLES'
08/11/2013;08/11/2013;'HOGAR&COMIDA';-3,66 €;7.973,71 €;4414;-3,66;12.497,80 €;'sin fechas';08/11/2013;'HOGARCOMIDA';'Gastos_Compras';'Supermercado';'VARIABLES'
08/11/2013;08/11/2013;'REINT.CAJERO';-20,00 €;7.953,71 €;4415;-20,00;12.477,80 €;'sin fechas';08/11/2013;'REINTCAJERO';'Gastos_Gastos varios';'Efectivo';'VARIABLES'
08/11/2013;08/11/2013;'SALA BADRINAS - MENJADOR';-116,62 €;7.837,09 €;4417;-116,62;12.361,18 €;'sin fechas';08/11/2013;'SALA';'Gastos_Salud, saber y deporte';'Estudios';'VARIABLES'
08/11/2013;08/11/2013;'TABASA VALLVI S. C:2T';-4,20 €;7.832,89 €;4418;-4,20;12.356,98 €;'sin fechas';08/11/2013;'TABASA';'Gastos_Ocio y transporte';'Parking y peaje';'VARIABLES'
09/11/2013;09/11/2013;'CAFET.C T PRAT';-3,85 €;7.829,04 €;4419;-3,85;12.353,13 €;'sin fechas';09/11/2013;'CAFETC';'Gastos_Ocio y transporte';'Restaurantes';'VARIABLES'
10/11/2013;10/11/2013;'CAFET.C T PRAT';-2,65 €;7.826,39 €;4420;-2,65;12.350,48 €;'sin fechas';10/11/2013;'CAFETC';'Gastos_Ocio y transporte';'Restaurantes';'VARIABLES'
10/11/2013;10/11/2013;'REINT.CAJERO';-100,00 €;7.726,39 €;4422;-100,00;12.250,48 €;'sin fechas';10/11/2013;'REINTCAJERO';'Gastos_Gastos varios';'Efectivo';'VARIABLES'
11/11/2013;11/11/2013;'ADESLAS CENTRAL 006662671613';-110,65 €;7.615,74 €;4423;-110,65;12.139,83 €;'sin fechas';11/11/2013;'ADESLAS';'Gastos_Salud, saber y deporte';'Medico';'VARIABLES'
11/11/2013;11/11/2013;'AUTOPISTA TERR';-1,32 €;7.614,42 €;4424;-1,32;12.138,51 €;'sin fechas';11/11/2013;'AUTOPISTA';'Gastos_Ocio y transporte';'Parking y peaje';'VARIABLES'
11/11/2013;11/11/2013;'AUTOPISTA TERR';-1,39 €;7.613,03 €;4425;-1,39;12.137,12 €;'sin fechas';11/11/2013;'AUTOPISTA';'Gastos_Ocio y transporte';'Parking y peaje';'VARIABLES'
11/11/2013;11/11/2013;'CAFET.C T PRAT';-3,60 €;7.609,43 €;4426;-3,60;12.133,52 €;'sin fechas';11/11/2013;'CAFETC';'Gastos_Ocio y transporte';'Restaurantes';'VARIABLES'
11/11/2013;11/11/2013;'ES STA. MARGARITA';-30,00 €;7.579,43 €;4427;-30,00;12.103,52 €;'sin fechas';11/11/2013;'STA';'Gastos_Ocio y transporte';'Gasolina';'VARIABLES'
11/11/2013;11/11/2013;'ESCOLA BRESSOL EINA';-467,15 €;7.112,28 €;4429;-467,15;11.636,37 €;'sin fechas';11/11/2013;'ESCOLA';'Gastos_Salud, saber y deporte';'Estudios';'VARIABLES'
11/11/2013;11/11/2013;'TABASA VALLVI S. C:2T';-4,20 €;7.108,08 €;4430;-4,20;11.632,17 €;'sin fechas';11/11/2013;'TABASA';'Gastos_Ocio y transporte';'Parking y peaje';'VARIABLES'
12/11/2013;12/11/2013;'AUTOPISTA TERR';-1,32 €;7.106,76 €;4431;-1,32;11.630,85 €;'sin fechas';12/11/2013;'AUTOPISTA';'Gastos_Ocio y transporte';'Parking y peaje';'VARIABLES'
12/11/2013;12/11/2013;'AUTOPISTA TERR';-1,32 €;7.105,44 €;4432;-1,32;11.629,53 €;'sin fechas';12/11/2013;'AUTOPISTA';'Gastos_Ocio y transporte';'Parking y peaje';'VARIABLES'
12/11/2013;12/11/2013;'SALA BADRINAS - QUOTA';-54,00 €;7.051,44 €;4434;-54,00;11.575,53 €;'sin fechas';12/11/2013;'SALA';'Gastos_Salud, saber y deporte';'Estudios';'VARIABLES'
12/11/2013;12/11/2013;'TABASA VALLVI S. C:2T';-3,73 €;7.047,71 €;4436;-3,73;11.571,80 €;'sin fechas';12/11/2013;'TABASA';'Gastos_Ocio y transporte';'Parking y peaje';'VARIABLES'
12/11/2013;12/11/2013;'COMISIONES';-1,50 €;7.046,21 €;4437;-1,50;11.570,30 €;'sin fechas';12/11/2013;'COMISIONES';'Gastos_Banco y organismos';'Cargos banco';'FIJO'
13/11/2013;13/11/2013;'AUTOPISTA TERR';-1,25 €;7.044,96 €;4438;-1,25;11.569,05 €;'sin fechas';13/11/2013;'AUTOPISTA';'Gastos_Ocio y transporte';'Parking y peaje';'VARIABLES'
13/11/2013;13/11/2013;'AUTOPISTA TERR';-1,25 €;7.043,71 €;4439;-1,25;11.567,80 €;'sin fechas';13/11/2013;'AUTOPISTA';'Gastos_Ocio y transporte';'Parking y peaje';'VARIABLES'
13/11/2013;13/11/2013;'TABASA VALLVI S. C:2T';-4,20 €;7.039,51 €;4440;-4,20;11.563,60 €;'sin fechas';13/11/2013;'TABASA';'Gastos_Ocio y transporte';'Parking y peaje';'VARIABLES'
14/11/2013;14/11/2013;'AUTOPISTA TERR';-1,25 €;7.038,26 €;4441;-1,25;11.562,35 €;'sin fechas';14/11/2013;'AUTOPISTA';'Gastos_Ocio y transporte';'Parking y peaje';'VARIABLES'
14/11/2013;14/11/2013;'AUTOPISTA TERR';-1,39 €;7.036,87 €;4442;-1,39;11.560,96 €;'sin fechas';14/11/2013;'AUTOPISTA';'Gastos_Ocio y transporte';'Parking y peaje';'VARIABLES'
14/11/2013;14/11/2013;'CAFET.C T PRAT';-4,50 €;7.032,37 €;4443;-4,50;11.556,46 €;'sin fechas';14/11/2013;'CAFETC';'Gastos_Ocio y transporte';'Restaurantes';'VARIABLES'
14/11/2013;14/11/2013;'FRUITES I VERDURES';-4,58 €;7.027,79 €;4444;-4,58;11.551,88 €;'sin fechas';14/11/2013;'FRUITES';'Gastos_Compras';'Supermercado';'VARIABLES'
14/11/2013;13/11/2013;'HOGAR&OTROS';-37,35 €;6.990,44 €;4445;-37,35;11.514,53 €;'sin fechas';13/11/2013;'HOGAROTROS';'Gastos_Vivienda y vehiculo';'Otros vivienda';'VARIABLES'
14/11/2013;12/11/2013;'MERCADONA';-38,86 €;6.951,58 €;4446;-38,86;11.475,67 €;'sin fechas';12/11/2013;'MERCADONA';'Gastos_Compras';'Supermercado';'VARIABLES'
14/11/2013;14/11/2013;'TABASA VALLVI S. C:2T';-4,20 €;6.947,38 €;4447;-4,20;11.471,47 €;'sin fechas';14/11/2013;'TABASA';'Gastos_Ocio y transporte';'Parking y peaje';'VARIABLES'
15/11/2013;15/11/2013;'AUTOPISTA TERR';-1,25 €;6.946,13 €;4448;-1,25;11.470,22 €;'sin fechas';15/11/2013;'AUTOPISTA';'Gastos_Ocio y transporte';'Parking y peaje';'VARIABLES'
15/11/2013;15/11/2013;'AUTOPISTA TERR';-1,25 €;6.944,88 €;4449;-1,25;11.468,97 €;'sin fechas';15/11/2013;'AUTOPISTA';'Gastos_Ocio y transporte';'Parking y peaje';'VARIABLES'
15/11/2013;15/11/2013;'CAFET.C T PRAT';-1,80 €;6.943,08 €;4450;-1,80;11.467,17 €;'sin fechas';15/11/2013;'CAFETC';'Gastos_Ocio y transporte';'Restaurantes';'VARIABLES'
15/11/2013;15/11/2013;'CCM VIDA Y P SEGURO PRESTAMO';-24,45 €;6.918,63 €;4451;-24,45;11.442,72 €;'sin fechas';15/11/2013;'CCM';'Gastos_Seguros';'Seguro vida';'FIJO'
15/11/2013;15/11/2013;'CCM VIDA Y PENSIO 000000493358';-18,07 €;6.900,56 €;4452;-18,07;11.424,65 €;'sin fechas';15/11/2013;'CCM';'Gastos_Seguros';'Seguro vida';'FIJO'
15/11/2013;15/11/2013;'TABASA VALLVI S. C:2T';-4,20 €;6.896,36 €;4453;-4,20;11.420,45 €;'sin fechas';15/11/2013;'TABASA';'Gastos_Ocio y transporte';'Parking y peaje';'VARIABLES'
16/11/2013;16/11/2013;'CAFET.C T PRAT';-3,60 €;6.892,76 €;4454;-3,60;11.416,85 €;'sin fechas';16/11/2013;'CAFETC';'Gastos_Ocio y transporte';'Restaurantes';'VARIABLES'
16/11/2013;16/11/2013;'MERCADONA';-182,87 €;6.709,89 €;4455;-182,87;11.233,98 €;'sin fechas';16/11/2013;'MERCADONA';'Gastos_Compras';'Supermercado';'VARIABLES'
17/11/2013;17/11/2013;'BON AREA';-21,74 €;6.688,15 €;4456;-21,74;11.212,24 €;'sin fechas';17/11/2013;'BON';'Gastos_Compras';'Supermercado';'VARIABLES'
17/11/2013;17/11/2013;'CAFET.C T PRAT';-2,65 €;6.685,50 €;4457;-2,65;11.209,59 €;'sin fechas';17/11/2013;'CAFETC';'Gastos_Ocio y transporte';'Restaurantes';'VARIABLES'
18/11/2013;18/11/2013;'AUTOPISTA TERR';-1,39 €;6.684,11 €;4458;-1,39;11.208,20 €;'sin fechas';18/11/2013;'AUTOPISTA';'Gastos_Ocio y transporte';'Parking y peaje';'VARIABLES'
18/11/2013;18/11/2013;'AUTOPISTA TERR';-1,25 €;6.682,86 €;4459;-1,25;11.206,95 €;'sin fechas';18/11/2013;'AUTOPISTA';'Gastos_Ocio y transporte';'Parking y peaje';'VARIABLES'
18/11/2013;18/11/2013;'AUTOPISTA TERR';-1,25 €;6.681,61 €;4460;-1,25;11.205,70 €;'sin fechas';18/11/2013;'AUTOPISTA';'Gastos_Ocio y transporte';'Parking y peaje';'VARIABLES'
18/11/2013;18/11/2013;'AUTOPISTA TERR';-1,39 €;6.680,22 €;4461;-1,39;11.204,31 €;'sin fechas';18/11/2013;'AUTOPISTA';'Gastos_Ocio y transporte';'Parking y peaje';'VARIABLES'
18/11/2013;18/11/2013;'CAFET.C T PRAT';-4,05 €;6.676,17 €;4462;-4,05;11.200,26 €;'sin fechas';18/11/2013;'CAFETC';'Gastos_Ocio y transporte';'Restaurantes';'VARIABLES'
18/11/2013;18/11/2013;'ONO';-112,41 €;6.563,76 €;4463;-112,41;11.087,85 €;'sin fechas';18/11/2013;'ONO';'Gastos_Servicios tipicos';'Telecomunicaciones';'FIJO'
18/11/2013;18/11/2013;'TABASA VALLVI S. C:2T';-4,20 €;6.559,56 €;4465;-4,20;11.083,65 €;'sin fechas';18/11/2013;'TABASA';'Gastos_Ocio y transporte';'Parking y peaje';'VARIABLES'
18/11/2013;18/11/2013;'TOCINERIES VENTURA';-6,35 €;6.553,21 €;4466;-6,35;11.077,30 €;'sin fechas';18/11/2013;'TOCINERIES';'Gastos_Compras';'Supermercado';'VARIABLES'
21/11/2013;21/11/2013;'AUTOPISTA TERR';-1,25 €;6.551,96 €;4468;-1,25;11.076,05 €;'sin fechas';21/11/2013;'AUTOPISTA';'Gastos_Ocio y transporte';'Parking y peaje';'VARIABLES'
21/11/2013;21/11/2013;'CAFET.C T PRAT';-2,65 €;6.549,31 €;4469;-2,65;11.073,40 €;'sin fechas';21/11/2013;'CAFETC';'Gastos_Ocio y transporte';'Restaurantes';'VARIABLES'
21/11/2013;21/11/2013;'ES STA. MARGARITA';-48,42 €;6.500,89 €;4470;-48,42;11.024,98 €;'sin fechas';21/11/2013;'STA';'Gastos_Ocio y transporte';'Gasolina';'VARIABLES'
21/11/2013;21/11/2013;'FARMACIA';-3,12 €;6.497,77 €;4471;-3,12;11.021,86 €;'sin fechas';21/11/2013;'FARMACIA';'Gastos_Salud, saber y deporte';'Farmacia';'VARIABLES'
21/11/2013;21/11/2013;'FARMACIA';-8,27 €;6.489,50 €;4472;-8,27;11.013,59 €;'sin fechas';21/11/2013;'FARMACIA';'Gastos_Salud, saber y deporte';'Farmacia';'VARIABLES'
21/11/2013;20/11/2013;'HOGAR&OTROS';-12,45 €;6.477,05 €;4473;-12,45;11.001,14 €;'sin fechas';20/11/2013;'HOGAROTROS';'Gastos_Vivienda y vehiculo';'Otros vivienda';'VARIABLES'
21/11/2013;21/11/2013;'TOCINERIES VENTURA';-10,07 €;6.466,98 €;4474;-10,07;10.991,07 €;'sin fechas';21/11/2013;'TOCINERIES';'Gastos_Compras';'Supermercado';'VARIABLES'
22/11/2013;22/11/2013;'AUTOPISTA TERR';-1,39 €;6.465,59 €;4475;-1,39;10.989,68 €;'sin fechas';22/11/2013;'AUTOPISTA';'Gastos_Ocio y transporte';'Parking y peaje';'VARIABLES'
22/11/2013;22/11/2013;'AUTOPISTA TERR';-1,39 €;6.464,20 €;4476;-1,39;10.988,29 €;'sin fechas';22/11/2013;'AUTOPISTA';'Gastos_Ocio y transporte';'Parking y peaje';'VARIABLES'
22/11/2013;22/11/2013;'CAFET.C T PRAT';-2,65 €;6.461,55 €;4477;-2,65;10.985,64 €;'sin fechas';22/11/2013;'CAFETC';'Gastos_Ocio y transporte';'Restaurantes';'VARIABLES'
23/11/2013;23/11/2013;'CAFET.C T PRAT';-1,80 €;6.459,75 €;4478;-1,80;10.983,84 €;'sin fechas';23/11/2013;'CAFETC';'Gastos_Ocio y transporte';'Restaurantes';'VARIABLES'
23/11/2013;23/11/2013;'REINT.CAJERO';-200,00 €;6.259,75 €;4479;-200,00;10.783,84 €;'sin fechas';23/11/2013;'REINTCAJERO';'Gastos_Gastos varios';'Efectivo';'VARIABLES'
24/11/2013;24/11/2013;'CAFET.C T PRAT';-2,60 €;6.257,15 €;4480;-2,60;10.781,24 €;'sin fechas';24/11/2013;'CAFETC';'Gastos_Ocio y transporte';'Restaurantes';'VARIABLES'
24/11/2013;24/11/2013;'HOGAR&OTROS';-18,90 €;6.238,25 €;4481;-18,90;10.762,34 €;'sin fechas';24/11/2013;'HOGAROTROS';'Gastos_Vivienda y vehiculo';'Otros vivienda';'VARIABLES'
25/11/2013;25/11/2013;'CAFET.C T PRAT';-3,60 €;6.234,65 €;4482;-3,60;10.758,74 €;'sin fechas';25/11/2013;'CAFETC';'Gastos_Ocio y transporte';'Restaurantes';'VARIABLES'
25/11/2013;25/11/2013;'RESTAURANTES';-19,45 €;6.215,20 €;4483;-19,45;10.739,29 €;'sin fechas';25/11/2013;'RESTAURANTES';'Gastos_Ocio y transporte';'Restaurantes';'VARIABLES'
25/11/2013;25/11/2013;'SATSA PL. VELLA TERRASSA';-5,00 €;6.210,20 €;4484;-5,00;10.734,29 €;'sin fechas';25/11/2013;'SATSA';'Gastos_Ocio y transporte';'Parking y peaje';'VARIABLES'
25/11/2013;25/11/2013;'VIENA';-16,15 €;6.194,05 €;4485;-16,15;10.718,14 €;'sin fechas';25/11/2013;'VIENA';'Gastos_Ocio y transporte';'Restaurantes';'VARIABLES'
26/11/2013;26/11/2013;'AUTOPISTA TERR';-1,25 €;6.192,80 €;4486;-1,25;10.716,89 €;'sin fechas';26/11/2013;'AUTOPISTA';'Gastos_Ocio y transporte';'Parking y peaje';'VARIABLES'
26/11/2013;26/11/2013;'AUTOPISTA TERR';-1,39 €;6.191,41 €;4487;-1,39;10.715,50 €;'sin fechas';26/11/2013;'AUTOPISTA';'Gastos_Ocio y transporte';'Parking y peaje';'VARIABLES'
27/11/2013;27/11/2013;'AUTOPISTA TERR';-1,11 €;6.190,30 €;4488;-1,11;10.714,39 €;'sin fechas';27/11/2013;'AUTOPISTA';'Gastos_Ocio y transporte';'Parking y peaje';'VARIABLES'
27/11/2013;27/11/2013;'AUTOPISTA TERR';-1,25 €;6.189,05 €;4489;-1,25;10.713,14 €;'sin fechas';27/11/2013;'AUTOPISTA';'Gastos_Ocio y transporte';'Parking y peaje';'VARIABLES'
28/11/2013;28/11/2013;'AUTOPISTA TERR';-1,11 €;6.187,94 €;4490;-1,11;10.712,03 €;'sin fechas';28/11/2013;'AUTOPISTA';'Gastos_Ocio y transporte';'Parking y peaje';'VARIABLES'
28/11/2013;28/11/2013;'AUTOPISTA TERR';-1,39 €;6.186,55 €;4491;-1,39;10.710,64 €;'sin fechas';28/11/2013;'AUTOPISTA';'Gastos_Ocio y transporte';'Parking y peaje';'VARIABLES'
28/11/2013;28/11/2013;'CATALA GRANADOS SL';-49,17 €;6.137,38 €;4492;-49,17;10.661,47 €;'sin fechas';28/11/2013;'CATALA';'Gastos_Ocio y transporte';'Gasolina';'VARIABLES'
28/11/2013;28/11/2013;'FOMENT DE TERRASSA, S.A. FOMEN';1.580,80 €;7.718,18 €;4493;1.580,80;12.242,27 €;'sin fechas';28/11/2013;'FOMENT';'Ingresos';'Nomina';'FIJO'
28/11/2013;26/11/2013;'GIFI';-41,35 €;7.676,83 €;4495;-41,35;12.200,92 €;'sin fechas';26/11/2013;'GIFI';'Gastos_Compras';'Hogar';'VARIABLES'
28/11/2013;28/11/2013;'INFORMACIO I TECNOLOGIA DE CAT';1.579,09 €;9.255,92 €;4496;1.579,09;13.780,01 €;'sin fechas';28/11/2013;'INFORMACIO';'Ingresos';'Nomina';'FIJO'
28/11/2013;26/11/2013;'OCIO&CINES';-15,40 €;9.240,52 €;4498;-15,40;13.764,61 €;'sin fechas';26/11/2013;'OCIOCINES';'Gastos_Ocio y transporte';'Espectáculos';'VARIABLES'
28/11/2013;28/11/2013;'VIENA';-9,50 €;9.231,02 €;4499;-9,50;13.755,11 €;'sin fechas';28/11/2013;'VIENA';'Gastos_Ocio y transporte';'Restaurantes';'VARIABLES'
29/11/2013;29/11/2013;'AJUNTAMENT DE TER 010000520716';-44,21 €;9.186,81 €;4500;-44,21;13.710,90 €;'sin fechas';29/11/2013;'AJUNTAMENT';'Gastos_Banco y organismos';'Ayuntamiento';'FIJO'
29/11/2013;29/11/2013;'AUTOPISTA TERR';-1,11 €;9.185,70 €;4501;-1,11;13.709,79 €;'sin fechas';29/11/2013;'AUTOPISTA';'Gastos_Ocio y transporte';'Parking y peaje';'VARIABLES'
29/11/2013;29/11/2013;'AUTOPISTA TERR';-1,39 €;9.184,31 €;4502;-1,39;13.708,40 €;'sin fechas';29/11/2013;'AUTOPISTA';'Gastos_Ocio y transporte';'Parking y peaje';'VARIABLES'
29/11/2013;25/11/2013;'AUTOPISTA TERR';-1,39 €;9.182,92 €;4503;-1,39;13.707,01 €;'sin fechas';25/11/2013;'AUTOPISTA';'Gastos_Ocio y transporte';'Parking y peaje';'VARIABLES'
29/11/2013;29/11/2013;'TABASA VALLVI S. C:2T';-4,20 €;9.178,72 €;4504;-4,20;13.702,81 €;'sin fechas';29/11/2013;'TABASA';'Gastos_Ocio y transporte';'Parking y peaje';'VARIABLES'
30/11/2013;30/11/2013;'AUTOPISTA TERR';-2,53 €;9.176,19 €;4505;-2,53;13.700,28 €;'sin fechas';30/11/2013;'AUTOPISTA';'Gastos_Ocio y transporte';'Parking y peaje';'VARIABLES'
30/11/2013;30/11/2013;'AUTOPISTA TERR';-2,53 €;9.173,66 €;4506;-2,53;13.697,75 €;'sin fechas';30/11/2013;'AUTOPISTA';'Gastos_Ocio y transporte';'Parking y peaje';'VARIABLES'
30/11/2013;30/11/2013;'FRUITES I VERDURES';-2,21 €;9.171,45 €;4507;-2,21;13.695,54 €;'sin fechas';30/11/2013;'FRUITES';'Gastos_Compras';'Supermercado';'VARIABLES'
30/11/2013;30/11/2013;'RECIBO PTMOS. 3061-0960001518';-562,73 €;8.608,72 €;4508;-562,73;13.132,81 €;'sin fechas';30/11/2013;'RECIBO';'Gastos_Banco y organismos';'Hipoteca';'FIJO'
30/11/2013;30/11/2013;'TACISA';-36,98 €;8.571,74 €;4509;-36,98;13.095,83 €;'sin fechas';30/11/2013;'TACISA';'Gastos_Compras';'Supermercado';'VARIABLES'
01/12/2013;01/12/2013;'CAFET.C T PRAT';-2,65 €;8.569,09 €;4510;-2,65;13.093,18 €;'sin fechas';01/12/2013;'CAFETC';'Gastos_Ocio y transporte';'Restaurantes';'VARIABLES'
02/12/2013;02/12/2013;'AUTOPISTA TERR';-1,39 €;8.567,70 €;4514;-1,39;13.091,79 €;'sin fechas';02/12/2013;'AUTOPISTA';'Gastos_Ocio y transporte';'Parking y peaje';'VARIABLES'
02/12/2013;02/12/2013;'AUTOPISTA TERR';-1,39 €;8.566,31 €;4515;-1,39;13.090,40 €;'sin fechas';02/12/2013;'AUTOPISTA';'Gastos_Ocio y transporte';'Parking y peaje';'VARIABLES'
02/12/2013;02/12/2013;'CAFET.C T PRAT';-3,60 €;8.562,71 €;4516;-3,60;13.086,80 €;'sin fechas';02/12/2013;'CAFETC';'Gastos_Ocio y transporte';'Restaurantes';'VARIABLES'
02/12/2013;26/11/2013;'COCHE&PARKING';-3,00 €;8.559,71 €;4517;-3,00;13.083,80 €;'sin fechas';26/11/2013;'COCHEPARKING';'Gastos_Ocio y transporte';'Parking y peaje';'VARIABLES'
02/12/2013;02/12/2013;'REINT.CAJERO';-100,00 €;8.459,71 €;4518;-100,00;12.983,80 €;'sin fechas';02/12/2013;'REINTCAJERO';'Gastos_Gastos varios';'Efectivo';'VARIABLES'
02/12/2013;02/12/2013;'TABASA VALLVI S. C:2T';-4,20 €;8.455,51 €;4519;-4,20;12.979,60 €;'sin fechas';02/12/2013;'TABASA';'Gastos_Ocio y transporte';'Parking y peaje';'VARIABLES'
03/12/2013;03/12/2013;'AUTOPISTA TERR';-1,39 €;8.454,12 €;4520;-1,39;12.978,21 €;'sin fechas';03/12/2013;'AUTOPISTA';'Gastos_Ocio y transporte';'Parking y peaje';'VARIABLES'
03/12/2013;03/12/2013;'AUTOPISTA TERR';-1,39 €;8.452,73 €;4521;-1,39;12.976,82 €;'sin fechas';03/12/2013;'AUTOPISTA';'Gastos_Ocio y transporte';'Parking y peaje';'VARIABLES'
03/12/2013;03/12/2013;'TABASA VALLVI S. C:2T';-4,20 €;8.448,53 €;4522;-4,20;12.972,62 €;'sin fechas';03/12/2013;'TABASA';'Gastos_Ocio y transporte';'Parking y peaje';'VARIABLES'
04/12/2013;04/12/2013;'AUTOPISTA TERR';-1,39 €;8.447,14 €;4523;-1,39;12.971,23 €;'sin fechas';04/12/2013;'AUTOPISTA';'Gastos_Ocio y transporte';'Parking y peaje';'VARIABLES'
04/12/2013;04/12/2013;'AUTOPISTA TERR';-1,39 €;8.445,75 €;4524;-1,39;12.969,84 €;'sin fechas';04/12/2013;'AUTOPISTA';'Gastos_Ocio y transporte';'Parking y peaje';'VARIABLES'
04/12/2013;04/12/2013;'TABASA VALLVI S. C:2T';-3,73 €;8.442,02 €;4525;-3,73;12.966,11 €;'sin fechas';04/12/2013;'TABASA';'Gastos_Ocio y transporte';'Parking y peaje';'VARIABLES'
05/12/2013;05/12/2013;'AUTOPISTA TERR';-1,39 €;8.440,63 €;4527;-1,39;12.964,72 €;'sin fechas';05/12/2013;'AUTOPISTA';'Gastos_Ocio y transporte';'Parking y peaje';'VARIABLES'
05/12/2013;05/12/2013;'AUTOPISTA TERR';-1,39 €;8.439,24 €;4528;-1,39;12.963,33 €;'sin fechas';05/12/2013;'AUTOPISTA';'Gastos_Ocio y transporte';'Parking y peaje';'VARIABLES'
05/12/2013;05/12/2013;'CAFET.C T PRAT';-1,80 €;8.437,44 €;4529;-1,80;12.961,53 €;'sin fechas';05/12/2013;'CAFETC';'Gastos_Ocio y transporte';'Restaurantes';'VARIABLES'
05/12/2013;05/12/2013;'COM. MANT. ACTIVAS DE LIQ.';-4,50 €;8.432,94 €;4530;-4,50;12.957,03 €;'sin fechas';05/12/2013;'COM';'Gastos_Banco y organismos';'Cargos banco';'FIJO'
05/12/2013;05/12/2013;'FARMACIA';-10,95 €;8.421,99 €;4531;-10,95;12.946,08 €;'sin fechas';05/12/2013;'FARMACIA';'Gastos_Salud, saber y deporte';'Farmacia';'VARIABLES'
05/12/2013;05/12/2013;'HOGAR&OTROS';-26,25 €;8.395,74 €;4532;-26,25;12.919,83 €;'sin fechas';05/12/2013;'HOGAROTROS';'Gastos_Vivienda y vehiculo';'Otros vivienda';'VARIABLES'
05/12/2013;03/12/2013;'KIABI';-77,92 €;8.317,82 €;4533;-77,92;12.841,91 €;'sin fechas';03/12/2013;'KIABI';'Gastos_Compras';'Ropa';'VARIABLES'
05/12/2013;03/12/2013;'MERCADONA';-57,27 €;8.260,55 €;4534;-57,27;12.784,64 €;'sin fechas';03/12/2013;'MERCADONA';'Gastos_Compras';'Supermercado';'VARIABLES'
05/12/2013;04/12/2013;'OCIO&CINES';-17,50 €;8.243,05 €;4535;-17,50;12.767,14 €;'sin fechas';04/12/2013;'OCIOCINES';'Gastos_Ocio y transporte';'Espectáculos';'VARIABLES'
05/12/2013;05/12/2013;'RESTAURANTES';-7,45 €;8.235,60 €;4536;-7,45;12.759,69 €;'sin fechas';05/12/2013;'RESTAURANTES';'Gastos_Ocio y transporte';'Restaurantes';'VARIABLES'
05/12/2013;03/12/2013;'RESTAURANTES';-22,25 €;8.213,35 €;4537;-22,25;12.737,44 €;'sin fechas';03/12/2013;'RESTAURANTES';'Gastos_Ocio y transporte';'Restaurantes';'VARIABLES'
05/12/2013;05/12/2013;'TABASA VALLVI S. C:2T';-4,20 €;8.209,15 €;4538;-4,20;12.733,24 €;'sin fechas';05/12/2013;'TABASA';'Gastos_Ocio y transporte';'Parking y peaje';'VARIABLES'
06/12/2013;06/12/2013;'A.C.E.S.A A.VENDR.-B.MART';-5,95 €;8.203,20 €;4539;-5,95;12.727,29 €;'sin fechas';06/12/2013;'ACESA';'Gastos_Ocio y transporte';'Parking y peaje';'VARIABLES'
06/12/2013;06/12/2013;'A.C.E.S.A B.MART.-A.REUS';-9,80 €;8.193,40 €;4540;-9,80;12.717,49 €;'sin fechas';06/12/2013;'ACESA';'Gastos_Ocio y transporte';'Parking y peaje';'VARIABLES'
06/12/2013;06/12/2013;'AUTOPISTA TERR';-2,53 €;8.190,87 €;4541;-2,53;12.714,96 €;'sin fechas';06/12/2013;'AUTOPISTA';'Gastos_Ocio y transporte';'Parking y peaje';'VARIABLES'
06/12/2013;06/12/2013;'AUTOPISTA TERR';-2,53 €;8.188,34 €;4542;-2,53;12.712,43 €;'sin fechas';06/12/2013;'AUTOPISTA';'Gastos_Ocio y transporte';'Parking y peaje';'VARIABLES'
06/12/2013;06/12/2013;'CAFET.C T PRAT';-2,70 €;8.185,64 €;4543;-2,70;12.709,73 €;'sin fechas';06/12/2013;'CAFETC';'Gastos_Ocio y transporte';'Restaurantes';'VARIABLES'
06/12/2013;06/12/2013;'COCHE&PARKING';-8,25 €;8.177,39 €;4544;-8,25;12.701,48 €;'sin fechas';06/12/2013;'COCHEPARKING';'Gastos_Ocio y transporte';'Parking y peaje';'VARIABLES'
07/12/2013;07/12/2013;'CAFET.C T PRAT';-2,60 €;8.174,79 €;4545;-2,60;12.698,88 €;'sin fechas';07/12/2013;'CAFETC';'Gastos_Ocio y transporte';'Restaurantes';'VARIABLES'
08/12/2013;08/12/2013;'BON AREA';-19,28 €;8.155,51 €;4546;-19,28;12.679,60 €;'sin fechas';08/12/2013;'BON';'Gastos_Compras';'Supermercado';'VARIABLES'
08/12/2013;08/12/2013;'CAFET.C T PRAT';-4,05 €;8.151,46 €;4547;-4,05;12.675,55 €;'sin fechas';08/12/2013;'CAFETC';'Gastos_Ocio y transporte';'Restaurantes';'VARIABLES'
08/12/2013;08/12/2013;'ES STA. MARGARITA';-40,00 €;8.111,46 €;4548;-40,00;12.635,55 €;'sin fechas';08/12/2013;'STA';'Gastos_Ocio y transporte';'Gasolina';'VARIABLES'
08/12/2013;08/12/2013;'REINT.CAJERO';-100,00 €;8.011,46 €;4549;-100,00;12.535,55 €;'sin fechas';08/12/2013;'REINTCAJERO';'Gastos_Gastos varios';'Efectivo';'VARIABLES'
08/12/2013;08/12/2013;'RESTAURANTES';-22,15 €;7.989,31 €;4550;-22,15;12.513,40 €;'sin fechas';08/12/2013;'RESTAURANTES';'Gastos_Ocio y transporte';'Restaurantes';'VARIABLES'
09/12/2013;09/12/2013;'AUTOPISTA TERR';-1,32 €;7.987,99 €;4551;-1,32;12.512,08 €;'sin fechas';09/12/2013;'AUTOPISTA';'Gastos_Ocio y transporte';'Parking y peaje';'VARIABLES'
09/12/2013;09/12/2013;'AUTOPISTA TERR';-1,39 €;7.986,60 €;4552;-1,39;12.510,69 €;'sin fechas';09/12/2013;'AUTOPISTA';'Gastos_Ocio y transporte';'Parking y peaje';'VARIABLES'
09/12/2013;09/12/2013;'ESCOLA BRESSOL EINA';-415,55 €;7.571,05 €;4554;-415,55;12.095,14 €;'sin fechas';09/12/2013;'ESCOLA';'Gastos_Salud, saber y deporte';'Estudios';'VARIABLES'
09/12/2013;09/12/2013;'SALA BADRINAS - MENJADOR';-86,80 €;7.484,25 €;4556;-86,80;12.008,34 €;'sin fechas';09/12/2013;'SALA';'Gastos_Salud, saber y deporte';'Estudios';'VARIABLES'
09/12/2013;09/12/2013;'TABASA VALLVI S. C:2T';-4,20 €;7.480,05 €;4557;-4,20;12.004,14 €;'sin fechas';09/12/2013;'TABASA';'Gastos_Ocio y transporte';'Parking y peaje';'VARIABLES'
10/12/2013;10/12/2013;'AUTOPISTA TERR';-1,32 €;7.478,73 €;4558;-1,32;12.002,82 €;'sin fechas';10/12/2013;'AUTOPISTA';'Gastos_Ocio y transporte';'Parking y peaje';'VARIABLES'
10/12/2013;10/12/2013;'AUTOPISTA TERR';-1,39 €;7.477,34 €;4559;-1,39;12.001,43 €;'sin fechas';10/12/2013;'AUTOPISTA';'Gastos_Ocio y transporte';'Parking y peaje';'VARIABLES'
10/12/2013;10/12/2013;'GAS NATURAL';-170,08 €;7.307,26 €;4561;-170,08;11.831,35 €;'sin fechas';10/12/2013;'GAS';'Gastos_Servicios tipicos';'Gas';'FIJO'
10/12/2013;10/12/2013;'TABASA VALLVI S. C:2T';-4,20 €;7.303,06 €;4563;-4,20;11.827,15 €;'sin fechas';10/12/2013;'TABASA';'Gastos_Ocio y transporte';'Parking y peaje';'VARIABLES'
11/12/2013;11/12/2013;'AUTOPISTA TERR';-1,32 €;7.301,74 €;4564;-1,32;11.825,83 €;'sin fechas';11/12/2013;'AUTOPISTA';'Gastos_Ocio y transporte';'Parking y peaje';'VARIABLES'
11/12/2013;11/12/2013;'AUTOPISTA TERR';-1,39 €;7.300,35 €;4565;-1,39;11.824,44 €;'sin fechas';11/12/2013;'AUTOPISTA';'Gastos_Ocio y transporte';'Parking y peaje';'VARIABLES'
11/12/2013;11/12/2013;'REINT.CAJERO';-100,00 €;7.200,35 €;4566;-100,00;11.724,44 €;'sin fechas';11/12/2013;'REINTCAJERO';'Gastos_Gastos varios';'Efectivo';'VARIABLES'
11/12/2013;11/12/2013;'TABASA VALLVI S. C:2T';-4,20 €;7.196,15 €;4567;-4,20;11.720,24 €;'sin fechas';11/12/2013;'TABASA';'Gastos_Ocio y transporte';'Parking y peaje';'VARIABLES'
12/12/2013;12/12/2013;'AUTOPISTA TERR';-1,32 €;7.194,83 €;4568;-1,32;11.718,92 €;'sin fechas';12/12/2013;'AUTOPISTA';'Gastos_Ocio y transporte';'Parking y peaje';'VARIABLES'
12/12/2013;12/12/2013;'AUTOPISTA TERR';-1,39 €;7.193,44 €;4569;-1,39;11.717,53 €;'sin fechas';12/12/2013;'AUTOPISTA';'Gastos_Ocio y transporte';'Parking y peaje';'VARIABLES'
12/12/2013;12/12/2013;'BLITZ';-72,50 €;7.120,94 €;4571;-72,50;11.645,03 €;'sin fechas';12/12/2013;'BLITZ';'Gastos_Vivienda y vehiculo';'Alquiler Parking';'FIJO'
12/12/2013;12/12/2013;'BON AREA';-5,67 €;7.115,27 €;4572;-5,67;11.639,36 €;'sin fechas';12/12/2013;'BON';'Gastos_Compras';'Supermercado';'VARIABLES'
12/12/2013;12/12/2013;'CAFET.C T PRAT';-2,60 €;7.112,67 €;4573;-2,60;11.636,76 €;'sin fechas';12/12/2013;'CAFETC';'Gastos_Ocio y transporte';'Restaurantes';'VARIABLES'
12/12/2013;10/12/2013;'MERCADONA';-8,65 €;7.104,02 €;4574;-8,65;11.628,11 €;'sin fechas';10/12/2013;'MERCADONA';'Gastos_Compras';'Supermercado';'VARIABLES'
12/12/2013;12/12/2013;'TABASA VALLVI S. C:2T';-4,20 €;7.099,82 €;4575;-4,20;11.623,91 €;'sin fechas';12/12/2013;'TABASA';'Gastos_Ocio y transporte';'Parking y peaje';'VARIABLES'
12/12/2013;10/12/2013;'VIENA';-13,20 €;7.086,62 €;4576;-13,20;11.610,71 €;'sin fechas';10/12/2013;'VIENA';'Gastos_Ocio y transporte';'Restaurantes';'VARIABLES'
12/12/2013;09/12/2013;'VIENA';-35,25 €;7.051,37 €;4577;-35,25;11.575,46 €;'sin fechas';09/12/2013;'VIENA';'Gastos_Ocio y transporte';'Restaurantes';'VARIABLES'
12/12/2013;10/12/2013;'YVES ROCHER';-19,35 €;7.032,02 €;4578;-19,35;11.556,11 €;'sin fechas';10/12/2013;'YVES';'Gastos_Salud, saber y deporte';'Belleza';'VARIABLES'
13/12/2013;13/12/2013;'AUTOPISTA TERR';-1,25 €;7.030,77 €;4579;-1,25;11.554,86 €;'sin fechas';13/12/2013;'AUTOPISTA';'Gastos_Ocio y transporte';'Parking y peaje';'VARIABLES'
13/12/2013;13/12/2013;'AUTOPISTA TERR';-1,32 €;7.029,45 €;4580;-1,32;11.553,54 €;'sin fechas';13/12/2013;'AUTOPISTA';'Gastos_Ocio y transporte';'Parking y peaje';'VARIABLES'
13/12/2013;13/12/2013;'CAFET.C T PRAT';-2,65 €;7.026,80 €;4581;-2,65;11.550,89 €;'sin fechas';13/12/2013;'CAFETC';'Gastos_Ocio y transporte';'Restaurantes';'VARIABLES'
13/12/2013;13/12/2013;'CAFET.C T PRAT';-4,25 €;7.022,55 €;4582;-4,25;11.546,64 €;'sin fechas';13/12/2013;'CAFETC';'Gastos_Ocio y transporte';'Restaurantes';'VARIABLES'
13/12/2013;13/12/2013;'REINT.CAJERO';-110,00 €;6.912,55 €;4583;-110,00;11.436,64 €;'sin fechas';13/12/2013;'REINTCAJERO';'Gastos_Gastos varios';'Efectivo';'VARIABLES'
13/12/2013;13/12/2013;'TABASA VALLVI S. C:2T';-4,20 €;6.908,35 €;4584;-4,20;11.432,44 €;'sin fechas';13/12/2013;'TABASA';'Gastos_Ocio y transporte';'Parking y peaje';'VARIABLES'
14/12/2013;14/12/2013;'CAFET.C T PRAT';-4,05 €;6.904,30 €;4585;-4,05;11.428,39 €;'sin fechas';14/12/2013;'CAFETC';'Gastos_Ocio y transporte';'Restaurantes';'VARIABLES'
14/12/2013;14/12/2013;'FRUITES I VERDURES';-2,07 €;6.902,23 €;4586;-2,07;11.426,32 €;'sin fechas';14/12/2013;'FRUITES';'Gastos_Compras';'Supermercado';'VARIABLES'
15/12/2013;15/12/2013;'CAFET.C T PRAT';-4,90 €;6.897,33 €;4587;-4,90;11.421,42 €;'sin fechas';15/12/2013;'CAFETC';'Gastos_Ocio y transporte';'Restaurantes';'VARIABLES'
15/12/2013;15/12/2013;'ES STA. MARGARITA';-51,02 €;6.846,31 €;4588;-51,02;11.370,40 €;'sin fechas';15/12/2013;'STA';'Gastos_Ocio y transporte';'Gasolina';'VARIABLES'
16/12/2013;16/12/2013;'AUTOPISTA TERR';-1,25 €;6.845,06 €;4589;-1,25;11.369,15 €;'sin fechas';16/12/2013;'AUTOPISTA';'Gastos_Ocio y transporte';'Parking y peaje';'VARIABLES'
16/12/2013;16/12/2013;'AUTOPISTA TERR';-1,39 €;6.843,67 €;4590;-1,39;11.367,76 €;'sin fechas';16/12/2013;'AUTOPISTA';'Gastos_Ocio y transporte';'Parking y peaje';'VARIABLES'
16/12/2013;16/12/2013;'CCM VIDA Y P SEGURO PRESTAMO';-24,37 €;6.819,30 €;4591;-24,37;11.343,39 €;'sin fechas';16/12/2013;'CCM';'Gastos_Seguros';'Seguro vida';'FIJO'
16/12/2013;16/12/2013;'CCM VIDA Y PENSIO 000000493358';-18,73 €;6.800,57 €;4592;-18,73;11.324,66 €;'sin fechas';16/12/2013;'CCM';'Gastos_Seguros';'Seguro vida';'FIJO'
16/12/2013;16/12/2013;'MERCADONA';-151,74 €;6.648,83 €;4593;-151,74;11.172,92 €;'sin fechas';16/12/2013;'MERCADONA';'Gastos_Compras';'Supermercado';'VARIABLES'
16/12/2013;16/12/2013;'MERCADONA';-10,41 €;6.638,42 €;4594;-10,41;11.162,51 €;'sin fechas';16/12/2013;'MERCADONA';'Gastos_Compras';'Supermercado';'VARIABLES'
16/12/2013;16/12/2013;'TABASA VALLVI S. C:2T';-4,20 €;6.634,22 €;4595;-4,20;11.158,31 €;'sin fechas';16/12/2013;'TABASA';'Gastos_Ocio y transporte';'Parking y peaje';'VARIABLES'
17/12/2013;17/12/2013;'AUTOPISTA TERR';-1,39 €;6.632,83 €;4596;-1,39;11.156,92 €;'sin fechas';17/12/2013;'AUTOPISTA';'Gastos_Ocio y transporte';'Parking y peaje';'VARIABLES'
17/12/2013;17/12/2013;'AUTOPISTA TERR';-1,39 €;6.631,44 €;4597;-1,39;11.155,53 €;'sin fechas';17/12/2013;'AUTOPISTA';'Gastos_Ocio y transporte';'Parking y peaje';'VARIABLES'
17/12/2013;21/10/2013;'AUTOPISTA TERR';-1,39 €;6.630,05 €;4598;-1,39;11.154,14 €;'sin fechas';21/10/2013;'AUTOPISTA';'Gastos_Ocio y transporte';'Parking y peaje';'VARIABLES'
17/12/2013;17/12/2013;'COCHE&PARKING';-12,95 €;6.617,10 €;4599;-12,95;11.141,19 €;'sin fechas';17/12/2013;'COCHEPARKING';'Gastos_Ocio y transporte';'Parking y peaje';'VARIABLES'
17/12/2013;17/12/2013;'HOGAR&OTROS';-149,89 €;6.467,21 €;4600;-149,89;10.991,30 €;'sin fechas';17/12/2013;'HOGAROTROS';'Gastos_Vivienda y vehiculo';'Otros vivienda';'VARIABLES'
17/12/2013;17/12/2013;'INFORMACIO I TECNOLOGIA DE CAT';1.724,25 €;8.191,46 €;4601;1.724,25;12.715,55 €;'sin fechas';17/12/2013;'INFORMACIO';'Ingresos';'Nomina';'FIJO'
17/12/2013;17/12/2013;'ONO';-112,41 €;8.079,05 €;4603;-112,41;12.603,14 €;'sin fechas';17/12/2013;'ONO';'Gastos_Servicios tipicos';'Telecomunicaciones';'FIJO'
17/12/2013;17/12/2013;'TABASA VALLVI N. C:2T';-4,20 €;8.074,85 €;4605;-4,20;12.598,94 €;'sin fechas';17/12/2013;'TABASA';'Gastos_Ocio y transporte';'Parking y peaje';'VARIABLES'
17/12/2013;17/12/2013;'TABASA VALLVI S. C:2T';-4,20 €;8.070,65 €;4606;-4,20;12.594,74 €;'sin fechas';17/12/2013;'TABASA';'Gastos_Ocio y transporte';'Parking y peaje';'VARIABLES'
18/12/2013;18/12/2013;'AUTOPISTA TERR';-1,25 €;8.069,40 €;4607;-1,25;12.593,49 €;'sin fechas';18/12/2013;'AUTOPISTA';'Gastos_Ocio y transporte';'Parking y peaje';'VARIABLES'
18/12/2013;18/12/2013;'MINA PUBLICA AIGUES T.01A75789';-38,22 €;8.031,18 €;4608;-38,22;12.555,27 €;'sin fechas';18/12/2013;'MINA';'Gastos_Servicios tipicos';'Agua';'FIJO'
18/12/2013;18/12/2013;'TABASA VALLVI S. C:2T';-3,73 €;8.027,45 €;4609;-3,73;12.551,54 €;'sin fechas';18/12/2013;'TABASA';'Gastos_Ocio y transporte';'Parking y peaje';'VARIABLES'
19/12/2013;19/12/2013;'AUTOPISTA TERR';-1,25 €;8.026,20 €;4610;-1,25;12.550,29 €;'sin fechas';19/12/2013;'AUTOPISTA';'Gastos_Ocio y transporte';'Parking y peaje';'VARIABLES'
19/12/2013;19/12/2013;'AUTOPISTA TERR';-1,25 €;8.024,95 €;4611;-1,25;12.549,04 €;'sin fechas';19/12/2013;'AUTOPISTA';'Gastos_Ocio y transporte';'Parking y peaje';'VARIABLES'
19/12/2013;19/12/2013;'CAFET.C T PRAT';-3,60 €;8.021,35 €;4612;-3,60;12.545,44 €;'sin fechas';19/12/2013;'CAFETC';'Gastos_Ocio y transporte';'Restaurantes';'VARIABLES'
19/12/2013;18/12/2013;'CARREFOUR-[OTROS]';-173,54 €;7.847,81 €;4613;-173,54;12.371,90 €;'sin fechas';18/12/2013;'CARREFOUROTROS';'Gastos_Compras';'Supermercado';'VARIABLES'
19/12/2013;17/12/2013;'CARREFOUR-[OTROS]';-32,37 €;7.815,44 €;4614;-32,37;12.339,53 €;'sin fechas';17/12/2013;'CARREFOUROTROS';'Gastos_Compras';'Supermercado';'VARIABLES'
19/12/2013;17/12/2013;'DECATHLON';-30,35 €;7.785,09 €;4615;-30,35;12.309,18 €;'sin fechas';17/12/2013;'DECATHLON';'Gastos_Compras';'Deportivo';'VARIABLES'
19/12/2013;17/12/2013;'EROSKI-[COMIDA]';-45,35 €;7.739,74 €;4616;-45,35;12.263,83 €;'sin fechas';17/12/2013;'EROSKICOMIDA';'Gastos_Compras';'Supermercado';'VARIABLES'
19/12/2013;19/12/2013;'FOMENT DE TERRASSA, S.A. FOMEN';2.977,13 €;10.716,87 €;4617;2.977,13;15.240,96 €;'sin fechas';19/12/2013;'FOMENT';'Ingresos';'Nomina';'FIJO'
19/12/2013;19/12/2013;'HOGAR&OTROS';-18,35 €;10.698,52 €;4619;-18,35;15.222,61 €;'sin fechas';19/12/2013;'HOGAROTROS';'Gastos_Vivienda y vehiculo';'Otros vivienda';'VARIABLES'
19/12/2013;17/12/2013;'HOGAR&OTROS';-8,10 €;10.690,42 €;4620;-8,10;15.214,51 €;'sin fechas';17/12/2013;'HOGAROTROS';'Gastos_Vivienda y vehiculo';'Otros vivienda';'VARIABLES'
19/12/2013;17/12/2013;'JUGUETILANDIA TERR';-54,75 €;10.635,67 €;4621;-54,75;15.159,76 €;'sin fechas';17/12/2013;'JUGUETILANDIA';'Gastos_Compras';'Niños';'VARIABLES'
19/12/2013;17/12/2013;'LIDL TERRASSA';-15,53 €;10.620,14 €;4622;-15,53;15.144,23 €;'sin fechas';17/12/2013;'LIDL';'Gastos_Compras';'Supermercado';'VARIABLES'
19/12/2013;19/12/2013;'RESTAURANTES';-3,70 €;10.616,44 €;4623;-3,70;15.140,53 €;'sin fechas';19/12/2013;'RESTAURANTES';'Gastos_Ocio y transporte';'Restaurantes';'VARIABLES'
19/12/2013;19/12/2013;'TACISA';-76,29 €;10.540,15 €;4624;-76,29;15.064,24 €;'sin fechas';19/12/2013;'TACISA';'Gastos_Compras';'Supermercado';'VARIABLES'
19/12/2013;17/12/2013;'VIENA';-10,10 €;10.530,05 €;4625;-10,10;15.054,14 €;'sin fechas';17/12/2013;'VIENA';'Gastos_Ocio y transporte';'Restaurantes';'VARIABLES'
19/12/2013;17/12/2013;'VIENA';-16,05 €;10.514,00 €;4626;-16,05;15.038,09 €;'sin fechas';17/12/2013;'VIENA';'Gastos_Ocio y transporte';'Restaurantes';'VARIABLES'
20/12/2013;20/12/2013;'ADESLAS CENTRAL 006662671613';-110,65 €;10.403,35 €;4627;-110,65;14.927,44 €;'sin fechas';20/12/2013;'ADESLAS';'Gastos_Salud, saber y deporte';'Medico';'VARIABLES'
20/12/2013;20/12/2013;'CRACK';-31,42 €;10.371,93 €;4628;-31,42;14.896,02 €;'sin fechas';20/12/2013;'CRACK';'Gastos_Compras';'Otras compras';'VARIABLES'
20/12/2013;20/12/2013;'HOGAR&OTROS';-40,39 €;10.331,54 €;4630;-40,39;14.855,63 €;'sin fechas';20/12/2013;'HOGAROTROS';'Gastos_Vivienda y vehiculo';'Otros vivienda';'VARIABLES'
20/12/2013;20/12/2013;'HOGAR&OTROS';-22,80 €;10.308,74 €;4631;-22,80;14.832,83 €;'sin fechas';20/12/2013;'HOGAROTROS';'Gastos_Vivienda y vehiculo';'Otros vivienda';'VARIABLES'
20/12/2013;20/12/2013;'IMAGINARIUM';-39,95 €;10.268,79 €;4632;-39,95;14.792,88 €;'sin fechas';20/12/2013;'IMAGINARIUM';'Gastos_Compras';'Niños';'VARIABLES'
20/12/2013;20/12/2013;'RESTAURANTES';-19,60 €;10.249,19 €;4633;-19,60;14.773,28 €;'sin fechas';20/12/2013;'RESTAURANTES';'Gastos_Ocio y transporte';'Restaurantes';'VARIABLES'
20/12/2013;20/12/2013;'TOCINERIES VENTURA';-11,66 €;10.237,53 €;4634;-11,66;14.761,62 €;'sin fechas';20/12/2013;'TOCINERIES';'Gastos_Compras';'Supermercado';'VARIABLES'
21/12/2013;21/12/2013;'CAFET.C T PRAT';-3,20 €;10.234,33 €;4635;-3,20;14.758,42 €;'sin fechas';21/12/2013;'CAFETC';'Gastos_Ocio y transporte';'Restaurantes';'VARIABLES'
21/12/2013;21/12/2013;'RESTAURANTES';-3,00 €;10.231,33 €;4636;-3,00;14.755,42 €;'sin fechas';21/12/2013;'RESTAURANTES';'Gastos_Ocio y transporte';'Restaurantes';'VARIABLES'
21/12/2013;21/12/2013;'WWW.JUST-EAT.ES';-14,00 €;10.217,33 €;4637;-14,00;14.741,42 €;'sin fechas';21/12/2013;'WWWJUSTEATES';'Gastos_Ocio y transporte';'Restaurantes';'VARIABLES'
22/12/2013;22/12/2013;'CAFET.C T PRAT';-2,70 €;10.214,63 €;4638;-2,70;14.738,72 €;'sin fechas';22/12/2013;'CAFETC';'Gastos_Ocio y transporte';'Restaurantes';'VARIABLES'
22/12/2013;22/12/2013;'REINT.CAJERO';-40,00 €;10.174,63 €;4639;-40,00;14.698,72 €;'sin fechas';22/12/2013;'REINTCAJERO';'Gastos_Gastos varios';'Efectivo';'VARIABLES'
22/12/2013;22/12/2013;'RESTAURANTES';-22,15 €;10.152,48 €;4640;-22,15;14.676,57 €;'sin fechas';22/12/2013;'RESTAURANTES';'Gastos_Ocio y transporte';'Restaurantes';'VARIABLES'
23/12/2013;23/12/2013;'AUTOPISTA TERR';-1,39 €;10.151,09 €;4641;-1,39;14.675,18 €;'sin fechas';23/12/2013;'AUTOPISTA';'Gastos_Ocio y transporte';'Parking y peaje';'VARIABLES'
23/12/2013;23/12/2013;'ESCOLA BRESSOL EINA';-256,00 €;9.895,09 €;4642;-256,00;14.419,18 €;'sin fechas';23/12/2013;'ESCOLA';'Gastos_Salud, saber y deporte';'Estudios';'VARIABLES'
23/12/2013;23/12/2013;'HOGAR&OTROS';-17,50 €;9.877,59 €;4644;-17,50;14.401,68 €;'sin fechas';23/12/2013;'HOGAROTROS';'Gastos_Vivienda y vehiculo';'Otros vivienda';'VARIABLES'
23/12/2013;23/12/2013;'LIDL TERRASSA';-33,36 €;9.844,23 €;4645;-33,36;14.368,32 €;'sin fechas';23/12/2013;'LIDL';'Gastos_Compras';'Supermercado';'VARIABLES'
23/12/2013;23/12/2013;'MERCADONA';-67,30 €;9.776,93 €;4646;-67,30;14.301,02 €;'sin fechas';23/12/2013;'MERCADONA';'Gastos_Compras';'Supermercado';'VARIABLES'
23/12/2013;23/12/2013;'TABASA VALLVI S. C:2T';-4,20 €;9.772,73 €;4647;-4,20;14.296,82 €;'sin fechas';23/12/2013;'TABASA';'Gastos_Ocio y transporte';'Parking y peaje';'VARIABLES'
23/12/2013;23/12/2013;'TOYOTA ORIENT CARS';-634,12 €;9.138,61 €;4648;-634,12;13.662,70 €;'sin fechas';23/12/2013;'TOYOTA';'Gastos_Vivienda y vehiculo';'Mnto. vehiculo';'VARIABLE'
24/12/2013;24/12/2013;'AUTOPISTA TERR';-1,25 €;9.137,36 €;4649;-1,25;13.661,45 €;'sin fechas';24/12/2013;'AUTOPISTA';'Gastos_Ocio y transporte';'Parking y peaje';'VARIABLES'
24/12/2013;18/12/2013;'AUTOPISTA TERR';-1,39 €;9.135,97 €;4650;-1,39;13.660,06 €;'sin fechas';18/12/2013;'AUTOPISTA';'Gastos_Ocio y transporte';'Parking y peaje';'VARIABLES'
24/12/2013;24/12/2013;'BON AREA';-40,51 €;9.095,46 €;4651;-40,51;13.619,55 €;'sin fechas';24/12/2013;'BON';'Gastos_Compras';'Supermercado';'VARIABLES'
24/12/2013;24/12/2013;'FRUITES I VERDURES';-8,70 €;9.086,76 €;4652;-8,70;13.610,85 €;'sin fechas';24/12/2013;'FRUITES';'Gastos_Compras';'Supermercado';'VARIABLES'
25/12/2013;25/12/2013;'AUTOPISTA TERR';-2,53 €;9.084,23 €;4654;-2,53;13.608,32 €;'sin fechas';25/12/2013;'AUTOPISTA';'Gastos_Ocio y transporte';'Parking y peaje';'VARIABLES'
26/12/2013;26/12/2013;'CAFET.C T PRAT';-3,60 €;9.080,63 €;4655;-3,60;13.604,72 €;'sin fechas';26/12/2013;'CAFETC';'Gastos_Ocio y transporte';'Restaurantes';'VARIABLES'
26/12/2013;24/12/2013;'CARREFOUR-[OTROS]';-127,04 €;8.953,59 €;4656;-127,04;13.477,68 €;'sin fechas';24/12/2013;'CARREFOUROTROS';'Gastos_Compras';'Supermercado';'VARIABLES'
26/12/2013;24/12/2013;'DRIM';-19,99 €;8.933,60 €;4657;-19,99;13.457,69 €;'sin fechas';24/12/2013;'DRIM';'Gastos_Compras';'Niños';'VARIABLES'
26/12/2013;25/12/2013;'HOGAR&OTROS';-14,95 €;8.918,65 €;4658;-14,95;13.442,74 €;'sin fechas';25/12/2013;'HOGAROTROS';'Gastos_Vivienda y vehiculo';'Otros vivienda';'VARIABLES'
26/12/2013;26/12/2013;'TACISA';-44,65 €;8.874,00 €;4659;-44,65;13.398,09 €;'sin fechas';26/12/2013;'TACISA';'Gastos_Compras';'Supermercado';'VARIABLES'
26/12/2013;24/12/2013;'VIENA';-20,80 €;8.853,20 €;4660;-20,80;13.377,29 €;'sin fechas';24/12/2013;'VIENA';'Gastos_Ocio y transporte';'Restaurantes';'VARIABLES'
27/12/2013;27/12/2013;'AJUNTAMENT DE TER 850000031046';-49,40 €;8.803,80 €;4661;-49,40;13.327,89 €;'sin fechas';27/12/2013;'AJUNTAMENT';'Gastos_Banco y organismos';'Ayuntamiento';'FIJO'
27/12/2013;21/12/2013;'AUTOPISTA TERR';-2,53 €;8.801,27 €;4662;-2,53;13.325,36 €;'sin fechas';21/12/2013;'AUTOPISTA';'Gastos_Ocio y transporte';'Parking y peaje';'VARIABLES'
27/12/2013;21/12/2013;'AUTOPISTA TERR';-2,53 €;8.798,74 €;4663;-2,53;13.322,83 €;'sin fechas';21/12/2013;'AUTOPISTA';'Gastos_Ocio y transporte';'Parking y peaje';'VARIABLES'
27/12/2013;27/12/2013;'CAFET.C T PRAT';-3,55 €;8.795,19 €;4664;-3,55;13.319,28 €;'sin fechas';27/12/2013;'CAFETC';'Gastos_Ocio y transporte';'Restaurantes';'VARIABLES'
28/12/2013;30/12/2013;'INFORMACIO I TECNOLOGIA DE CAT';1.579,09 €;10.374,28 €;4666;1.579,09;14.898,37 €;'sin fechas';30/12/2013;'INFORMACIO';'Ingresos';'Nomina';'FIJO'
29/12/2013;28/12/2013;'ES STA. MARGARITA';-30,33 €;10.343,95 €;4668;-30,33;14.868,04 €;'sin fechas';28/12/2013;'STA';'Gastos_Ocio y transporte';'Gasolina';'VARIABLES'
30/12/2013;30/12/2013;'AUTOPISTA TERR';-1,25 €;10.342,70 €;4669;-1,25;14.866,79 €;'sin fechas';30/12/2013;'AUTOPISTA';'Gastos_Ocio y transporte';'Parking y peaje';'VARIABLES'
30/12/2013;30/12/2013;'BON AREA';-14,21 €;10.328,49 €;4670;-14,21;14.852,58 €;'sin fechas';30/12/2013;'BON';'Gastos_Compras';'Supermercado';'VARIABLES'
30/12/2013;30/12/2013;'CAJA DE SEGUROS R 300045047898';-304,27 €;10.024,22 €;4672;-304,27;14.548,31 €;'sin fechas';30/12/2013;'CAJA';'Gastos_Seguros';'Seguro hogar';'FIJO'
30/12/2013;30/12/2013;'HOGAR&OTROS';-26,30 €;9.997,92 €;4673;-26,30;14.522,01 €;'sin fechas';30/12/2013;'HOGAROTROS';'Gastos_Vivienda y vehiculo';'Otros vivienda';'VARIABLES'
30/12/2013;30/12/2013;'REINT.CAJERO';-30,00 €;9.967,92 €;4674;-30,00;14.492,01 €;'sin fechas';30/12/2013;'REINTCAJERO';'Gastos_Gastos varios';'Efectivo';'VARIABLES'
31/12/2013;31/12/2013;'AUTOPISTA TERR';-1,25 €;9.966,67 €;4675;-1,25;14.490,76 €;'sin fechas';31/12/2013;'AUTOPISTA';'Gastos_Ocio y transporte';'Parking y peaje';'VARIABLES'
31/12/2013;31/12/2013;'HOGAR&OTROS';-115,33 €;9.851,34 €;4676;-115,33;14.375,43 €;'sin fechas';31/12/2013;'HOGAROTROS';'Gastos_Vivienda y vehiculo';'Otros vivienda';'VARIABLES'
31/12/2013;31/12/2013;'RECIBO PTMOS. 3061-0960001518';-562,73 €;9.288,61 €;4677;-562,73;13.812,70 €;'sin fechas';31/12/2013;'RECIBO';'Gastos_Banco y organismos';'Hipoteca';'FIJO'
31/12/2013;31/12/2013;'REINT.CAJERO';-100,00 €;9.188,61 €;4678;-100,00;13.712,70 €;'sin fechas';31/12/2013;'REINTCAJERO';'Gastos_Gastos varios';'Efectivo';'VARIABLES'
02/01/2014;02/01/2014;'AUTOPISTA TERR';-1,39 €;9.187,22 €;4679;-1,39;13.711,31 €;'sin fechas';02/01/2014;'AUTOPISTA';'Gastos_Ocio y transporte';'Parking y peaje';'VARIABLES'
02/01/2014;02/01/2014;'AUTOPISTA TERR';-1,39 €;9.185,83 €;4680;-1,39;13.709,92 €;'sin fechas';02/01/2014;'AUTOPISTA';'Gastos_Ocio y transporte';'Parking y peaje';'VARIABLES'
02/01/2014;02/01/2014;'CAFET.C T PRAT';-2,65 €;9.183,18 €;4681;-2,65;13.707,27 €;'sin fechas';02/01/2014;'CAFETC';'Gastos_Ocio y transporte';'Restaurantes';'VARIABLES'
02/01/2014;02/01/2014;'CAFET.C T PRAT';-2,70 €;9.180,48 €;4682;-2,70;13.704,57 €;'sin fechas';02/01/2014;'CAFETC';'Gastos_Ocio y transporte';'Restaurantes';'VARIABLES'
02/01/2014;02/01/2014;'CARREFOUR-[COMIDA]';-56,60 €;9.123,88 €;4683;-56,60;13.647,97 €;'sin fechas';02/01/2014;'CARREFOURCOMIDA';'Gastos_Compras';'Supermercado';'VARIABLES'
02/01/2014;02/01/2014;'MERCADONA';-34,07 €;9.089,81 €;4684;-34,07;13.613,90 €;'sin fechas';02/01/2014;'MERCADONA';'Gastos_Compras';'Supermercado';'VARIABLES'
02/01/2014;01/01/2014;'PRENSA';-17,45 €;9.072,36 €;4685;-17,45;13.596,45 €;'sin fechas';01/01/2014;'PRENSA';'Gastos_Compras';'Libreria';'VARIABLES'
02/01/2014;01/01/2014;'REDPIZZA';-18,85 €;9.053,51 €;4686;-18,85;13.577,60 €;'sin fechas';01/01/2014;'REDPIZZA';'Gastos_Ocio y transporte';'Restaurantes';'VARIABLES'
03/01/2014;03/01/2014;'CAFET.C T PRAT';-2,20 €;9.051,31 €;4687;-2,20;13.575,40 €;'sin fechas';03/01/2014;'CAFETC';'Gastos_Ocio y transporte';'Restaurantes';'VARIABLES'
03/01/2014;03/01/2014;'REINT.CAJERO';-70,00 €;8.981,31 €;4688;-70,00;13.505,40 €;'sin fechas';03/01/2014;'REINTCAJERO';'Gastos_Gastos varios';'Efectivo';'VARIABLES'
05/01/2014;05/01/2014;'AMC PARC VALLES';-12,00 €;8.969,31 €;4689;-12,00;13.493,40 €;'sin fechas';05/01/2014;'AMC';'Gastos_Ocio y transporte';'Espectáculos';'VARIABLES'
05/01/2014;05/01/2014;'CAFET.C T PRAT';-2,65 €;8.966,66 €;4690;-2,65;13.490,75 €;'sin fechas';05/01/2014;'CAFETC';'Gastos_Ocio y transporte';'Restaurantes';'VARIABLES'
05/01/2014;05/01/2014;'VIENA';-10,80 €;8.955,86 €;4691;-10,80;13.479,95 €;'sin fechas';05/01/2014;'VIENA';'Gastos_Ocio y transporte';'Restaurantes';'VARIABLES'
06/01/2014;06/01/2014;'C&A';-87,09 €;8.868,77 €;4692;-87,09;13.392,86 €;'sin fechas';06/01/2014;'CA';'Gastos_Compras';'Ropa';'VARIABLES'
06/01/2014;06/01/2014;'CAFET.C T PRAT';-2,65 €;8.866,12 €;4693;-2,65;13.390,21 €;'sin fechas';06/01/2014;'CAFETC';'Gastos_Ocio y transporte';'Restaurantes';'VARIABLES'
06/01/2014;06/01/2014;'COCHE&PARKING';-0,85 €;8.865,27 €;4694;-0,85;13.389,36 €;'sin fechas';06/01/2014;'COCHEPARKING';'Gastos_Ocio y transporte';'Parking y peaje';'VARIABLES'
06/01/2014;06/01/2014;'COCHE&PARKING';-0,65 €;8.864,62 €;4695;-0,65;13.388,71 €;'sin fechas';06/01/2014;'COCHEPARKING';'Gastos_Ocio y transporte';'Parking y peaje';'VARIABLES'
06/01/2014;06/01/2014;'ES STA. MARGARITA';-41,51 €;8.823,11 €;4696;-41,51;13.347,20 €;'sin fechas';06/01/2014;'STA';'Gastos_Ocio y transporte';'Gasolina';'VARIABLES'
06/01/2014;06/01/2014;'VIENA';-14,40 €;8.808,71 €;4697;-14,40;13.332,80 €;'sin fechas';06/01/2014;'VIENA';'Gastos_Ocio y transporte';'Restaurantes';'VARIABLES'
07/01/2014;07/01/2014;'CAJA DE SEGUROS R G00031940935';-351,61 €;8.457,10 €;4698;-351,61;12.981,19 €;'sin fechas';07/01/2014;'CAJA';'Gastos_Seguros';'Seguro hogar';'FIJO'
07/01/2014;07/01/2014;'ESCOLA BRESSOL EINA';-468,10 €;7.989,00 €;4700;-468,10;12.513,09 €;'sin fechas';07/01/2014;'ESCOLA';'Gastos_Salud, saber y deporte';'Estudios';'VARIABLES'
08/01/2014;08/01/2014;'AUTOPISTA TERR';-1,39 €;7.987,61 €;4701;-1,39;12.511,70 €;'sin fechas';08/01/2014;'AUTOPISTA';'Gastos_Ocio y transporte';'Parking y peaje';'VARIABLES'
08/01/2014;08/01/2014;'TABASA VALLVI S. C:2T';-4,19 €;7.983,42 €;4702;-4,19;12.507,51 €;'sin fechas';08/01/2014;'TABASA';'Gastos_Ocio y transporte';'Parking y peaje';'VARIABLES'
09/01/2014;09/01/2014;'AUTOPISTA TERR';-1,39 €;7.982,03 €;4703;-1,39;12.506,12 €;'sin fechas';09/01/2014;'AUTOPISTA';'Gastos_Ocio y transporte';'Parking y peaje';'VARIABLES'
09/01/2014;09/01/2014;'AUTOPISTA TERR';-1,39 €;7.980,64 €;4704;-1,39;12.504,73 €;'sin fechas';09/01/2014;'AUTOPISTA';'Gastos_Ocio y transporte';'Parking y peaje';'VARIABLES'
09/01/2014;09/01/2014;'CAJA DE SEGUROS R 300045047898';304,27 €;8.284,91 €;4705;304,27;12.809,00 €;'sin fechas';09/01/2014;'CAJA';'Gastos_Seguros';'Seguro hogar';'FIJO'
09/01/2014;09/01/2014;'TABASA VALLVI S. C:2T';-4,19 €;8.280,72 €;4706;-4,19;12.804,81 €;'sin fechas';09/01/2014;'TABASA';'Gastos_Ocio y transporte';'Parking y peaje';'VARIABLES'
10/01/2014;08/01/2014;'AMC PARC VALLES';-16,50 €;8.264,22 €;4707;-16,50;12.788,31 €;'sin fechas';08/01/2014;'AMC';'Gastos_Ocio y transporte';'Espectáculos';'VARIABLES'
10/01/2014;10/01/2014;'AUTOPISTA TERR';-1,39 €;8.262,83 €;4708;-1,39;12.786,92 €;'sin fechas';10/01/2014;'AUTOPISTA';'Gastos_Ocio y transporte';'Parking y peaje';'VARIABLES'
10/01/2014;07/01/2014;'BON AREA';-13,56 €;8.249,27 €;4709;-13,56;12.773,36 €;'sin fechas';07/01/2014;'BON';'Gastos_Compras';'Supermercado';'VARIABLES'
10/01/2014;10/01/2014;'CAFET.C T PRAT';-2,60 €;8.246,67 €;4710;-2,60;12.770,76 €;'sin fechas';10/01/2014;'CAFETC';'Gastos_Ocio y transporte';'Restaurantes';'VARIABLES'
10/01/2014;07/01/2014;'DRIM';-19,99 €;8.226,68 €;4711;-19,99;12.750,77 €;'sin fechas';07/01/2014;'DRIM';'Gastos_Compras';'Niños';'VARIABLES'
10/01/2014;07/01/2014;'IKEA';-49,32 €;8.177,36 €;4712;-49,32;12.701,45 €;'sin fechas';07/01/2014;'IKEA';'Gastos_Vivienda y vehiculo';'Mnto. hogar';'VARIABLES'
10/01/2014;08/01/2014;'PRENSA';-12,45 €;8.164,91 €;4713;-12,45;12.689,00 €;'sin fechas';08/01/2014;'PRENSA';'Gastos_Compras';'Libreria';'VARIABLES'
10/01/2014;09/01/2014;'REDPIZZA';-21,35 €;8.143,56 €;4714;-21,35;12.667,65 €;'sin fechas';09/01/2014;'REDPIZZA';'Gastos_Ocio y transporte';'Restaurantes';'VARIABLES'
10/01/2014;10/01/2014;'SALA BADRINAS - MENJADOR';-111,60 €;8.031,96 €;4715;-111,60;12.556,05 €;'sin fechas';10/01/2014;'SALA';'Gastos_Salud, saber y deporte';'Estudios';'VARIABLES'
10/01/2014;10/01/2014;'TABASA VALLVI S. C:2T';-3,73 €;8.028,23 €;4717;-3,73;12.552,32 €;'sin fechas';10/01/2014;'TABASA';'Gastos_Ocio y transporte';'Parking y peaje';'VARIABLES'
10/01/2014;07/01/2014;'VIENA';-30,45 €;7.997,78 €;4718;-30,45;12.521,87 €;'sin fechas';07/01/2014;'VIENA';'Gastos_Ocio y transporte';'Restaurantes';'VARIABLES'
11/01/2014;02/01/2014;'AUTOPISTA TERR';-1,39 €;7.996,39 €;4719;-1,39;12.520,48 €;'sin fechas';02/01/2014;'AUTOPISTA';'Gastos_Ocio y transporte';'Parking y peaje';'VARIABLES'
11/01/2014;11/01/2014;'CAFET.C T PRAT';-4,90 €;7.991,49 €;4720;-4,90;12.515,58 €;'sin fechas';11/01/2014;'CAFETC';'Gastos_Ocio y transporte';'Restaurantes';'VARIABLES'
11/01/2014;11/01/2014;'H&M';-17,00 €;7.974,49 €;4721;-17,00;12.498,58 €;'sin fechas';11/01/2014;'HM';'Gastos_Compras';'Ropa';'VARIABLES'
12/01/2014;12/01/2014;'CAFET.C T PRAT';-2,70 €;7.971,79 €;4722;-2,70;12.495,88 €;'sin fechas';12/01/2014;'CAFETC';'Gastos_Ocio y transporte';'Restaurantes';'VARIABLES'
12/01/2014;12/01/2014;'KIABI.COM';-126,31 €;7.845,48 €;4723;-126,31;12.369,57 €;'sin fechas';12/01/2014;'KIABICOM';'Gastos_Compras';'Ropa';'VARIABLES'
12/01/2014;12/01/2014;'LA TERRASSETA - REST COLEGI';-4,55 €;7.840,93 €;4724;-4,55;12.365,02 €;'sin fechas';12/01/2014;'TERRASSETA';'Gastos_Ocio y transporte';'Restaurantes';'VARIABLES'
12/01/2014;12/01/2014;'MERCADONA';-67,18 €;7.773,75 €;4725;-67,18;12.297,84 €;'sin fechas';12/01/2014;'MERCADONA';'Gastos_Compras';'Supermercado';'VARIABLES'
12/01/2014;12/01/2014;'MERCADONA';-9,36 €;7.764,39 €;4726;-9,36;12.288,48 €;'sin fechas';12/01/2014;'MERCADONA';'Gastos_Compras';'Supermercado';'VARIABLES'
13/01/2014;03/01/2014;'AUTOPISTA TERR';-1,39 €;7.763,00 €;4727;-1,39;12.287,09 €;'sin fechas';03/01/2014;'AUTOPISTA';'Gastos_Ocio y transporte';'Parking y peaje';'VARIABLES'
13/01/2014;07/01/2014;'AUTOPISTA TERR';-1,39 €;7.761,61 €;4728;-1,39;12.285,70 €;'sin fechas';07/01/2014;'AUTOPISTA';'Gastos_Ocio y transporte';'Parking y peaje';'VARIABLES'
13/01/2014;07/01/2014;'AUTOPISTA TERR';-1,39 €;7.760,22 €;4729;-1,39;12.284,31 €;'sin fechas';07/01/2014;'AUTOPISTA';'Gastos_Ocio y transporte';'Parking y peaje';'VARIABLES'
13/01/2014;13/01/2014;'AUTOPISTA TERR';-1,39 €;7.758,83 €;4730;-1,39;12.282,92 €;'sin fechas';13/01/2014;'AUTOPISTA';'Gastos_Ocio y transporte';'Parking y peaje';'VARIABLES'
13/01/2014;13/01/2014;'CAFET.C T PRAT';-4,10 €;7.754,73 €;4731;-4,10;12.278,82 €;'sin fechas';13/01/2014;'CAFETC';'Gastos_Ocio y transporte';'Restaurantes';'VARIABLES'
13/01/2014;13/01/2014;'CAFET.C T PRAT';-3,60 €;7.751,13 €;4732;-3,60;12.275,22 €;'sin fechas';13/01/2014;'CAFETC';'Gastos_Ocio y transporte';'Restaurantes';'VARIABLES'
13/01/2014;13/01/2014;'LA TERRASSETA - REST COLEGI';-2,30 €;7.748,83 €;4733;-2,30;12.272,92 €;'sin fechas';13/01/2014;'TERRASSETA';'Gastos_Ocio y transporte';'Restaurantes';'VARIABLES'
13/01/2014;13/01/2014;'SALA BADRINAS - QUOTA';-80,00 €;7.668,83 €;4734;-80,00;12.192,92 €;'sin fechas';13/01/2014;'SALA';'Gastos_Salud, saber y deporte';'Estudios';'VARIABLES'
13/01/2014;13/01/2014;'COMISIONES';-1,50 €;7.667,33 €;4736;-1,50;12.191,42 €;'sin fechas';13/01/2014;'COMISIONES';'Gastos_Banco y organismos';'Cargos banco';'FIJO'
14/01/2014;08/01/2014;'AUTOPISTA TERR';-1,39 €;7.665,94 €;4737;-1,39;12.190,03 €;'sin fechas';08/01/2014;'AUTOPISTA';'Gastos_Ocio y transporte';'Parking y peaje';'VARIABLES'
14/01/2014;14/01/2014;'BLITZ';-72,50 €;7.593,44 €;4738;-72,50;12.117,53 €;'sin fechas';14/01/2014;'BLITZ';'Gastos_Vivienda y vehiculo';'Alquiler Parking';'FIJO'
15/01/2014;15/01/2014;'AUTOPISTA TERR';-1,39 €;7.592,05 €;4740;-1,39;12.116,14 €;'sin fechas';15/01/2014;'AUTOPISTA';'Gastos_Ocio y transporte';'Parking y peaje';'VARIABLES'
15/01/2014;15/01/2014;'BON AREA';-13,75 €;7.578,30 €;4741;-13,75;12.102,39 €;'sin fechas';15/01/2014;'BON';'Gastos_Compras';'Supermercado';'VARIABLES'
15/01/2014;15/01/2014;'CCM VIDA Y P SEGURO PRESTAMO';-24,30 €;7.554,00 €;4742;-24,30;12.078,09 €;'sin fechas';15/01/2014;'CCM';'Gastos_Seguros';'Seguro vida';'FIJO'
15/01/2014;15/01/2014;'CCM VIDA Y PENSIO 000000493358';-18,68 €;7.535,32 €;4743;-18,68;12.059,41 €;'sin fechas';15/01/2014;'CCM';'Gastos_Seguros';'Seguro vida';'FIJO'
15/01/2014;15/01/2014;'SALA BADRINAS - QUOTA';-80,00 €;7.455,32 €;4744;-80,00;11.979,41 €;'sin fechas';15/01/2014;'SALA';'Gastos_Salud, saber y deporte';'Estudios';'VARIABLES'
16/01/2014;10/01/2014;'AUTOPISTA TERR';-1,39 €;7.453,93 €;4745;-1,39;11.978,02 €;'sin fechas';10/01/2014;'AUTOPISTA';'Gastos_Ocio y transporte';'Parking y peaje';'VARIABLES'
16/01/2014;14/01/2014;'CARREFOUR-[COMIDA]';-19,65 €;7.434,28 €;4746;-19,65;11.958,37 €;'sin fechas';14/01/2014;'CARREFOURCOMIDA';'Gastos_Compras';'Supermercado';'VARIABLES'
16/01/2014;14/01/2014;'CARREFOUR-[COMIDA]';-8,00 €;7.426,28 €;4747;-8,00;11.950,37 €;'sin fechas';14/01/2014;'CARREFOURCOMIDA';'Gastos_Compras';'Supermercado';'VARIABLES'
16/01/2014;16/01/2014;'FRUITES I VERDURES';-9,59 €;7.416,69 €;4748;-9,59;11.940,78 €;'sin fechas';16/01/2014;'FRUITES';'Gastos_Compras';'Supermercado';'VARIABLES'
16/01/2014;15/01/2014;'LA BRASA';-10,00 €;7.406,69 €;4749;-10,00;11.930,78 €;'sin fechas';15/01/2014;'BRASA';'Gastos_Ocio y transporte';'Restaurantes';'VARIABLES'
16/01/2014;16/01/2014;'REINT.CAJERO';-40,00 €;7.366,69 €;4750;-40,00;11.890,78 €;'sin fechas';16/01/2014;'REINTCAJERO';'Gastos_Gastos varios';'Efectivo';'VARIABLES'
16/01/2014;16/01/2014;'TACISA';-77,10 €;7.289,59 €;4751;-77,10;11.813,68 €;'sin fechas';16/01/2014;'TACISA';'Gastos_Compras';'Supermercado';'VARIABLES'
16/01/2014;14/01/2014;'VIENA';-19,30 €;7.270,29 €;4752;-19,30;11.794,38 €;'sin fechas';14/01/2014;'VIENA';'Gastos_Ocio y transporte';'Restaurantes';'VARIABLES'
17/01/2014;10/01/2014;'AUTOPISTA TERR';-4,19 €;7.266,10 €;4753;-4,19;11.790,19 €;'sin fechas';10/01/2014;'AUTOPISTA';'Gastos_Ocio y transporte';'Parking y peaje';'VARIABLES'
17/01/2014;13/01/2014;'AUTOPISTA TERR';-1,39 €;7.264,71 €;4754;-1,39;11.788,80 €;'sin fechas';13/01/2014;'AUTOPISTA';'Gastos_Ocio y transporte';'Parking y peaje';'VARIABLES'
17/01/2014;17/01/2014;'ES STA. MARGARITA';-20,00 €;7.244,71 €;4755;-20,00;11.768,80 €;'sin fechas';17/01/2014;'STA';'Gastos_Ocio y transporte';'Gasolina';'VARIABLES'
17/01/2014;17/01/2014;'ONO';-115,66 €;7.129,05 €;4756;-115,66;11.653,14 €;'sin fechas';17/01/2014;'ONO';'Gastos_Servicios tipicos';'Telecomunicaciones';'FIJO'
18/01/2014;18/01/2014;'CAFET.C T PRAT';-3,40 €;7.125,65 €;4758;-3,40;11.649,74 €;'sin fechas';18/01/2014;'CAFETC';'Gastos_Ocio y transporte';'Restaurantes';'VARIABLES'
18/01/2014;18/01/2014;'FARMACIA';-92,34 €;7.033,31 €;4759;-92,34;11.557,40 €;'sin fechas';18/01/2014;'FARMACIA';'Gastos_Salud, saber y deporte';'Farmacia';'VARIABLES'
19/01/2014;19/01/2014;'CAFET.C T PRAT';-3,60 €;7.029,71 €;4760;-3,60;11.553,80 €;'sin fechas';19/01/2014;'CAFETC';'Gastos_Ocio y transporte';'Restaurantes';'VARIABLES'
19/01/2014;19/01/2014;'CAFET.C T PRAT';-1,80 €;7.027,91 €;4761;-1,80;11.552,00 €;'sin fechas';19/01/2014;'CAFETC';'Gastos_Ocio y transporte';'Restaurantes';'VARIABLES'
19/01/2014;19/01/2014;'ES STA. MARGARITA';-48,81 €;6.979,10 €;4762;-48,81;11.503,19 €;'sin fechas';19/01/2014;'STA';'Gastos_Ocio y transporte';'Gasolina';'VARIABLES'
19/01/2014;19/01/2014;'VIENA';-11,80 €;6.967,30 €;4763;-11,80;11.491,39 €;'sin fechas';19/01/2014;'VIENA';'Gastos_Ocio y transporte';'Restaurantes';'VARIABLES'
20/01/2014;20/01/2014;'ADESLAS CENTRAL 006662671613';-110,99 €;6.856,31 €;4764;-110,99;11.380,40 €;'sin fechas';20/01/2014;'ADESLAS';'Gastos_Salud, saber y deporte';'Medico';'VARIABLES'
20/01/2014;14/01/2014;'AUTOPISTA TERR';-1,39 €;6.854,92 €;4765;-1,39;11.379,01 €;'sin fechas';14/01/2014;'AUTOPISTA';'Gastos_Ocio y transporte';'Parking y peaje';'VARIABLES'
20/01/2014;14/01/2014;'AUTOPISTA TERR';-1,39 €;6.853,53 €;4766;-1,39;11.377,62 €;'sin fechas';14/01/2014;'AUTOPISTA';'Gastos_Ocio y transporte';'Parking y peaje';'VARIABLES'
20/01/2014;20/01/2014;'CAFET.C T PRAT';-4,00 €;6.849,53 €;4767;-4,00;11.373,62 €;'sin fechas';20/01/2014;'CAFETC';'Gastos_Ocio y transporte';'Restaurantes';'VARIABLES'
20/01/2014;14/01/2014;'COCHE&PARKING';-14,65 €;6.834,88 €;4768;-14,65;11.358,97 €;'sin fechas';14/01/2014;'COCHEPARKING';'Gastos_Ocio y transporte';'Parking y peaje';'VARIABLES'
20/01/2014;20/01/2014;'RESTAURANTES';-12,50 €;6.822,38 €;4769;-12,50;11.346,47 €;'sin fechas';20/01/2014;'RESTAURANTES';'Gastos_Ocio y transporte';'Restaurantes';'VARIABLES'
20/01/2014;20/01/2014;'TOCINERIES VENTURA';-14,79 €;6.807,59 €;4770;-14,79;11.331,68 €;'sin fechas';20/01/2014;'TOCINERIES';'Gastos_Compras';'Supermercado';'VARIABLES'
21/01/2014;21/01/2014;'AUTOPISTA TERR';-1,39 €;6.806,20 €;4771;-1,39;11.330,29 €;'sin fechas';21/01/2014;'AUTOPISTA';'Gastos_Ocio y transporte';'Parking y peaje';'VARIABLES'
21/01/2014;16/01/2014;'AUTOPISTA TERR';-1,32 €;6.804,88 €;4772;-1,32;11.328,97 €;'sin fechas';16/01/2014;'AUTOPISTA';'Gastos_Ocio y transporte';'Parking y peaje';'VARIABLES'
21/01/2014;15/01/2014;'AUTOPISTA TERR';-1,32 €;6.803,56 €;4773;-1,32;11.327,65 €;'sin fechas';15/01/2014;'AUTOPISTA';'Gastos_Ocio y transporte';'Parking y peaje';'VARIABLES'
21/01/2014;16/01/2014;'AUTOPISTA TERR';-1,39 €;6.802,17 €;4774;-1,39;11.326,26 €;'sin fechas';16/01/2014;'AUTOPISTA';'Gastos_Ocio y transporte';'Parking y peaje';'VARIABLES'
22/01/2014;22/01/2014;'AUTOPISTA TERR';-1,32 €;6.800,85 €;4775;-1,32;11.324,94 €;'sin fechas';22/01/2014;'AUTOPISTA';'Gastos_Ocio y transporte';'Parking y peaje';'VARIABLES'
22/01/2014;22/01/2014;'AUTOPISTA TERR';-4,19 €;6.796,66 €;4776;-4,19;11.320,75 €;'sin fechas';22/01/2014;'AUTOPISTA';'Gastos_Ocio y transporte';'Parking y peaje';'VARIABLES'
23/01/2014;16/01/2014;'AUTOPISTA TERR';-4,19 €;6.792,47 €;4777;-4,19;11.316,56 €;'sin fechas';16/01/2014;'AUTOPISTA';'Gastos_Ocio y transporte';'Parking y peaje';'VARIABLES'
23/01/2014;23/01/2014;'FRUITES I VERDURES';-15,25 €;6.777,22 €;4778;-15,25;11.301,31 €;'sin fechas';23/01/2014;'FRUITES';'Gastos_Compras';'Supermercado';'VARIABLES'
23/01/2014;23/01/2014;'MERCADONA';-21,70 €;6.755,52 €;4779;-21,70;11.279,61 €;'sin fechas';23/01/2014;'MERCADONA';'Gastos_Compras';'Supermercado';'VARIABLES'
24/01/2014;19/01/2014;'AUTOPISTA TERR';-4,19 €;6.751,33 €;4780;-4,19;11.275,42 €;'sin fechas';19/01/2014;'AUTOPISTA';'Gastos_Ocio y transporte';'Parking y peaje';'VARIABLES'
24/01/2014;17/01/2014;'AUTOPISTA TERR';-4,19 €;6.747,14 €;4781;-4,19;11.271,23 €;'sin fechas';17/01/2014;'AUTOPISTA';'Gastos_Ocio y transporte';'Parking y peaje';'VARIABLES'
24/01/2014;24/01/2014;'AUTOPISTA TERR';-1,32 €;6.745,82 €;4782;-1,32;11.269,91 €;'sin fechas';24/01/2014;'AUTOPISTA';'Gastos_Ocio y transporte';'Parking y peaje';'VARIABLES'
24/01/2014;24/01/2014;'CAFET.C T PRAT';-3,60 €;6.742,22 €;4783;-3,60;11.266,31 €;'sin fechas';24/01/2014;'CAFETC';'Gastos_Ocio y transporte';'Restaurantes';'VARIABLES'
25/01/2014;25/01/2014;'CAFET.C T PRAT';-3,55 €;6.738,67 €;4784;-3,55;11.262,76 €;'sin fechas';25/01/2014;'CAFETC';'Gastos_Ocio y transporte';'Restaurantes';'VARIABLES'
25/01/2014;27/01/2014;'FOMENT DE TERRASSA, S.A. FOMEN';1.538,64 €;8.277,31 €;4786;1.538,64;12.801,40 €;'sin fechas';27/01/2014;'FOMENT';'Ingresos';'Nomina';'FIJO'
25/01/2014;25/01/2014;'WWW.JUST-EAT.ES';-14,00 €;8.263,31 €;4787;-14,00;12.787,40 €;'sin fechas';25/01/2014;'WWWJUSTEATES';'Gastos_Ocio y transporte';'Restaurantes';'VARIABLES'
26/01/2014;26/01/2014;'CAFET.C T PRAT';-4,05 €;8.259,26 €;4788;-4,05;12.783,35 €;'sin fechas';26/01/2014;'CAFETC';'Gastos_Ocio y transporte';'Restaurantes';'VARIABLES'
26/01/2014;26/01/2014;'PERRUQUERIA';-36,30 €;8.222,96 €;4789;-36,30;12.747,05 €;'sin fechas';26/01/2014;'PERRUQUERIA';'Gastos_Salud, saber y deporte';'Belleza';'VARIABLES'
27/01/2014;20/01/2014;'AUTOPISTA TERR';-1,32 €;8.221,64 €;4790;-1,32;12.745,73 €;'sin fechas';20/01/2014;'AUTOPISTA';'Gastos_Ocio y transporte';'Parking y peaje';'VARIABLES'
27/01/2014;21/01/2014;'AUTOPISTA TERR';-1,32 €;8.220,32 €;4791;-1,32;12.744,41 €;'sin fechas';21/01/2014;'AUTOPISTA';'Gastos_Ocio y transporte';'Parking y peaje';'VARIABLES'
27/01/2014;20/01/2014;'AUTOPISTA TERR';-1,39 €;8.218,93 €;4792;-1,39;12.743,02 €;'sin fechas';20/01/2014;'AUTOPISTA';'Gastos_Ocio y transporte';'Parking y peaje';'VARIABLES'
27/01/2014;27/01/2014;'BON AREA';-41,98 €;8.176,95 €;4793;-41,98;12.701,04 €;'sin fechas';27/01/2014;'BON';'Gastos_Compras';'Supermercado';'VARIABLES'
27/01/2014;27/01/2014;'RESTAURANTES';-1,60 €;8.175,35 €;4794;-1,60;12.699,44 €;'sin fechas';27/01/2014;'RESTAURANTES';'Gastos_Ocio y transporte';'Restaurantes';'VARIABLES'
28/01/2014;23/01/2014;'AUTOPISTA TERR';-1,25 €;8.174,10 €;4795;-1,25;12.698,19 €;'sin fechas';23/01/2014;'AUTOPISTA';'Gastos_Ocio y transporte';'Parking y peaje';'VARIABLES'
28/01/2014;22/01/2014;'AUTOPISTA TERR';-1,32 €;8.172,78 €;4796;-1,32;12.696,87 €;'sin fechas';22/01/2014;'AUTOPISTA';'Gastos_Ocio y transporte';'Parking y peaje';'VARIABLES'
28/01/2014;23/01/2014;'AUTOPISTA TERR';-1,25 €;8.171,53 €;4797;-1,25;12.695,62 €;'sin fechas';23/01/2014;'AUTOPISTA';'Gastos_Ocio y transporte';'Parking y peaje';'VARIABLES'
29/01/2014;29/01/2014;'INFORMACIO I TECNOLOGIA DE CAT';1.575,50 €;9.747,03 €;4799;1.575,50;14.271,12 €;'sin fechas';29/01/2014;'INFORMACIO';'Ingresos';'Nomina';'FIJO'
30/01/2014;23/01/2014;'AUTOPISTA TERR';-4,19 €;9.742,84 €;4800;-4,19;14.266,93 €;'sin fechas';23/01/2014;'AUTOPISTA';'Gastos_Ocio y transporte';'Parking y peaje';'VARIABLES'
30/01/2014;24/01/2014;'AUTOPISTA TERR';-1,25 €;9.741,59 €;4801;-1,25;14.265,68 €;'sin fechas';24/01/2014;'AUTOPISTA';'Gastos_Ocio y transporte';'Parking y peaje';'VARIABLES'
30/01/2014;29/01/2014;'ES STA. MARGARITA';-30,00 €;9.711,59 €;4802;-30,00;14.235,68 €;'sin fechas';29/01/2014;'STA';'Gastos_Ocio y transporte';'Gasolina';'VARIABLES'
30/01/2014;30/01/2014;'LA TERRASSETA - REST COLEGI';-2,30 €;9.709,29 €;4804;-2,30;14.233,38 €;'sin fechas';30/01/2014;'TERRASSETA';'Gastos_Ocio y transporte';'Restaurantes';'VARIABLES'
31/01/2014;31/01/2014;'AJUNTAMENT DE TER 010000520716';-44,87 €;9.664,42 €;4805;-44,87;14.188,51 €;'sin fechas';31/01/2014;'AJUNTAMENT';'Gastos_Banco y organismos';'Ayuntamiento';'FIJO'
31/01/2014;26/01/2014;'AUTOPISTA TERR';-4,19 €;9.660,23 €;4806;-4,19;14.184,32 €;'sin fechas';26/01/2014;'AUTOPISTA';'Gastos_Ocio y transporte';'Parking y peaje';'VARIABLES'
31/01/2014;31/01/2014;'AUTOPISTA TERR';-1,32 €;9.658,91 €;4807;-1,32;14.183,00 €;'sin fechas';31/01/2014;'AUTOPISTA';'Gastos_Ocio y transporte';'Parking y peaje';'VARIABLES'
31/01/2014;27/01/2014;'AUTOPISTA TERR';-1,25 €;9.657,66 €;4808;-1,25;14.181,75 €;'sin fechas';27/01/2014;'AUTOPISTA';'Gastos_Ocio y transporte';'Parking y peaje';'VARIABLES'
31/01/2014;27/01/2014;'AUTOPISTA TERR';-1,39 €;9.656,27 €;4809;-1,39;14.180,36 €;'sin fechas';27/01/2014;'AUTOPISTA';'Gastos_Ocio y transporte';'Parking y peaje';'VARIABLES'
31/01/2014;31/01/2014;'CAFET.C T PRAT';-3,50 €;9.652,77 €;4810;-3,50;14.176,86 €;'sin fechas';31/01/2014;'CAFETC';'Gastos_Ocio y transporte';'Restaurantes';'VARIABLES'
31/01/2014;31/01/2014;'RECIBO PTMOS. 3061-0960001518';-562,73 €;9.090,04 €;4811;-562,73;13.614,13 €;'sin fechas';31/01/2014;'RECIBO';'Gastos_Banco y organismos';'Hipoteca';'FIJO'
01/02/2014;01/02/2014;'CAFET.C T PRAT';-4,05 €;9.085,99 €;4812;-4,05;13.610,08 €;'sin fechas';01/02/2014;'CAFETC';'Gastos_Ocio y transporte';'Restaurantes';'VARIABLES'
01/02/2014;01/02/2014;'LA TERRASSETA - REST COLEGI';-2,30 €;9.083,69 €;4814;-2,30;13.607,78 €;'sin fechas';01/02/2014;'TERRASSETA';'Gastos_Ocio y transporte';'Restaurantes';'VARIABLES'
01/02/2014;01/02/2014;'MERCADONA';-12,49 €;9.071,20 €;4815;-12,49;13.595,29 €;'sin fechas';01/02/2014;'MERCADONA';'Gastos_Compras';'Supermercado';'VARIABLES'
01/02/2014;01/02/2014;'MERCADONA';-147,25 €;8.923,95 €;4816;-147,25;13.448,04 €;'sin fechas';01/02/2014;'MERCADONA';'Gastos_Compras';'Supermercado';'VARIABLES'
01/02/2014;01/02/2014;'MERCADONA';-1,00 €;8.922,95 €;4817;-1,00;13.447,04 €;'sin fechas';01/02/2014;'MERCADONA';'Gastos_Compras';'Supermercado';'VARIABLES'
02/02/2014;02/02/2014;'CAFET.C T PRAT';-0,90 €;8.922,05 €;4818;-0,90;13.446,14 €;'sin fechas';02/02/2014;'CAFETC';'Gastos_Ocio y transporte';'Restaurantes';'VARIABLES'
02/02/2014;02/02/2014;'ES STA. MARGARITA';-47,14 €;8.874,91 €;4819;-47,14;13.399,00 €;'sin fechas';02/02/2014;'STA';'Gastos_Ocio y transporte';'Gasolina';'VARIABLES'
02/02/2014;02/02/2014;'SONY ENT NETWORK';-49,99 €;8.824,92 €;4820;-49,99;13.349,01 €;'sin fechas';02/02/2014;'SONY';'Gastos_Servicios tipicos';'Servicios online';'FIJO'
03/02/2014;28/01/2014;'AUTOPISTA TERR';-1,25 €;8.823,67 €;4821;-1,25;13.347,76 €;'sin fechas';28/01/2014;'AUTOPISTA';'Gastos_Ocio y transporte';'Parking y peaje';'VARIABLES'
03/02/2014;28/01/2014;'AUTOPISTA TERR';-1,39 €;8.822,28 €;4822;-1,39;13.346,37 €;'sin fechas';28/01/2014;'AUTOPISTA';'Gastos_Ocio y transporte';'Parking y peaje';'VARIABLES'
03/02/2014;03/02/2014;'AUTOPISTA TERR';-1,39 €;8.820,89 €;4823;-1,39;13.344,98 €;'sin fechas';03/02/2014;'AUTOPISTA';'Gastos_Ocio y transporte';'Parking y peaje';'VARIABLES'
03/02/2014;29/01/2014;'AUTOPISTA TERR';-10,60 €;8.810,29 €;4824;-10,60;13.334,38 €;'sin fechas';29/01/2014;'AUTOPISTA';'Gastos_Ocio y transporte';'Parking y peaje';'VARIABLES'
03/02/2014;29/01/2014;'AUTOPISTA TERR';-10,60 €;8.799,69 €;4825;-10,60;13.323,78 €;'sin fechas';29/01/2014;'AUTOPISTA';'Gastos_Ocio y transporte';'Parking y peaje';'VARIABLES'
03/02/2014;29/01/2014;'AUTOPISTA TERR';-7,15 €;8.792,54 €;4826;-7,15;13.316,63 €;'sin fechas';29/01/2014;'AUTOPISTA';'Gastos_Ocio y transporte';'Parking y peaje';'VARIABLES'
03/02/2014;29/01/2014;'AUTOPISTA TERR';-7,15 €;8.785,39 €;4827;-7,15;13.309,48 €;'sin fechas';29/01/2014;'AUTOPISTA';'Gastos_Ocio y transporte';'Parking y peaje';'VARIABLES'
03/02/2014;03/02/2014;'CAJA DE SEGUROS R 300045047898';-304,27 €;8.481,12 €;4828;-304,27;13.005,21 €;'sin fechas';03/02/2014;'CAJA';'Gastos_Seguros';'Seguro hogar';'FIJO'
03/02/2014;03/02/2014;'TABASA VALLVI S. C:2T';-4,19 €;8.476,93 €;4829;-4,19;13.001,02 €;'sin fechas';03/02/2014;'TABASA';'Gastos_Ocio y transporte';'Parking y peaje';'VARIABLES'
04/02/2014;30/01/2014;'AUTOPISTA TERR';-1,25 €;8.475,68 €;4830;-1,25;12.999,77 €;'sin fechas';30/01/2014;'AUTOPISTA';'Gastos_Ocio y transporte';'Parking y peaje';'VARIABLES'
04/02/2014;29/01/2014;'AUTOPISTA TERR';-1,25 €;8.474,43 €;4831;-1,25;12.998,52 €;'sin fechas';29/01/2014;'AUTOPISTA';'Gastos_Ocio y transporte';'Parking y peaje';'VARIABLES'
04/02/2014;30/01/2014;'AUTOPISTA TERR';-1,39 €;8.473,04 €;4832;-1,39;12.997,13 €;'sin fechas';30/01/2014;'AUTOPISTA';'Gastos_Ocio y transporte';'Parking y peaje';'VARIABLES'
04/02/2014;29/01/2014;'AUTOPISTA TERR';-1,25 €;8.471,79 €;4833;-1,25;12.995,88 €;'sin fechas';29/01/2014;'AUTOPISTA';'Gastos_Ocio y transporte';'Parking y peaje';'VARIABLES'
04/02/2014;04/02/2014;'AUTOPISTA TERR';-1,39 €;8.470,40 €;4834;-1,39;12.994,49 €;'sin fechas';04/02/2014;'AUTOPISTA';'Gastos_Ocio y transporte';'Parking y peaje';'VARIABLES'
04/02/2014;04/02/2014;'CAJA DE SEGUROS R 300045047898';304,27 €;8.774,67 €;4835;304,27;13.298,76 €;'sin fechas';04/02/2014;'CAJA';'Gastos_Seguros';'Seguro hogar';'FIJO'
04/02/2014;04/02/2014;'TABASA VALLVI S. C:2T';-4,19 €;8.770,48 €;4836;-4,19;13.294,57 €;'sin fechas';04/02/2014;'TABASA';'Gastos_Ocio y transporte';'Parking y peaje';'VARIABLES'
05/02/2014;05/02/2014;'FARMACIA';-14,29 €;8.756,19 €;4837;-14,29;13.280,28 €;'sin fechas';05/02/2014;'FARMACIA';'Gastos_Salud, saber y deporte';'Farmacia';'VARIABLES'
05/02/2014;05/02/2014;'RESTAURANTES';-9,80 €;8.746,39 €;4838;-9,80;13.270,48 €;'sin fechas';05/02/2014;'RESTAURANTES';'Gastos_Ocio y transporte';'Restaurantes';'VARIABLES'
06/02/2014;06/02/2014;'AUTOPISTA TERR';-1,39 €;8.745,00 €;4839;-1,39;13.269,09 €;'sin fechas';06/02/2014;'AUTOPISTA';'Gastos_Ocio y transporte';'Parking y peaje';'VARIABLES'
06/02/2014;31/01/2014;'AUTOPISTA TERR';-1,39 €;8.743,61 €;4840;-1,39;13.267,70 €;'sin fechas';31/01/2014;'AUTOPISTA';'Gastos_Ocio y transporte';'Parking y peaje';'VARIABLES'
06/02/2014;06/02/2014;'CAFET.C T PRAT';-3,60 €;8.740,01 €;4841;-3,60;13.264,10 €;'sin fechas';06/02/2014;'CAFETC';'Gastos_Ocio y transporte';'Restaurantes';'VARIABLES'
06/02/2014;06/02/2014;'CAFET.C T PRAT';-5,50 €;8.734,51 €;4842;-5,50;13.258,60 €;'sin fechas';06/02/2014;'CAFETC';'Gastos_Ocio y transporte';'Restaurantes';'VARIABLES'
06/02/2014;06/02/2014;'ESCOLA BRESSOL EINA';-482,60 €;8.251,91 €;4843;-482,60;12.776,00 €;'sin fechas';06/02/2014;'ESCOLA';'Gastos_Salud, saber y deporte';'Estudios';'VARIABLES'
06/02/2014;06/02/2014;'LETSBONUS';-98,00 €;8.153,91 €;4844;-98,00;12.678,00 €;'sin fechas';06/02/2014;'LETSBONUS';'Gastos_Ocio y transporte';'Vacaciones';'VARIABLES'
06/02/2014;06/02/2014;'SALA BADRINAS - AMPA';-118,00 €;8.035,91 €;4845;-118,00;12.560,00 €;'sin fechas';06/02/2014;'SALA';'Gastos_Salud, saber y deporte';'Estudios';'VARIABLES'
06/02/2014;30/01/2014;'TABASA VALLVI S. C:2T';-4,19 €;8.031,72 €;4846;-4,19;12.555,81 €;'sin fechas';30/01/2014;'TABASA';'Gastos_Ocio y transporte';'Parking y peaje';'VARIABLES'
06/02/2014;06/02/2014;'COMISIONES';-1,50 €;8.030,22 €;4847;-1,50;12.554,31 €;'sin fechas';06/02/2014;'COMISIONES';'Gastos_Banco y organismos';'Cargos banco';'FIJO'
07/02/2014;07/02/2014;'BLITZ';-72,50 €;7.957,72 €;4848;-72,50;12.481,81 €;'sin fechas';07/02/2014;'BLITZ';'Gastos_Vivienda y vehiculo';'Alquiler Parking';'FIJO'
07/02/2014;07/02/2014;'CAFET.C T PRAT';-2,65 €;7.955,07 €;4849;-2,65;12.479,16 €;'sin fechas';07/02/2014;'CAFETC';'Gastos_Ocio y transporte';'Restaurantes';'VARIABLES'
07/02/2014;07/02/2014;'FRUITES I VERDURES';-5,57 €;7.949,50 €;4850;-5,57;12.473,59 €;'sin fechas';07/02/2014;'FRUITES';'Gastos_Compras';'Supermercado';'VARIABLES'
07/02/2014;07/02/2014;'LA TERRASSETA - REST COLEGI';-2,40 €;7.947,10 €;4851;-2,40;12.471,19 €;'sin fechas';07/02/2014;'TERRASSETA';'Gastos_Ocio y transporte';'Restaurantes';'VARIABLES'
07/02/2014;02/02/2014;'TABASA VALLVI S. C:2T';-4,19 €;7.942,91 €;4852;-4,19;12.467,00 €;'sin fechas';02/02/2014;'TABASA';'Gastos_Ocio y transporte';'Parking y peaje';'VARIABLES'
07/02/2014;31/01/2014;'TABASA VALLVI S. C:2T';-4,19 €;7.938,72 €;4853;-4,19;12.462,81 €;'sin fechas';31/01/2014;'TABASA';'Gastos_Ocio y transporte';'Parking y peaje';'VARIABLES'
08/02/2014;08/02/2014;'BON AREA';-21,03 €;7.917,69 €;4854;-21,03;12.441,78 €;'sin fechas';08/02/2014;'BON';'Gastos_Compras';'Supermercado';'VARIABLES'
10/02/2014;10/02/2014;'AUTOPISTA TERR';-1,39 €;7.916,30 €;4855;-1,39;12.440,39 €;'sin fechas';10/02/2014;'AUTOPISTA';'Gastos_Ocio y transporte';'Parking y peaje';'VARIABLES'
10/02/2014;04/02/2014;'AUTOPISTA TERR';-1,39 €;7.914,91 €;4856;-1,39;12.439,00 €;'sin fechas';04/02/2014;'AUTOPISTA';'Gastos_Ocio y transporte';'Parking y peaje';'VARIABLES'
10/02/2014;03/02/2014;'AUTOPISTA TERR';-1,39 €;7.913,52 €;4857;-1,39;12.437,61 €;'sin fechas';03/02/2014;'AUTOPISTA';'Gastos_Ocio y transporte';'Parking y peaje';'VARIABLES'
10/02/2014;03/02/2014;'AUTOPISTA TERR';-4,19 €;7.909,33 €;4858;-4,19;12.433,42 €;'sin fechas';03/02/2014;'AUTOPISTA';'Gastos_Ocio y transporte';'Parking y peaje';'VARIABLES'
10/02/2014;10/02/2014;'SALA BADRINAS - MENJADOR';-124,00 €;7.785,33 €;4859;-124,00;12.309,42 €;'sin fechas';10/02/2014;'SALA';'Gastos_Salud, saber y deporte';'Estudios';'VARIABLES'
10/02/2014;10/02/2014;'TACISA';-109,10 €;7.676,23 €;4860;-109,10;12.200,32 €;'sin fechas';10/02/2014;'TACISA';'Gastos_Compras';'Supermercado';'VARIABLES'
10/02/2014;10/02/2014;'VIENA';-16,20 €;7.660,03 €;4861;-16,20;12.184,12 €;'sin fechas';10/02/2014;'VIENA';'Gastos_Ocio y transporte';'Restaurantes';'VARIABLES'
11/02/2014;05/02/2014;'AUTOPISTA TERR';-1,39 €;7.658,64 €;4862;-1,39;12.182,73 €;'sin fechas';05/02/2014;'AUTOPISTA';'Gastos_Ocio y transporte';'Parking y peaje';'VARIABLES'
11/02/2014;05/02/2014;'AUTOPISTA TERR';-1,39 €;7.657,25 €;4863;-1,39;12.181,34 €;'sin fechas';05/02/2014;'AUTOPISTA';'Gastos_Ocio y transporte';'Parking y peaje';'VARIABLES'
12/02/2014;12/02/2014;'ADESLAS CENTRAL 006662671613';-110,99 €;7.546,26 €;4864;-110,99;12.070,35 €;'sin fechas';12/02/2014;'ADESLAS';'Gastos_Salud, saber y deporte';'Medico';'VARIABLES'
12/02/2014;12/02/2014;'AUTOPISTA TERR';-1,39 €;7.544,87 €;4865;-1,39;12.068,96 €;'sin fechas';12/02/2014;'AUTOPISTA';'Gastos_Ocio y transporte';'Parking y peaje';'VARIABLES'
12/02/2014;12/02/2014;'BON AREA';-13,89 €;7.530,98 €;4866;-13,89;12.055,07 €;'sin fechas';12/02/2014;'BON';'Gastos_Compras';'Supermercado';'VARIABLES'
12/02/2014;12/02/2014;'CATALANA DIAG.I CIRUR';-4,75 €;7.526,23 €;4867;-4,75;12.050,32 €;'sin fechas';12/02/2014;'CATALANA';'Gastos_Ocio y transporte';'Parking y peaje';'VARIABLES'
12/02/2014;12/02/2014;'COM. MANT. ACTIVAS DE LIQ.';-3,45 €;7.522,78 €;4868;-3,45;12.046,87 €;'sin fechas';12/02/2014;'COM';'Gastos_Banco y organismos';'Cargos banco';'FIJO'
13/02/2014;13/02/2014;'AUTOPISTA TERR';-1,39 €;7.521,39 €;4869;-1,39;12.045,48 €;'sin fechas';13/02/2014;'AUTOPISTA';'Gastos_Ocio y transporte';'Parking y peaje';'VARIABLES'
13/02/2014;13/02/2014;'CAFET.C T PRAT';-2,15 €;7.519,24 €;4870;-2,15;12.043,33 €;'sin fechas';13/02/2014;'CAFETC';'Gastos_Ocio y transporte';'Restaurantes';'VARIABLES'
13/02/2014;13/02/2014;'ES STA. MARGARITA';-32,95 €;7.486,29 €;4871;-32,95;12.010,38 €;'sin fechas';13/02/2014;'STA';'Gastos_Ocio y transporte';'Gasolina';'VARIABLES'
13/02/2014;13/02/2014;'FRUITES I VERDURES';-8,40 €;7.477,89 €;4872;-8,40;12.001,98 €;'sin fechas';13/02/2014;'FRUITES';'Gastos_Compras';'Supermercado';'VARIABLES'
13/02/2014;13/02/2014;'GAS NATURAL';-227,59 €;7.250,30 €;4873;-227,59;11.774,39 €;'sin fechas';13/02/2014;'GAS';'Gastos_Servicios tipicos';'Gas';'FIJO'
13/02/2014;13/02/2014;'FRANKFURT LES LLETRES';-6,40 €;7.243,90 €;4874;-6,40;11.767,99 €;'sin fechas';13/02/2014;'FRANKFURT';'Gastos_Ocio y transporte';'Restaurantes';'VARIABLES'
14/02/2014;14/02/2014;'AUTOPISTA TERR';-1,39 €;7.242,51 €;4875;-1,39;11.766,60 €;'sin fechas';14/02/2014;'AUTOPISTA';'Gastos_Ocio y transporte';'Parking y peaje';'VARIABLES'
14/02/2014;10/02/2014;'AUTOPISTA TERR';-1,39 €;7.241,12 €;4876;-1,39;11.765,21 €;'sin fechas';10/02/2014;'AUTOPISTA';'Gastos_Ocio y transporte';'Parking y peaje';'VARIABLES'
14/02/2014;08/02/2014;'AUTOPISTA TERR';-4,19 €;7.236,93 €;4877;-4,19;11.761,02 €;'sin fechas';08/02/2014;'AUTOPISTA';'Gastos_Ocio y transporte';'Parking y peaje';'VARIABLES'
14/02/2014;14/02/2014;'BON AREA';-18,16 €;7.218,77 €;4878;-18,16;11.742,86 €;'sin fechas';14/02/2014;'BON';'Gastos_Compras';'Supermercado';'VARIABLES'
14/02/2014;14/02/2014;'CAFET.C T PRAT';-4,10 €;7.214,67 €;4879;-4,10;11.738,76 €;'sin fechas';14/02/2014;'CAFETC';'Gastos_Ocio y transporte';'Restaurantes';'VARIABLES'
14/02/2014;14/02/2014;'CAFET.C T PRAT';-2,10 €;7.212,57 €;4880;-2,10;11.736,66 €;'sin fechas';14/02/2014;'CAFETC';'Gastos_Ocio y transporte';'Restaurantes';'VARIABLES'
14/02/2014;14/02/2014;'CAL TONI';-11,10 €;7.201,47 €;4881;-11,10;11.725,56 €;'sin fechas';14/02/2014;'CAL';'Gastos_Ocio y transporte';'Restaurantes';'VARIABLES'
14/02/2014;14/02/2014;'CCM VIDA Y PENSIO 000000493358';-18,62 €;7.182,85 €;4882;-18,62;11.706,94 €;'sin fechas';14/02/2014;'CCM';'Gastos_Seguros';'Seguro vida';'FIJO'
15/02/2014;15/02/2014;'CAFET.C T PRAT';-9,05 €;7.173,80 €;4883;-9,05;11.697,89 €;'sin fechas';15/02/2014;'CAFETC';'Gastos_Ocio y transporte';'Restaurantes';'VARIABLES'
15/02/2014;15/02/2014;'CAFET.C T PRAT';-1,30 €;7.172,50 €;4884;-1,30;11.696,59 €;'sin fechas';15/02/2014;'CAFETC';'Gastos_Ocio y transporte';'Restaurantes';'VARIABLES'
15/02/2014;15/02/2014;'COCHE&PARKING';-4,10 €;7.168,40 €;4885;-4,10;11.692,49 €;'sin fechas';15/02/2014;'COCHEPARKING';'Gastos_Ocio y transporte';'Parking y peaje';'VARIABLES'
15/02/2014;15/02/2014;'COCHE&PARKING';-12,15 €;7.156,25 €;4886;-12,15;11.680,34 €;'sin fechas';15/02/2014;'COCHEPARKING';'Gastos_Ocio y transporte';'Parking y peaje';'VARIABLES'
15/02/2014;15/02/2014;'LA TERRASSETA - REST COLEGI';-5,65 €;7.150,60 €;4888;-5,65;11.674,69 €;'sin fechas';15/02/2014;'TERRASSETA';'Gastos_Ocio y transporte';'Restaurantes';'VARIABLES'
15/02/2014;15/02/2014;'MUSEO HISTORIA CATALUNYA';-7,00 €;7.143,60 €;4889;-7,00;11.667,69 €;'sin fechas';15/02/2014;'MUSEO';'Gastos_Ocio y transporte';'Espectáculos';'VARIABLES'
16/02/2014;16/02/2014;'CAFET.C T PRAT';-2,55 €;7.141,05 €;4890;-2,55;11.665,14 €;'sin fechas';16/02/2014;'CAFETC';'Gastos_Ocio y transporte';'Restaurantes';'VARIABLES'
16/02/2014;16/02/2014;'REINT.CAJERO';-120,00 €;7.021,05 €;4891;-120,00;11.545,14 €;'sin fechas';16/02/2014;'REINTCAJERO';'Gastos_Gastos varios';'Efectivo';'VARIABLES'
17/02/2014;11/02/2014;'AUTOPISTA TERR';-1,39 €;7.019,66 €;4892;-1,39;11.543,75 €;'sin fechas';11/02/2014;'AUTOPISTA';'Gastos_Ocio y transporte';'Parking y peaje';'VARIABLES'
17/02/2014;11/02/2014;'AUTOPISTA TERR';-1,39 €;7.018,27 €;4893;-1,39;11.542,36 €;'sin fechas';11/02/2014;'AUTOPISTA';'Gastos_Ocio y transporte';'Parking y peaje';'VARIABLES'
17/02/2014;17/02/2014;'CCM VIDA Y P SEGURO PRESTAMO';-24,24 €;6.994,03 €;4894;-24,24;11.518,12 €;'sin fechas';17/02/2014;'CCM';'Gastos_Seguros';'Seguro vida';'FIJO'
17/02/2014;17/02/2014;'LA TERRASSETA - REST COLEGI';-3,75 €;6.990,28 €;4895;-3,75;11.514,37 €;'sin fechas';17/02/2014;'TERRASSETA';'Gastos_Ocio y transporte';'Restaurantes';'VARIABLES'
17/02/2014;17/02/2014;'ONO';-112,41 €;6.877,87 €;4896;-112,41;11.401,96 €;'sin fechas';17/02/2014;'ONO';'Gastos_Servicios tipicos';'Telecomunicaciones';'FIJO'
17/02/2014;17/02/2014;'REINT.CAJERO';-20,00 €;6.857,87 €;4897;-20,00;11.381,96 €;'sin fechas';17/02/2014;'REINTCAJERO';'Gastos_Gastos varios';'Efectivo';'VARIABLES'
18/02/2014;12/02/2014;'AUTOPISTA TERR';-1,39 €;6.856,48 €;4898;-1,39;11.380,57 €;'sin fechas';12/02/2014;'AUTOPISTA';'Gastos_Ocio y transporte';'Parking y peaje';'VARIABLES'
18/02/2014;13/02/2014;'AUTOPISTA TERR';-1,32 €;6.855,16 €;4899;-1,32;11.379,25 €;'sin fechas';13/02/2014;'AUTOPISTA';'Gastos_Ocio y transporte';'Parking y peaje';'VARIABLES'
18/02/2014;12/02/2014;'AUTOPISTA TERR';-1,39 €;6.853,77 €;4900;-1,39;11.377,86 €;'sin fechas';12/02/2014;'AUTOPISTA';'Gastos_Ocio y transporte';'Parking y peaje';'VARIABLES'
18/02/2014;12/02/2014;'AUTOPISTA TERR';-1,39 €;6.852,38 €;4901;-1,39;11.376,47 €;'sin fechas';12/02/2014;'AUTOPISTA';'Gastos_Ocio y transporte';'Parking y peaje';'VARIABLES'
18/02/2014;18/02/2014;'FRANKFURT LES LLETRES';-5,15 €;6.847,23 €;4902;-5,15;11.371,32 €;'sin fechas';18/02/2014;'FRANKFURT';'Gastos_Ocio y transporte';'Restaurantes';'VARIABLES'
19/02/2014;19/02/2014;'REINT.CAJERO';-40,00 €;6.807,23 €;4903;-40,00;11.331,32 €;'sin fechas';19/02/2014;'REINTCAJERO';'Gastos_Gastos varios';'Efectivo';'VARIABLES'
20/02/2014;14/02/2014;'AUTOPISTA TERR';-1,39 €;6.805,84 €;4904;-1,39;11.329,93 €;'sin fechas';14/02/2014;'AUTOPISTA';'Gastos_Ocio y transporte';'Parking y peaje';'VARIABLES'
20/02/2014;13/02/2014;'AUTOPISTA TERR';-4,19 €;6.801,65 €;4905;-4,19;11.325,74 €;'sin fechas';13/02/2014;'AUTOPISTA';'Gastos_Ocio y transporte';'Parking y peaje';'VARIABLES'
20/02/2014;18/02/2014;'LIFE-INFORMATICA';-41,61 €;6.760,04 €;4906;-41,61;11.284,13 €;'sin fechas';18/02/2014;'LIFEINFORMATICA';'Gastos_Compras';'Hobbys';'VARIABLES'
20/02/2014;18/02/2014;'PANS';-20,60 €;6.739,44 €;4907;-20,60;11.263,53 €;'sin fechas';18/02/2014;'PANS';'Gastos_Ocio y transporte';'Restaurantes';'VARIABLES'
20/02/2014;18/02/2014;'VIENA';-9,45 €;6.729,99 €;4908;-9,45;11.254,08 €;'sin fechas';18/02/2014;'VIENA';'Gastos_Ocio y transporte';'Restaurantes';'VARIABLES'
20/02/2014;18/02/2014;'WORTEN';-20,98 €;6.709,01 €;4909;-20,98;11.233,10 €;'sin fechas';18/02/2014;'WORTEN';'Gastos_Compras';'Hobbys';'VARIABLES'
21/02/2014;17/02/2014;'AUTOPISTA TERR';-1,32 €;6.707,69 €;4910;-1,32;11.231,78 €;'sin fechas';17/02/2014;'AUTOPISTA';'Gastos_Ocio y transporte';'Parking y peaje';'VARIABLES'
21/02/2014;17/02/2014;'AUTOPISTA TERR';-1,39 €;6.706,30 €;4911;-1,39;11.230,39 €;'sin fechas';17/02/2014;'AUTOPISTA';'Gastos_Ocio y transporte';'Parking y peaje';'VARIABLES'
21/02/2014;15/02/2014;'AUTOPISTA TERR';-4,19 €;6.702,11 €;4912;-4,19;11.226,20 €;'sin fechas';15/02/2014;'AUTOPISTA';'Gastos_Ocio y transporte';'Parking y peaje';'VARIABLES'
21/02/2014;14/02/2014;'AUTOPISTA TERR';-4,19 €;6.697,92 €;4913;-4,19;11.222,01 €;'sin fechas';14/02/2014;'AUTOPISTA';'Gastos_Ocio y transporte';'Parking y peaje';'VARIABLES'
21/02/2014;21/02/2014;'MERCADONA';-29,46 €;6.668,46 €;4914;-29,46;11.192,55 €;'sin fechas';21/02/2014;'MERCADONA';'Gastos_Compras';'Supermercado';'VARIABLES'
22/02/2014;22/02/2014;'CAFET.C T PRAT';-4,50 €;6.663,96 €;4915;-4,50;11.188,05 €;'sin fechas';22/02/2014;'CAFETC';'Gastos_Ocio y transporte';'Restaurantes';'VARIABLES'
22/02/2014;22/02/2014;'FRUITES I VERDURES';-1,10 €;6.662,86 €;4916;-1,10;11.186,95 €;'sin fechas';22/02/2014;'FRUITES';'Gastos_Compras';'Supermercado';'VARIABLES'
23/02/2014;23/02/2014;'ES STA. MARGARITA';-32,73 €;6.630,13 €;4917;-32,73;11.154,22 €;'sin fechas';23/02/2014;'STA';'Gastos_Ocio y transporte';'Gasolina';'VARIABLES'
23/02/2014;23/02/2014;'FRUITES I VERDURES';-3,84 €;6.626,29 €;4918;-3,84;11.150,38 €;'sin fechas';23/02/2014;'FRUITES';'Gastos_Compras';'Supermercado';'VARIABLES'
23/02/2014;23/02/2014;'LA BRASA';-12,90 €;6.613,39 €;4919;-12,90;11.137,48 €;'sin fechas';23/02/2014;'BRASA';'Gastos_Ocio y transporte';'Restaurantes';'VARIABLES'
24/02/2014;24/02/2014;'AUTOPISTA TERR';-1,39 €;6.612,00 €;4920;-1,39;11.136,09 €;'sin fechas';24/02/2014;'AUTOPISTA';'Gastos_Ocio y transporte';'Parking y peaje';'VARIABLES'
24/02/2014;18/02/2014;'AUTOPISTA TERR';-1,39 €;6.610,61 €;4921;-1,39;11.134,70 €;'sin fechas';18/02/2014;'AUTOPISTA';'Gastos_Ocio y transporte';'Parking y peaje';'VARIABLES'
24/02/2014;18/02/2014;'AUTOPISTA TERR';-1,32 €;6.609,29 €;4922;-1,32;11.133,38 €;'sin fechas';18/02/2014;'AUTOPISTA';'Gastos_Ocio y transporte';'Parking y peaje';'VARIABLES'
24/02/2014;24/02/2014;'CAFET.C T PRAT';-4,10 €;6.605,19 €;4923;-4,10;11.129,28 €;'sin fechas';24/02/2014;'CAFETC';'Gastos_Ocio y transporte';'Restaurantes';'VARIABLES'
24/02/2014;24/02/2014;'RESTAURANTES';-41,90 €;6.563,29 €;4924;-41,90;11.087,38 €;'sin fechas';24/02/2014;'RESTAURANTES';'Gastos_Ocio y transporte';'Restaurantes';'VARIABLES'
25/02/2014;19/02/2014;'AUTOPISTA TERR';-1,39 €;6.561,90 €;4925;-1,39;11.085,99 €;'sin fechas';19/02/2014;'AUTOPISTA';'Gastos_Ocio y transporte';'Parking y peaje';'VARIABLES'
25/02/2014;19/02/2014;'AUTOPISTA TERR';-1,32 €;6.560,58 €;4926;-1,32;11.084,67 €;'sin fechas';19/02/2014;'AUTOPISTA';'Gastos_Ocio y transporte';'Parking y peaje';'VARIABLES'
25/02/2014;20/02/2014;'AUTOPISTA TERR';-1,32 €;6.559,26 €;4927;-1,32;11.083,35 €;'sin fechas';20/02/2014;'AUTOPISTA';'Gastos_Ocio y transporte';'Parking y peaje';'VARIABLES'
25/02/2014;20/02/2014;'AUTOPISTA TERR';-1,25 €;6.558,01 €;4928;-1,25;11.082,10 €;'sin fechas';20/02/2014;'AUTOPISTA';'Gastos_Ocio y transporte';'Parking y peaje';'VARIABLES'
25/02/2014;25/02/2014;'FRANKFURT LES LLETRES';-4,70 €;6.553,31 €;4929;-4,70;11.077,40 €;'sin fechas';25/02/2014;'FRANKFURT';'Gastos_Ocio y transporte';'Restaurantes';'VARIABLES'
26/02/2014;26/02/2014;'A* CUOTA TARJETA PRINCIPAL';-33,00 €;6.520,31 €;4930;-33,00;11.044,40 €;'sin fechas';26/02/2014;'CUOTA';'Gastos_Banco y organismos';'Cargos banco';'FIJO'
26/02/2014;26/02/2014;'FOMENT DE TERRASSA, S.A. FOMEN';1.548,50 €;8.068,81 €;4931;1.548,50;12.592,90 €;'sin fechas';26/02/2014;'FOMENT';'Ingresos';'Nomina';'FIJO'
26/02/2014;26/02/2014;'FRANKFURT LES LLETRES';-10,10 €;8.058,71 €;4932;-10,10;12.582,80 €;'sin fechas';26/02/2014;'FRANKFURT';'Gastos_Ocio y transporte';'Restaurantes';'VARIABLES'
26/02/2014;26/02/2014;'MERCADONA';-16,55 €;8.042,16 €;4933;-16,55;12.566,25 €;'sin fechas';26/02/2014;'MERCADONA';'Gastos_Compras';'Supermercado';'VARIABLES'
27/02/2014;20/02/2014;'AUTOPISTA TERR';-4,19 €;8.037,97 €;4934;-4,19;12.562,06 €;'sin fechas';20/02/2014;'AUTOPISTA';'Gastos_Ocio y transporte';'Parking y peaje';'VARIABLES'
27/02/2014;21/02/2014;'AUTOPISTA TERR';-1,39 €;8.036,58 €;4935;-1,39;12.560,67 €;'sin fechas';21/02/2014;'AUTOPISTA';'Gastos_Ocio y transporte';'Parking y peaje';'VARIABLES'
27/02/2014;21/02/2014;'AUTOPISTA TERR';-1,25 €;8.035,33 €;4936;-1,25;12.559,42 €;'sin fechas';21/02/2014;'AUTOPISTA';'Gastos_Ocio y transporte';'Parking y peaje';'VARIABLES'
27/02/2014;25/02/2014;'BON AREA';-29,35 €;8.005,98 €;4938;-29,35;12.530,07 €;'sin fechas';25/02/2014;'BON';'Gastos_Compras';'Supermercado';'VARIABLES'
27/02/2014;27/02/2014;'CAFET.C T PRAT';-3,45 €;8.002,53 €;4939;-3,45;12.526,62 €;'sin fechas';27/02/2014;'CAFETC';'Gastos_Ocio y transporte';'Restaurantes';'VARIABLES'
27/02/2014;25/02/2014;'CARREFOUR-[COMIDA]';-42,98 €;7.959,55 €;4940;-42,98;12.483,64 €;'sin fechas';25/02/2014;'CARREFOURCOMIDA';'Gastos_Compras';'Supermercado';'VARIABLES'
27/02/2014;27/02/2014;'FARMACIA';-9,18 €;7.950,37 €;4942;-9,18;12.474,46 €;'sin fechas';27/02/2014;'FARMACIA';'Gastos_Salud, saber y deporte';'Farmacia';'VARIABLES'
27/02/2014;27/02/2014;'FRUITES I VERDURES';-3,60 €;7.946,77 €;4944;-3,60;12.470,86 €;'sin fechas';27/02/2014;'FRUITES';'Gastos_Compras';'Supermercado';'VARIABLES'
27/02/2014;27/02/2014;'FRUITES I VERDURES';-9,45 €;7.937,32 €;4945;-9,45;12.461,41 €;'sin fechas';27/02/2014;'FRUITES';'Gastos_Compras';'Supermercado';'VARIABLES'
27/02/2014;27/02/2014;'INFORMACIO I TECNOLOGIA DE CAT';1.576,35 €;9.513,67 €;4947;1.576,35;14.037,76 €;'sin fechas';27/02/2014;'INFORMACIO';'Ingresos';'Nomina';'FIJO'
28/02/2014;23/02/2014;'AUTOPISTA TERR';-3,73 €;9.509,94 €;4950;-3,73;14.034,03 €;'sin fechas';23/02/2014;'AUTOPISTA';'Gastos_Ocio y transporte';'Parking y peaje';'VARIABLES'
28/02/2014;22/02/2014;'AUTOPISTA TERR';-4,19 €;9.505,75 €;4951;-4,19;14.029,84 €;'sin fechas';22/02/2014;'AUTOPISTA';'Gastos_Ocio y transporte';'Parking y peaje';'VARIABLES'
28/02/2014;21/02/2014;'AUTOPISTA TERR';-4,19 €;9.501,56 €;4952;-4,19;14.025,65 €;'sin fechas';21/02/2014;'AUTOPISTA';'Gastos_Ocio y transporte';'Parking y peaje';'VARIABLES'
28/02/2014;24/02/2014;'AUTOPISTA TERR';-1,25 €;9.500,31 €;4953;-1,25;14.024,40 €;'sin fechas';24/02/2014;'AUTOPISTA';'Gastos_Ocio y transporte';'Parking y peaje';'VARIABLES'
28/02/2014;28/02/2014;'LA TERRASSETA - REST COLEGI';-3,75 €;9.496,56 €;4954;-3,75;14.020,65 €;'sin fechas';28/02/2014;'TERRASSETA';'Gastos_Ocio y transporte';'Restaurantes';'VARIABLES'
28/02/2014;28/02/2014;'RECIBO PTMOS. 3061-0960001518';-562,73 €;8.933,83 €;4955;-562,73;13.457,92 €;'sin fechas';28/02/2014;'RECIBO';'Gastos_Banco y organismos';'Hipoteca';'FIJO'
01/03/2014;01/03/2014;'AJUNTAMENT DE TER 010000520716';-44,24 €;8.889,59 €;4956;-44,24;13.413,68 €;'sin fechas';01/03/2014;'AJUNTAMENT';'Gastos_Banco y organismos';'Ayuntamiento';'FIJO'
01/03/2014;01/03/2014;'CAFET.C T PRAT';-3,60 €;8.885,99 €;4957;-3,60;13.410,08 €;'sin fechas';01/03/2014;'CAFETC';'Gastos_Ocio y transporte';'Restaurantes';'VARIABLES'
01/03/2014;01/03/2014;'LA TERRASSETA - REST COLEGI';-3,50 €;8.882,49 €;4959;-3,50;13.406,58 €;'sin fechas';01/03/2014;'TERRASSETA';'Gastos_Ocio y transporte';'Restaurantes';'VARIABLES'
01/03/2014;01/03/2014;'VIENA';-8,55 €;8.873,94 €;4960;-8,55;13.398,03 €;'sin fechas';01/03/2014;'VIENA';'Gastos_Ocio y transporte';'Restaurantes';'VARIABLES'
02/03/2014;02/03/2014;'ES STA. MARGARITA';-49,90 €;8.824,04 €;4961;-49,90;13.348,13 €;'sin fechas';02/03/2014;'STA';'Gastos_Ocio y transporte';'Gasolina';'VARIABLES'
03/03/2014;25/02/2014;'AUTOPISTA TERR';-1,25 €;8.822,79 €;4962;-1,25;13.346,88 €;'sin fechas';25/02/2014;'AUTOPISTA';'Gastos_Ocio y transporte';'Parking y peaje';'VARIABLES'
03/03/2014;25/02/2014;'AUTOPISTA TERR';-1,39 €;8.821,40 €;4963;-1,39;13.345,49 €;'sin fechas';25/02/2014;'AUTOPISTA';'Gastos_Ocio y transporte';'Parking y peaje';'VARIABLES'
03/03/2014;24/02/2014;'AUTOPISTA TERR';-4,19 €;8.817,21 €;4964;-4,19;13.341,30 €;'sin fechas';24/02/2014;'AUTOPISTA';'Gastos_Ocio y transporte';'Parking y peaje';'VARIABLES'
03/03/2014;03/03/2014;'WWW.JUST-EAT.ES';-25,85 €;8.791,36 €;4965;-25,85;13.315,45 €;'sin fechas';03/03/2014;'WWWJUSTEATES';'Gastos_Ocio y transporte';'Restaurantes';'VARIABLES'
04/03/2014;27/02/2014;'AUTOPISTA TERR';-1,39 €;8.789,97 €;4966;-1,39;13.314,06 €;'sin fechas';27/02/2014;'AUTOPISTA';'Gastos_Ocio y transporte';'Parking y peaje';'VARIABLES'
04/03/2014;27/02/2014;'AUTOPISTA TERR';-1,39 €;8.788,58 €;4967;-1,39;13.312,67 €;'sin fechas';27/02/2014;'AUTOPISTA';'Gastos_Ocio y transporte';'Parking y peaje';'VARIABLES'
04/03/2014;26/02/2014;'AUTOPISTA TERR';-1,25 €;8.787,33 €;4968;-1,25;13.311,42 €;'sin fechas';26/02/2014;'AUTOPISTA';'Gastos_Ocio y transporte';'Parking y peaje';'VARIABLES'
04/03/2014;26/02/2014;'AUTOPISTA TERR';-1,25 €;8.786,08 €;4969;-1,25;13.310,17 €;'sin fechas';26/02/2014;'AUTOPISTA';'Gastos_Ocio y transporte';'Parking y peaje';'VARIABLES'
04/03/2014;04/03/2014;'AUTOPISTA TERR';-1,39 €;8.784,69 €;4970;-1,39;13.308,78 €;'sin fechas';04/03/2014;'AUTOPISTA';'Gastos_Ocio y transporte';'Parking y peaje';'VARIABLES'
04/03/2014;04/03/2014;'AUTOPISTA TERR';-1,39 €;8.783,30 €;4971;-1,39;13.307,39 €;'sin fechas';04/03/2014;'AUTOPISTA';'Gastos_Ocio y transporte';'Parking y peaje';'VARIABLES'
04/03/2014;04/03/2014;'FRANKFURT LES LLETRES';-5,60 €;8.777,70 €;4972;-5,60;13.301,79 €;'sin fechas';04/03/2014;'FRANKFURT';'Gastos_Ocio y transporte';'Restaurantes';'VARIABLES'
04/03/2014;04/03/2014;'TABASA VALLVI S. C:2T';-4,19 €;8.773,51 €;4973;-4,19;13.297,60 €;'sin fechas';04/03/2014;'TABASA';'Gastos_Ocio y transporte';'Parking y peaje';'VARIABLES'
05/03/2014;05/03/2014;'AUTOPISTA TERR';-1,39 €;8.772,12 €;4974;-1,39;13.296,21 €;'sin fechas';05/03/2014;'AUTOPISTA';'Gastos_Ocio y transporte';'Parking y peaje';'VARIABLES'
05/03/2014;05/03/2014;'AUTOPISTA TERR';-1,39 €;8.770,73 €;4975;-1,39;13.294,82 €;'sin fechas';05/03/2014;'AUTOPISTA';'Gastos_Ocio y transporte';'Parking y peaje';'VARIABLES'
05/03/2014;05/03/2014;'ESCOLA BRESSOL EINA';-469,05 €;8.301,68 €;4976;-469,05;12.825,77 €;'sin fechas';05/03/2014;'ESCOLA';'Gastos_Salud, saber y deporte';'Estudios';'VARIABLES'
05/03/2014;05/03/2014;'TABASA VALLVI S. C:2T';-4,19 €;8.297,49 €;4977;-4,19;12.821,58 €;'sin fechas';05/03/2014;'TABASA';'Gastos_Ocio y transporte';'Parking y peaje';'VARIABLES'
06/03/2014;06/03/2014;'AUTOPISTA TERR';-1,39 €;8.296,10 €;4978;-1,39;12.820,19 €;'sin fechas';06/03/2014;'AUTOPISTA';'Gastos_Ocio y transporte';'Parking y peaje';'VARIABLES'
06/03/2014;06/03/2014;'DECATHLON';-47,81 €;8.248,29 €;4979;-47,81;12.772,38 €;'sin fechas';06/03/2014;'DECATHLON';'Gastos_Compras';'Deportivo';'VARIABLES'
06/03/2014;04/03/2014;'EROSKI-[COMIDA]';-58,17 €;8.190,12 €;4980;-58,17;12.714,21 €;'sin fechas';04/03/2014;'EROSKICOMIDA';'Gastos_Compras';'Supermercado';'VARIABLES'
06/03/2014;05/03/2014;'LLIBR.SANT JORDI';-8,25 €;8.181,87 €;4981;-8,25;12.705,96 €;'sin fechas';05/03/2014;'LLIBRSANT';'Gastos_Compras';'Libreria';'VARIABLES'
06/03/2014;04/03/2014;'MC DONALDS';-0,30 €;8.181,57 €;4982;-0,30;12.705,66 €;'sin fechas';04/03/2014;'DONALDS';'Gastos_Ocio y transporte';'Restaurantes';'VARIABLES'
06/03/2014;04/03/2014;'MC DONALDS';-21,40 €;8.160,17 €;4983;-21,40;12.684,26 €;'sin fechas';04/03/2014;'DONALDS';'Gastos_Ocio y transporte';'Restaurantes';'VARIABLES'
06/03/2014;06/03/2014;'VIENA';-16,10 €;8.144,07 €;4984;-16,10;12.668,16 €;'sin fechas';06/03/2014;'VIENA';'Gastos_Ocio y transporte';'Restaurantes';'VARIABLES'
07/03/2014;28/02/2014;'AUTOPISTA TERR';-4,19 €;8.139,88 €;4985;-4,19;12.663,97 €;'sin fechas';28/02/2014;'AUTOPISTA';'Gastos_Ocio y transporte';'Parking y peaje';'VARIABLES'
07/03/2014;02/03/2014;'AUTOPISTA TERR';-4,19 €;8.135,69 €;4986;-4,19;12.659,78 €;'sin fechas';02/03/2014;'AUTOPISTA';'Gastos_Ocio y transporte';'Parking y peaje';'VARIABLES'
07/03/2014;07/03/2014;'AUTOPISTA TERR';-1,39 €;8.134,30 €;4987;-1,39;12.658,39 €;'sin fechas';07/03/2014;'AUTOPISTA';'Gastos_Ocio y transporte';'Parking y peaje';'VARIABLES'
07/03/2014;07/03/2014;'BON AREA';-14,35 €;8.119,95 €;4988;-14,35;12.644,04 €;'sin fechas';07/03/2014;'BON';'Gastos_Compras';'Supermercado';'VARIABLES'
07/03/2014;18/02/2014;'LIFE-INFORMATICA';-8,00 €;8.111,95 €;4989;-8,00;12.636,04 €;'sin fechas';18/02/2014;'LIFEINFORMATICA';'Gastos_Compras';'Hobbys';'VARIABLES'
07/03/2014;07/03/2014;'MERCADONA';-13,82 €;8.098,13 €;4990;-13,82;12.622,22 €;'sin fechas';07/03/2014;'MERCADONA';'Gastos_Compras';'Supermercado';'VARIABLES'
07/03/2014;07/03/2014;'PERRUQUERIA';-10,00 €;8.088,13 €;4991;-10,00;12.612,22 €;'sin fechas';07/03/2014;'PERRUQUERIA';'Gastos_Salud, saber y deporte';'Belleza';'VARIABLES'
07/03/2014;07/03/2014;'TABASA VALLVI S. C:2T';-4,19 €;8.083,94 €;4992;-4,19;12.608,03 €;'sin fechas';07/03/2014;'TABASA';'Gastos_Ocio y transporte';'Parking y peaje';'VARIABLES'
08/03/2014;08/03/2014;'FRUITES I VERDURES';-5,44 €;8.078,50 €;4993;-5,44;12.602,59 €;'sin fechas';08/03/2014;'FRUITES';'Gastos_Compras';'Supermercado';'VARIABLES'
09/03/2014;09/03/2014;'MERCADONA';-184,63 €;7.893,87 €;4994;-184,63;12.417,96 €;'sin fechas';09/03/2014;'MERCADONA';'Gastos_Compras';'Supermercado';'VARIABLES'
10/03/2014;10/03/2014;'CAFET.C T PRAT';-3,65 €;7.890,22 €;4995;-3,65;12.414,31 €;'sin fechas';10/03/2014;'CAFETC';'Gastos_Ocio y transporte';'Restaurantes';'VARIABLES'
10/03/2014;10/03/2014;'CAFET.C T PRAT';-1,80 €;7.888,42 €;4996;-1,80;12.412,51 €;'sin fechas';10/03/2014;'CAFETC';'Gastos_Ocio y transporte';'Restaurantes';'VARIABLES'
10/03/2014;10/03/2014;'WWW.JUST-EAT.ES';-10,15 €;7.878,27 €;4997;-10,15;12.402,36 €;'sin fechas';10/03/2014;'WWWJUSTEATES';'Gastos_Ocio y transporte';'Restaurantes';'VARIABLES'
11/03/2014;11/03/2014;'ADESLAS CENTRAL 006662671613';-110,99 €;7.767,28 €;4998;-110,99;12.291,37 €;'sin fechas';11/03/2014;'ADESLAS';'Gastos_Salud, saber y deporte';'Medico';'VARIABLES'
11/03/2014;06/03/2014;'AUTOPISTA TERR';-1,39 €;7.765,89 €;4999;-1,39;12.289,98 €;'sin fechas';06/03/2014;'AUTOPISTA';'Gastos_Ocio y transporte';'Parking y peaje';'VARIABLES'
11/03/2014;11/03/2014;'AUTOPISTA TERR';-1,32 €;7.764,57 €;5000;-1,32;12.288,66 €;'sin fechas';11/03/2014;'AUTOPISTA';'Gastos_Ocio y transporte';'Parking y peaje';'VARIABLES'
11/03/2014;11/03/2014;'AUTOPISTA TERR';-1,32 €;7.763,25 €;5001;-1,32;12.287,34 €;'sin fechas';11/03/2014;'AUTOPISTA';'Gastos_Ocio y transporte';'Parking y peaje';'VARIABLES'
11/03/2014;11/03/2014;'FRUITES I VERDURES';-7,08 €;7.756,17 €;5002;-7,08;12.280,26 €;'sin fechas';11/03/2014;'FRUITES';'Gastos_Compras';'Supermercado';'VARIABLES'
11/03/2014;11/03/2014;'TABASA VALLVI S. C:2T';-4,19 €;7.751,98 €;5003;-4,19;12.276,07 €;'sin fechas';11/03/2014;'TABASA';'Gastos_Ocio y transporte';'Parking y peaje';'VARIABLES'
12/03/2014;12/03/2014;'AUTOPISTA TERR';-1,39 €;7.750,59 €;5004;-1,39;12.274,68 €;'sin fechas';12/03/2014;'AUTOPISTA';'Gastos_Ocio y transporte';'Parking y peaje';'VARIABLES'
12/03/2014;12/03/2014;'BLITZ';-72,50 €;7.678,09 €;5005;-72,50;12.202,18 €;'sin fechas';12/03/2014;'BLITZ';'Gastos_Vivienda y vehiculo';'Alquiler Parking';'FIJO'
12/03/2014;12/03/2014;'TABASA VALLVI S. C:2T';-4,19 €;7.673,90 €;5006;-4,19;12.197,99 €;'sin fechas';12/03/2014;'TABASA';'Gastos_Ocio y transporte';'Parking y peaje';'VARIABLES'
13/03/2014;07/03/2014;'AUTOPISTA TERR';-1,39 €;7.672,51 €;5007;-1,39;12.196,60 €;'sin fechas';07/03/2014;'AUTOPISTA';'Gastos_Ocio y transporte';'Parking y peaje';'VARIABLES'
13/03/2014;08/03/2014;'AUTOPISTA TERR';-2,53 €;7.669,98 €;5008;-2,53;12.194,07 €;'sin fechas';08/03/2014;'AUTOPISTA';'Gastos_Ocio y transporte';'Parking y peaje';'VARIABLES'
13/03/2014;08/03/2014;'AUTOPISTA TERR';-2,53 €;7.667,45 €;5009;-2,53;12.191,54 €;'sin fechas';08/03/2014;'AUTOPISTA';'Gastos_Ocio y transporte';'Parking y peaje';'VARIABLES'
13/03/2014;11/03/2014;'EROSKI-[COMIDA]';-19,28 €;7.648,17 €;5010;-19,28;12.172,26 €;'sin fechas';11/03/2014;'EROSKICOMIDA';'Gastos_Compras';'Supermercado';'VARIABLES'
13/03/2014;11/03/2014;'EROSKI-[OTROS]';-0,78 €;7.647,39 €;5011;-0,78;12.171,48 €;'sin fechas';11/03/2014;'EROSKIOTROS';'Gastos_Compras';'Supermercado';'VARIABLES'
13/03/2014;13/03/2014;'FARMACIA';-12,04 €;7.635,35 €;5012;-12,04;12.159,44 €;'sin fechas';13/03/2014;'FARMACIA';'Gastos_Salud, saber y deporte';'Farmacia';'VARIABLES'
13/03/2014;13/03/2014;'SALA BADRINAS - MENJADOR';-121,64 €;7.513,71 €;5013;-121,64;12.037,80 €;'sin fechas';13/03/2014;'SALA';'Gastos_Salud, saber y deporte';'Estudios';'VARIABLES'
14/03/2014;10/03/2014;'AUTOPISTA TERR';-1,39 €;7.512,32 €;5014;-1,39;12.036,41 €;'sin fechas';10/03/2014;'AUTOPISTA';'Gastos_Ocio y transporte';'Parking y peaje';'VARIABLES'
14/03/2014;10/03/2014;'AUTOPISTA TERR';-1,39 €;7.510,93 €;5015;-1,39;12.035,02 €;'sin fechas';10/03/2014;'AUTOPISTA';'Gastos_Ocio y transporte';'Parking y peaje';'VARIABLES'
14/03/2014;09/03/2014;'AUTOPISTA TERR';-4,19 €;7.506,74 €;5016;-4,19;12.030,83 €;'sin fechas';09/03/2014;'AUTOPISTA';'Gastos_Ocio y transporte';'Parking y peaje';'VARIABLES'
14/03/2014;14/03/2014;'CCM VIDA Y PENSIO 000000493358';-18,57 €;7.488,17 €;5017;-18,57;12.012,26 €;'sin fechas';14/03/2014;'CCM';'Gastos_Seguros';'Seguro vida';'FIJO'
14/03/2014;14/03/2014;'REINT.CAJERO';-40,00 €;7.448,17 €;5018;-40,00;11.972,26 €;'sin fechas';14/03/2014;'REINTCAJERO';'Gastos_Gastos varios';'Efectivo';'VARIABLES'
15/03/2014;15/03/2014;'ES STA. MARGARITA';-33,80 €;7.414,37 €;5019;-33,80;11.938,46 €;'sin fechas';15/03/2014;'STA';'Gastos_Ocio y transporte';'Gasolina';'VARIABLES'
15/03/2014;15/03/2014;'FRUITES I VERDURES';-3,22 €;7.411,15 €;5020;-3,22;11.935,24 €;'sin fechas';15/03/2014;'FRUITES';'Gastos_Compras';'Supermercado';'VARIABLES'
15/03/2014;15/03/2014;'LA TERRASSETA - REST COLEGI';-1,30 €;7.409,85 €;5021;-1,30;11.933,94 €;'sin fechas';15/03/2014;'TERRASSETA';'Gastos_Ocio y transporte';'Restaurantes';'VARIABLES'
15/03/2014;15/03/2014;'VIENA';-30,35 €;7.379,50 €;5022;-30,35;11.903,59 €;'sin fechas';15/03/2014;'VIENA';'Gastos_Ocio y transporte';'Restaurantes';'VARIABLES'
16/03/2014;16/03/2014;'CAFET.C T PRAT';-4,50 €;7.375,00 €;5023;-4,50;11.899,09 €;'sin fechas';16/03/2014;'CAFETC';'Gastos_Ocio y transporte';'Restaurantes';'VARIABLES'
16/03/2014;16/03/2014;'FRUITES I VERDURES';-5,67 €;7.369,33 €;5024;-5,67;11.893,42 €;'sin fechas';16/03/2014;'FRUITES';'Gastos_Compras';'Supermercado';'VARIABLES'
16/03/2014;16/03/2014;'LA TERRASSETA - REST COLEGI';-2,75 €;7.366,58 €;5025;-2,75;11.890,67 €;'sin fechas';16/03/2014;'TERRASSETA';'Gastos_Ocio y transporte';'Restaurantes';'VARIABLES'
17/03/2014;17/03/2014;'AUTOPISTA TERR';-1,32 €;7.365,26 €;5026;-1,32;11.889,35 €;'sin fechas';17/03/2014;'AUTOPISTA';'Gastos_Ocio y transporte';'Parking y peaje';'VARIABLES'
17/03/2014;17/03/2014;'AUTOPISTA TERR';-1,39 €;7.363,87 €;5027;-1,39;11.887,96 €;'sin fechas';17/03/2014;'AUTOPISTA';'Gastos_Ocio y transporte';'Parking y peaje';'VARIABLES'
17/03/2014;17/03/2014;'CAFET.C T PRAT';-3,65 €;7.360,22 €;5028;-3,65;11.884,31 €;'sin fechas';17/03/2014;'CAFETC';'Gastos_Ocio y transporte';'Restaurantes';'VARIABLES'
17/03/2014;17/03/2014;'CCM VIDA Y P SEGURO PRESTAMO';-24,17 €;7.336,05 €;5029;-24,17;11.860,14 €;'sin fechas';17/03/2014;'CCM';'Gastos_Seguros';'Seguro vida';'FIJO'
17/03/2014;17/03/2014;'MERCADONA';-19,06 €;7.316,99 €;5030;-19,06;11.841,08 €;'sin fechas';17/03/2014;'MERCADONA';'Gastos_Compras';'Supermercado';'VARIABLES'
17/03/2014;17/03/2014;'ONO';-112,41 €;7.204,58 €;5031;-112,41;11.728,67 €;'sin fechas';17/03/2014;'ONO';'Gastos_Servicios tipicos';'Telecomunicaciones';'FIJO'
17/03/2014;17/03/2014;'TABASA VALLVI S. C:2T';-4,19 €;7.200,39 €;5032;-4,19;11.724,48 €;'sin fechas';17/03/2014;'TABASA';'Gastos_Ocio y transporte';'Parking y peaje';'VARIABLES'
18/03/2014;13/03/2014;'AUTOPISTA TERR';-1,39 €;7.199,00 €;5033;-1,39;11.723,09 €;'sin fechas';13/03/2014;'AUTOPISTA';'Gastos_Ocio y transporte';'Parking y peaje';'VARIABLES'
18/03/2014;13/03/2014;'AUTOPISTA TERR';-1,39 €;7.197,61 €;5034;-1,39;11.721,70 €;'sin fechas';13/03/2014;'AUTOPISTA';'Gastos_Ocio y transporte';'Parking y peaje';'VARIABLES'
18/03/2014;12/03/2014;'AUTOPISTA TERR';-1,39 €;7.196,22 €;5035;-1,39;11.720,31 €;'sin fechas';12/03/2014;'AUTOPISTA';'Gastos_Ocio y transporte';'Parking y peaje';'VARIABLES'
18/03/2014;15/03/2014;'AUTOPISTA TERR';-2,53 €;7.193,69 €;5036;-2,53;11.717,78 €;'sin fechas';15/03/2014;'AUTOPISTA';'Gastos_Ocio y transporte';'Parking y peaje';'VARIABLES'
19/03/2014;19/03/2014;'AUTOPISTA TERR';-1,32 €;7.192,37 €;5037;-1,32;11.716,46 €;'sin fechas';19/03/2014;'AUTOPISTA';'Gastos_Ocio y transporte';'Parking y peaje';'VARIABLES'
19/03/2014;19/03/2014;'AUTOPISTA TERR';-1,39 €;7.190,98 €;5038;-1,39;11.715,07 €;'sin fechas';19/03/2014;'AUTOPISTA';'Gastos_Ocio y transporte';'Parking y peaje';'VARIABLES'
19/03/2014;19/03/2014;'ES STA. MARGARITA';-51,77 €;7.139,21 €;5039;-51,77;11.663,30 €;'sin fechas';19/03/2014;'STA';'Gastos_Ocio y transporte';'Gasolina';'VARIABLES'
19/03/2014;19/03/2014;'MINA PUBLICA AIGUES T.01A75789';-41,53 €;7.097,68 €;5040;-41,53;11.621,77 €;'sin fechas';19/03/2014;'MINA';'Gastos_Servicios tipicos';'Agua';'FIJO'
19/03/2014;19/03/2014;'TABASA VALLVI S. C:2T';-4,19 €;7.093,49 €;5041;-4,19;11.617,58 €;'sin fechas';19/03/2014;'TABASA';'Gastos_Ocio y transporte';'Parking y peaje';'VARIABLES'
20/03/2014;14/03/2014;'AUTOPISTA TERR';-1,32 €;7.092,17 €;5042;-1,32;11.616,26 €;'sin fechas';14/03/2014;'AUTOPISTA';'Gastos_Ocio y transporte';'Parking y peaje';'VARIABLES'
20/03/2014;15/03/2014;'AUTOPISTA TERR';-2,53 €;7.089,64 €;5043;-2,53;11.613,73 €;'sin fechas';15/03/2014;'AUTOPISTA';'Gastos_Ocio y transporte';'Parking y peaje';'VARIABLES'
20/03/2014;14/03/2014;'AUTOPISTA TERR';-1,32 €;7.088,32 €;5044;-1,32;11.612,41 €;'sin fechas';14/03/2014;'AUTOPISTA';'Gastos_Ocio y transporte';'Parking y peaje';'VARIABLES'
20/03/2014;13/03/2014;'AUTOPISTA TERR';-4,19 €;7.084,13 €;5045;-4,19;11.608,22 €;'sin fechas';13/03/2014;'AUTOPISTA';'Gastos_Ocio y transporte';'Parking y peaje';'VARIABLES'
20/03/2014;18/03/2014;'DEICHMAN - SABATERIA';-29,80 €;7.054,33 €;5046;-29,80;11.578,42 €;'sin fechas';18/03/2014;'DEICHMAN';'Gastos_Compras';'Ropa';'VARIABLES'
20/03/2014;18/03/2014;'MERCADONA';-22,77 €;7.031,56 €;5047;-22,77;11.555,65 €;'sin fechas';18/03/2014;'MERCADONA';'Gastos_Compras';'Supermercado';'VARIABLES'
20/03/2014;18/03/2014;'PRIMARK';-72,50 €;6.959,06 €;5048;-72,50;11.483,15 €;'sin fechas';18/03/2014;'PRIMARK';'Gastos_Compras';'Ropa';'VARIABLES'
20/03/2014;20/03/2014;'REINT.CAJERO';-20,00 €;6.939,06 €;5049;-20,00;11.463,15 €;'sin fechas';20/03/2014;'REINTCAJERO';'Gastos_Gastos varios';'Efectivo';'VARIABLES'
20/03/2014;18/03/2014;'VIENA';-30,35 €;6.908,71 €;5050;-30,35;11.432,80 €;'sin fechas';18/03/2014;'VIENA';'Gastos_Ocio y transporte';'Restaurantes';'VARIABLES'
20/03/2014;18/03/2014;'VIENA';-29,85 €;6.878,86 €;5051;-29,85;11.402,95 €;'sin fechas';18/03/2014;'VIENA';'Gastos_Ocio y transporte';'Restaurantes';'VARIABLES'
21/03/2014;16/03/2014;'AUTOPISTA TERR';-4,19 €;6.874,67 €;5052;-4,19;11.398,76 €;'sin fechas';16/03/2014;'AUTOPISTA';'Gastos_Ocio y transporte';'Parking y peaje';'VARIABLES'
21/03/2014;21/03/2014;'FRANKFURT LES LLETRES';-5,10 €;6.869,57 €;5053;-5,10;11.393,66 €;'sin fechas';21/03/2014;'FRANKFURT';'Gastos_Ocio y transporte';'Restaurantes';'VARIABLES'
22/03/2014;22/03/2014;'FARMACIA';-8,12 €;6.861,45 €;5054;-8,12;11.385,54 €;'sin fechas';22/03/2014;'FARMACIA';'Gastos_Salud, saber y deporte';'Farmacia';'VARIABLES'
22/03/2014;22/03/2014;'MERCADONA';-162,77 €;6.698,68 €;5055;-162,77;11.222,77 €;'sin fechas';22/03/2014;'MERCADONA';'Gastos_Compras';'Supermercado';'VARIABLES'
24/03/2014;18/03/2014;'AUTOPISTA TERR';-1,32 €;6.697,36 €;5056;-1,32;11.221,45 €;'sin fechas';18/03/2014;'AUTOPISTA';'Gastos_Ocio y transporte';'Parking y peaje';'VARIABLES'
24/03/2014;18/03/2014;'AUTOPISTA TERR';-1,32 €;6.696,04 €;5057;-1,32;11.220,13 €;'sin fechas';18/03/2014;'AUTOPISTA';'Gastos_Ocio y transporte';'Parking y peaje';'VARIABLES'
24/03/2014;17/03/2014;'AUTOPISTA TERR';-3,73 €;6.692,31 €;5058;-3,73;11.216,40 €;'sin fechas';17/03/2014;'AUTOPISTA';'Gastos_Ocio y transporte';'Parking y peaje';'VARIABLES'
24/03/2014;24/03/2014;'BON AREA';-10,52 €;6.681,79 €;5059;-10,52;11.205,88 €;'sin fechas';24/03/2014;'BON';'Gastos_Compras';'Supermercado';'VARIABLES'
24/03/2014;24/03/2014;'LOLA CASOLA';-16,40 €;6.665,39 €;5060;-16,40;11.189,48 €;'sin fechas';24/03/2014;'LOLA';'Gastos_Ocio y transporte';'Restaurantes';'VARIABLES'
25/03/2014;20/03/2014;'AUTOPISTA TERR';-1,32 €;6.664,07 €;5061;-1,32;11.188,16 €;'sin fechas';20/03/2014;'AUTOPISTA';'Gastos_Ocio y transporte';'Parking y peaje';'VARIABLES'
25/03/2014;20/03/2014;'AUTOPISTA TERR';-1,25 €;6.662,82 €;5062;-1,25;11.186,91 €;'sin fechas';20/03/2014;'AUTOPISTA';'Gastos_Ocio y transporte';'Parking y peaje';'VARIABLES'
27/03/2014;27/03/2014;'FOMENT DE TERRASSA, S.A. FOMEN';2.041,81 €;8.704,63 €;5063;2.041,81;13.228,72 €;'sin fechas';27/03/2014;'FOMENT';'Ingresos';'Nomina';'FIJO'
27/03/2014;27/03/2014;'REINT.CAJERO';-40,00 €;8.664,63 €;5064;-40,00;13.188,72 €;'sin fechas';27/03/2014;'REINTCAJERO';'Gastos_Gastos varios';'Efectivo';'VARIABLES'
27/03/2014;27/03/2014;'TABASA VALLVI S. C:2T';-4,19 €;8.660,44 €;5065;-4,19;13.184,53 €;'sin fechas';27/03/2014;'TABASA';'Gastos_Ocio y transporte';'Parking y peaje';'VARIABLES'
28/03/2014;24/03/2014;'AUTOPISTA TERR';-1,39 €;8.659,05 €;5066;-1,39;13.183,14 €;'sin fechas';24/03/2014;'AUTOPISTA';'Gastos_Ocio y transporte';'Parking y peaje';'VARIABLES'
28/03/2014;24/03/2014;'AUTOPISTA TERR';-1,25 €;8.657,80 €;5067;-1,25;13.181,89 €;'sin fechas';24/03/2014;'AUTOPISTA';'Gastos_Ocio y transporte';'Parking y peaje';'VARIABLES'
28/03/2014;28/03/2014;'AUTOPISTA TERR';-1,25 €;8.656,55 €;5068;-1,25;13.180,64 €;'sin fechas';28/03/2014;'AUTOPISTA';'Gastos_Ocio y transporte';'Parking y peaje';'VARIABLES'
28/03/2014;28/03/2014;'AUTOPISTA TERR';-1,25 €;8.655,30 €;5069;-1,25;13.179,39 €;'sin fechas';28/03/2014;'AUTOPISTA';'Gastos_Ocio y transporte';'Parking y peaje';'VARIABLES'
28/03/2014;28/03/2014;'CAFET.C T PRAT';-2,60 €;8.652,70 €;5070;-2,60;13.176,79 €;'sin fechas';28/03/2014;'CAFETC';'Gastos_Ocio y transporte';'Restaurantes';'VARIABLES'
28/03/2014;28/03/2014;'INFORMACIO I TECNOLOGIA DE CAT';1.576,76 €;10.229,46 €;5071;1.576,76;14.753,55 €;'sin fechas';28/03/2014;'INFORMACIO';'Ingresos';'Nomina';'FIJO'
28/03/2014;28/03/2014;'TABASA VALLVI S. C:2T';-3,73 €;10.225,73 €;5072;-3,73;14.749,82 €;'sin fechas';28/03/2014;'TABASA';'Gastos_Ocio y transporte';'Parking y peaje';'VARIABLES'
29/03/2014;29/03/2014;'CAFET.C T PRAT';-4,50 €;10.221,23 €;5073;-4,50;14.745,32 €;'sin fechas';29/03/2014;'CAFETC';'Gastos_Ocio y transporte';'Restaurantes';'VARIABLES'
29/03/2014;29/03/2014;'CAFET.C T PRAT';-2,55 €;10.218,68 €;5074;-2,55;14.742,77 €;'sin fechas';29/03/2014;'CAFETC';'Gastos_Ocio y transporte';'Restaurantes';'VARIABLES'
29/03/2014;29/03/2014;'TABASA VALLVI S. C:2T';-4,19 €;10.214,49 €;5075;-4,19;14.738,58 €;'sin fechas';29/03/2014;'TABASA';'Gastos_Ocio y transporte';'Parking y peaje';'VARIABLES'
30/03/2014;30/03/2014;'CAFET.C T PRAT';-2,70 €;10.211,79 €;5077;-2,70;14.735,88 €;'sin fechas';30/03/2014;'CAFETC';'Gastos_Ocio y transporte';'Restaurantes';'VARIABLES'
30/03/2014;30/03/2014;'PKREGESA';-11,40 €;10.200,39 €;5083;-11,40;14.724,48 €;'sin fechas';30/03/2014;'PKREGESA';'Gastos_Ocio y transporte';'Parking y peaje';'VARIABLES'
30/03/2014;30/03/2014;'TABASA VALLVI S. C:2T';-4,19 €;10.196,20 €;5085;-4,19;14.720,29 €;'sin fechas';30/03/2014;'TABASA';'Gastos_Ocio y transporte';'Parking y peaje';'VARIABLES'
31/03/2014;31/03/2014;'IBI';-44,87 €;10.151,33 €;5086;-44,87;14.675,42 €;'sin fechas';31/03/2014;'IBI';'Gastos_Banco y organismos';'Ayuntamiento';'FIJO'
31/03/2014;31/03/2014;'RECIBO PTMOS. 3061-0960001518';-562,73 €;9.588,60 €;5087;-562,73;14.112,69 €;'sin fechas';31/03/2014;'RECIBO';'Gastos_Banco y organismos';'Hipoteca';'FIJO'
31/03/2014;31/03/2014;'TABASA VALLVI S. C:2T';-3,73 €;9.584,87 €;5088;-3,73;14.108,96 €;'sin fechas';31/03/2014;'TABASA';'Gastos_Ocio y transporte';'Parking y peaje';'VARIABLES'
01/04/2014;01/04/2014;'AUTOPISTA TERR';-1,39 €;9.583,48 €;5089;-1,39;14.107,57 €;'sin fechas';01/04/2014;'AUTOPISTA';'Gastos_Ocio y transporte';'Parking y peaje';'VARIABLES'
01/04/2014;01/04/2014;'AUTOPISTA TERR';-1,39 €;9.582,09 €;5090;-1,39;14.106,18 €;'sin fechas';01/04/2014;'AUTOPISTA';'Gastos_Ocio y transporte';'Parking y peaje';'VARIABLES'
01/04/2014;01/04/2014;'CATALANA DIAG.I CIRUR';-0,60 €;9.581,49 €;5091;-0,60;14.105,58 €;'sin fechas';01/04/2014;'CATALANA';'Gastos_Ocio y transporte';'Parking y peaje';'VARIABLES'
01/04/2014;01/04/2014;'FRANKFURT LES LLETRES';-4,35 €;9.577,14 €;5093;-4,35;14.101,23 €;'sin fechas';01/04/2014;'FRANKFURT';'Gastos_Ocio y transporte';'Restaurantes';'VARIABLES'
01/04/2014;01/04/2014;'REINT.CAJERO';-20,00 €;9.557,14 €;5094;-20,00;14.081,23 €;'sin fechas';01/04/2014;'REINTCAJERO';'Gastos_Gastos varios';'Efectivo';'VARIABLES'
02/04/2014;02/04/2014;'AUTOPISTA TERR';-1,39 €;9.555,75 €;5095;-1,39;14.079,84 €;'sin fechas';02/04/2014;'AUTOPISTA';'Gastos_Ocio y transporte';'Parking y peaje';'VARIABLES'
02/04/2014;02/04/2014;'AUTOPISTA TERR';-1,39 €;9.554,36 €;5096;-1,39;14.078,45 €;'sin fechas';02/04/2014;'AUTOPISTA';'Gastos_Ocio y transporte';'Parking y peaje';'VARIABLES'
02/04/2014;02/04/2014;'ESCOLA BRESSOL EINA';-466,90 €;9.087,46 €;5097;-466,90;13.611,55 €;'sin fechas';02/04/2014;'ESCOLA';'Gastos_Salud, saber y deporte';'Estudios';'VARIABLES'
03/04/2014;03/04/2014;'AUTOPISTA TERR';-1,39 €;9.086,07 €;5098;-1,39;13.610,16 €;'sin fechas';03/04/2014;'AUTOPISTA';'Gastos_Ocio y transporte';'Parking y peaje';'VARIABLES'
03/04/2014;03/04/2014;'AUTOPISTA TERR';-1,39 €;9.084,68 €;5099;-1,39;13.608,77 €;'sin fechas';03/04/2014;'AUTOPISTA';'Gastos_Ocio y transporte';'Parking y peaje';'VARIABLES'
03/04/2014;03/04/2014;'CAFET.C T PRAT';-2,15 €;9.082,53 €;5100;-2,15;13.606,62 €;'sin fechas';03/04/2014;'CAFETC';'Gastos_Ocio y transporte';'Restaurantes';'VARIABLES'
03/04/2014;03/04/2014;'ES STA. MARGARITA';-29,33 €;9.053,20 €;5101;-29,33;13.577,29 €;'sin fechas';03/04/2014;'STA';'Gastos_Ocio y transporte';'Gasolina';'VARIABLES'
03/04/2014;03/04/2014;'FRUITES I VERDURES';-3,86 €;9.049,34 €;5102;-3,86;13.573,43 €;'sin fechas';03/04/2014;'FRUITES';'Gastos_Compras';'Supermercado';'VARIABLES'
03/04/2014;03/04/2014;'GAS NATURAL';-570,56 €;8.478,78 €;5103;-570,56;13.002,87 €;'sin fechas';03/04/2014;'GAS';'Gastos_Servicios tipicos';'Gas';'FIJO'
03/04/2014;03/04/2014;'LA TERRASSETA - REST COLEGI';-2,50 €;8.476,28 €;5104;-2,50;13.000,37 €;'sin fechas';03/04/2014;'TERRASSETA';'Gastos_Ocio y transporte';'Restaurantes';'VARIABLES'
03/04/2014;03/04/2014;'MERCADONA';-7,95 €;8.468,33 €;5105;-7,95;12.992,42 €;'sin fechas';03/04/2014;'MERCADONA';'Gastos_Compras';'Supermercado';'VARIABLES'
03/04/2014;03/04/2014;'PERRUQUERIA';-10,00 €;8.458,33 €;5106;-10,00;12.982,42 €;'sin fechas';03/04/2014;'PERRUQUERIA';'Gastos_Salud, saber y deporte';'Belleza';'VARIABLES'
03/04/2014;03/04/2014;'REINT.CAJERO';-40,00 €;8.418,33 €;5107;-40,00;12.942,42 €;'sin fechas';03/04/2014;'REINTCAJERO';'Gastos_Gastos varios';'Efectivo';'VARIABLES'
03/04/2014;03/04/2014;'SEGUROS CATALANA';-306,94 €;8.111,39 €;5109;-306,94;12.635,48 €;'sin fechas';03/04/2014;'CATALANA';'Gastos_Ocio y transporte';'Parking y peaje';'VARIABLES'
03/04/2014;03/04/2014;'TABASA VALLVI S. C:2T';-4,19 €;8.107,20 €;5110;-4,19;12.631,29 €;'sin fechas';03/04/2014;'TABASA';'Gastos_Ocio y transporte';'Parking y peaje';'VARIABLES'
04/04/2014;04/04/2014;'ADESLAS CENTRAL 006662671613';-110,99 €;7.996,21 €;5111;-110,99;12.520,30 €;'sin fechas';04/04/2014;'ADESLAS';'Gastos_Salud, saber y deporte';'Medico';'VARIABLES'
04/04/2014;31/03/2014;'AUTOPISTA TERR';-1,39 €;7.994,82 €;5112;-1,39;12.518,91 €;'sin fechas';31/03/2014;'AUTOPISTA';'Gastos_Ocio y transporte';'Parking y peaje';'VARIABLES'
04/04/2014;04/04/2014;'AUTOPISTA TERR';-1,39 €;7.993,43 €;5113;-1,39;12.517,52 €;'sin fechas';04/04/2014;'AUTOPISTA';'Gastos_Ocio y transporte';'Parking y peaje';'VARIABLES'
04/04/2014;04/04/2014;'AUTOPISTA TERR';-1,32 €;7.992,11 €;5114;-1,32;12.516,20 €;'sin fechas';04/04/2014;'AUTOPISTA';'Gastos_Ocio y transporte';'Parking y peaje';'VARIABLES'
04/04/2014;31/03/2014;'AUTOPISTA TERR';-1,11 €;7.991,00 €;5115;-1,11;12.515,09 €;'sin fechas';31/03/2014;'AUTOPISTA';'Gastos_Ocio y transporte';'Parking y peaje';'VARIABLES'
04/04/2014;04/04/2014;'BON AREA';-12,04 €;7.978,96 €;5116;-12,04;12.503,05 €;'sin fechas';04/04/2014;'BON';'Gastos_Compras';'Supermercado';'VARIABLES'
04/04/2014;04/04/2014;'CAFET.C T PRAT';-3,60 €;7.975,36 €;5117;-3,60;12.499,45 €;'sin fechas';04/04/2014;'CAFETC';'Gastos_Ocio y transporte';'Restaurantes';'VARIABLES'
04/04/2014;04/04/2014;'TABASA VALLVI S. C:2T';-4,19 €;7.971,17 €;5118;-4,19;12.495,26 €;'sin fechas';04/04/2014;'TABASA';'Gastos_Ocio y transporte';'Parking y peaje';'VARIABLES'
04/04/2014;04/04/2014;'TOCINERIES VENTURA';-6,03 €;7.965,14 €;5119;-6,03;12.489,23 €;'sin fechas';04/04/2014;'TOCINERIES';'Gastos_Compras';'Supermercado';'VARIABLES'
05/04/2014;05/04/2014;'AMC PARC VALLES';-16,40 €;7.948,74 €;5120;-16,40;12.472,83 €;'sin fechas';05/04/2014;'AMC';'Gastos_Ocio y transporte';'Espectáculos';'VARIABLES'
05/04/2014;05/04/2014;'CAFET.C T PRAT';-6,65 €;7.942,09 €;5121;-6,65;12.466,18 €;'sin fechas';05/04/2014;'CAFETC';'Gastos_Ocio y transporte';'Restaurantes';'VARIABLES'
05/04/2014;05/04/2014;'CARREFOUR-[COMIDA]';-46,90 €;7.895,19 €;5122;-46,90;12.419,28 €;'sin fechas';05/04/2014;'CARREFOURCOMIDA';'Gastos_Compras';'Supermercado';'VARIABLES'
05/04/2014;05/04/2014;'DECATHLON';-59,17 €;7.836,02 €;5123;-59,17;12.360,11 €;'sin fechas';05/04/2014;'DECATHLON';'Gastos_Compras';'Deportivo';'VARIABLES'
05/04/2014;05/04/2014;'RESTAURANTES';-40,85 €;7.795,17 €;5124;-40,85;12.319,26 €;'sin fechas';05/04/2014;'RESTAURANTES';'Gastos_Ocio y transporte';'Restaurantes';'VARIABLES'
05/04/2014;05/04/2014;'TABASA VALLVI S. C:2T';-4,19 €;7.790,98 €;5125;-4,19;12.315,07 €;'sin fechas';05/04/2014;'TABASA';'Gastos_Ocio y transporte';'Parking y peaje';'VARIABLES'
06/04/2014;06/04/2014;'CAFET.C T PRAT';-2,25 €;7.788,73 €;5126;-2,25;12.312,82 €;'sin fechas';06/04/2014;'CAFETC';'Gastos_Ocio y transporte';'Restaurantes';'VARIABLES'
06/04/2014;06/04/2014;'MERCADONA';-34,55 €;7.754,18 €;5127;-34,55;12.278,27 €;'sin fechas';06/04/2014;'MERCADONA';'Gastos_Compras';'Supermercado';'VARIABLES'
06/04/2014;06/04/2014;'TABASA VALLVI S. C:2T';-4,19 €;7.749,99 €;5128;-4,19;12.274,08 €;'sin fechas';06/04/2014;'TABASA';'Gastos_Ocio y transporte';'Parking y peaje';'VARIABLES'
07/04/2014;07/04/2014;'AUTOPISTA TERR';-1,32 €;7.748,67 €;5129;-1,32;12.272,76 €;'sin fechas';07/04/2014;'AUTOPISTA';'Gastos_Ocio y transporte';'Parking y peaje';'VARIABLES'
07/04/2014;07/04/2014;'AUTOPISTA TERR';-1,32 €;7.747,35 €;5130;-1,32;12.271,44 €;'sin fechas';07/04/2014;'AUTOPISTA';'Gastos_Ocio y transporte';'Parking y peaje';'VARIABLES'
07/04/2014;07/04/2014;'CAFET.C T PRAT';-3,65 €;7.743,70 €;5131;-3,65;12.267,79 €;'sin fechas';07/04/2014;'CAFETC';'Gastos_Ocio y transporte';'Restaurantes';'VARIABLES'
07/04/2014;07/04/2014;'ES STA. MARGARITA';-30,00 €;7.713,70 €;5132;-30,00;12.237,79 €;'sin fechas';07/04/2014;'STA';'Gastos_Ocio y transporte';'Gasolina';'VARIABLES'
07/04/2014;07/04/2014;'TABASA VALLVI S. C:2T';-4,19 €;7.709,51 €;5133;-4,19;12.233,60 €;'sin fechas';07/04/2014;'TABASA';'Gastos_Ocio y transporte';'Parking y peaje';'VARIABLES'
08/04/2014;08/04/2014;'AUTOPISTA TERR';-1,39 €;7.708,12 €;5134;-1,39;12.232,21 €;'sin fechas';08/04/2014;'AUTOPISTA';'Gastos_Ocio y transporte';'Parking y peaje';'VARIABLES'
08/04/2014;08/04/2014;'AUTOPISTA TERR';-1,32 €;7.706,80 €;5135;-1,32;12.230,89 €;'sin fechas';08/04/2014;'AUTOPISTA';'Gastos_Ocio y transporte';'Parking y peaje';'VARIABLES'
09/04/2014;09/04/2014;'AUTOPISTA TERR';-1,32 €;7.705,48 €;5136;-1,32;12.229,57 €;'sin fechas';09/04/2014;'AUTOPISTA';'Gastos_Ocio y transporte';'Parking y peaje';'VARIABLES'
09/04/2014;09/04/2014;'AUTOPISTA TERR';-1,25 €;7.704,23 €;5137;-1,25;12.228,32 €;'sin fechas';09/04/2014;'AUTOPISTA';'Gastos_Ocio y transporte';'Parking y peaje';'VARIABLES'
09/04/2014;09/04/2014;'FRANKFURT LES LLETRES';-5,60 €;7.698,63 €;5138;-5,60;12.222,72 €;'sin fechas';09/04/2014;'FRANKFURT';'Gastos_Ocio y transporte';'Restaurantes';'VARIABLES'
10/04/2014;10/04/2014;'AUTOPISTA TERR';-1,39 €;7.697,24 €;5139;-1,39;12.221,33 €;'sin fechas';10/04/2014;'AUTOPISTA';'Gastos_Ocio y transporte';'Parking y peaje';'VARIABLES'
10/04/2014;10/04/2014;'AUTOPISTA TERR';-1,25 €;7.695,99 €;5140;-1,25;12.220,08 €;'sin fechas';10/04/2014;'AUTOPISTA';'Gastos_Ocio y transporte';'Parking y peaje';'VARIABLES'
10/04/2014;10/04/2014;'CAFET.C T PRAT';-2,25 €;7.693,74 €;5141;-2,25;12.217,83 €;'sin fechas';10/04/2014;'CAFETC';'Gastos_Ocio y transporte';'Restaurantes';'VARIABLES'
10/04/2014;10/04/2014;'CARREFOUR-[COMIDA]';-11,15 €;7.682,59 €;5142;-11,15;12.206,68 €;'sin fechas';10/04/2014;'CARREFOURCOMIDA';'Gastos_Compras';'Supermercado';'VARIABLES'
10/04/2014;10/04/2014;'FRANKFURT LES LLETRES';-7,35 €;7.675,24 €;5143;-7,35;12.199,33 €;'sin fechas';10/04/2014;'FRANKFURT';'Gastos_Ocio y transporte';'Restaurantes';'VARIABLES'
10/04/2014;10/04/2014;'LLIBR.SANT JORDI';-9,00 €;7.666,24 €;5144;-9,00;12.190,33 €;'sin fechas';10/04/2014;'LLIBRSANT';'Gastos_Compras';'Libreria';'VARIABLES'
10/04/2014;10/04/2014;'MULTA';-50,00 €;7.616,24 €;5145;-50,00;12.140,33 €;'sin fechas';10/04/2014;'MULTA';'Gastos_Banco y organismos';'Multas';
10/04/2014;10/04/2014;'TABASA VALLVI S. C:2T';-3,73 €;7.612,51 €;5146;-3,73;12.136,60 €;'sin fechas';10/04/2014;'TABASA';'Gastos_Ocio y transporte';'Parking y peaje';'VARIABLES'
11/04/2014;11/04/2014;'AUTOPISTA TERR';-1,39 €;7.611,12 €;5147;-1,39;12.135,21 €;'sin fechas';11/04/2014;'AUTOPISTA';'Gastos_Ocio y transporte';'Parking y peaje';'VARIABLES'
11/04/2014;11/04/2014;'AUTOPISTA TERR';-1,25 €;7.609,87 €;5148;-1,25;12.133,96 €;'sin fechas';11/04/2014;'AUTOPISTA';'Gastos_Ocio y transporte';'Parking y peaje';'VARIABLES'
11/04/2014;11/04/2014;'CAFET.C T PRAT';-1,80 €;7.608,07 €;5149;-1,80;12.132,16 €;'sin fechas';11/04/2014;'CAFETC';'Gastos_Ocio y transporte';'Restaurantes';'VARIABLES'
11/04/2014;11/04/2014;'MERCADONA';-32,42 €;7.575,65 €;5150;-32,42;12.099,74 €;'sin fechas';11/04/2014;'MERCADONA';'Gastos_Compras';'Supermercado';'VARIABLES'
11/04/2014;11/04/2014;'REINT.CAJERO';-70,00 €;7.505,65 €;5151;-70,00;12.029,74 €;'sin fechas';11/04/2014;'REINTCAJERO';'Gastos_Gastos varios';'Efectivo';'VARIABLES'
11/04/2014;11/04/2014;'SALA BADRINAS - MENJADOR';-95,66 €;7.409,99 €;5152;-95,66;11.934,08 €;'sin fechas';11/04/2014;'SALA';'Gastos_Salud, saber y deporte';'Estudios';'VARIABLES'
11/04/2014;11/04/2014;'TABASA VALLVI S. C:2T';-4,19 €;7.405,80 €;5153;-4,19;11.929,89 €;'sin fechas';11/04/2014;'TABASA';'Gastos_Ocio y transporte';'Parking y peaje';'VARIABLES'
12/04/2014;12/04/2014;'AUTOPISTA TERR';-2,53 €;7.403,27 €;5154;-2,53;11.927,36 €;'sin fechas';12/04/2014;'AUTOPISTA';'Gastos_Ocio y transporte';'Parking y peaje';'VARIABLES'
12/04/2014;12/04/2014;'CAFET.C T PRAT';-3,65 €;7.399,62 €;5155;-3,65;11.923,71 €;'sin fechas';12/04/2014;'CAFETC';'Gastos_Ocio y transporte';'Restaurantes';'VARIABLES'
12/04/2014;12/04/2014;'M&S';-37,97 €;7.361,65 €;5156;-37,97;11.885,74 €;'sin fechas';12/04/2014;'MS';'Gastos_Compras';'Ropa';'VARIABLES'
12/04/2014;12/04/2014;'PERRUQUERIA';-15,90 €;7.345,75 €;5157;-15,90;11.869,84 €;'sin fechas';12/04/2014;'PERRUQUERIA';'Gastos_Salud, saber y deporte';'Belleza';'VARIABLES'
13/04/2014;13/04/2014;'AUTOPISTA TERR';-2,53 €;7.343,22 €;5158;-2,53;11.867,31 €;'sin fechas';13/04/2014;'AUTOPISTA';'Gastos_Ocio y transporte';'Parking y peaje';'VARIABLES'
13/04/2014;13/04/2014;'CAFET.C T PRAT';-2,70 €;7.340,52 €;5159;-2,70;11.864,61 €;'sin fechas';13/04/2014;'CAFETC';'Gastos_Ocio y transporte';'Restaurantes';'VARIABLES'
13/04/2014;13/04/2014;'TABASA VALLVI S. C:2T';-4,19 €;7.336,33 €;5160;-4,19;11.860,42 €;'sin fechas';13/04/2014;'TABASA';'Gastos_Ocio y transporte';'Parking y peaje';'VARIABLES'
14/04/2014;14/04/2014;'AUTOPISTA TERR';-1,39 €;7.334,94 €;5161;-1,39;11.859,03 €;'sin fechas';14/04/2014;'AUTOPISTA';'Gastos_Ocio y transporte';'Parking y peaje';'VARIABLES'
14/04/2014;14/04/2014;'AUTOPISTA TERR';-1,39 €;7.333,55 €;5162;-1,39;11.857,64 €;'sin fechas';14/04/2014;'AUTOPISTA';'Gastos_Ocio y transporte';'Parking y peaje';'VARIABLES'
14/04/2014;14/04/2014;'CAFET.C T PRAT';-3,65 €;7.329,90 €;5163;-3,65;11.853,99 €;'sin fechas';14/04/2014;'CAFETC';'Gastos_Ocio y transporte';'Restaurantes';'VARIABLES'
14/04/2014;14/04/2014;'TABASA VALLVI S. C:2T';-4,19 €;7.325,71 €;5164;-4,19;11.849,80 €;'sin fechas';14/04/2014;'TABASA';'Gastos_Ocio y transporte';'Parking y peaje';'VARIABLES'
15/04/2014;15/04/2014;'AUTOPISTA TERR';-1,39 €;7.324,32 €;5165;-1,39;11.848,41 €;'sin fechas';15/04/2014;'AUTOPISTA';'Gastos_Ocio y transporte';'Parking y peaje';'VARIABLES'
15/04/2014;15/04/2014;'AUTOPISTA TERR';-1,25 €;7.323,07 €;5166;-1,25;11.847,16 €;'sin fechas';15/04/2014;'AUTOPISTA';'Gastos_Ocio y transporte';'Parking y peaje';'VARIABLES'
15/04/2014;15/04/2014;'AUTOPISTA TERR';-10,60 €;7.312,47 €;5167;-10,60;11.836,56 €;'sin fechas';15/04/2014;'AUTOPISTA';'Gastos_Ocio y transporte';'Parking y peaje';'VARIABLES'
15/04/2014;15/04/2014;'AUTOPISTA TERR';-7,15 €;7.305,32 €;5168;-7,15;11.829,41 €;'sin fechas';15/04/2014;'AUTOPISTA';'Gastos_Ocio y transporte';'Parking y peaje';'VARIABLES'
15/04/2014;15/04/2014;'BLITZ';-72,50 €;7.232,82 €;5169;-72,50;11.756,91 €;'sin fechas';15/04/2014;'BLITZ';'Gastos_Vivienda y vehiculo';'Alquiler Parking';'FIJO'
15/04/2014;15/04/2014;'CCM VIDA Y PENSIO 000000493358';-18,52 €;7.214,30 €;5170;-18,52;11.738,39 €;'sin fechas';15/04/2014;'CCM';'Gastos_Seguros';'Seguro vida';'FIJO'
16/04/2014;16/04/2014;'AUTOPISTA TERR';-1,39 €;7.212,91 €;5171;-1,39;11.737,00 €;'sin fechas';16/04/2014;'AUTOPISTA';'Gastos_Ocio y transporte';'Parking y peaje';'VARIABLES'
16/04/2014;16/04/2014;'AUTOPISTA TERR';-1,39 €;7.211,52 €;5172;-1,39;11.735,61 €;'sin fechas';16/04/2014;'AUTOPISTA';'Gastos_Ocio y transporte';'Parking y peaje';'VARIABLES'
16/04/2014;16/04/2014;'AUTOPISTA TERR';-1,25 €;7.210,27 €;5173;-1,25;11.734,36 €;'sin fechas';16/04/2014;'AUTOPISTA';'Gastos_Ocio y transporte';'Parking y peaje';'VARIABLES'
16/04/2014;16/04/2014;'AUTOPISTA TERR';-10,60 €;7.199,67 €;5174;-10,60;11.723,76 €;'sin fechas';16/04/2014;'AUTOPISTA';'Gastos_Ocio y transporte';'Parking y peaje';'VARIABLES'
16/04/2014;16/04/2014;'AUTOPISTA TERR';-7,15 €;7.192,52 €;5175;-7,15;11.716,61 €;'sin fechas';16/04/2014;'AUTOPISTA';'Gastos_Ocio y transporte';'Parking y peaje';'VARIABLES'
16/04/2014;16/04/2014;'CCM VIDA Y P SEGURO PRESTAMO';-24,10 €;7.168,42 €;5176;-24,10;11.692,51 €;'sin fechas';16/04/2014;'CCM';'Gastos_Seguros';'Seguro vida';'FIJO'
17/04/2014;17/04/2014;'CAFET.C T PRAT';-3,65 €;7.164,77 €;5177;-3,65;11.688,86 €;'sin fechas';17/04/2014;'CAFETC';'Gastos_Ocio y transporte';'Restaurantes';'VARIABLES'
17/04/2014;17/04/2014;'CINES OSCAR \\ROQUETES';-24,30 €;7.140,47 €;5178;-24,30;11.664,56 €;'sin fechas';17/04/2014;'CINES';'Gastos_Ocio y transporte';'Espectáculos';'VARIABLES'
17/04/2014;17/04/2014;'DECATHLON';-67,72 €;7.072,75 €;5179;-67,72;11.596,84 €;'sin fechas';17/04/2014;'DECATHLON';'Gastos_Compras';'Deportivo';'VARIABLES'
17/04/2014;15/04/2014;'ES STA. MARGARITA';-49,37 €;7.023,38 €;5180;-49,37;11.547,47 €;'sin fechas';15/04/2014;'STA';'Gastos_Ocio y transporte';'Gasolina';'VARIABLES'
17/04/2014;15/04/2014;'MERCADONA';-29,85 €;6.993,53 €;5181;-29,85;11.517,62 €;'sin fechas';15/04/2014;'MERCADONA';'Gastos_Compras';'Supermercado';'VARIABLES'
17/04/2014;17/04/2014;'ONO';-112,41 €;6.881,12 €;5182;-112,41;11.405,21 €;'sin fechas';17/04/2014;'ONO';'Gastos_Servicios tipicos';'Telecomunicaciones';'FIJO'
17/04/2014;17/04/2014;'TABASA VALLVI S. C:2T';-4,19 €;6.876,93 €;5183;-4,19;11.401,02 €;'sin fechas';17/04/2014;'TABASA';'Gastos_Ocio y transporte';'Parking y peaje';'VARIABLES'
18/04/2014;18/04/2014;'CAFET.C T PRAT';-2,25 €;6.874,68 €;5184;-2,25;11.398,77 €;'sin fechas';18/04/2014;'CAFETC';'Gastos_Ocio y transporte';'Restaurantes';'VARIABLES'
18/04/2014;18/04/2014;'MERCADONA';-7,80 €;6.866,88 €;5185;-7,80;11.390,97 €;'sin fechas';18/04/2014;'MERCADONA';'Gastos_Compras';'Supermercado';'VARIABLES'
18/04/2014;18/04/2014;'TABASA VALLVI S. C:2T';-4,19 €;6.862,69 €;5186;-4,19;11.386,78 €;'sin fechas';18/04/2014;'TABASA';'Gastos_Ocio y transporte';'Parking y peaje';'VARIABLES'
19/04/2014;19/04/2014;'AUTOPISTA TERR';-10,60 €;6.852,09 €;5187;-10,60;11.376,18 €;'sin fechas';19/04/2014;'AUTOPISTA';'Gastos_Ocio y transporte';'Parking y peaje';'VARIABLES'
19/04/2014;19/04/2014;'AUTOPISTA TERR';-7,15 €;6.844,94 €;5188;-7,15;11.369,03 €;'sin fechas';19/04/2014;'AUTOPISTA';'Gastos_Ocio y transporte';'Parking y peaje';'VARIABLES'
19/04/2014;19/04/2014;'CAFET.C T PRAT';-2,70 €;6.842,24 €;5189;-2,70;11.366,33 €;'sin fechas';19/04/2014;'CAFETC';'Gastos_Ocio y transporte';'Restaurantes';'VARIABLES'
19/04/2014;19/04/2014;'ES STA. MARGARITA';-44,89 €;6.797,35 €;5190;-44,89;11.321,44 €;'sin fechas';19/04/2014;'STA';'Gastos_Ocio y transporte';'Gasolina';'VARIABLES'
22/04/2014;22/04/2014;'FRANKFURT LES LLETRES';-9,00 €;6.788,35 €;5195;-9,00;11.312,44 €;'sin fechas';22/04/2014;'FRANKFURT';'Gastos_Ocio y transporte';'Restaurantes';'VARIABLES'
23/04/2014;23/04/2014;'AUTOPISTA TERR';-1,39 €;6.786,96 €;5196;-1,39;11.311,05 €;'sin fechas';23/04/2014;'AUTOPISTA';'Gastos_Ocio y transporte';'Parking y peaje';'VARIABLES'
23/04/2014;23/04/2014;'AUTOPISTA TERR';-1,25 €;6.785,71 €;5197;-1,25;11.309,80 €;'sin fechas';23/04/2014;'AUTOPISTA';'Gastos_Ocio y transporte';'Parking y peaje';'VARIABLES'
24/04/2014;24/04/2014;'AUTOPISTA TERR';-1,39 €;6.784,32 €;5198;-1,39;11.308,41 €;'sin fechas';24/04/2014;'AUTOPISTA';'Gastos_Ocio y transporte';'Parking y peaje';'VARIABLES'
24/04/2014;24/04/2014;'AUTOPISTA TERR';-1,25 €;6.783,07 €;5199;-1,25;11.307,16 €;'sin fechas';24/04/2014;'AUTOPISTA';'Gastos_Ocio y transporte';'Parking y peaje';'VARIABLES'
24/04/2014;24/04/2014;'AUTOPISTA TERR';-10,60 €;6.772,47 €;5200;-10,60;11.296,56 €;'sin fechas';24/04/2014;'AUTOPISTA';'Gastos_Ocio y transporte';'Parking y peaje';'VARIABLES'
24/04/2014;24/04/2014;'AUTOPISTA TERR';-6,08 €;6.766,39 €;5201;-6,08;11.290,48 €;'sin fechas';24/04/2014;'AUTOPISTA';'Gastos_Ocio y transporte';'Parking y peaje';'VARIABLES'
24/04/2014;24/04/2014;'REINT.CAJERO';-40,00 €;6.726,39 €;5202;-40,00;11.250,48 €;'sin fechas';24/04/2014;'REINTCAJERO';'Gastos_Gastos varios';'Efectivo';'VARIABLES'
25/04/2014;25/04/2014;'AUTOPISTA TERR';-4,19 €;6.722,20 €;5203;-4,19;11.246,29 €;'sin fechas';25/04/2014;'AUTOPISTA';'Gastos_Ocio y transporte';'Parking y peaje';'VARIABLES'
25/04/2014;21/04/2014;'AUTOPISTA TERR';-2,53 €;6.719,67 €;5204;-2,53;11.243,76 €;'sin fechas';21/04/2014;'AUTOPISTA';'Gastos_Ocio y transporte';'Parking y peaje';'VARIABLES'
25/04/2014;25/04/2014;'AUTOPISTA TERR';-1,39 €;6.718,28 €;5205;-1,39;11.242,37 €;'sin fechas';25/04/2014;'AUTOPISTA';'Gastos_Ocio y transporte';'Parking y peaje';'VARIABLES'
25/04/2014;25/04/2014;'AUTOPISTA TERR';-1,25 €;6.717,03 €;5206;-1,25;11.241,12 €;'sin fechas';25/04/2014;'AUTOPISTA';'Gastos_Ocio y transporte';'Parking y peaje';'VARIABLES'
25/04/2014;25/04/2014;'BON AREA';-40,22 €;6.676,81 €;5207;-40,22;11.200,90 €;'sin fechas';25/04/2014;'BON';'Gastos_Compras';'Supermercado';'VARIABLES'
25/04/2014;25/04/2014;'CAFET.C T PRAT';-4,50 €;6.672,31 €;5208;-4,50;11.196,40 €;'sin fechas';25/04/2014;'CAFETC';'Gastos_Ocio y transporte';'Restaurantes';'VARIABLES'
25/04/2014;25/04/2014;'CAFET.C T PRAT';-2,70 €;6.669,61 €;5209;-2,70;11.193,70 €;'sin fechas';25/04/2014;'CAFETC';'Gastos_Ocio y transporte';'Restaurantes';'VARIABLES'
26/04/2014;26/04/2014;'AUTOPISTA TERR';-4,19 €;6.665,42 €;5210;-4,19;11.189,51 €;'sin fechas';26/04/2014;'AUTOPISTA';'Gastos_Ocio y transporte';'Parking y peaje';'VARIABLES'
26/04/2014;26/04/2014;'AUTOPISTA TERR';-2,53 €;6.662,89 €;5211;-2,53;11.186,98 €;'sin fechas';26/04/2014;'AUTOPISTA';'Gastos_Ocio y transporte';'Parking y peaje';'VARIABLES'
26/04/2014;26/04/2014;'CAFET.C T PRAT';-3,65 €;6.659,24 €;5212;-3,65;11.183,33 €;'sin fechas';26/04/2014;'CAFETC';'Gastos_Ocio y transporte';'Restaurantes';'VARIABLES'
26/04/2014;26/04/2014;'CAPRABO';-15,54 €;6.643,70 €;5213;-15,54;11.167,79 €;'sin fechas';26/04/2014;'CAPRABO';'Gastos_Compras';'Supermercado';'VARIABLES'
26/04/2014;28/04/2014;'FOMENT DE TERRASSA, S.A. FOMEN';1.548,50 €;8.192,20 €;5214;1.548,50;12.716,29 €;'sin fechas';28/04/2014;'FOMENT';'Ingresos';'Nomina';'FIJO'
26/04/2014;26/04/2014;'FRUITES I VERDURES';-6,65 €;8.185,55 €;5215;-6,65;12.709,64 €;'sin fechas';26/04/2014;'FRUITES';'Gastos_Compras';'Supermercado';'VARIABLES'
27/04/2014;27/04/2014;'AUTOPISTA TERR';-4,19 €;8.181,36 €;5216;-4,19;12.705,45 €;'sin fechas';27/04/2014;'AUTOPISTA';'Gastos_Ocio y transporte';'Parking y peaje';'VARIABLES'
27/04/2014;27/04/2014;'BON AREA';-6,07 €;8.175,29 €;5217;-6,07;12.699,38 €;'sin fechas';27/04/2014;'BON';'Gastos_Compras';'Supermercado';'VARIABLES'
27/04/2014;27/04/2014;'ES STA. MARGARITA';-30,45 €;8.144,84 €;5218;-30,45;12.668,93 €;'sin fechas';27/04/2014;'STA';'Gastos_Ocio y transporte';'Gasolina';'VARIABLES'
28/04/2014;28/04/2014;'AUTOPISTA TERR';-4,19 €;8.140,65 €;5219;-4,19;12.664,74 €;'sin fechas';28/04/2014;'AUTOPISTA';'Gastos_Ocio y transporte';'Parking y peaje';'VARIABLES'
28/04/2014;22/04/2014;'AUTOPISTA TERR';-1,39 €;8.139,26 €;5220;-1,39;12.663,35 €;'sin fechas';22/04/2014;'AUTOPISTA';'Gastos_Ocio y transporte';'Parking y peaje';'VARIABLES'
28/04/2014;28/04/2014;'AUTOPISTA TERR';-1,39 €;8.137,87 €;5221;-1,39;12.661,96 €;'sin fechas';28/04/2014;'AUTOPISTA';'Gastos_Ocio y transporte';'Parking y peaje';'VARIABLES'
28/04/2014;22/04/2014;'AUTOPISTA TERR';-1,25 €;8.136,62 €;5222;-1,25;12.660,71 €;'sin fechas';22/04/2014;'AUTOPISTA';'Gastos_Ocio y transporte';'Parking y peaje';'VARIABLES'
28/04/2014;28/04/2014;'AUTOPISTA TERR';-1,25 €;8.135,37 €;5223;-1,25;12.659,46 €;'sin fechas';28/04/2014;'AUTOPISTA';'Gastos_Ocio y transporte';'Parking y peaje';'VARIABLES'
28/04/2014;28/04/2014;'CAFET.C T PRAT';-1,40 €;8.133,97 €;5224;-1,40;12.658,06 €;'sin fechas';28/04/2014;'CAFETC';'Gastos_Ocio y transporte';'Restaurantes';'VARIABLES'
28/04/2014;28/04/2014;'FRUITES I VERDURES';-12,40 €;8.121,57 €;5225;-12,40;12.645,66 €;'sin fechas';28/04/2014;'FRUITES';'Gastos_Compras';'Supermercado';'VARIABLES'
28/04/2014;28/04/2014;'LA TERRASSETA - REST COLEGI';-5,85 €;8.115,72 €;5226;-5,85;12.639,81 €;'sin fechas';28/04/2014;'TERRASSETA';'Gastos_Ocio y transporte';'Restaurantes';'VARIABLES'
28/04/2014;28/04/2014;'FRANKFURT LES LLETRES';-9,45 €;8.106,27 €;5227;-9,45;12.630,36 €;'sin fechas';28/04/2014;'FRANKFURT';'Gastos_Ocio y transporte';'Restaurantes';'VARIABLES'
29/04/2014;29/04/2014;'AUTOPISTA TERR';-1,11 €;8.105,16 €;5228;-1,11;12.629,25 €;'sin fechas';29/04/2014;'AUTOPISTA';'Gastos_Ocio y transporte';'Parking y peaje';'VARIABLES'
29/04/2014;29/04/2014;'AUTOPISTA TERR';-1,11 €;8.104,05 €;5229;-1,11;12.628,14 €;'sin fechas';29/04/2014;'AUTOPISTA';'Gastos_Ocio y transporte';'Parking y peaje';'VARIABLES'
29/04/2014;29/04/2014;'COCHE&PARKING';-8,60 €;8.095,45 €;5231;-8,60;12.619,54 €;'sin fechas';29/04/2014;'COCHEPARKING';'Gastos_Ocio y transporte';'Parking y peaje';'VARIABLES'
29/04/2014;29/04/2014;'HOGAR&COMIDA';-8,00 €;8.087,45 €;5235;-8,00;12.611,54 €;'sin fechas';29/04/2014;'HOGARCOMIDA';'Gastos_Compras';'Supermercado';'VARIABLES'
29/04/2014;29/04/2014;'INFORMACIO I TECNOLOGIA DE CAT';1.576,66 €;9.664,11 €;5237;1.576,66;14.188,20 €;'sin fechas';29/04/2014;'INFORMACIO';'Ingresos';'Nomina';'FIJO'
29/04/2014;29/04/2014;'REINT.CAJERO';-20,00 €;9.644,11 €;5239;-20,00;14.168,20 €;'sin fechas';29/04/2014;'REINTCAJERO';'Gastos_Gastos varios';'Efectivo';'VARIABLES'
29/04/2014;29/04/2014;'REINT.CAJERO';-20,00 €;9.624,11 €;5240;-20,00;14.148,20 €;'sin fechas';29/04/2014;'REINTCAJERO';'Gastos_Gastos varios';'Efectivo';'VARIABLES'
29/04/2014;29/04/2014;'VIENA';-21,35 €;9.602,76 €;5242;-21,35;14.126,85 €;'sin fechas';29/04/2014;'VIENA';'Gastos_Ocio y transporte';'Restaurantes';'VARIABLES'
30/04/2014;26/04/2014;'AUTOPISTA TERR';-3,73 €;9.599,03 €;5243;-3,73;14.123,12 €;'sin fechas';26/04/2014;'AUTOPISTA';'Gastos_Ocio y transporte';'Parking y peaje';'VARIABLES'
30/04/2014;30/04/2014;'AUTOPISTA TERR';-1,11 €;9.597,92 €;5244;-1,11;14.122,01 €;'sin fechas';30/04/2014;'AUTOPISTA';'Gastos_Ocio y transporte';'Parking y peaje';'VARIABLES'
30/04/2014;30/04/2014;'AUTOPISTA TERR';-1,11 €;9.596,81 €;5245;-1,11;14.120,90 €;'sin fechas';30/04/2014;'AUTOPISTA';'Gastos_Ocio y transporte';'Parking y peaje';'VARIABLES'
30/04/2014;30/04/2014;'IBI';-44,87 €;9.551,94 €;5246;-44,87;14.076,03 €;'sin fechas';30/04/2014;'IBI';'Gastos_Banco y organismos';'Ayuntamiento';'FIJO'
30/04/2014;30/04/2014;'RECIBO PTMOS. 3061-0960001518';-562,73 €;8.989,21 €;5247;-562,73;13.513,30 €;'sin fechas';30/04/2014;'RECIBO';'Gastos_Banco y organismos';'Hipoteca';'FIJO'
01/05/2014;01/05/2014;'CAFET.C T PRAT';-4,50 €;8.984,71 €;5248;-4,50;13.508,80 €;'sin fechas';01/05/2014;'CAFETC';'Gastos_Ocio y transporte';'Restaurantes';'VARIABLES'
01/05/2014;01/05/2014;'CAFET.C T PRAT';-4,10 €;8.980,61 €;5249;-4,10;13.504,70 €;'sin fechas';01/05/2014;'CAFETC';'Gastos_Ocio y transporte';'Restaurantes';'VARIABLES'
01/05/2014;01/05/2014;'LA TERRASSETA - REST COLEGI';-4,95 €;8.975,66 €;5251;-4,95;13.499,75 €;'sin fechas';01/05/2014;'TERRASSETA';'Gastos_Ocio y transporte';'Restaurantes';'VARIABLES'
02/05/2014;02/05/2014;'CAPRABO';-14,36 €;8.961,30 €;5252;-14,36;13.485,39 €;'sin fechas';02/05/2014;'CAPRABO';'Gastos_Compras';'Supermercado';'VARIABLES'
02/05/2014;02/05/2014;'FOSTER HOLLYWOOD';-21,90 €;8.939,40 €;5253;-21,90;13.463,49 €;'sin fechas';02/05/2014;'FOSTER';'Gastos_Ocio y transporte';'Restaurantes';'VARIABLES'
03/05/2014;03/05/2014;'BON AREA';-41,02 €;8.898,38 €;5254;-41,02;13.422,47 €;'sin fechas';03/05/2014;'BON';'Gastos_Compras';'Supermercado';'VARIABLES'
03/05/2014;03/05/2014;'CAFET.C T PRAT';-3,65 €;8.894,73 €;5255;-3,65;13.418,82 €;'sin fechas';03/05/2014;'CAFETC';'Gastos_Ocio y transporte';'Restaurantes';'VARIABLES'
05/05/2014;05/05/2014;'ADESLAS CENTRAL 006662671613';-110,99 €;8.783,74 €;5256;-110,99;13.307,83 €;'sin fechas';05/05/2014;'ADESLAS';'Gastos_Salud, saber y deporte';'Medico';'VARIABLES'
05/05/2014;05/05/2014;'AJUNTAMENT BARCELON 0332641FMY';-62,78 €;8.720,96 €;5257;-62,78;13.245,05 €;'sin fechas';05/05/2014;'AJUNTAMENT';'Gastos_Banco y organismos';'Ayuntamiento';'FIJO'
05/05/2014;05/05/2014;'CAFET.C T PRAT';-3,65 €;8.717,31 €;5258;-3,65;13.241,40 €;'sin fechas';05/05/2014;'CAFETC';'Gastos_Ocio y transporte';'Restaurantes';'VARIABLES'
05/05/2014;05/05/2014;'CAPRABO';-13,98 €;8.703,33 €;5259;-13,98;13.227,42 €;'sin fechas';05/05/2014;'CAPRABO';'Gastos_Compras';'Supermercado';'VARIABLES'
05/05/2014;05/05/2014;'ES STA. MARGARITA';-30,00 €;8.673,33 €;5260;-30,00;13.197,42 €;'sin fechas';05/05/2014;'STA';'Gastos_Ocio y transporte';'Gasolina';'VARIABLES'
05/05/2014;05/05/2014;'FRANKFURT LES LLETRES';-5,60 €;8.667,73 €;5261;-5,60;13.191,82 €;'sin fechas';05/05/2014;'FRANKFURT';'Gastos_Ocio y transporte';'Restaurantes';'VARIABLES'
05/05/2014;05/05/2014;'MERCADONA';-1,07 €;8.666,66 €;5262;-1,07;13.190,75 €;'sin fechas';05/05/2014;'MERCADONA';'Gastos_Compras';'Supermercado';'VARIABLES'
05/05/2014;05/05/2014;'NEW PARK';-19,00 €;8.647,66 €;5263;-19,00;13.171,75 €;'sin fechas';05/05/2014;'NEW';'Gastos_Ocio y transporte';'Otros ocio';'VARIABLES'
06/05/2014;06/05/2014;'REINT.CAJERO';-20,00 €;8.627,66 €;5264;-20,00;13.151,75 €;'sin fechas';06/05/2014;'REINTCAJERO';'Gastos_Gastos varios';'Efectivo';'VARIABLES'
07/05/2014;07/05/2014;'ESCOLA BRESSOL EINA';-479,37 €;8.148,29 €;5265;-479,37;12.672,38 €;'sin fechas';07/05/2014;'ESCOLA';'Gastos_Salud, saber y deporte';'Estudios';'VARIABLES'
07/05/2014;07/05/2014;'UNIO PAPERS \\TERRASSA';-87,37 €;8.060,92 €;5266;-87,37;12.585,01 €;'sin fechas';07/05/2014;'UNIO';'Gastos_Compras';'Libreria';'VARIABLES'
08/05/2014;07/05/2014;'AMC PARC VALLES';-18,10 €;8.042,82 €;5267;-18,10;12.566,91 €;'sin fechas';07/05/2014;'AMC';'Gastos_Ocio y transporte';'Espectáculos';'VARIABLES'
08/05/2014;01/05/2014;'AUTOPISTA TERR';-4,19 €;8.038,63 €;5268;-4,19;12.562,72 €;'sin fechas';01/05/2014;'AUTOPISTA';'Gastos_Ocio y transporte';'Parking y peaje';'VARIABLES'
08/05/2014;08/05/2014;'BLITZ';-72,50 €;7.966,13 €;5269;-72,50;12.490,22 €;'sin fechas';08/05/2014;'BLITZ';'Gastos_Vivienda y vehiculo';'Alquiler Parking';'FIJO'
08/05/2014;05/05/2014;'BURGUER KING';-25,37 €;7.940,76 €;5270;-25,37;12.464,85 €;'sin fechas';05/05/2014;'BURGUER';'Gastos_Ocio y transporte';'Restaurantes';'VARIABLES'
08/05/2014;08/05/2014;'CAFET.C T PRAT';-3,65 €;7.937,11 €;5271;-3,65;12.461,20 €;'sin fechas';08/05/2014;'CAFETC';'Gastos_Ocio y transporte';'Restaurantes';'VARIABLES'
08/05/2014;08/05/2014;'CARREFOUR-[COMIDA]';-8,04 €;7.929,07 €;5272;-8,04;12.453,16 €;'sin fechas';08/05/2014;'CARREFOURCOMIDA';'Gastos_Compras';'Supermercado';'VARIABLES'
08/05/2014;06/05/2014;'MERCADONA';-184,68 €;7.744,39 €;5273;-184,68;12.268,48 €;'sin fechas';06/05/2014;'MERCADONA';'Gastos_Compras';'Supermercado';'VARIABLES'
08/05/2014;08/05/2014;'NATURCENTER';-44,87 €;7.699,52 €;5274;-44,87;12.223,61 €;'sin fechas';08/05/2014;'NATURCENTER';'Gastos_Salud, saber y deporte';'Farmacia';'VARIABLES'
09/05/2014;02/05/2014;'AUTOPISTA TERR';-1,39 €;7.698,13 €;5275;-1,39;12.222,22 €;'sin fechas';02/05/2014;'AUTOPISTA';'Gastos_Ocio y transporte';'Parking y peaje';'VARIABLES'
09/05/2014;02/05/2014;'AUTOPISTA TERR';-1,39 €;7.696,74 €;5276;-1,39;12.220,83 €;'sin fechas';02/05/2014;'AUTOPISTA';'Gastos_Ocio y transporte';'Parking y peaje';'VARIABLES'
09/05/2014;09/05/2014;'BON AREA';-17,83 €;7.678,91 €;5277;-17,83;12.203,00 €;'sin fechas';09/05/2014;'BON';'Gastos_Compras';'Supermercado';'VARIABLES'
09/05/2014;09/05/2014;'CAFET.C T PRAT';-3,05 €;7.675,86 €;5278;-3,05;12.199,95 €;'sin fechas';09/05/2014;'CAFETC';'Gastos_Ocio y transporte';'Restaurantes';'VARIABLES'
10/05/2014;10/05/2014;'CAFET.C T PRAT';-3,60 €;7.672,26 €;5279;-3,60;12.196,35 €;'sin fechas';10/05/2014;'CAFETC';'Gastos_Ocio y transporte';'Restaurantes';'VARIABLES'
10/05/2014;10/05/2014;'CARREFOUR-[MODA]';-87,00 €;7.585,26 €;5280;-87,00;12.109,35 €;'sin fechas';10/05/2014;'CARREFOURMODA';'Gastos_Compras';'Supermercado';'VARIABLES'
10/05/2014;10/05/2014;'FARMACIA';-3,95 €;7.581,31 €;5281;-3,95;12.105,40 €;'sin fechas';10/05/2014;'FARMACIA';'Gastos_Salud, saber y deporte';'Farmacia';'VARIABLES'
10/05/2014;10/05/2014;'REINT.CAJERO';-100,00 €;7.481,31 €;5282;-100,00;12.005,40 €;'sin fechas';10/05/2014;'REINTCAJERO';'Gastos_Gastos varios';'Efectivo';'VARIABLES'
10/05/2014;10/05/2014;'UNIO PAPERS \\TERRASSA';-87,37 €;7.393,94 €;5283;-87,37;11.918,03 €;'sin fechas';10/05/2014;'UNIO';'Gastos_Compras';'Libreria';'VARIABLES'
10/05/2014;10/05/2014;'UNIO PAPERS \\TERRASSA';-87,37 €;7.306,57 €;5284;-87,37;11.830,66 €;'sin fechas';10/05/2014;'UNIO';'Gastos_Compras';'Libreria';'VARIABLES'
10/05/2014;10/05/2014;'VIENA';-3,75 €;7.302,82 €;5285;-3,75;11.826,91 €;'sin fechas';10/05/2014;'VIENA';'Gastos_Ocio y transporte';'Restaurantes';'VARIABLES'
11/05/2014;11/05/2014;'CAFET.C T PRAT';-1,80 €;7.301,02 €;5286;-1,80;11.825,11 €;'sin fechas';11/05/2014;'CAFETC';'Gastos_Ocio y transporte';'Restaurantes';'VARIABLES'
11/05/2014;11/05/2014;'LA TERRASSETA - REST COLEGI';-6,25 €;7.294,77 €;5287;-6,25;11.818,86 €;'sin fechas';11/05/2014;'TERRASSETA';'Gastos_Ocio y transporte';'Restaurantes';'VARIABLES'
12/05/2014;03/05/2014;'AUTOPISTA TERR';-3,73 €;7.291,04 €;5288;-3,73;11.815,13 €;'sin fechas';03/05/2014;'AUTOPISTA';'Gastos_Ocio y transporte';'Parking y peaje';'VARIABLES'
12/05/2014;06/05/2014;'AUTOPISTA TERR';-1,39 €;7.289,65 €;5289;-1,39;11.813,74 €;'sin fechas';06/05/2014;'AUTOPISTA';'Gastos_Ocio y transporte';'Parking y peaje';'VARIABLES'
12/05/2014;05/05/2014;'AUTOPISTA TERR';-1,39 €;7.288,26 €;5290;-1,39;11.812,35 €;'sin fechas';05/05/2014;'AUTOPISTA';'Gastos_Ocio y transporte';'Parking y peaje';'VARIABLES'
12/05/2014;05/05/2014;'AUTOPISTA TERR';-1,39 €;7.286,87 €;5291;-1,39;11.810,96 €;'sin fechas';05/05/2014;'AUTOPISTA';'Gastos_Ocio y transporte';'Parking y peaje';'VARIABLES'
12/05/2014;06/05/2014;'AUTOPISTA TERR';-1,39 €;7.285,48 €;5292;-1,39;11.809,57 €;'sin fechas';06/05/2014;'AUTOPISTA';'Gastos_Ocio y transporte';'Parking y peaje';'VARIABLES'
12/05/2014;12/05/2014;'BON AREA';-23,19 €;7.262,29 €;5293;-23,19;11.786,38 €;'sin fechas';12/05/2014;'BON';'Gastos_Compras';'Supermercado';'VARIABLES'
12/05/2014;12/05/2014;'CAFET.C T PRAT';-4,50 €;7.257,79 €;5294;-4,50;11.781,88 €;'sin fechas';12/05/2014;'CAFETC';'Gastos_Ocio y transporte';'Restaurantes';'VARIABLES'
12/05/2014;12/05/2014;'SALA BADRINAS - MENJADOR';-124,00 €;7.133,79 €;5295;-124,00;11.657,88 €;'sin fechas';12/05/2014;'SALA';'Gastos_Salud, saber y deporte';'Estudios';'VARIABLES'
13/05/2014;07/05/2014;'AUTOPISTA TERR';-1,39 €;7.132,40 €;5296;-1,39;11.656,49 €;'sin fechas';07/05/2014;'AUTOPISTA';'Gastos_Ocio y transporte';'Parking y peaje';'VARIABLES'
13/05/2014;07/05/2014;'AUTOPISTA TERR';-1,39 €;7.131,01 €;5297;-1,39;11.655,10 €;'sin fechas';07/05/2014;'AUTOPISTA';'Gastos_Ocio y transporte';'Parking y peaje';'VARIABLES'
13/05/2014;08/05/2014;'AUTOPISTA TERR';-1,39 €;7.129,62 €;5298;-1,39;11.653,71 €;'sin fechas';08/05/2014;'AUTOPISTA';'Gastos_Ocio y transporte';'Parking y peaje';'VARIABLES'
13/05/2014;08/05/2014;'AUTOPISTA TERR';-1,32 €;7.128,30 €;5299;-1,32;11.652,39 €;'sin fechas';08/05/2014;'AUTOPISTA';'Gastos_Ocio y transporte';'Parking y peaje';'VARIABLES'
14/05/2014;14/05/2014;'CAFET.C T PRAT';-4,50 €;7.123,80 €;5300;-4,50;11.647,89 €;'sin fechas';14/05/2014;'CAFETC';'Gastos_Ocio y transporte';'Restaurantes';'VARIABLES'
15/05/2014;08/05/2014;'AUTOPISTA TERR';-4,19 €;7.119,61 €;5301;-4,19;11.643,70 €;'sin fechas';08/05/2014;'AUTOPISTA';'Gastos_Ocio y transporte';'Parking y peaje';'VARIABLES'
15/05/2014;09/05/2014;'AUTOPISTA TERR';-1,39 €;7.118,22 €;5302;-1,39;11.642,31 €;'sin fechas';09/05/2014;'AUTOPISTA';'Gastos_Ocio y transporte';'Parking y peaje';'VARIABLES'
15/05/2014;09/05/2014;'AUTOPISTA TERR';-1,32 €;7.116,90 €;5303;-1,32;11.640,99 €;'sin fechas';09/05/2014;'AUTOPISTA';'Gastos_Ocio y transporte';'Parking y peaje';'VARIABLES'
15/05/2014;15/05/2014;'CCM VIDA Y PENSIO 000000493358';-18,46 €;7.098,44 €;5304;-18,46;11.622,53 €;'sin fechas';15/05/2014;'CCM';'Gastos_Seguros';'Seguro vida';'FIJO'
15/05/2014;15/05/2014;'ES STA. MARGARITA';-48,12 €;7.050,32 €;5305;-48,12;11.574,41 €;'sin fechas';15/05/2014;'STA';'Gastos_Ocio y transporte';'Gasolina';'VARIABLES'
15/05/2014;13/05/2014;'RESTAURANTES';-23,40 €;7.026,92 €;5306;-23,40;11.551,01 €;'sin fechas';13/05/2014;'RESTAURANTES';'Gastos_Ocio y transporte';'Restaurantes';'VARIABLES'
15/05/2014;15/05/2014;'VIENA';-17,75 €;7.009,17 €;5307;-17,75;11.533,26 €;'sin fechas';15/05/2014;'VIENA';'Gastos_Ocio y transporte';'Restaurantes';'VARIABLES'
16/05/2014;10/05/2014;'AUTOPISTA TERR';-4,19 €;7.004,98 €;5308;-4,19;11.529,07 €;'sin fechas';10/05/2014;'AUTOPISTA';'Gastos_Ocio y transporte';'Parking y peaje';'VARIABLES'
16/05/2014;09/05/2014;'AUTOPISTA TERR';-4,19 €;7.000,79 €;5309;-4,19;11.524,88 €;'sin fechas';09/05/2014;'AUTOPISTA';'Gastos_Ocio y transporte';'Parking y peaje';'VARIABLES'
16/05/2014;12/05/2014;'AUTOPISTA TERR';-1,39 €;6.999,40 €;5310;-1,39;11.523,49 €;'sin fechas';12/05/2014;'AUTOPISTA';'Gastos_Ocio y transporte';'Parking y peaje';'VARIABLES'
16/05/2014;12/05/2014;'AUTOPISTA TERR';-1,32 €;6.998,08 €;5311;-1,32;11.522,17 €;'sin fechas';12/05/2014;'AUTOPISTA';'Gastos_Ocio y transporte';'Parking y peaje';'VARIABLES'
16/05/2014;16/05/2014;'CAFET.C T PRAT';-0,90 €;6.997,18 €;5312;-0,90;11.521,27 €;'sin fechas';16/05/2014;'CAFETC';'Gastos_Ocio y transporte';'Restaurantes';'VARIABLES'
16/05/2014;16/05/2014;'CCM VIDA Y P SEGURO PRESTAMO';-24,04 €;6.973,14 €;5313;-24,04;11.497,23 €;'sin fechas';16/05/2014;'CCM';'Gastos_Seguros';'Seguro vida';'FIJO'
16/05/2014;10/05/2014;'SATSA PL. VELLA TERRASSA';-1,50 €;6.971,64 €;5314;-1,50;11.495,73 €;'sin fechas';10/05/2014;'SATSA';'Gastos_Ocio y transporte';'Parking y peaje';'VARIABLES'
19/05/2014;12/05/2014;'AUTOPISTA TERR';-4,19 €;6.967,45 €;5315;-4,19;11.491,54 €;'sin fechas';12/05/2014;'AUTOPISTA';'Gastos_Ocio y transporte';'Parking y peaje';'VARIABLES'
19/05/2014;13/05/2014;'AUTOPISTA TERR';-1,39 €;6.966,06 €;5316;-1,39;11.490,15 €;'sin fechas';13/05/2014;'AUTOPISTA';'Gastos_Ocio y transporte';'Parking y peaje';'VARIABLES'
19/05/2014;13/05/2014;'AUTOPISTA TERR';-1,32 €;6.964,74 €;5317;-1,32;11.488,83 €;'sin fechas';13/05/2014;'AUTOPISTA';'Gastos_Ocio y transporte';'Parking y peaje';'VARIABLES'
19/05/2014;19/05/2014;'ONO';-114,08 €;6.850,66 €;5318;-114,08;11.374,75 €;'sin fechas';19/05/2014;'ONO';'Gastos_Servicios tipicos';'Telecomunicaciones';'FIJO'
22/05/2014;15/05/2014;'AUTOPISTA TERR';-4,19 €;6.846,47 €;5319;-4,19;11.370,56 €;'sin fechas';15/05/2014;'AUTOPISTA';'Gastos_Ocio y transporte';'Parking y peaje';'VARIABLES'
22/05/2014;18/05/2014;'AUTOPISTA TERR';-2,53 €;6.843,94 €;5320;-2,53;11.368,03 €;'sin fechas';18/05/2014;'AUTOPISTA';'Gastos_Ocio y transporte';'Parking y peaje';'VARIABLES'
22/05/2014;18/05/2014;'AUTOPISTA TERR';-2,53 €;6.841,41 €;5321;-2,53;11.365,50 €;'sin fechas';18/05/2014;'AUTOPISTA';'Gastos_Ocio y transporte';'Parking y peaje';'VARIABLES'
22/05/2014;22/05/2014;'CATALANA DIAG.I CIRUR';-3,80 €;6.837,61 €;5322;-3,80;11.361,70 €;'sin fechas';22/05/2014;'CATALANA';'Gastos_Ocio y transporte';'Parking y peaje';'VARIABLES'
22/05/2014;20/05/2014;'FARMACIA';-6,55 €;6.831,06 €;5323;-6,55;11.355,15 €;'sin fechas';20/05/2014;'FARMACIA';'Gastos_Salud, saber y deporte';'Farmacia';'VARIABLES'
22/05/2014;20/05/2014;'H&M';-12,39 €;6.818,67 €;5324;-12,39;11.342,76 €;'sin fechas';20/05/2014;'HM';'Gastos_Compras';'Ropa';'VARIABLES'
22/05/2014;21/05/2014;'LA TERRASSETA - REST COLEGI';-14,50 €;6.804,17 €;5325;-14,50;11.328,26 €;'sin fechas';21/05/2014;'TERRASSETA';'Gastos_Ocio y transporte';'Restaurantes';'VARIABLES'
22/05/2014;20/05/2014;'FRANKFURT LES LLETRES';-12,35 €;6.791,82 €;5326;-12,35;11.315,91 €;'sin fechas';20/05/2014;'FRANKFURT';'Gastos_Ocio y transporte';'Restaurantes';'VARIABLES'
22/05/2014;20/05/2014;'MERCADONA';-25,11 €;6.766,71 €;5327;-25,11;11.290,80 €;'sin fechas';20/05/2014;'MERCADONA';'Gastos_Compras';'Supermercado';'VARIABLES'
22/05/2014;22/05/2014;'MERCADONA';-17,90 €;6.748,81 €;5328;-17,90;11.272,90 €;'sin fechas';22/05/2014;'MERCADONA';'Gastos_Compras';'Supermercado';'VARIABLES'
23/05/2014;16/05/2014;'AUTOPISTA TERR';-4,19 €;6.744,62 €;5329;-4,19;11.268,71 €;'sin fechas';16/05/2014;'AUTOPISTA';'Gastos_Ocio y transporte';'Parking y peaje';'VARIABLES'
23/05/2014;19/05/2014;'AUTOPISTA TERR';-1,39 €;6.743,23 €;5330;-1,39;11.267,32 €;'sin fechas';19/05/2014;'AUTOPISTA';'Gastos_Ocio y transporte';'Parking y peaje';'VARIABLES'
23/05/2014;19/05/2014;'AUTOPISTA TERR';-1,32 €;6.741,91 €;5331;-1,32;11.266,00 €;'sin fechas';19/05/2014;'AUTOPISTA';'Gastos_Ocio y transporte';'Parking y peaje';'VARIABLES'
23/05/2014;23/05/2014;'CAFET.C T PRAT';-2,15 €;6.739,76 €;5332;-2,15;11.263,85 €;'sin fechas';23/05/2014;'CAFETC';'Gastos_Ocio y transporte';'Restaurantes';'VARIABLES'
23/05/2014;16/05/2014;'SATSA PL. VELLA TERRASSA';-1,85 €;6.737,91 €;5333;-1,85;11.262,00 €;'sin fechas';16/05/2014;'SATSA';'Gastos_Ocio y transporte';'Parking y peaje';'VARIABLES'
24/05/2014;24/05/2014;'CAFET.C T PRAT';-2,15 €;6.735,76 €;5334;-2,15;11.259,85 €;'sin fechas';24/05/2014;'CAFETC';'Gastos_Ocio y transporte';'Restaurantes';'VARIABLES'
24/05/2014;24/05/2014;'ES STA. MARGARITA';-54,33 €;6.681,43 €;5335;-54,33;11.205,52 €;'sin fechas';24/05/2014;'STA';'Gastos_Ocio y transporte';'Gasolina';'VARIABLES'
24/05/2014;24/05/2014;'IKEA';-22,71 €;6.658,72 €;5336;-22,71;11.182,81 €;'sin fechas';24/05/2014;'IKEA';'Gastos_Vivienda y vehiculo';'Mnto. hogar';'VARIABLES'
24/05/2014;24/05/2014;'IKEA';-22,00 €;6.636,72 €;5337;-22,00;11.160,81 €;'sin fechas';24/05/2014;'IKEA';'Gastos_Vivienda y vehiculo';'Mnto. hogar';'VARIABLES'
24/05/2014;24/05/2014;'IKEA';-3,50 €;6.633,22 €;5338;-3,50;11.157,31 €;'sin fechas';24/05/2014;'IKEA';'Gastos_Vivienda y vehiculo';'Mnto. hogar';'VARIABLES'
24/05/2014;24/05/2014;'LA TERRASSETA - REST COLEGI';-6,00 €;6.627,22 €;5339;-6,00;11.151,31 €;'sin fechas';24/05/2014;'TERRASSETA';'Gastos_Ocio y transporte';'Restaurantes';'VARIABLES'
25/05/2014;25/05/2014;'CAFET.C T PRAT';-3,60 €;6.623,62 €;5340;-3,60;11.147,71 €;'sin fechas';25/05/2014;'CAFETC';'Gastos_Ocio y transporte';'Restaurantes';'VARIABLES'
25/05/2014;25/05/2014;'CATALANA DIAG.I CIRUR';-4,20 €;6.619,42 €;5341;-4,20;11.143,51 €;'sin fechas';25/05/2014;'CATALANA';'Gastos_Ocio y transporte';'Parking y peaje';'VARIABLES'
25/05/2014;25/05/2014;'FARMACIA';-13,21 €;6.606,21 €;5342;-13,21;11.130,30 €;'sin fechas';25/05/2014;'FARMACIA';'Gastos_Salud, saber y deporte';'Farmacia';'VARIABLES'
26/05/2014;20/05/2014;'AUTOPISTA TERR';-1,39 €;6.604,82 €;5343;-1,39;11.128,91 €;'sin fechas';20/05/2014;'AUTOPISTA';'Gastos_Ocio y transporte';'Parking y peaje';'VARIABLES'
26/05/2014;20/05/2014;'AUTOPISTA TERR';-1,39 €;6.603,43 €;5344;-1,39;11.127,52 €;'sin fechas';20/05/2014;'AUTOPISTA';'Gastos_Ocio y transporte';'Parking y peaje';'VARIABLES'
26/05/2014;20/05/2014;'AUTOPISTA TERR';-1,39 €;6.602,04 €;5345;-1,39;11.126,13 €;'sin fechas';20/05/2014;'AUTOPISTA';'Gastos_Ocio y transporte';'Parking y peaje';'VARIABLES'
26/05/2014;20/05/2014;'AUTOPISTA TERR';-1,25 €;6.600,79 €;5346;-1,25;11.124,88 €;'sin fechas';20/05/2014;'AUTOPISTA';'Gastos_Ocio y transporte';'Parking y peaje';'VARIABLES'
26/05/2014;26/05/2014;'CAFET.C T PRAT';-4,50 €;6.596,29 €;5347;-4,50;11.120,38 €;'sin fechas';26/05/2014;'CAFETC';'Gastos_Ocio y transporte';'Restaurantes';'VARIABLES'
26/05/2014;26/05/2014;'CAFET.C T PRAT';-3,65 €;6.592,64 €;5348;-3,65;11.116,73 €;'sin fechas';26/05/2014;'CAFETC';'Gastos_Ocio y transporte';'Restaurantes';'VARIABLES'
26/05/2014;26/05/2014;'FARMACIA';-4,95 €;6.587,69 €;5349;-4,95;11.111,78 €;'sin fechas';26/05/2014;'FARMACIA';'Gastos_Salud, saber y deporte';'Farmacia';'VARIABLES'
26/05/2014;26/05/2014;'LA TERRASSETA - REST COLEGI';-4,70 €;6.582,99 €;5350;-4,70;11.107,08 €;'sin fechas';26/05/2014;'TERRASSETA';'Gastos_Ocio y transporte';'Restaurantes';'VARIABLES'
26/05/2014;26/05/2014;'FRANKFURT LES LLETRES';-6,70 €;6.576,29 €;5351;-6,70;11.100,38 €;'sin fechas';26/05/2014;'FRANKFURT';'Gastos_Ocio y transporte';'Restaurantes';'VARIABLES'
27/05/2014;25/05/2014;'AUTOPISTA TERR';-2,53 €;6.573,76 €;5352;-2,53;11.097,85 €;'sin fechas';25/05/2014;'AUTOPISTA';'Gastos_Ocio y transporte';'Parking y peaje';'VARIABLES'
27/05/2014;21/05/2014;'AUTOPISTA TERR';-1,39 €;6.572,37 €;5353;-1,39;11.096,46 €;'sin fechas';21/05/2014;'AUTOPISTA';'Gastos_Ocio y transporte';'Parking y peaje';'VARIABLES'
27/05/2014;22/05/2014;'AUTOPISTA TERR';-1,39 €;6.570,98 €;5354;-1,39;11.095,07 €;'sin fechas';22/05/2014;'AUTOPISTA';'Gastos_Ocio y transporte';'Parking y peaje';'VARIABLES'
27/05/2014;21/05/2014;'AUTOPISTA TERR';-1,25 €;6.569,73 €;5355;-1,25;11.093,82 €;'sin fechas';21/05/2014;'AUTOPISTA';'Gastos_Ocio y transporte';'Parking y peaje';'VARIABLES'
27/05/2014;22/05/2014;'AUTOPISTA TERR';-1,25 €;6.568,48 €;5356;-1,25;11.092,57 €;'sin fechas';22/05/2014;'AUTOPISTA';'Gastos_Ocio y transporte';'Parking y peaje';'VARIABLES'
27/05/2014;22/05/2014;'AUTOPISTA TERR';-1,25 €;6.567,23 €;5357;-1,25;11.091,32 €;'sin fechas';22/05/2014;'AUTOPISTA';'Gastos_Ocio y transporte';'Parking y peaje';'VARIABLES'
27/05/2014;22/05/2014;'AUTOPISTA TERR';-1,25 €;6.565,98 €;5358;-1,25;11.090,07 €;'sin fechas';22/05/2014;'AUTOPISTA';'Gastos_Ocio y transporte';'Parking y peaje';'VARIABLES'
28/05/2014;28/05/2014;'FOMENT DE TERRASSA, S.A. FOMEN';1.538,64 €;8.104,62 €;5359;1.538,64;12.628,71 €;'sin fechas';28/05/2014;'FOMENT';'Ingresos';'Nomina';'FIJO'
29/05/2014;22/05/2014;'AUTOPISTA TERR';-4,19 €;8.100,43 €;5360;-4,19;12.624,52 €;'sin fechas';22/05/2014;'AUTOPISTA';'Gastos_Ocio y transporte';'Parking y peaje';'VARIABLES'
29/05/2014;25/05/2014;'AUTOPISTA TERR';-2,53 €;8.097,90 €;5361;-2,53;12.621,99 €;'sin fechas';25/05/2014;'AUTOPISTA';'Gastos_Ocio y transporte';'Parking y peaje';'VARIABLES'
29/05/2014;23/05/2014;'AUTOPISTA TERR';-1,25 €;8.096,65 €;5362;-1,25;12.620,74 €;'sin fechas';23/05/2014;'AUTOPISTA';'Gastos_Ocio y transporte';'Parking y peaje';'VARIABLES'
29/05/2014;23/05/2014;'AUTOPISTA TERR';-1,25 €;8.095,40 €;5363;-1,25;12.619,49 €;'sin fechas';23/05/2014;'AUTOPISTA';'Gastos_Ocio y transporte';'Parking y peaje';'VARIABLES'
29/05/2014;29/05/2014;'CAFET.C T PRAT';-2,70 €;8.092,70 €;5364;-2,70;12.616,79 €;'sin fechas';29/05/2014;'CAFETC';'Gastos_Ocio y transporte';'Restaurantes';'VARIABLES'
29/05/2014;29/05/2014;'INFORMACIO I TECNOLOGIA DE CAT';1.576,66 €;9.669,36 €;5365;1.576,66;14.193,45 €;'sin fechas';29/05/2014;'INFORMACIO';'Ingresos';'Nomina';'FIJO'
29/05/2014;27/05/2014;'LEROY MERLIN';-64,80 €;9.604,56 €;5366;-64,80;14.128,65 €;'sin fechas';27/05/2014;'LEROY';'Gastos_Vivienda y vehiculo';'Mnto. hogar';'VARIABLES'
29/05/2014;29/05/2014;'MERCADONA';-23,32 €;9.581,24 €;5367;-23,32;14.105,33 €;'sin fechas';29/05/2014;'MERCADONA';'Gastos_Compras';'Supermercado';'VARIABLES'
29/05/2014;29/05/2014;'REINT.CAJERO';-300,00 €;9.281,24 €;5368;-300,00;13.805,33 €;'sin fechas';29/05/2014;'REINTCAJERO';'Gastos_Gastos varios';'Efectivo';'VARIABLES'
29/05/2014;29/05/2014;'REINT.CAJERO';-300,00 €;8.981,24 €;5369;-300,00;13.505,33 €;'sin fechas';29/05/2014;'REINTCAJERO';'Gastos_Gastos varios';'Efectivo';'VARIABLES'
29/05/2014;29/05/2014;'REINT.CAJERO';-70,00 €;8.911,24 €;5370;-70,00;13.435,33 €;'sin fechas';29/05/2014;'REINTCAJERO';'Gastos_Gastos varios';'Efectivo';'VARIABLES'
29/05/2014;29/05/2014;'SATSA PL. VELLA TERRASSA';-3,10 €;8.908,14 €;5371;-3,10;13.432,23 €;'sin fechas';29/05/2014;'SATSA';'Gastos_Ocio y transporte';'Parking y peaje';'VARIABLES'
30/05/2014;30/05/2014;'CAFET.C T PRAT';-2,70 €;8.905,44 €;5373;-2,70;13.429,53 €;'sin fechas';30/05/2014;'CAFETC';'Gastos_Ocio y transporte';'Restaurantes';'VARIABLES'
30/05/2014;30/05/2014;'FRUITES I VERDURES';-3,69 €;8.901,75 €;5376;-3,69;13.425,84 €;'sin fechas';30/05/2014;'FRUITES';'Gastos_Compras';'Supermercado';'VARIABLES'
30/05/2014;30/05/2014;'HOGAR&OTROS';-1.468,00 €;7.433,75 €;5377;-1.468,00;11.957,84 €;'sin fechas';30/05/2014;'HOGAROTROS';'Gastos_Vivienda y vehiculo';'Otros vivienda';'VARIABLES'
30/05/2014;30/05/2014;'HOGAR&OTROS';-367,00 €;7.066,75 €;5378;-367,00;11.590,84 €;'sin fechas';30/05/2014;'HOGAROTROS';'Gastos_Vivienda y vehiculo';'Otros vivienda';'VARIABLES'
30/05/2014;30/05/2014;'REINT.CAJERO';-367,00 €;6.699,75 €;5381;-367,00;11.223,84 €;'sin fechas';30/05/2014;'REINTCAJERO';'Gastos_Gastos varios';'Efectivo';'VARIABLES'
30/05/2014;30/05/2014;'RESTAURANTES';-21,90 €;6.677,85 €;5382;-21,90;11.201,94 €;'sin fechas';30/05/2014;'RESTAURANTES';'Gastos_Ocio y transporte';'Restaurantes';'VARIABLES'
31/05/2014;31/05/2014;'CAFET.C T PRAT';-4,50 €;6.673,35 €;5384;-4,50;11.197,44 €;'sin fechas';31/05/2014;'CAFETC';'Gastos_Ocio y transporte';'Restaurantes';'VARIABLES'
31/05/2014;31/05/2014;'CAFET.C T PRAT';-4,10 €;6.669,25 €;5385;-4,10;11.193,34 €;'sin fechas';31/05/2014;'CAFETC';'Gastos_Ocio y transporte';'Restaurantes';'VARIABLES'
31/05/2014;31/05/2014;'RECIBO PTMOS. 3061-0960001518';-562,73 €;6.106,52 €;5386;-562,73;10.630,61 €;'sin fechas';31/05/2014;'RECIBO';'Gastos_Banco y organismos';'Hipoteca';'FIJO'
01/06/2014;01/06/2014;'CARREFOUR-[COMIDA]';-30,55 €;6.075,97 €;5387;-30,55;10.600,06 €;'sin fechas';01/06/2014;'CARREFOURCOMIDA';'Gastos_Compras';'Supermercado';'VARIABLES'
01/06/2014;01/06/2014;'ES STA. MARGARITA';-50,68 €;6.025,29 €;5389;-50,68;10.549,38 €;'sin fechas';01/06/2014;'STA';'Gastos_Ocio y transporte';'Gasolina';'VARIABLES'
01/06/2014;01/06/2014;'FARMACIA';-61,34 €;5.963,95 €;5390;-61,34;10.488,04 €;'sin fechas';01/06/2014;'FARMACIA';'Gastos_Salud, saber y deporte';'Farmacia';'VARIABLES'
01/06/2014;01/06/2014;'FARMACIA';-9,37 €;5.954,58 €;5391;-9,37;10.478,67 €;'sin fechas';01/06/2014;'FARMACIA';'Gastos_Salud, saber y deporte';'Farmacia';'VARIABLES'
01/06/2014;01/06/2014;'RESTAURANTES';-8,65 €;5.945,93 €;5392;-8,65;10.470,02 €;'sin fechas';01/06/2014;'RESTAURANTES';'Gastos_Ocio y transporte';'Restaurantes';'VARIABLES'
02/06/2014;27/05/2014;'AUTOPISTA TERR';-1,25 €;5.944,68 €;5393;-1,25;10.468,77 €;'sin fechas';27/05/2014;'AUTOPISTA';'Gastos_Ocio y transporte';'Parking y peaje';'VARIABLES'
02/06/2014;02/06/2014;'CAFET.C T PRAT';-4,95 €;5.939,73 €;5394;-4,95;10.463,82 €;'sin fechas';02/06/2014;'CAFETC';'Gastos_Ocio y transporte';'Restaurantes';'VARIABLES'
02/06/2014;02/06/2014;'CAFET.C T PRAT';-1,40 €;5.938,33 €;5395;-1,40;10.462,42 €;'sin fechas';02/06/2014;'CAFETC';'Gastos_Ocio y transporte';'Restaurantes';'VARIABLES'
02/06/2014;02/06/2014;'ESCOLA BRESSOL EINA';-619,74 €;5.318,59 €;5396;-619,74;9.842,68 €;'sin fechas';02/06/2014;'ESCOLA';'Gastos_Salud, saber y deporte';'Estudios';'VARIABLES'
02/06/2014;02/06/2014;'FARMACIA-DIETA';-29,95 €;5.288,64 €;5397;-29,95;9.812,73 €;'sin fechas';02/06/2014;'FARMACIADIETA';'Gastos_Salud, saber y deporte';'Farmacia';'VARIABLES'
02/06/2014;02/06/2014;'MERCADONA';-9,33 €;5.279,31 €;5398;-9,33;9.803,40 €;'sin fechas';02/06/2014;'MERCADONA';'Gastos_Compras';'Supermercado';'VARIABLES'
02/06/2014;02/06/2014;'REINT.CAJERO';-20,00 €;5.259,31 €;5399;-20,00;9.783,40 €;'sin fechas';02/06/2014;'REINTCAJERO';'Gastos_Gastos varios';'Efectivo';'VARIABLES'
02/06/2014;02/06/2014;'RESTAURANTES';-17,59 €;5.241,72 €;5400;-17,59;9.765,81 €;'sin fechas';02/06/2014;'RESTAURANTES';'Gastos_Ocio y transporte';'Restaurantes';'VARIABLES'
03/06/2014;29/05/2014;'AUTOPISTA TERR';-1,39 €;5.240,33 €;5401;-1,39;9.764,42 €;'sin fechas';29/05/2014;'AUTOPISTA';'Gastos_Ocio y transporte';'Parking y peaje';'VARIABLES'
03/06/2014;28/05/2014;'AUTOPISTA TERR';-1,39 €;5.238,94 €;5402;-1,39;9.763,03 €;'sin fechas';28/05/2014;'AUTOPISTA';'Gastos_Ocio y transporte';'Parking y peaje';'VARIABLES'
03/06/2014;28/05/2014;'AUTOPISTA TERR';-1,25 €;5.237,69 €;5403;-1,25;9.761,78 €;'sin fechas';28/05/2014;'AUTOPISTA';'Gastos_Ocio y transporte';'Parking y peaje';'VARIABLES'
03/06/2014;03/06/2014;'BON AREA';-15,19 €;5.222,50 €;5404;-15,19;9.746,59 €;'sin fechas';03/06/2014;'BON';'Gastos_Compras';'Supermercado';'VARIABLES'
05/06/2014;31/05/2014;'AUTOPISTA TERR';-2,53 €;5.219,97 €;5405;-2,53;9.744,06 €;'sin fechas';31/05/2014;'AUTOPISTA';'Gastos_Ocio y transporte';'Parking y peaje';'VARIABLES'
05/06/2014;05/06/2014;'CAFET.C T PRAT';-2,25 €;5.217,72 €;5406;-2,25;9.741,81 €;'sin fechas';05/06/2014;'CAFETC';'Gastos_Ocio y transporte';'Restaurantes';'VARIABLES'
05/06/2014;05/06/2014;'MERCADONA';-119,68 €;5.098,04 €;5407;-119,68;9.622,13 €;'sin fechas';05/06/2014;'MERCADONA';'Gastos_Compras';'Supermercado';'VARIABLES'
05/06/2014;03/06/2014;'MERCADONA';-32,75 €;5.065,29 €;5408;-32,75;9.589,38 €;'sin fechas';03/06/2014;'MERCADONA';'Gastos_Compras';'Supermercado';'VARIABLES'
05/06/2014;03/06/2014;'MERCADONA';-23,28 €;5.042,01 €;5409;-23,28;9.566,10 €;'sin fechas';03/06/2014;'MERCADONA';'Gastos_Compras';'Supermercado';'VARIABLES'
05/06/2014;03/06/2014;'MERCADONA';-5,90 €;5.036,11 €;5410;-5,90;9.560,20 €;'sin fechas';03/06/2014;'MERCADONA';'Gastos_Compras';'Supermercado';'VARIABLES'
05/06/2014;05/06/2014;'PERRUQUERIA';-17,40 €;5.018,71 €;5411;-17,40;9.542,80 €;'sin fechas';05/06/2014;'PERRUQUERIA';'Gastos_Salud, saber y deporte';'Belleza';'VARIABLES'
05/06/2014;03/06/2014;'RESTAURANTES';-28,95 €;4.989,76 €;5412;-28,95;9.513,85 €;'sin fechas';03/06/2014;'RESTAURANTES';'Gastos_Ocio y transporte';'Restaurantes';'VARIABLES'
06/06/2014;01/06/2014;'AUTOPISTA TERR';-4,19 €;4.985,57 €;5413;-4,19;9.509,66 €;'sin fechas';01/06/2014;'AUTOPISTA';'Gastos_Ocio y transporte';'Parking y peaje';'VARIABLES'
06/06/2014;31/05/2014;'AUTOPISTA TERR';-4,19 €;4.981,38 €;5414;-4,19;9.505,47 €;'sin fechas';31/05/2014;'AUTOPISTA';'Gastos_Ocio y transporte';'Parking y peaje';'VARIABLES'
06/06/2014;06/06/2014;'BLITZ';-72,50 €;4.908,88 €;5415;-72,50;9.432,97 €;'sin fechas';06/06/2014;'BLITZ';'Gastos_Vivienda y vehiculo';'Alquiler Parking';'FIJO'
06/06/2014;06/06/2014;'CAFET.C T PRAT';-2,25 €;4.906,63 €;5416;-2,25;9.430,72 €;'sin fechas';06/06/2014;'CAFETC';'Gastos_Ocio y transporte';'Restaurantes';'VARIABLES'
06/06/2014;06/06/2014;'GAS NATURAL';-323,10 €;4.583,53 €;5417;-323,10;9.107,62 €;'sin fechas';06/06/2014;'GAS';'Gastos_Servicios tipicos';'Gas';'FIJO'
07/06/2014;07/06/2014;'CINESA HERON CITY';-53,50 €;4.530,03 €;5418;-53,50;9.054,12 €;'sin fechas';07/06/2014;'CINESA';'Gastos_Ocio y transporte';'Espectáculos';'VARIABLES'
07/06/2014;07/06/2014;'FRUITES I VERDURES';-8,45 €;4.521,58 €;5419;-8,45;9.045,67 €;'sin fechas';07/06/2014;'FRUITES';'Gastos_Compras';'Supermercado';'VARIABLES'
07/06/2014;07/06/2014;'RESTAURANTES';-12,43 €;4.509,15 €;5420;-12,43;9.033,24 €;'sin fechas';07/06/2014;'RESTAURANTES';'Gastos_Ocio y transporte';'Restaurantes';'VARIABLES'
07/06/2014;07/06/2014;'TOYOTA ORIENT CARS';-20,36 €;4.488,79 €;5421;-20,36;9.012,88 €;'sin fechas';07/06/2014;'TOYOTA';'Gastos_Vivienda y vehiculo';'Mnto. vehiculo';'VARIABLE'
07/06/2014;07/06/2014;'VIENA';-21,85 €;4.466,94 €;5422;-21,85;8.991,03 €;'sin fechas';07/06/2014;'VIENA';'Gastos_Ocio y transporte';'Restaurantes';'VARIABLES'
08/06/2014;08/06/2014;'CAFET.C T PRAT';-5,85 €;4.461,09 €;5423;-5,85;8.985,18 €;'sin fechas';08/06/2014;'CAFETC';'Gastos_Ocio y transporte';'Restaurantes';'VARIABLES'
09/06/2014;03/06/2014;'AUTOPISTA TERR';-1,39 €;4.459,70 €;5424;-1,39;8.983,79 €;'sin fechas';03/06/2014;'AUTOPISTA';'Gastos_Ocio y transporte';'Parking y peaje';'VARIABLES'
09/06/2014;03/06/2014;'AUTOPISTA TERR';-1,39 €;4.458,31 €;5425;-1,39;8.982,40 €;'sin fechas';03/06/2014;'AUTOPISTA';'Gastos_Ocio y transporte';'Parking y peaje';'VARIABLES'
09/06/2014;02/06/2014;'AUTOPISTA TERR';-1,39 €;4.456,92 €;5426;-1,39;8.981,01 €;'sin fechas';02/06/2014;'AUTOPISTA';'Gastos_Ocio y transporte';'Parking y peaje';'VARIABLES'
09/06/2014;03/06/2014;'AUTOPISTA TERR';-1,39 €;4.455,53 €;5427;-1,39;8.979,62 €;'sin fechas';03/06/2014;'AUTOPISTA';'Gastos_Ocio y transporte';'Parking y peaje';'VARIABLES'
09/06/2014;03/06/2014;'AUTOPISTA TERR';-1,39 €;4.454,14 €;5428;-1,39;8.978,23 €;'sin fechas';03/06/2014;'AUTOPISTA';'Gastos_Ocio y transporte';'Parking y peaje';'VARIABLES'
09/06/2014;02/06/2014;'AUTOPISTA TERR';-1,39 €;4.452,75 €;5429;-1,39;8.976,84 €;'sin fechas';02/06/2014;'AUTOPISTA';'Gastos_Ocio y transporte';'Parking y peaje';'VARIABLES'
09/06/2014;09/06/2014;'TACISA';-20,38 €;4.432,37 €;5430;-20,38;8.956,46 €;'sin fechas';09/06/2014;'TACISA';'Gastos_Compras';'Supermercado';'VARIABLES'
10/06/2014;10/06/2014;'1ER ORGANITZ JORNADA INTENSIVA';-50,00 €;4.382,37 €;5431;-50,00;8.906,46 €;'sin fechas';10/06/2014;'ORGANITZ';'Gastos_Salud, saber y deporte';'Estudios';'VARIABLES'
10/06/2014;04/06/2014;'AUTOPISTA TERR';-1,39 €;4.380,98 €;5432;-1,39;8.905,07 €;'sin fechas';04/06/2014;'AUTOPISTA';'Gastos_Ocio y transporte';'Parking y peaje';'VARIABLES'
10/06/2014;04/06/2014;'AUTOPISTA TERR';-1,39 €;4.379,59 €;5433;-1,39;8.903,68 €;'sin fechas';04/06/2014;'AUTOPISTA';'Gastos_Ocio y transporte';'Parking y peaje';'VARIABLES'
10/06/2014;05/06/2014;'AUTOPISTA TERR';-1,39 €;4.378,20 €;5434;-1,39;8.902,29 €;'sin fechas';05/06/2014;'AUTOPISTA';'Gastos_Ocio y transporte';'Parking y peaje';'VARIABLES'
10/06/2014;05/06/2014;'AUTOPISTA TERR';-1,39 €;4.376,81 €;5435;-1,39;8.900,90 €;'sin fechas';05/06/2014;'AUTOPISTA';'Gastos_Ocio y transporte';'Parking y peaje';'VARIABLES'
11/06/2014;08/06/2014;'AUTOPISTA TERR';-2,53 €;4.374,28 €;5436;-2,53;8.898,37 €;'sin fechas';08/06/2014;'AUTOPISTA';'Gastos_Ocio y transporte';'Parking y peaje';'VARIABLES'
11/06/2014;06/06/2014;'AUTOPISTA TERR';-1,39 €;4.372,89 €;5437;-1,39;8.896,98 €;'sin fechas';06/06/2014;'AUTOPISTA';'Gastos_Ocio y transporte';'Parking y peaje';'VARIABLES'
11/06/2014;11/06/2014;'VIENA';-9,25 €;4.363,64 €;5438;-9,25;8.887,73 €;'sin fechas';11/06/2014;'VIENA';'Gastos_Ocio y transporte';'Restaurantes';'VARIABLES'
12/06/2014;05/06/2014;'AUTOPISTA TERR';-4,19 €;4.359,45 €;5439;-4,19;8.883,54 €;'sin fechas';05/06/2014;'AUTOPISTA';'Gastos_Ocio y transporte';'Parking y peaje';'VARIABLES'
12/06/2014;12/06/2014;'BON AREA';-23,21 €;4.336,24 €;5440;-23,21;8.860,33 €;'sin fechas';12/06/2014;'BON';'Gastos_Compras';'Supermercado';'VARIABLES'
12/06/2014;12/06/2014;'BON AREA';-8,71 €;4.327,53 €;5441;-8,71;8.851,62 €;'sin fechas';12/06/2014;'BON';'Gastos_Compras';'Supermercado';'VARIABLES'
12/06/2014;10/06/2014;'ES STA. MARGARITA';-35,00 €;4.292,53 €;5442;-35,00;8.816,62 €;'sin fechas';10/06/2014;'STA';'Gastos_Ocio y transporte';'Gasolina';'VARIABLES'
12/06/2014;12/06/2014;'SALA BADRINAS - MENJADOR';-87,10 €;4.205,43 €;5443;-87,10;8.729,52 €;'sin fechas';12/06/2014;'SALA';'Gastos_Salud, saber y deporte';'Estudios';'VARIABLES'
13/06/2014;08/06/2014;'AUTOPISTA TERR';-4,19 €;4.201,24 €;5444;-4,19;8.725,33 €;'sin fechas';08/06/2014;'AUTOPISTA';'Gastos_Ocio y transporte';'Parking y peaje';'VARIABLES'
13/06/2014;07/06/2014;'AUTOPISTA TERR';-4,19 €;4.197,05 €;5445;-4,19;8.721,14 €;'sin fechas';07/06/2014;'AUTOPISTA';'Gastos_Ocio y transporte';'Parking y peaje';'VARIABLES'
13/06/2014;06/06/2014;'AUTOPISTA TERR';-4,19 €;4.192,86 €;5446;-4,19;8.716,95 €;'sin fechas';06/06/2014;'AUTOPISTA';'Gastos_Ocio y transporte';'Parking y peaje';'VARIABLES'
13/06/2014;08/06/2014;'AUTOPISTA TERR';-2,53 €;4.190,33 €;5447;-2,53;8.714,42 €;'sin fechas';08/06/2014;'AUTOPISTA';'Gastos_Ocio y transporte';'Parking y peaje';'VARIABLES'
13/06/2014;06/06/2014;'AUTOPISTA TERR';-1,39 €;4.188,94 €;5448;-1,39;8.713,03 €;'sin fechas';06/06/2014;'AUTOPISTA';'Gastos_Ocio y transporte';'Parking y peaje';'VARIABLES'
13/06/2014;06/06/2014;'AUTOPISTA TERR';-1,32 €;4.187,62 €;5449;-1,32;8.711,71 €;'sin fechas';06/06/2014;'AUTOPISTA';'Gastos_Ocio y transporte';'Parking y peaje';'VARIABLES'
14/06/2014;14/06/2014;'CAFET.C T PRAT';-4,50 €;4.183,12 €;5450;-4,50;8.707,21 €;'sin fechas';14/06/2014;'CAFETC';'Gastos_Ocio y transporte';'Restaurantes';'VARIABLES'
14/06/2014;14/06/2014;'DECATHLON';-44,86 €;4.138,26 €;5451;-44,86;8.662,35 €;'sin fechas';14/06/2014;'DECATHLON';'Gastos_Compras';'Deportivo';'VARIABLES'
14/06/2014;14/06/2014;'VIENA';-3,50 €;4.134,76 €;5452;-3,50;8.658,85 €;'sin fechas';14/06/2014;'VIENA';'Gastos_Ocio y transporte';'Restaurantes';'VARIABLES'
15/06/2014;09/06/2014;'SATSA PL. VELLA TERRASSA';-2,10 €;4.132,66 €;5453;-2,10;8.656,75 €;'sin fechas';09/06/2014;'SATSA';'Gastos_Ocio y transporte';'Parking y peaje';'VARIABLES'
16/06/2014;10/06/2014;'AUTOPISTA TERR';-1,39 €;4.131,27 €;5454;-1,39;8.655,36 €;'sin fechas';10/06/2014;'AUTOPISTA';'Gastos_Ocio y transporte';'Parking y peaje';'VARIABLES'
16/06/2014;10/06/2014;'AUTOPISTA TERR';-1,32 €;4.129,95 €;5455;-1,32;8.654,04 €;'sin fechas';10/06/2014;'AUTOPISTA';'Gastos_Ocio y transporte';'Parking y peaje';'VARIABLES'
16/06/2014;16/06/2014;'CAFET.C T PRAT';-4,10 €;4.125,85 €;5456;-4,10;8.649,94 €;'sin fechas';16/06/2014;'CAFETC';'Gastos_Ocio y transporte';'Restaurantes';'VARIABLES'
16/06/2014;16/06/2014;'FARMACIA-DIETA';-14,95 €;4.110,90 €;5457;-14,95;8.634,99 €;'sin fechas';16/06/2014;'FARMACIADIETA';'Gastos_Salud, saber y deporte';'Farmacia';'VARIABLES'
16/06/2014;16/06/2014;'SATSA PL. VELLA TERRASSA';-0,05 €;4.110,85 €;5458;-0,05;8.634,94 €;'sin fechas';16/06/2014;'SATSA';'Gastos_Ocio y transporte';'Parking y peaje';'VARIABLES'
17/06/2014;17/06/2014;'ADESLAS CENTRAL 006662671613';-110,99 €;3.999,86 €;5459;-110,99;8.523,95 €;'sin fechas';17/06/2014;'ADESLAS';'Gastos_Salud, saber y deporte';'Medico';'VARIABLES'
17/06/2014;11/06/2014;'AUTOPISTA TERR';-1,39 €;3.998,47 €;5460;-1,39;8.522,56 €;'sin fechas';11/06/2014;'AUTOPISTA';'Gastos_Ocio y transporte';'Parking y peaje';'VARIABLES'
17/06/2014;12/06/2014;'AUTOPISTA TERR';-1,32 €;3.997,15 €;5461;-1,32;8.521,24 €;'sin fechas';12/06/2014;'AUTOPISTA';'Gastos_Ocio y transporte';'Parking y peaje';'VARIABLES'
17/06/2014;12/06/2014;'AUTOPISTA TERR';-1,32 €;3.995,83 €;5462;-1,32;8.519,92 €;'sin fechas';12/06/2014;'AUTOPISTA';'Gastos_Ocio y transporte';'Parking y peaje';'VARIABLES'
17/06/2014;11/06/2014;'AUTOPISTA TERR';-1,32 €;3.994,51 €;5463;-1,32;8.518,60 €;'sin fechas';11/06/2014;'AUTOPISTA';'Gastos_Ocio y transporte';'Parking y peaje';'VARIABLES'
17/06/2014;17/06/2014;'MERKALZADOS TARRAS';-35,00 €;3.959,51 €;5464;-35,00;8.483,60 €;'sin fechas';17/06/2014;'MERKALZADOS';'Gastos_Compras';'Ropa';'VARIABLES'
17/06/2014;17/06/2014;'ONO';-116,47 €;3.843,04 €;5465;-116,47;8.367,13 €;'sin fechas';17/06/2014;'ONO';'Gastos_Servicios tipicos';'Telecomunicaciones';'FIJO'
18/06/2014;18/06/2014;'CCM VIDA Y P SEGURO PRESTAMO';-23,95 €;3.819,09 €;5466;-23,95;8.343,18 €;'sin fechas';18/06/2014;'CCM';'Gastos_Seguros';'Seguro vida';'FIJO'
18/06/2014;18/06/2014;'CCM VIDA Y PENSIO 000000493358';-18,41 €;3.800,68 €;5467;-18,41;8.324,77 €;'sin fechas';18/06/2014;'CCM';'Gastos_Seguros';'Seguro vida';'FIJO'
18/06/2014;18/06/2014;'MINA PUBLICA AIGUES T.01A75789';-33,96 €;3.766,72 €;5468;-33,96;8.290,81 €;'sin fechas';18/06/2014;'MINA';'Gastos_Servicios tipicos';'Agua';'FIJO'
19/06/2014;19/06/2014;'A.E.A.T. DEVOLUCIONES TRIBUTAR';2.274,02 €;6.040,74 €;5469;2.274,02;10.564,83 €;'sin fechas';19/06/2014;'AEAT';'Ingresos';'Devoluciones';'VARIABLES'
19/06/2014;09/06/2014;'AUTOPISTA TERR';-4,19 €;6.036,55 €;5470;-4,19;10.560,64 €;'sin fechas';09/06/2014;'AUTOPISTA';'Gastos_Ocio y transporte';'Parking y peaje';'VARIABLES'
19/06/2014;13/06/2014;'AUTOPISTA TERR';-1,39 €;6.035,16 €;5471;-1,39;10.559,25 €;'sin fechas';13/06/2014;'AUTOPISTA';'Gastos_Ocio y transporte';'Parking y peaje';'VARIABLES'
19/06/2014;13/06/2014;'AUTOPISTA TERR';-1,25 €;6.033,91 €;5472;-1,25;10.558,00 €;'sin fechas';13/06/2014;'AUTOPISTA';'Gastos_Ocio y transporte';'Parking y peaje';'VARIABLES'
19/06/2014;17/06/2014;'CAPRABO';-23,86 €;6.010,05 €;5473;-23,86;10.534,14 €;'sin fechas';17/06/2014;'CAPRABO';'Gastos_Compras';'Supermercado';'VARIABLES'
19/06/2014;19/06/2014;'CATALANA DIAG.I CIRUR';-4,10 €;6.005,95 €;5474;-4,10;10.530,04 €;'sin fechas';19/06/2014;'CATALANA';'Gastos_Ocio y transporte';'Parking y peaje';'VARIABLES'
19/06/2014;17/06/2014;'RESTAURANTES';-56,05 €;5.949,90 €;5475;-56,05;10.473,99 €;'sin fechas';17/06/2014;'RESTAURANTES';'Gastos_Ocio y transporte';'Restaurantes';'VARIABLES'
20/06/2014;15/06/2014;'AUTOPISTA TERR';-4,19 €;5.945,71 €;5476;-4,19;10.469,80 €;'sin fechas';15/06/2014;'AUTOPISTA';'Gastos_Ocio y transporte';'Parking y peaje';'VARIABLES'
20/06/2014;14/06/2014;'AUTOPISTA TERR';-4,19 €;5.941,52 €;5477;-4,19;10.465,61 €;'sin fechas';14/06/2014;'AUTOPISTA';'Gastos_Ocio y transporte';'Parking y peaje';'VARIABLES'
20/06/2014;13/06/2014;'AUTOPISTA TERR';-4,19 €;5.937,33 €;5478;-4,19;10.461,42 €;'sin fechas';13/06/2014;'AUTOPISTA';'Gastos_Ocio y transporte';'Parking y peaje';'VARIABLES'
20/06/2014;16/06/2014;'AUTOPISTA TERR';-1,39 €;5.935,94 €;5479;-1,39;10.460,03 €;'sin fechas';16/06/2014;'AUTOPISTA';'Gastos_Ocio y transporte';'Parking y peaje';'VARIABLES'
20/06/2014;16/06/2014;'AUTOPISTA TERR';-1,25 €;5.934,69 €;5480;-1,25;10.458,78 €;'sin fechas';16/06/2014;'AUTOPISTA';'Gastos_Ocio y transporte';'Parking y peaje';'VARIABLES'
20/06/2014;20/06/2014;'BON AREA';-14,27 €;5.920,42 €;5481;-14,27;10.444,51 €;'sin fechas';20/06/2014;'BON';'Gastos_Compras';'Supermercado';'VARIABLES'
20/06/2014;20/06/2014;'CAFET.C T PRAT';-2,70 €;5.917,72 €;5482;-2,70;10.441,81 €;'sin fechas';20/06/2014;'CAFETC';'Gastos_Ocio y transporte';'Restaurantes';'VARIABLES'
20/06/2014;20/06/2014;'ES STA. MARGARITA';-50,32 €;5.867,40 €;5483;-50,32;10.391,49 €;'sin fechas';20/06/2014;'STA';'Gastos_Ocio y transporte';'Gasolina';'VARIABLES'
20/06/2014;20/06/2014;'FOMENT DE TERRASSA, S.A. FOMEN';3.208,00 €;9.075,40 €;5484;3.208,00;13.599,49 €;'sin fechas';20/06/2014;'FOMENT';'Ingresos';'Nomina';'FIJO'
21/06/2014;21/06/2014;'BON AREA';-29,77 €;9.045,63 €;5485;-29,77;13.569,72 €;'sin fechas';21/06/2014;'BON';'Gastos_Compras';'Supermercado';'VARIABLES'
21/06/2014;21/06/2014;'BON AREA';-29,68 €;9.015,95 €;5486;-29,68;13.540,04 €;'sin fechas';21/06/2014;'BON';'Gastos_Compras';'Supermercado';'VARIABLES'
21/06/2014;21/06/2014;'CAFET.C T PRAT';-3,60 €;9.012,35 €;5487;-3,60;13.536,44 €;'sin fechas';21/06/2014;'CAFETC';'Gastos_Ocio y transporte';'Restaurantes';'VARIABLES'
21/06/2014;21/06/2014;'HOGAR&OTROS';-10,35 €;9.002,00 €;5488;-10,35;13.526,09 €;'sin fechas';21/06/2014;'HOGAROTROS';'Gastos_Vivienda y vehiculo';'Otros vivienda';'VARIABLES'
21/06/2014;21/06/2014;'PERRUQUERIA';-20,00 €;8.982,00 €;5489;-20,00;13.506,09 €;'sin fechas';21/06/2014;'PERRUQUERIA';'Gastos_Salud, saber y deporte';'Belleza';'VARIABLES'
22/06/2014;22/06/2014;'CAFET.C T PRAT';-3,60 €;8.978,40 €;5490;-3,60;13.502,49 €;'sin fechas';22/06/2014;'CAFETC';'Gastos_Ocio y transporte';'Restaurantes';'VARIABLES'
22/06/2014;22/06/2014;'MERCADONA';-159,92 €;8.818,48 €;5491;-159,92;13.342,57 €;'sin fechas';22/06/2014;'MERCADONA';'Gastos_Compras';'Supermercado';'VARIABLES'
22/06/2014;22/06/2014;'VIENA';-20,35 €;8.798,13 €;5492;-20,35;13.322,22 €;'sin fechas';22/06/2014;'VIENA';'Gastos_Ocio y transporte';'Restaurantes';'VARIABLES'
23/06/2014;16/06/2014;'AUTOPISTA TERR';-4,19 €;8.793,94 €;5493;-4,19;13.318,03 €;'sin fechas';16/06/2014;'AUTOPISTA';'Gastos_Ocio y transporte';'Parking y peaje';'VARIABLES'
23/06/2014;17/06/2014;'AUTOPISTA TERR';-1,39 €;8.792,55 €;5494;-1,39;13.316,64 €;'sin fechas';17/06/2014;'AUTOPISTA';'Gastos_Ocio y transporte';'Parking y peaje';'VARIABLES'
23/06/2014;17/06/2014;'AUTOPISTA TERR';-1,25 €;8.791,30 €;5495;-1,25;13.315,39 €;'sin fechas';17/06/2014;'AUTOPISTA';'Gastos_Ocio y transporte';'Parking y peaje';'VARIABLES'
23/06/2014;23/06/2014;'CAFET.C T PRAT';-3,65 €;8.787,65 €;5496;-3,65;13.311,74 €;'sin fechas';23/06/2014;'CAFETC';'Gastos_Ocio y transporte';'Restaurantes';'VARIABLES'
23/06/2014;23/06/2014;'MERKALZADOS TARRAS';-19,00 €;8.768,65 €;5497;-19,00;13.292,74 €;'sin fechas';23/06/2014;'MERKALZADOS';'Gastos_Compras';'Ropa';'VARIABLES'
23/06/2014;23/06/2014;'RESTAURANTES';-23,65 €;8.745,00 €;5498;-23,65;13.269,09 €;'sin fechas';23/06/2014;'RESTAURANTES';'Gastos_Ocio y transporte';'Restaurantes';'VARIABLES'
24/06/2014;18/06/2014;'AUTOPISTA TERR';-1,39 €;8.743,61 €;5499;-1,39;13.267,70 €;'sin fechas';18/06/2014;'AUTOPISTA';'Gastos_Ocio y transporte';'Parking y peaje';'VARIABLES'
24/06/2014;19/06/2014;'AUTOPISTA TERR';-1,39 €;8.742,22 €;5500;-1,39;13.266,31 €;'sin fechas';19/06/2014;'AUTOPISTA';'Gastos_Ocio y transporte';'Parking y peaje';'VARIABLES'
24/06/2014;19/06/2014;'AUTOPISTA TERR';-1,25 €;8.740,97 €;5501;-1,25;13.265,06 €;'sin fechas';19/06/2014;'AUTOPISTA';'Gastos_Ocio y transporte';'Parking y peaje';'VARIABLES'
24/06/2014;19/06/2014;'AUTOPISTA TERR';-1,25 €;8.739,72 €;5502;-1,25;13.263,81 €;'sin fechas';19/06/2014;'AUTOPISTA';'Gastos_Ocio y transporte';'Parking y peaje';'VARIABLES'
24/06/2014;18/06/2014;'AUTOPISTA TERR';-1,25 €;8.738,47 €;5503;-1,25;13.262,56 €;'sin fechas';18/06/2014;'AUTOPISTA';'Gastos_Ocio y transporte';'Parking y peaje';'VARIABLES'
24/06/2014;19/06/2014;'AUTOPISTA TERR';-1,25 €;8.737,22 €;5504;-1,25;13.261,31 €;'sin fechas';19/06/2014;'AUTOPISTA';'Gastos_Ocio y transporte';'Parking y peaje';'VARIABLES'
26/06/2014;19/06/2014;'AUTOPISTA TERR';-4,19 €;8.733,03 €;5505;-4,19;13.257,12 €;'sin fechas';19/06/2014;'AUTOPISTA';'Gastos_Ocio y transporte';'Parking y peaje';'VARIABLES'
26/06/2014;20/06/2014;'AUTOPISTA TERR';-1,39 €;8.731,64 €;5506;-1,39;13.255,73 €;'sin fechas';20/06/2014;'AUTOPISTA';'Gastos_Ocio y transporte';'Parking y peaje';'VARIABLES'
26/06/2014;20/06/2014;'AUTOPISTA TERR';-1,25 €;8.730,39 €;5507;-1,25;13.254,48 €;'sin fechas';20/06/2014;'AUTOPISTA';'Gastos_Ocio y transporte';'Parking y peaje';'VARIABLES'
26/06/2014;26/06/2014;'AUTOPISTA TERR';-1,39 €;8.729,00 €;5508;-1,39;13.253,09 €;'sin fechas';26/06/2014;'AUTOPISTA';'Gastos_Ocio y transporte';'Parking y peaje';'VARIABLES'
26/06/2014;26/06/2014;'CAFET.C T PRAT';-3,60 €;8.725,40 €;5509;-3,60;13.249,49 €;'sin fechas';26/06/2014;'CAFETC';'Gastos_Ocio y transporte';'Restaurantes';'VARIABLES'
26/06/2014;24/06/2014;'FARMACIA';-25,23 €;8.700,17 €;5510;-25,23;13.224,26 €;'sin fechas';24/06/2014;'FARMACIA';'Gastos_Salud, saber y deporte';'Farmacia';'VARIABLES'
26/06/2014;24/06/2014;'HOGAR&OTROS';-10,50 €;8.689,67 €;5511;-10,50;13.213,76 €;'sin fechas';24/06/2014;'HOGAROTROS';'Gastos_Vivienda y vehiculo';'Otros vivienda';'VARIABLES'
26/06/2014;26/06/2014;'MERCADONA';-26,81 €;8.662,86 €;5512;-26,81;13.186,95 €;'sin fechas';26/06/2014;'MERCADONA';'Gastos_Compras';'Supermercado';'VARIABLES'
26/06/2014;26/06/2014;'MERKALZADOS TARRAS';-19,00 €;8.643,86 €;5513;-19,00;13.167,95 €;'sin fechas';26/06/2014;'MERKALZADOS';'Gastos_Compras';'Ropa';'VARIABLES'
26/06/2014;26/06/2014;'MERKALZADOS TARRAS';-19,00 €;8.624,86 €;5514;-19,00;13.148,95 €;'sin fechas';26/06/2014;'MERKALZADOS';'Gastos_Compras';'Ropa';'VARIABLES'
26/06/2014;24/06/2014;'REDPIZZA';-16,65 €;8.608,21 €;5515;-16,65;13.132,30 €;'sin fechas';24/06/2014;'REDPIZZA';'Gastos_Ocio y transporte';'Restaurantes';'VARIABLES'
26/06/2014;26/06/2014;'SATSA PL. VELLA TERRASSA';-2,00 €;8.606,21 €;5516;-2,00;13.130,30 €;'sin fechas';26/06/2014;'SATSA';'Gastos_Ocio y transporte';'Parking y peaje';'VARIABLES'
26/06/2014;26/06/2014;'TABASA VALLVI S. C:2T';-4,19 €;8.602,02 €;5517;-4,19;13.126,11 €;'sin fechas';26/06/2014;'TABASA';'Gastos_Ocio y transporte';'Parking y peaje';'VARIABLES'
27/06/2014;22/06/2014;'AUTOPISTA TERR';-4,19 €;8.597,83 €;5518;-4,19;13.121,92 €;'sin fechas';22/06/2014;'AUTOPISTA';'Gastos_Ocio y transporte';'Parking y peaje';'VARIABLES'
27/06/2014;21/06/2014;'AUTOPISTA TERR';-4,19 €;8.593,64 €;5519;-4,19;13.117,73 €;'sin fechas';21/06/2014;'AUTOPISTA';'Gastos_Ocio y transporte';'Parking y peaje';'VARIABLES'
27/06/2014;20/06/2014;'AUTOPISTA TERR';-4,19 €;8.589,45 €;5520;-4,19;13.113,54 €;'sin fechas';20/06/2014;'AUTOPISTA';'Gastos_Ocio y transporte';'Parking y peaje';'VARIABLES'
27/06/2014;27/06/2014;'INFORMACIO I TECNOLOGIA DE CAT';1.576,66 €;10.166,11 €;5521;1.576,66;14.690,20 €;'sin fechas';27/06/2014;'INFORMACIO';'Ingresos';'Nomina';'FIJO'
27/06/2014;27/06/2014;'REINT.CAJERO';-70,00 €;10.096,11 €;5522;-70,00;14.620,20 €;'sin fechas';27/06/2014;'REINTCAJERO';'Gastos_Gastos varios';'Efectivo';'VARIABLES'
28/06/2014;28/06/2014;'CAFET.C T PRAT';-3,65 €;10.092,46 €;5523;-3,65;14.616,55 €;'sin fechas';28/06/2014;'CAFETC';'Gastos_Ocio y transporte';'Restaurantes';'VARIABLES'
30/06/2014;30/06/2014;'A.E.A.T. DEVOLUCIONES TRIBUTAR';-101,78 €;9.990,68 €;5531;-101,78;14.514,77 €;'sin fechas';30/06/2014;'AEAT';'Ingresos';'Devoluciones';'VARIABLES'
30/06/2014;23/06/2014;'AUTOPISTA TERR';-1,39 €;9.989,29 €;5532;-1,39;14.513,38 €;'sin fechas';23/06/2014;'AUTOPISTA';'Gastos_Ocio y transporte';'Parking y peaje';'VARIABLES'
30/06/2014;23/06/2014;'AUTOPISTA TERR';-1,25 €;9.988,04 €;5533;-1,25;14.512,13 €;'sin fechas';23/06/2014;'AUTOPISTA';'Gastos_Ocio y transporte';'Parking y peaje';'VARIABLES'
30/06/2014;30/06/2014;'ES STA. MARGARITA';-28,92 €;9.959,12 €;5534;-28,92;14.483,21 €;'sin fechas';30/06/2014;'STA';'Gastos_Ocio y transporte';'Gasolina';'VARIABLES'
30/06/2014;01/07/2014;'ESCOLA BRESSOL EINA';-405,97 €;9.553,15 €;5535;-405,97;14.077,24 €;'sin fechas';01/07/2014;'ESCOLA';'Gastos_Salud, saber y deporte';'Estudios';'VARIABLES'
30/06/2014;30/06/2014;'IBI';-44,87 €;9.508,28 €;5536;-44,87;14.032,37 €;'sin fechas';30/06/2014;'IBI';'Gastos_Banco y organismos';'Ayuntamiento';'FIJO'
30/06/2014;30/06/2014;'RECIBO PTMOS. 3061-0960001518';-562,73 €;8.945,55 €;5537;-562,73;13.469,64 €;'sin fechas';30/06/2014;'RECIBO';'Gastos_Banco y organismos';'Hipoteca';'FIJO'
30/06/2014;30/06/2014;'VIENA';-12,40 €;8.933,15 €;5538;-12,40;13.457,24 €;'sin fechas';30/06/2014;'VIENA';'Gastos_Ocio y transporte';'Restaurantes';'VARIABLES'
01/07/2014;25/06/2014;'AUTOPISTA TERR';-1,39 €;8.931,76 €;5539;-1,39;13.455,85 €;'sin fechas';25/06/2014;'AUTOPISTA';'Gastos_Ocio y transporte';'Parking y peaje';'VARIABLES'
01/07/2014;25/06/2014;'AUTOPISTA TERR';-1,25 €;8.930,51 €;5540;-1,25;13.454,60 €;'sin fechas';25/06/2014;'AUTOPISTA';'Gastos_Ocio y transporte';'Parking y peaje';'VARIABLES'
01/07/2014;01/07/2014;'AUTOPISTA TERR';-1,39 €;8.929,12 €;5541;-1,39;13.453,21 €;'sin fechas';01/07/2014;'AUTOPISTA';'Gastos_Ocio y transporte';'Parking y peaje';'VARIABLES'
01/07/2014;01/07/2014;'AUTOPISTA TERR';-1,39 €;8.927,73 €;5542;-1,39;13.451,82 €;'sin fechas';01/07/2014;'AUTOPISTA';'Gastos_Ocio y transporte';'Parking y peaje';'VARIABLES'
03/07/2014;27/06/2014;'AUTOPISTA TERR';-1,11 €;8.926,62 €;5544;-1,11;13.450,71 €;'sin fechas';27/06/2014;'AUTOPISTA';'Gastos_Ocio y transporte';'Parking y peaje';'VARIABLES'
03/07/2014;01/07/2014;'BON AREA';-22,07 €;8.904,55 €;5545;-22,07;13.428,64 €;'sin fechas';01/07/2014;'BON';'Gastos_Compras';'Supermercado';'VARIABLES'
03/07/2014;03/07/2014;'CAFET.C T PRAT';-3,60 €;8.900,95 €;5546;-3,60;13.425,04 €;'sin fechas';03/07/2014;'CAFETC';'Gastos_Ocio y transporte';'Restaurantes';'VARIABLES'
03/07/2014;03/07/2014;'CARREFOUR-[COMIDA]';-6,35 €;8.894,60 €;5547;-6,35;13.418,69 €;'sin fechas';03/07/2014;'CARREFOURCOMIDA';'Gastos_Compras';'Supermercado';'VARIABLES'
03/07/2014;02/07/2014;'FARMACIA';-13,71 €;8.880,89 €;5548;-13,71;13.404,98 €;'sin fechas';02/07/2014;'FARMACIA';'Gastos_Salud, saber y deporte';'Farmacia';'VARIABLES'
03/07/2014;01/07/2014;'KIABI';-124,06 €;8.756,83 €;5549;-124,06;13.280,92 €;'sin fechas';01/07/2014;'KIABI';'Gastos_Compras';'Ropa';'VARIABLES'
04/07/2014;28/06/2014;'AUTOPISTA TERR';-4,19 €;8.752,64 €;5550;-4,19;13.276,73 €;'sin fechas';28/06/2014;'AUTOPISTA';'Gastos_Ocio y transporte';'Parking y peaje';'VARIABLES'
04/07/2014;23/06/2014;'AUTOPISTA TERR';-4,19 €;8.748,45 €;5551;-4,19;13.272,54 €;'sin fechas';23/06/2014;'AUTOPISTA';'Gastos_Ocio y transporte';'Parking y peaje';'VARIABLES'
04/07/2014;04/07/2014;'BLITZ';-72,50 €;8.675,95 €;5552;-72,50;13.200,04 €;'sin fechas';04/07/2014;'BLITZ';'Gastos_Vivienda y vehiculo';'Alquiler Parking';'FIJO'
04/07/2014;04/07/2014;'BON AREA';-3,01 €;8.672,94 €;5553;-3,01;13.197,03 €;'sin fechas';04/07/2014;'BON';'Gastos_Compras';'Supermercado';'VARIABLES'
04/07/2014;04/07/2014;'CAFET.C T PRAT';-3,65 €;8.669,29 €;5554;-3,65;13.193,38 €;'sin fechas';04/07/2014;'CAFETC';'Gastos_Ocio y transporte';'Restaurantes';'VARIABLES'
04/07/2014;04/07/2014;'HOGAR&COMIDA';-10,29 €;8.659,00 €;5555;-10,29;13.183,09 €;'sin fechas';04/07/2014;'HOGARCOMIDA';'Gastos_Compras';'Supermercado';'VARIABLES'
04/07/2014;04/07/2014;'MERCADONA';-17,71 €;8.641,29 €;5556;-17,71;13.165,38 €;'sin fechas';04/07/2014;'MERCADONA';'Gastos_Compras';'Supermercado';'VARIABLES'
05/07/2014;05/07/2014;'CAFET.C T PRAT';-3,60 €;8.637,69 €;5557;-3,60;13.161,78 €;'sin fechas';05/07/2014;'CAFETC';'Gastos_Ocio y transporte';'Restaurantes';'VARIABLES'
05/07/2014;05/07/2014;'FARMACIA';-5,42 €;8.632,27 €;5558;-5,42;13.156,36 €;'sin fechas';05/07/2014;'FARMACIA';'Gastos_Salud, saber y deporte';'Farmacia';'VARIABLES'
06/07/2014;06/07/2014;'BOLIN SHIJIA, SCP';-43,45 €;8.588,82 €;5559;-43,45;13.112,91 €;'sin fechas';06/07/2014;'BOLIN';'Gastos_Ocio y transporte';'Restaurantes';'VARIABLES'
06/07/2014;06/07/2014;'CARREFOUR-[COMIDA]';-23,29 €;8.565,53 €;5560;-23,29;13.089,62 €;'sin fechas';06/07/2014;'CARREFOURCOMIDA';'Gastos_Compras';'Supermercado';'VARIABLES'
06/07/2014;06/07/2014;'ES STA. MARGARITA';-30,00 €;8.535,53 €;5561;-30,00;13.059,62 €;'sin fechas';06/07/2014;'STA';'Gastos_Ocio y transporte';'Gasolina';'VARIABLES'
06/07/2014;06/07/2014;'SATSA PL. VELLA TERRASSA';-1,70 €;8.533,83 €;5562;-1,70;13.057,92 €;'sin fechas';06/07/2014;'SATSA';'Gastos_Ocio y transporte';'Parking y peaje';'VARIABLES'
07/07/2014;07/07/2014;'AUTOPISTA TERR';-1,39 €;8.532,44 €;5563;-1,39;13.056,53 €;'sin fechas';07/07/2014;'AUTOPISTA';'Gastos_Ocio y transporte';'Parking y peaje';'VARIABLES'
07/07/2014;07/07/2014;'AUTOPISTA TERR';-1,39 €;8.531,05 €;5564;-1,39;13.055,14 €;'sin fechas';07/07/2014;'AUTOPISTA';'Gastos_Ocio y transporte';'Parking y peaje';'VARIABLES'
07/07/2014;07/07/2014;'CAFET.C T PRAT';-3,65 €;8.527,40 €;5565;-3,65;13.051,49 €;'sin fechas';07/07/2014;'CAFETC';'Gastos_Ocio y transporte';'Restaurantes';'VARIABLES'
07/07/2014;30/06/2014;'COCHE&PARKING';-5,50 €;8.521,90 €;5566;-5,50;13.045,99 €;'sin fechas';30/06/2014;'COCHEPARKING';'Gastos_Ocio y transporte';'Parking y peaje';'VARIABLES'
07/07/2014;30/06/2014;'COCHE&PARKING';-1,80 €;8.520,10 €;5567;-1,80;13.044,19 €;'sin fechas';30/06/2014;'COCHEPARKING';'Gastos_Ocio y transporte';'Parking y peaje';'VARIABLES'
07/07/2014;07/07/2014;'TABASA VALLVI S. C:2T';-4,19 €;8.515,91 €;5568;-4,19;13.040,00 €;'sin fechas';07/07/2014;'TABASA';'Gastos_Ocio y transporte';'Parking y peaje';'VARIABLES'
08/07/2014;08/07/2014;'KIABI';-124,06 €;8.391,85 €;5569;-124,06;12.915,94 €;'sin fechas';08/07/2014;'KIABI';'Gastos_Compras';'Ropa';'VARIABLES'
09/07/2014;09/07/2014;'ADESLAS CENTRAL 006662671613';-110,99 €;8.280,86 €;5570;-110,99;12.804,95 €;'sin fechas';09/07/2014;'ADESLAS';'Gastos_Salud, saber y deporte';'Medico';'VARIABLES'
10/07/2014;10/07/2014;'ES STA. MARGARITA';-30,00 €;8.250,86 €;5571;-30,00;12.774,95 €;'sin fechas';10/07/2014;'STA';'Gastos_Ocio y transporte';'Gasolina';'VARIABLES'
10/07/2014;08/07/2014;'MERCADONA';-108,39 €;8.142,47 €;5572;-108,39;12.666,56 €;'sin fechas';08/07/2014;'MERCADONA';'Gastos_Compras';'Supermercado';'VARIABLES'
11/07/2014;11/07/2014;'CAFET.C T PRAT';-3,65 €;8.138,82 €;5573;-3,65;12.662,91 €;'sin fechas';11/07/2014;'CAFETC';'Gastos_Ocio y transporte';'Restaurantes';'VARIABLES'
11/07/2014;11/07/2014;'RESTAURANTES';-42,55 €;8.096,27 €;5574;-42,55;12.620,36 €;'sin fechas';11/07/2014;'RESTAURANTES';'Gastos_Ocio y transporte';'Restaurantes';'VARIABLES'
12/07/2014;12/07/2014;'H&M';-105,34 €;7.990,93 €;5575;-105,34;12.515,02 €;'sin fechas';12/07/2014;'HM';'Gastos_Compras';'Ropa';'VARIABLES'
12/07/2014;01/07/2014;'KIABI';-124,06 €;7.866,87 €;5576;-124,06;12.390,96 €;'sin fechas';01/07/2014;'KIABI';'Gastos_Compras';'Ropa';'VARIABLES'
12/07/2014;12/07/2014;'KIABI';-41,46 €;7.825,41 €;5577;-41,46;12.349,50 €;'sin fechas';12/07/2014;'KIABI';'Gastos_Compras';'Ropa';'VARIABLES'
12/07/2014;12/07/2014;'M&S';-19,00 €;7.806,41 €;5578;-19,00;12.330,50 €;'sin fechas';12/07/2014;'MS';'Gastos_Compras';'Ropa';'VARIABLES'
12/07/2014;12/07/2014;'MERCADONA';-7,00 €;7.799,41 €;5579;-7,00;12.323,50 €;'sin fechas';12/07/2014;'MERCADONA';'Gastos_Compras';'Supermercado';'VARIABLES'
12/07/2014;12/07/2014;'RESTAURANTES';-51,79 €;7.747,62 €;5580;-51,79;12.271,71 €;'sin fechas';12/07/2014;'RESTAURANTES';'Gastos_Ocio y transporte';'Restaurantes';'VARIABLES'
12/07/2014;12/07/2014;'VIENA';-14,15 €;7.733,47 €;5581;-14,15;12.257,56 €;'sin fechas';12/07/2014;'VIENA';'Gastos_Ocio y transporte';'Restaurantes';'VARIABLES'
13/07/2014;13/07/2014;'REDPIZZA';-19,75 €;7.713,72 €;5582;-19,75;12.237,81 €;'sin fechas';13/07/2014;'REDPIZZA';'Gastos_Ocio y transporte';'Restaurantes';'VARIABLES'
14/07/2014;14/07/2014;'VIENA';-13,55 €;7.700,17 €;5583;-13,55;12.224,26 €;'sin fechas';14/07/2014;'VIENA';'Gastos_Ocio y transporte';'Restaurantes';'VARIABLES'
15/07/2014;12/07/2014;'AUTOPISTA TERR';-2,53 €;7.697,64 €;5584;-2,53;12.221,73 €;'sin fechas';12/07/2014;'AUTOPISTA';'Gastos_Ocio y transporte';'Parking y peaje';'VARIABLES'
15/07/2014;12/07/2014;'AUTOPISTA TERR';-2,53 €;7.695,11 €;5585;-2,53;12.219,20 €;'sin fechas';12/07/2014;'AUTOPISTA';'Gastos_Ocio y transporte';'Parking y peaje';'VARIABLES'
15/07/2014;15/07/2014;'MERCADONA';-32,51 €;7.662,60 €;5586;-32,51;12.186,69 €;'sin fechas';15/07/2014;'MERCADONA';'Gastos_Compras';'Supermercado';'VARIABLES'
15/07/2014;15/07/2014;'VIENA';-14,35 €;7.648,25 €;5587;-14,35;12.172,34 €;'sin fechas';15/07/2014;'VIENA';'Gastos_Ocio y transporte';'Restaurantes';'VARIABLES'
16/07/2014;16/07/2014;'CCM VIDA Y P SEGURO PRESTAMO';-24,32 €;7.623,93 €;5588;-24,32;12.148,02 €;'sin fechas';16/07/2014;'CCM';'Gastos_Seguros';'Seguro vida';'FIJO'
16/07/2014;16/07/2014;'CCM VIDA Y PENSIO 000000493358';-18,36 €;7.605,57 €;5589;-18,36;12.129,66 €;'sin fechas';16/07/2014;'CCM';'Gastos_Seguros';'Seguro vida';'FIJO'
16/07/2014;16/07/2014;'ES STA. MARGARITA';-50,78 €;7.554,79 €;5590;-50,78;12.078,88 €;'sin fechas';16/07/2014;'STA';'Gastos_Ocio y transporte';'Gasolina';'VARIABLES'
17/07/2014;17/06/2014;'ENTREGA PTMO. 3061-0960001518';-3.000,00 €;4.554,79 €;5591;-3.000,00;9.078,88 €;'sin fechas';17/06/2014;'ENTREGA';'Gastos_Banco y organismos';'Hipoteca';'FIJO'
17/07/2014;17/07/2014;'FRANKFURT LES LLETRES';-4,20 €;4.550,59 €;5592;-4,20;9.074,68 €;'sin fechas';17/07/2014;'FRANKFURT';'Gastos_Ocio y transporte';'Restaurantes';'VARIABLES'
17/07/2014;17/07/2014;'MERCADONA';-9,97 €;4.540,62 €;5593;-9,97;9.064,71 €;'sin fechas';17/07/2014;'MERCADONA';'Gastos_Compras';'Supermercado';'VARIABLES'
17/07/2014;17/07/2014;'ONO';-118,47 €;4.422,15 €;5594;-118,47;8.946,24 €;'sin fechas';17/07/2014;'ONO';'Gastos_Servicios tipicos';'Telecomunicaciones';'FIJO'
17/07/2014;17/07/2014;'REINT.CAJERO';-300,00 €;4.122,15 €;5595;-300,00;8.646,24 €;'sin fechas';17/07/2014;'REINTCAJERO';'Gastos_Gastos varios';'Efectivo';'VARIABLES'
18/07/2014;18/07/2014;'INFORMACIO I TECNOLOGIA DE CAT';1.724,45 €;5.846,60 €;5596;1.724,45;10.370,69 €;'sin fechas';18/07/2014;'INFORMACIO';'Ingresos';'Nomina';'FIJO'
20/07/2014;20/07/2014;'CAFET.C T PRAT';-3,65 €;5.842,95 €;5597;-3,65;10.367,04 €;'sin fechas';20/07/2014;'CAFETC';'Gastos_Ocio y transporte';'Restaurantes';'VARIABLES'
21/07/2014;21/07/2014;'CAFET.C T PRAT';-2,70 €;5.840,25 €;5598;-2,70;10.364,34 €;'sin fechas';21/07/2014;'CAFETC';'Gastos_Ocio y transporte';'Restaurantes';'VARIABLES'
21/07/2014;18/07/2014;'KIABI';-44,65 €;5.795,60 €;5599;-44,65;10.319,69 €;'sin fechas';18/07/2014;'KIABI';'Gastos_Compras';'Ropa';'VARIABLES'
22/07/2014;17/07/2014;'AUTOPISTA TERR';-1,39 €;5.794,21 €;5600;-1,39;10.318,30 €;'sin fechas';17/07/2014;'AUTOPISTA';'Gastos_Ocio y transporte';'Parking y peaje';'VARIABLES'
24/07/2014;24/07/2014;'DECATHLON';-22,88 €;5.771,33 €;5601;-22,88;10.295,42 €;'sin fechas';24/07/2014;'DECATHLON';'Gastos_Compras';'Deportivo';'VARIABLES'
24/07/2014;24/07/2014;'MERCADONA';-103,46 €;5.667,87 €;5602;-103,46;10.191,96 €;'sin fechas';24/07/2014;'MERCADONA';'Gastos_Compras';'Supermercado';'VARIABLES'
25/07/2014;18/07/2014;'AUTOPISTA TERR';-1,39 €;5.666,48 €;5603;-1,39;10.190,57 €;'sin fechas';18/07/2014;'AUTOPISTA';'Gastos_Ocio y transporte';'Parking y peaje';'VARIABLES'
25/07/2014;25/07/2014;'COMISIONES';-3,50 €;5.662,98 €;5604;-3,50;10.187,07 €;'sin fechas';25/07/2014;'COMISIONES';'Gastos_Banco y organismos';'Cargos banco';'FIJO'
25/07/2014;25/07/2014;'REINT.CAJERO';-40,00 €;5.622,98 €;5605;-40,00;10.147,07 €;'sin fechas';25/07/2014;'REINTCAJERO';'Gastos_Gastos varios';'Efectivo';'VARIABLES'
26/07/2014;28/07/2014;'COMISIONES';-18,00 €;5.604,98 €;5606;-18,00;10.129,07 €;'sin fechas';28/07/2014;'COMISIONES';'Gastos_Banco y organismos';'Cargos banco';'FIJO'
26/07/2014;28/07/2014;'COMISIONES';-9,00 €;5.595,98 €;5607;-9,00;10.120,07 €;'sin fechas';28/07/2014;'COMISIONES';'Gastos_Banco y organismos';'Cargos banco';'FIJO'
27/07/2014;27/07/2014;'SABECO';-30,48 €;5.565,50 €;5608;-30,48;10.089,59 €;'sin fechas';27/07/2014;'SABECO';'Gastos_Compras';'Supermercado';'VARIABLES'
28/07/2014;28/07/2014;'FOMENT DE TERRASSA, S.A. FOMEN';1.548,50 €;7.114,00 €;5609;1.548,50;11.638,09 €;'sin fechas';28/07/2014;'FOMENT';'Ingresos';'Nomina';'FIJO'
28/07/2014;21/07/2014;'TABASA VALLVI S. C:2T';-3,73 €;7.110,27 €;5610;-3,73;11.634,36 €;'sin fechas';21/07/2014;'TABASA';'Gastos_Ocio y transporte';'Parking y peaje';'VARIABLES'
29/07/2014;29/07/2014;'INFORMACIO I TECNOLOGIA DE CAT';1.576,66 €;8.686,93 €;5611;1.576,66;13.211,02 €;'sin fechas';29/07/2014;'INFORMACIO';'Ingresos';'Nomina';'FIJO'
30/07/2014;30/07/2014;'MERCADONA';-169,53 €;8.517,40 €;5617;-169,53;13.041,49 €;'sin fechas';30/07/2014;'MERCADONA';'Gastos_Compras';'Supermercado';'VARIABLES'
31/07/2014;31/07/2014;'AJUNTAMENT DE TER 850000031046';-50,38 €;8.467,02 €;5620;-50,38;12.991,11 €;'sin fechas';31/07/2014;'AJUNTAMENT';'Gastos_Banco y organismos';'Ayuntamiento';'FIJO'
31/07/2014;31/07/2014;'RECIBO PTMOS. 3061-0960001518';-406,65 €;8.060,37 €;5621;-406,65;12.584,46 €;'sin fechas';31/07/2014;'RECIBO';'Gastos_Banco y organismos';'Hipoteca';'FIJO'
31/07/2014;31/07/2014;'SABECO';-15,89 €;8.044,48 €;5622;-15,89;12.568,57 €;'sin fechas';31/07/2014;'SABECO';'Gastos_Compras';'Supermercado';'VARIABLES'
01/08/2014;01/08/2014;'BLITZ';-72,50 €;7.971,98 €;5623;-72,50;12.496,07 €;'sin fechas';01/08/2014;'BLITZ';'Gastos_Vivienda y vehiculo';'Alquiler Parking';'FIJO'
01/08/2014;01/08/2014;'OCIO&CINES';-14,00 €;7.957,98 €;5625;-14,00;12.482,07 €;'sin fechas';01/08/2014;'OCIOCINES';'Gastos_Ocio y transporte';'Espectáculos';'VARIABLES'
02/08/2014;02/08/2014;'DECATHLON';-26,79 €;7.931,19 €;5626;-26,79;12.455,28 €;'sin fechas';02/08/2014;'DECATHLON';'Gastos_Compras';'Deportivo';'VARIABLES'
02/08/2014;02/08/2014;'SABECO';-5,64 €;7.925,55 €;5627;-5,64;12.449,64 €;'sin fechas';02/08/2014;'SABECO';'Gastos_Compras';'Supermercado';'VARIABLES'
03/08/2014;03/08/2014;'FARMACIA';-10,88 €;7.914,67 €;5628;-10,88;12.438,76 €;'sin fechas';03/08/2014;'FARMACIA';'Gastos_Salud, saber y deporte';'Farmacia';'VARIABLES'
04/08/2014;04/08/2014;'ADESLAS CENTRAL 006662671613';-110,99 €;7.803,68 €;5629;-110,99;12.327,77 €;'sin fechas';04/08/2014;'ADESLAS';'Gastos_Salud, saber y deporte';'Medico';'VARIABLES'
04/08/2014;04/08/2014;'GAS NATURAL';-195,35 €;7.608,33 €;5630;-195,35;12.132,42 €;'sin fechas';04/08/2014;'GAS';'Gastos_Servicios tipicos';'Gas';'FIJO'
05/08/2014;05/08/2014;'MERCADONA';-134,28 €;7.474,05 €;5631;-134,28;11.998,14 €;'sin fechas';05/08/2014;'MERCADONA';'Gastos_Compras';'Supermercado';'VARIABLES'
07/08/2014;07/08/2014;'EMTE SERVICE, S.A.U, 1112298';-73,54 €;7.400,51 €;5632;-73,54;11.924,60 €;'sin fechas';07/08/2014;'EMTE';'Gastos_Servicios tipicos';'Otros servicios';'VARIABLES'
07/08/2014;07/08/2014;'RESTAURANTES';-13,00 €;7.387,51 €;5633;-13,00;11.911,60 €;'sin fechas';07/08/2014;'RESTAURANTES';'Gastos_Ocio y transporte';'Restaurantes';'VARIABLES'
09/08/2014;09/08/2014;'RESTAURANTES';-115,00 €;7.272,51 €;5634;-115,00;11.796,60 €;'sin fechas';09/08/2014;'RESTAURANTES';'Gastos_Ocio y transporte';'Restaurantes';'VARIABLES'
11/08/2014;11/08/2014;'HOGAR&MODA';-29,29 €;7.243,22 €;5635;-29,29;11.767,31 €;'sin fechas';11/08/2014;'HOGARMODA';'Gastos_Compras';'Ropa';'VARIABLES'
12/08/2014;12/08/2014;'OCIO&OTROS';-0,78 €;7.242,44 €;5636;-0,78;11.766,53 €;'sin fechas';12/08/2014;'OCIOOTROS';'Gastos_Ocio y transporte';'Otros ocio';'VARIABLES'
14/08/2014;13/08/2014;'ES STA. MARGARITA';-40,75 €;7.201,69 €;5637;-40,75;11.725,78 €;'sin fechas';13/08/2014;'STA';'Gastos_Ocio y transporte';'Gasolina';'VARIABLES'
15/08/2014;11/08/2014;'AUTOPISTA TERR';-1,39 €;7.200,30 €;5638;-1,39;11.724,39 €;'sin fechas';11/08/2014;'AUTOPISTA';'Gastos_Ocio y transporte';'Parking y peaje';'VARIABLES'
15/08/2014;11/08/2014;'AUTOPISTA TERR';-1,39 €;7.198,91 €;5639;-1,39;11.723,00 €;'sin fechas';11/08/2014;'AUTOPISTA';'Gastos_Ocio y transporte';'Parking y peaje';'VARIABLES'
15/08/2014;15/08/2014;'CCM VIDA Y P SEGURO PRESTAMO';-23,59 €;7.175,32 €;5640;-23,59;11.699,41 €;'sin fechas';15/08/2014;'CCM';'Gastos_Seguros';'Seguro vida';'FIJO'
15/08/2014;15/08/2014;'CCM VIDA Y PENSIO 000000493358';-17,80 €;7.157,52 €;5641;-17,80;11.681,61 €;'sin fechas';15/08/2014;'CCM';'Gastos_Seguros';'Seguro vida';'FIJO'
15/08/2014;15/08/2014;'MERCADONA';-22,13 €;7.135,39 €;5642;-22,13;11.659,48 €;'sin fechas';15/08/2014;'MERCADONA';'Gastos_Compras';'Supermercado';'VARIABLES'
15/08/2014;15/08/2014;'OCIO&OTROS';-48,56 €;7.086,83 €;5643;-48,56;11.610,92 €;'sin fechas';15/08/2014;'OCIOOTROS';'Gastos_Ocio y transporte';'Otros ocio';'VARIABLES'
15/08/2014;15/08/2014;'OCIO&OTROS';-0,78 €;7.086,05 €;5644;-0,78;11.610,14 €;'sin fechas';15/08/2014;'OCIOOTROS';'Gastos_Ocio y transporte';'Otros ocio';'VARIABLES'
15/08/2014;15/08/2014;'RESTAURANTES';-9,99 €;7.076,06 €;5645;-9,99;11.600,15 €;'sin fechas';15/08/2014;'RESTAURANTES';'Gastos_Ocio y transporte';'Restaurantes';'VARIABLES'
16/08/2014;16/08/2014;'CAFET.C T PRAT';-3,90 €;7.072,16 €;5646;-3,90;11.596,25 €;'sin fechas';16/08/2014;'CAFETC';'Gastos_Ocio y transporte';'Restaurantes';'VARIABLES'
16/08/2014;16/08/2014;'MERCADONA';-65,59 €;7.006,57 €;5647;-65,59;11.530,66 €;'sin fechas';16/08/2014;'MERCADONA';'Gastos_Compras';'Supermercado';'VARIABLES'
16/08/2014;16/08/2014;'RESTAURANTES';-25,50 €;6.981,07 €;5648;-25,50;11.505,16 €;'sin fechas';16/08/2014;'RESTAURANTES';'Gastos_Ocio y transporte';'Restaurantes';'VARIABLES'
16/08/2014;16/08/2014;'VIENA';-14,40 €;6.966,67 €;5649;-14,40;11.490,76 €;'sin fechas';16/08/2014;'VIENA';'Gastos_Ocio y transporte';'Restaurantes';'VARIABLES'
17/08/2014;17/08/2014;'ES STA. MARGARITA';-40,50 €;6.926,17 €;5650;-40,50;11.450,26 €;'sin fechas';17/08/2014;'STA';'Gastos_Ocio y transporte';'Gasolina';'VARIABLES'
17/08/2014;17/08/2014;'RESTAURANTES';-12,60 €;6.913,57 €;5651;-12,60;11.437,66 €;'sin fechas';17/08/2014;'RESTAURANTES';'Gastos_Ocio y transporte';'Restaurantes';'VARIABLES'
18/08/2014;18/08/2014;'ONO';-114,71 €;6.798,86 €;5652;-114,71;11.322,95 €;'sin fechas';18/08/2014;'ONO';'Gastos_Servicios tipicos';'Telecomunicaciones';'FIJO'
19/08/2014;17/08/2014;'AUTOPISTA TERR';-2,53 €;6.796,33 €;5653;-2,53;11.320,42 €;'sin fechas';17/08/2014;'AUTOPISTA';'Gastos_Ocio y transporte';'Parking y peaje';'VARIABLES'
19/08/2014;13/08/2014;'AUTOPISTA TERR';-1,39 €;6.794,94 €;5654;-1,39;11.319,03 €;'sin fechas';13/08/2014;'AUTOPISTA';'Gastos_Ocio y transporte';'Parking y peaje';'VARIABLES'
19/08/2014;13/08/2014;'AUTOPISTA TERR';-1,39 €;6.793,55 €;5655;-1,39;11.317,64 €;'sin fechas';13/08/2014;'AUTOPISTA';'Gastos_Ocio y transporte';'Parking y peaje';'VARIABLES'
19/08/2014;12/08/2014;'AUTOPISTA TERR';-1,39 €;6.792,16 €;5656;-1,39;11.316,25 €;'sin fechas';12/08/2014;'AUTOPISTA';'Gastos_Ocio y transporte';'Parking y peaje';'VARIABLES'
20/08/2014;17/08/2014;'AUTOPISTA TERR';-10,60 €;6.781,56 €;5657;-10,60;11.305,65 €;'sin fechas';17/08/2014;'AUTOPISTA';'Gastos_Ocio y transporte';'Parking y peaje';'VARIABLES'
20/08/2014;17/08/2014;'AUTOPISTA TERR';-7,15 €;6.774,41 €;5658;-7,15;11.298,50 €;'sin fechas';17/08/2014;'AUTOPISTA';'Gastos_Ocio y transporte';'Parking y peaje';'VARIABLES'
21/08/2014;14/08/2014;'AUTOPISTA TERR';-1,39 €;6.773,02 €;5659;-1,39;11.297,11 €;'sin fechas';14/08/2014;'AUTOPISTA';'Gastos_Ocio y transporte';'Parking y peaje';'VARIABLES'
21/08/2014;14/08/2014;'AUTOPISTA TERR';-1,39 €;6.771,63 €;5660;-1,39;11.295,72 €;'sin fechas';14/08/2014;'AUTOPISTA';'Gastos_Ocio y transporte';'Parking y peaje';'VARIABLES'
21/08/2014;14/08/2014;'AUTOPISTA TERR';-1,39 €;6.770,24 €;5661;-1,39;11.294,33 €;'sin fechas';14/08/2014;'AUTOPISTA';'Gastos_Ocio y transporte';'Parking y peaje';'VARIABLES'
21/08/2014;21/08/2014;'CAFET.C T PRAT';-3,90 €;6.766,34 €;5662;-3,90;11.290,43 €;'sin fechas';21/08/2014;'CAFETC';'Gastos_Ocio y transporte';'Restaurantes';'VARIABLES'
21/08/2014;21/08/2014;'MERCADONA';-75,52 €;6.690,82 €;5663;-75,52;11.214,91 €;'sin fechas';21/08/2014;'MERCADONA';'Gastos_Compras';'Supermercado';'VARIABLES'
21/08/2014;21/08/2014;'MERCADONA';-10,93 €;6.679,89 €;5664;-10,93;11.203,98 €;'sin fechas';21/08/2014;'MERCADONA';'Gastos_Compras';'Supermercado';'VARIABLES'
22/08/2014;18/08/2014;'AUTOPISTA TERR';-1,39 €;6.678,50 €;5665;-1,39;11.202,59 €;'sin fechas';18/08/2014;'AUTOPISTA';'Gastos_Ocio y transporte';'Parking y peaje';'VARIABLES'
22/08/2014;18/08/2014;'AUTOPISTA TERR';-1,39 €;6.677,11 €;5666;-1,39;11.201,20 €;'sin fechas';18/08/2014;'AUTOPISTA';'Gastos_Ocio y transporte';'Parking y peaje';'VARIABLES'
22/08/2014;22/08/2014;'CAFET.C T PRAT';-3,35 €;6.673,76 €;5667;-3,35;11.197,85 €;'sin fechas';22/08/2014;'CAFETC';'Gastos_Ocio y transporte';'Restaurantes';'VARIABLES'
22/08/2014;15/08/2014;'TABASA VALLVI S. C:2T';-4,19 €;6.669,57 €;5668;-4,19;11.193,66 €;'sin fechas';15/08/2014;'TABASA';'Gastos_Ocio y transporte';'Parking y peaje';'VARIABLES'
23/08/2014;19/08/2014;'AUTOPISTA TERR';-1,32 €;6.668,25 €;5669;-1,32;11.192,34 €;'sin fechas';19/08/2014;'AUTOPISTA';'Gastos_Ocio y transporte';'Parking y peaje';'VARIABLES'
23/08/2014;19/08/2014;'AUTOPISTA TERR';-1,39 €;6.666,86 €;5670;-1,39;11.190,95 €;'sin fechas';19/08/2014;'AUTOPISTA';'Gastos_Ocio y transporte';'Parking y peaje';'VARIABLES'
23/08/2014;23/08/2014;'CAFET.C T PRAT';-4,10 €;6.662,76 €;5671;-4,10;11.186,85 €;'sin fechas';23/08/2014;'CAFETC';'Gastos_Ocio y transporte';'Restaurantes';'VARIABLES'
23/08/2014;23/08/2014;'COMISIONES';-4,00 €;6.658,76 €;5672;-4,00;11.182,85 €;'sin fechas';23/08/2014;'COMISIONES';'Gastos_Banco y organismos';'Cargos banco';'FIJO'
23/08/2014;23/08/2014;'COMISIONES';-4,00 €;6.654,76 €;5673;-4,00;11.178,85 €;'sin fechas';23/08/2014;'COMISIONES';'Gastos_Banco y organismos';'Cargos banco';'FIJO'
23/08/2014;23/08/2014;'REINT.CAJERO';-100,00 €;6.554,76 €;5674;-100,00;11.078,85 €;'sin fechas';23/08/2014;'REINTCAJERO';'Gastos_Gastos varios';'Efectivo';'VARIABLES'
23/08/2014;23/08/2014;'RESTAURANTES';-36,00 €;6.518,76 €;5675;-36,00;11.042,85 €;'sin fechas';23/08/2014;'RESTAURANTES';'Gastos_Ocio y transporte';'Restaurantes';'VARIABLES'
25/08/2014;17/08/2014;'AUTOPISTA TERR';-10,60 €;6.508,16 €;5676;-10,60;11.032,25 €;'sin fechas';17/08/2014;'AUTOPISTA';'Gastos_Ocio y transporte';'Parking y peaje';'VARIABLES'
25/08/2014;17/08/2014;'AUTOPISTA TERR';-7,15 €;6.501,01 €;5677;-7,15;11.025,10 €;'sin fechas';17/08/2014;'AUTOPISTA';'Gastos_Ocio y transporte';'Parking y peaje';'VARIABLES'
25/08/2014;25/08/2014;'CAFET.C T PRAT';-3,65 €;6.497,36 €;5678;-3,65;11.021,45 €;'sin fechas';25/08/2014;'CAFETC';'Gastos_Ocio y transporte';'Restaurantes';'VARIABLES'
25/08/2014;25/08/2014;'ES STA. MARGARITA';-55,17 €;6.442,19 €;5679;-55,17;10.966,28 €;'sin fechas';25/08/2014;'STA';'Gastos_Ocio y transporte';'Gasolina';'VARIABLES'
25/08/2014;25/08/2014;'FARMACIA-DIETA';-29,95 €;6.412,24 €;5680;-29,95;10.936,33 €;'sin fechas';25/08/2014;'FARMACIADIETA';'Gastos_Salud, saber y deporte';'Farmacia';'VARIABLES'
25/08/2014;25/08/2014;'RESTAURANTES';-26,30 €;6.385,94 €;5681;-26,30;10.910,03 €;'sin fechas';25/08/2014;'RESTAURANTES';'Gastos_Ocio y transporte';'Restaurantes';'VARIABLES'
26/08/2014;21/08/2014;'AUTOPISTA TERR';-1,39 €;6.384,55 €;5682;-1,39;10.908,64 €;'sin fechas';21/08/2014;'AUTOPISTA';'Gastos_Ocio y transporte';'Parking y peaje';'VARIABLES'
26/08/2014;21/08/2014;'AUTOPISTA TERR';-1,32 €;6.383,23 €;5683;-1,32;10.907,32 €;'sin fechas';21/08/2014;'AUTOPISTA';'Gastos_Ocio y transporte';'Parking y peaje';'VARIABLES'
26/08/2014;20/08/2014;'AUTOPISTA TERR';-1,39 €;6.381,84 €;5684;-1,39;10.905,93 €;'sin fechas';20/08/2014;'AUTOPISTA';'Gastos_Ocio y transporte';'Parking y peaje';'VARIABLES'
26/08/2014;20/08/2014;'AUTOPISTA TERR';-1,32 €;6.380,52 €;5685;-1,32;10.904,61 €;'sin fechas';20/08/2014;'AUTOPISTA';'Gastos_Ocio y transporte';'Parking y peaje';'VARIABLES'
27/08/2014;27/08/2014;'FOMENT DE TERRASSA, S.A. FOMEN';2.268,02 €;8.648,54 €;5686;2.268,02;13.172,63 €;'sin fechas';27/08/2014;'FOMENT';'Ingresos';'Nomina';'FIJO'
27/08/2014;27/08/2014;'REINT.CAJERO';-60,00 €;8.588,54 €;5687;-60,00;13.112,63 €;'sin fechas';27/08/2014;'REINTCAJERO';'Gastos_Gastos varios';'Efectivo';'VARIABLES'
27/08/2014;27/08/2014;'REINT.CAJERO';-20,00 €;8.568,54 €;5688;-20,00;13.092,63 €;'sin fechas';27/08/2014;'REINTCAJERO';'Gastos_Gastos varios';'Efectivo';'VARIABLES'
28/08/2014;24/08/2014;'AUTOPISTA TERR';-2,53 €;8.566,01 €;5689;-2,53;13.090,10 €;'sin fechas';24/08/2014;'AUTOPISTA';'Gastos_Ocio y transporte';'Parking y peaje';'VARIABLES'
28/08/2014;22/08/2014;'AUTOPISTA TERR';-1,39 €;8.564,62 €;5690;-1,39;13.088,71 €;'sin fechas';22/08/2014;'AUTOPISTA';'Gastos_Ocio y transporte';'Parking y peaje';'VARIABLES'
28/08/2014;22/08/2014;'AUTOPISTA TERR';-1,32 €;8.563,30 €;5691;-1,32;13.087,39 €;'sin fechas';22/08/2014;'AUTOPISTA';'Gastos_Ocio y transporte';'Parking y peaje';'VARIABLES'
28/08/2014;22/08/2014;'AUTOPISTA TERR';-1,32 €;8.561,98 €;5692;-1,32;13.086,07 €;'sin fechas';22/08/2014;'AUTOPISTA';'Gastos_Ocio y transporte';'Parking y peaje';'VARIABLES'
28/08/2014;28/08/2014;'MERCADONA';-16,01 €;8.545,97 €;5693;-16,01;13.070,06 €;'sin fechas';28/08/2014;'MERCADONA';'Gastos_Compras';'Supermercado';'VARIABLES'
28/08/2014;28/08/2014;'VIENA';-9,45 €;8.536,52 €;5694;-9,45;13.060,61 €;'sin fechas';28/08/2014;'VIENA';'Gastos_Ocio y transporte';'Restaurantes';'VARIABLES'
29/08/2014;25/08/2014;'AUTOPISTA TERR';-1,25 €;8.535,27 €;5695;-1,25;13.059,36 €;'sin fechas';25/08/2014;'AUTOPISTA';'Gastos_Ocio y transporte';'Parking y peaje';'VARIABLES'
29/08/2014;25/08/2014;'AUTOPISTA TERR';-1,39 €;8.533,88 €;5696;-1,39;13.057,97 €;'sin fechas';25/08/2014;'AUTOPISTA';'Gastos_Ocio y transporte';'Parking y peaje';'VARIABLES'
29/08/2014;29/08/2014;'BON AREA';-6,47 €;8.527,41 €;5697;-6,47;13.051,50 €;'sin fechas';29/08/2014;'BON';'Gastos_Compras';'Supermercado';'VARIABLES'
29/08/2014;29/08/2014;'INFORMACIO I TECNOLOGIA DE CAT';1.576,66 €;10.104,07 €;5698;1.576,66;14.628,16 €;'sin fechas';29/08/2014;'INFORMACIO';'Ingresos';'Nomina';'FIJO'
29/08/2014;29/08/2014;'OCIO&CINES';-11,25 €;10.092,82 €;5699;-11,25;14.616,91 €;'sin fechas';29/08/2014;'OCIOCINES';'Gastos_Ocio y transporte';'Espectáculos';'VARIABLES'
29/08/2014;29/08/2014;'OCIO&CINES';-9,30 €;10.083,52 €;5700;-9,30;14.607,61 €;'sin fechas';29/08/2014;'OCIOCINES';'Gastos_Ocio y transporte';'Espectáculos';'VARIABLES'
29/08/2014;29/08/2014;'PERRUQUERIA';-15,90 €;10.067,62 €;5701;-15,90;14.591,71 €;'sin fechas';29/08/2014;'PERRUQUERIA';'Gastos_Salud, saber y deporte';'Belleza';'VARIABLES'
30/08/2014;30/08/2014;'IKEA';-97,63 €;9.969,99 €;5705;-97,63;14.494,08 €;'sin fechas';30/08/2014;'IKEA';'Gastos_Vivienda y vehiculo';'Mnto. hogar';'VARIABLES'
30/08/2014;30/08/2014;'IKEA';-16,60 €;9.953,39 €;5706;-16,60;14.477,48 €;'sin fechas';30/08/2014;'IKEA';'Gastos_Vivienda y vehiculo';'Mnto. hogar';'VARIABLES'
30/08/2014;30/08/2014;'REINT.CAJERO';-100,00 €;9.853,39 €;5709;-100,00;14.377,48 €;'sin fechas';30/08/2014;'REINTCAJERO';'Gastos_Gastos varios';'Efectivo';'VARIABLES'
31/08/2014;31/08/2014;'CAFET.C T PRAT';-3,55 €;9.849,84 €;5710;-3,55;14.373,93 €;'sin fechas';31/08/2014;'CAFETC';'Gastos_Ocio y transporte';'Restaurantes';'VARIABLES'
31/08/2014;31/08/2014;'ES STA. MARGARITA';-51,91 €;9.797,93 €;5711;-51,91;14.322,02 €;'sin fechas';31/08/2014;'STA';'Gastos_Ocio y transporte';'Gasolina';'VARIABLES'
31/08/2014;31/08/2014;'RECIBO PTMOS. 3061-0960001518';-547,25 €;9.250,68 €;5712;-547,25;13.774,77 €;'sin fechas';31/08/2014;'RECIBO';'Gastos_Banco y organismos';'Hipoteca';'FIJO'
31/08/2014;01/09/2014;'VIRGIN-ACTIVE';-40,00 €;9.210,68 €;5713;-40,00;13.734,77 €;'sin fechas';01/09/2014;'VIRGINACTIVE';'Gastos_Salud, saber y deporte';'Deportes';'VARIABLES'
01/09/2014;01/09/2014;'CAFET.C T PRAT';-3,65 €;9.207,03 €;5714;-3,65;13.731,12 €;'sin fechas';01/09/2014;'CAFETC';'Gastos_Ocio y transporte';'Restaurantes';'VARIABLES'
01/09/2014;01/09/2014;'CREDITO';-20,28 €;9.186,75 €;5715;-20,28;13.710,84 €;'sin fechas';01/09/2014;'CREDITO';'No computable';'Recibo Tarjeta';
01/09/2014;01/09/2014;'RESTAURANTES';-26,70 €;9.160,05 €;5716;-26,70;13.684,14 €;'sin fechas';01/09/2014;'RESTAURANTES';'Gastos_Ocio y transporte';'Restaurantes';'VARIABLES'
02/09/2014;28/08/2014;'AUTOPISTA TERR';-1,25 €;9.158,80 €;5717;-1,25;13.682,89 €;'sin fechas';28/08/2014;'AUTOPISTA';'Gastos_Ocio y transporte';'Parking y peaje';'VARIABLES'
02/09/2014;28/08/2014;'AUTOPISTA TERR';-1,25 €;9.157,55 €;5718;-1,25;13.681,64 €;'sin fechas';28/08/2014;'AUTOPISTA';'Gastos_Ocio y transporte';'Parking y peaje';'VARIABLES'
02/09/2014;27/08/2014;'AUTOPISTA TERR';-1,25 €;9.156,30 €;5719;-1,25;13.680,39 €;'sin fechas';27/08/2014;'AUTOPISTA';'Gastos_Ocio y transporte';'Parking y peaje';'VARIABLES'
02/09/2014;27/08/2014;'AUTOPISTA TERR';-1,25 €;9.155,05 €;5720;-1,25;13.679,14 €;'sin fechas';27/08/2014;'AUTOPISTA';'Gastos_Ocio y transporte';'Parking y peaje';'VARIABLES'
02/09/2014;26/08/2014;'AUTOPISTA TERR';-1,39 €;9.153,66 €;5721;-1,39;13.677,75 €;'sin fechas';26/08/2014;'AUTOPISTA';'Gastos_Ocio y transporte';'Parking y peaje';'VARIABLES'
02/09/2014;26/08/2014;'AUTOPISTA TERR';-1,25 €;9.152,41 €;5722;-1,25;13.676,50 €;'sin fechas';26/08/2014;'AUTOPISTA';'Gastos_Ocio y transporte';'Parking y peaje';'VARIABLES'
02/09/2014;02/09/2014;'ESCOLA BRESSOL EINA';-431,24 €;8.721,17 €;5723;-431,24;13.245,26 €;'sin fechas';02/09/2014;'ESCOLA';'Gastos_Salud, saber y deporte';'Estudios';'VARIABLES'
02/09/2014;02/09/2014;'TOYOTA ORIENT CARS';-324,30 €;8.396,87 €;5725;-324,30;12.920,96 €;'sin fechas';02/09/2014;'TOYOTA';'Gastos_Vivienda y vehiculo';'Mnto. vehiculo';'VARIABLE'
04/09/2014;04/09/2014;'ADESLAS CENTRAL 006662671613';-110,99 €;8.285,88 €;5726;-110,99;12.809,97 €;'sin fechas';04/09/2014;'ADESLAS';'Gastos_Salud, saber y deporte';'Medico';'VARIABLES'
04/09/2014;31/08/2014;'AUTOPISTA TERR';-2,53 €;8.283,35 €;5727;-2,53;12.807,44 €;'sin fechas';31/08/2014;'AUTOPISTA';'Gastos_Ocio y transporte';'Parking y peaje';'VARIABLES'
04/09/2014;29/08/2014;'AUTOPISTA TERR';-1,39 €;8.281,96 €;5728;-1,39;12.806,05 €;'sin fechas';29/08/2014;'AUTOPISTA';'Gastos_Ocio y transporte';'Parking y peaje';'VARIABLES'
04/09/2014;29/08/2014;'AUTOPISTA TERR';-1,25 €;8.280,71 €;5729;-1,25;12.804,80 €;'sin fechas';29/08/2014;'AUTOPISTA';'Gastos_Ocio y transporte';'Parking y peaje';'VARIABLES'
04/09/2014;29/08/2014;'AUTOPISTA TERR';-1,25 €;8.279,46 €;5730;-1,25;12.803,55 €;'sin fechas';29/08/2014;'AUTOPISTA';'Gastos_Ocio y transporte';'Parking y peaje';'VARIABLES'
04/09/2014;25/08/2014;'AUTOPISTA TERR';-10,60 €;8.268,86 €;5731;-10,60;12.792,95 €;'sin fechas';25/08/2014;'AUTOPISTA';'Gastos_Ocio y transporte';'Parking y peaje';'VARIABLES'
04/09/2014;25/08/2014;'AUTOPISTA TERR';-7,15 €;8.261,71 €;5732;-7,15;12.785,80 €;'sin fechas';25/08/2014;'AUTOPISTA';'Gastos_Ocio y transporte';'Parking y peaje';'VARIABLES'
04/09/2014;27/08/2014;'AUTOPISTA TERR';-7,15 €;8.254,56 €;5733;-7,15;12.778,65 €;'sin fechas';27/08/2014;'AUTOPISTA';'Gastos_Ocio y transporte';'Parking y peaje';'VARIABLES'
04/09/2014;27/08/2014;'AUTOPISTA TERR';-10,60 €;8.243,96 €;5734;-10,60;12.768,05 €;'sin fechas';27/08/2014;'AUTOPISTA';'Gastos_Ocio y transporte';'Parking y peaje';'VARIABLES'
04/09/2014;04/09/2014;'DECATHLON';-100,49 €;8.143,47 €;5735;-100,49;12.667,56 €;'sin fechas';04/09/2014;'DECATHLON';'Gastos_Compras';'Deportivo';'VARIABLES'
04/09/2014;04/09/2014;'OCIO&CINES';-8,40 €;8.135,07 €;5736;-8,40;12.659,16 €;'sin fechas';04/09/2014;'OCIOCINES';'Gastos_Ocio y transporte';'Espectáculos';'VARIABLES'
04/09/2014;04/09/2014;'OCIO&CINES';-18,10 €;8.116,97 €;5737;-18,10;12.641,06 €;'sin fechas';04/09/2014;'OCIOCINES';'Gastos_Ocio y transporte';'Espectáculos';'VARIABLES'
04/09/2014;03/09/2014;'RESTAURANTES';-4,80 €;8.112,17 €;5738;-4,80;12.636,26 €;'sin fechas';03/09/2014;'RESTAURANTES';'Gastos_Ocio y transporte';'Restaurantes';'VARIABLES'
05/09/2014;01/09/2014;'AUTOPISTA TERR';-6,08 €;8.106,09 €;5739;-6,08;12.630,18 €;'sin fechas';01/09/2014;'AUTOPISTA';'Gastos_Ocio y transporte';'Parking y peaje';'VARIABLES'
05/09/2014;05/09/2014;'CAFET.C T PRAT';-5,00 €;8.101,09 €;5740;-5,00;12.625,18 €;'sin fechas';05/09/2014;'CAFETC';'Gastos_Ocio y transporte';'Restaurantes';'VARIABLES'
05/09/2014;28/08/2014;'COCHE&PARKING';-5,65 €;8.095,44 €;5741;-5,65;12.619,53 €;'sin fechas';28/08/2014;'COCHEPARKING';'Gastos_Ocio y transporte';'Parking y peaje';'VARIABLES'
05/09/2014;05/09/2014;'ES STA. MARGARITA';-30,00 €;8.065,44 €;5742;-30,00;12.589,53 €;'sin fechas';05/09/2014;'STA';'Gastos_Ocio y transporte';'Gasolina';'VARIABLES'
06/09/2014;02/09/2014;'AUTOPISTA TERR';-1,39 €;8.064,05 €;5743;-1,39;12.588,14 €;'sin fechas';02/09/2014;'AUTOPISTA';'Gastos_Ocio y transporte';'Parking y peaje';'VARIABLES'
06/09/2014;02/09/2014;'AUTOPISTA TERR';-1,39 €;8.062,66 €;5744;-1,39;12.586,75 €;'sin fechas';02/09/2014;'AUTOPISTA';'Gastos_Ocio y transporte';'Parking y peaje';'VARIABLES'
06/09/2014;01/09/2014;'AUTOPISTA TERR';-1,39 €;8.061,27 €;5745;-1,39;12.585,36 €;'sin fechas';01/09/2014;'AUTOPISTA';'Gastos_Ocio y transporte';'Parking y peaje';'VARIABLES'
06/09/2014;01/09/2014;'AUTOPISTA TERR';-1,39 €;8.059,88 €;5746;-1,39;12.583,97 €;'sin fechas';01/09/2014;'AUTOPISTA';'Gastos_Ocio y transporte';'Parking y peaje';'VARIABLES'
06/09/2014;06/09/2014;'BOLIN SHIJIA, SCP';-22,10 €;8.037,78 €;5747;-22,10;12.561,87 €;'sin fechas';06/09/2014;'BOLIN';'Gastos_Ocio y transporte';'Restaurantes';'VARIABLES'
06/09/2014;06/09/2014;'CAFET.C T PRAT';-4,10 €;8.033,68 €;5748;-4,10;12.557,77 €;'sin fechas';06/09/2014;'CAFETC';'Gastos_Ocio y transporte';'Restaurantes';'VARIABLES'
06/09/2014;06/09/2014;'EROSKI-[OTROS]';-132,42 €;7.901,26 €;5749;-132,42;12.425,35 €;'sin fechas';06/09/2014;'EROSKIOTROS';'Gastos_Compras';'Supermercado';'VARIABLES'
07/09/2014;07/09/2014;'CAFET.C T PRAT';-3,05 €;7.898,21 €;5750;-3,05;12.422,30 €;'sin fechas';07/09/2014;'CAFETC';'Gastos_Ocio y transporte';'Restaurantes';'VARIABLES'
07/09/2014;07/09/2014;'VIENA';-13,30 €;7.884,91 €;5751;-13,30;12.409,00 €;'sin fechas';07/09/2014;'VIENA';'Gastos_Ocio y transporte';'Restaurantes';'VARIABLES'
08/09/2014;03/09/2014;'AUTOPISTA TERR';-6,08 €;7.878,83 €;5752;-6,08;12.402,92 €;'sin fechas';03/09/2014;'AUTOPISTA';'Gastos_Ocio y transporte';'Parking y peaje';'VARIABLES'
08/09/2014;08/09/2014;'CAFET.C T PRAT';-3,55 €;7.875,28 €;5753;-3,55;12.399,37 €;'sin fechas';08/09/2014;'CAFETC';'Gastos_Ocio y transporte';'Restaurantes';'VARIABLES'
08/09/2014;07/09/2014;'MERCADONA';-108,60 €;7.766,68 €;5754;-108,60;12.290,77 €;'sin fechas';07/09/2014;'MERCADONA';'Gastos_Compras';'Supermercado';'VARIABLES'
09/09/2014;04/09/2014;'AUTOPISTA TERR';-1,39 €;7.765,29 €;5755;-1,39;12.289,38 €;'sin fechas';04/09/2014;'AUTOPISTA';'Gastos_Ocio y transporte';'Parking y peaje';'VARIABLES'
09/09/2014;04/09/2014;'AUTOPISTA TERR';-1,39 €;7.763,90 €;5756;-1,39;12.287,99 €;'sin fechas';04/09/2014;'AUTOPISTA';'Gastos_Ocio y transporte';'Parking y peaje';'VARIABLES'
09/09/2014;03/09/2014;'AUTOPISTA TERR';-1,39 €;7.762,51 €;5757;-1,39;12.286,60 €;'sin fechas';03/09/2014;'AUTOPISTA';'Gastos_Ocio y transporte';'Parking y peaje';'VARIABLES'
09/09/2014;03/09/2014;'AUTOPISTA TERR';-1,39 €;7.761,12 €;5758;-1,39;12.285,21 €;'sin fechas';03/09/2014;'AUTOPISTA';'Gastos_Ocio y transporte';'Parking y peaje';'VARIABLES'
09/09/2014;09/09/2014;'BLITZ';-72,50 €;7.688,62 €;5759;-72,50;12.212,71 €;'sin fechas';09/09/2014;'BLITZ';'Gastos_Vivienda y vehiculo';'Alquiler Parking';'FIJO'
09/09/2014;09/09/2014;'REINT.CAJERO';-50,00 €;7.638,62 €;5760;-50,00;12.162,71 €;'sin fechas';09/09/2014;'REINTCAJERO';'Gastos_Gastos varios';'Efectivo';'VARIABLES'
11/09/2014;07/09/2014;'AUTOPISTA TERR';-2,53 €;7.636,09 €;5761;-2,53;12.160,18 €;'sin fechas';07/09/2014;'AUTOPISTA';'Gastos_Ocio y transporte';'Parking y peaje';'VARIABLES'
11/09/2014;07/09/2014;'AUTOPISTA TERR';-2,53 €;7.633,56 €;5762;-2,53;12.157,65 €;'sin fechas';07/09/2014;'AUTOPISTA';'Gastos_Ocio y transporte';'Parking y peaje';'VARIABLES'
11/09/2014;05/09/2014;'AUTOPISTA TERR';-1,39 €;7.632,17 €;5763;-1,39;12.156,26 €;'sin fechas';05/09/2014;'AUTOPISTA';'Gastos_Ocio y transporte';'Parking y peaje';'VARIABLES'
11/09/2014;05/09/2014;'AUTOPISTA TERR';-1,39 €;7.630,78 €;5764;-1,39;12.154,87 €;'sin fechas';05/09/2014;'AUTOPISTA';'Gastos_Ocio y transporte';'Parking y peaje';'VARIABLES'
11/09/2014;01/09/2014;'AUTOPISTA TERR';-10,60 €;7.620,18 €;5765;-10,60;12.144,27 €;'sin fechas';01/09/2014;'AUTOPISTA';'Gastos_Ocio y transporte';'Parking y peaje';'VARIABLES'
11/09/2014;03/09/2014;'AUTOPISTA TERR';-10,60 €;7.609,58 €;5766;-10,60;12.133,67 €;'sin fechas';03/09/2014;'AUTOPISTA';'Gastos_Ocio y transporte';'Parking y peaje';'VARIABLES'
11/09/2014;11/09/2014;'CAFET.C T PRAT';-4,10 €;7.605,48 €;5767;-4,10;12.129,57 €;'sin fechas';11/09/2014;'CAFETC';'Gastos_Ocio y transporte';'Restaurantes';'VARIABLES'
11/09/2014;10/09/2014;'ES STA. MARGARITA';-30,00 €;7.575,48 €;5768;-30,00;12.099,57 €;'sin fechas';10/09/2014;'STA';'Gastos_Ocio y transporte';'Gasolina';'VARIABLES'
11/09/2014;11/09/2014;'FARMACIA-DIETA';-48,30 €;7.527,18 €;5769;-48,30;12.051,27 €;'sin fechas';11/09/2014;'FARMACIADIETA';'Gastos_Salud, saber y deporte';'Farmacia';'VARIABLES'
11/09/2014;11/09/2014;'MERCADONA';-17,56 €;7.509,62 €;5770;-17,56;12.033,71 €;'sin fechas';11/09/2014;'MERCADONA';'Gastos_Compras';'Supermercado';'VARIABLES'
11/09/2014;10/09/2014;'RESTAURANTES';-5,70 €;7.503,92 €;5771;-5,70;12.028,01 €;'sin fechas';10/09/2014;'RESTAURANTES';'Gastos_Ocio y transporte';'Restaurantes';'VARIABLES'
11/09/2014;09/09/2014;'VIENA';-26,30 €;7.477,62 €;5772;-26,30;12.001,71 €;'sin fechas';09/09/2014;'VIENA';'Gastos_Ocio y transporte';'Restaurantes';'VARIABLES'
12/09/2014;08/09/2014;'AUTOPISTA TERR';-1,39 €;7.476,23 €;5773;-1,39;12.000,32 €;'sin fechas';08/09/2014;'AUTOPISTA';'Gastos_Ocio y transporte';'Parking y peaje';'VARIABLES'
12/09/2014;08/09/2014;'AUTOPISTA TERR';-1,32 €;7.474,91 €;5774;-1,32;11.999,00 €;'sin fechas';08/09/2014;'AUTOPISTA';'Gastos_Ocio y transporte';'Parking y peaje';'VARIABLES'
12/09/2014;12/09/2014;'CAFET.C T PRAT';-2,90 €;7.472,01 €;5775;-2,90;11.996,10 €;'sin fechas';12/09/2014;'CAFETC';'Gastos_Ocio y transporte';'Restaurantes';'VARIABLES'
13/09/2014;09/09/2014;'AUTOPISTA TERR';-1,32 €;7.470,69 €;5776;-1,32;11.994,78 €;'sin fechas';09/09/2014;'AUTOPISTA';'Gastos_Ocio y transporte';'Parking y peaje';'VARIABLES'
13/09/2014;09/09/2014;'AUTOPISTA TERR';-1,32 €;7.469,37 €;5777;-1,32;11.993,46 €;'sin fechas';09/09/2014;'AUTOPISTA';'Gastos_Ocio y transporte';'Parking y peaje';'VARIABLES'
13/09/2014;13/09/2014;'BON AREA';-7,55 €;7.461,82 €;5778;-7,55;11.985,91 €;'sin fechas';13/09/2014;'BON';'Gastos_Compras';'Supermercado';'VARIABLES'
13/09/2014;13/09/2014;'CAFET.C T PRAT';-2,85 €;7.458,97 €;5779;-2,85;11.983,06 €;'sin fechas';13/09/2014;'CAFETC';'Gastos_Ocio y transporte';'Restaurantes';'VARIABLES'
13/09/2014;13/09/2014;'FRUITES I VERDURES';-3,63 €;7.455,34 €;5780;-3,63;11.979,43 €;'sin fechas';13/09/2014;'FRUITES';'Gastos_Compras';'Supermercado';'VARIABLES'
15/09/2014;15/09/2014;'CAFET.C T PRAT';-3,45 €;7.451,89 €;5781;-3,45;11.975,98 €;'sin fechas';15/09/2014;'CAFETC';'Gastos_Ocio y transporte';'Restaurantes';'VARIABLES'
15/09/2014;15/09/2014;'FARMACIA-DIETA';-33,45 €;7.418,44 €;5782;-33,45;11.942,53 €;'sin fechas';15/09/2014;'FARMACIADIETA';'Gastos_Salud, saber y deporte';'Farmacia';'VARIABLES'
15/09/2014;15/09/2014;'HOGAR&OTROS';-547,00 €;6.871,44 €;5783;-547,00;11.395,53 €;'sin fechas';15/09/2014;'HOGAROTROS';'Gastos_Vivienda y vehiculo';'Otros vivienda';'VARIABLES'
15/09/2014;15/09/2014;'IKEA';-5,90 €;6.865,54 €;5784;-5,90;11.389,63 €;'sin fechas';15/09/2014;'IKEA';'Gastos_Vivienda y vehiculo';'Mnto. hogar';'VARIABLES'
15/09/2014;15/09/2014;'REINT.CAJERO';-20,00 €;6.845,54 €;5785;-20,00;11.369,63 €;'sin fechas';15/09/2014;'REINTCAJERO';'Gastos_Gastos varios';'Efectivo';'VARIABLES'
15/09/2014;15/09/2014;'REINT.CAJERO';-20,00 €;6.825,54 €;5786;-20,00;11.349,63 €;'sin fechas';15/09/2014;'REINTCAJERO';'Gastos_Gastos varios';'Efectivo';'VARIABLES'
15/09/2014;15/09/2014;'VIENA';-20,45 €;6.805,09 €;5787;-20,45;11.329,18 €;'sin fechas';15/09/2014;'VIENA';'Gastos_Ocio y transporte';'Restaurantes';'VARIABLES'
16/09/2014;10/09/2014;'AUTOPISTA TERR';-1,39 €;6.803,70 €;5788;-1,39;11.327,79 €;'sin fechas';10/09/2014;'AUTOPISTA';'Gastos_Ocio y transporte';'Parking y peaje';'VARIABLES'
16/09/2014;10/09/2014;'AUTOPISTA TERR';-1,32 €;6.802,38 €;5789;-1,32;11.326,47 €;'sin fechas';10/09/2014;'AUTOPISTA';'Gastos_Ocio y transporte';'Parking y peaje';'VARIABLES'
17/09/2014;17/09/2014;'CCM VIDA Y P SEGURO PRESTAMO';-23,51 €;6.778,87 €;5790;-23,51;11.302,96 €;'sin fechas';17/09/2014;'CCM';'Gastos_Seguros';'Seguro vida';'FIJO'
17/09/2014;17/09/2014;'CCM VIDA Y PENSIO 000000493358';-17,75 €;6.761,12 €;5791;-17,75;11.285,21 €;'sin fechas';17/09/2014;'CCM';'Gastos_Seguros';'Seguro vida';'FIJO'
17/09/2014;17/09/2014;'FRANKFURT LES LLETRES';-4,70 €;6.756,42 €;5792;-4,70;11.280,51 €;'sin fechas';17/09/2014;'FRANKFURT';'Gastos_Ocio y transporte';'Restaurantes';'VARIABLES'
17/09/2014;17/09/2014;'MINA PUBLICA AIGUES T.01A75789';-33,01 €;6.723,41 €;5793;-33,01;11.247,50 €;'sin fechas';17/09/2014;'MINA';'Gastos_Servicios tipicos';'Agua';'FIJO'
17/09/2014;17/09/2014;'ONO';-115,66 €;6.607,75 €;5794;-115,66;11.131,84 €;'sin fechas';17/09/2014;'ONO';'Gastos_Servicios tipicos';'Telecomunicaciones';'FIJO'
18/09/2014;12/09/2014;'AUTOPISTA TERR';-1,39 €;6.606,36 €;5795;-1,39;11.130,45 €;'sin fechas';12/09/2014;'AUTOPISTA';'Gastos_Ocio y transporte';'Parking y peaje';'VARIABLES'
18/09/2014;12/09/2014;'AUTOPISTA TERR';-1,32 €;6.605,04 €;5796;-1,32;11.129,13 €;'sin fechas';12/09/2014;'AUTOPISTA';'Gastos_Ocio y transporte';'Parking y peaje';'VARIABLES'
18/09/2014;18/09/2014;'CAFET.C T PRAT';-3,30 €;6.601,74 €;5797;-3,30;11.125,83 €;'sin fechas';18/09/2014;'CAFETC';'Gastos_Ocio y transporte';'Restaurantes';'VARIABLES'
18/09/2014;18/09/2014;'EROSKI-[Comida]';-34,79 €;6.566,95 €;5798;-34,79;11.091,04 €;'sin fechas';18/09/2014;'EROSKICOMIDA';'Gastos_Compras';'Supermercado';'VARIABLES'
18/09/2014;18/09/2014;'ES STA. MARGARITA';-40,78 €;6.526,17 €;5799;-40,78;11.050,26 €;'sin fechas';18/09/2014;'STA';'Gastos_Ocio y transporte';'Gasolina';'VARIABLES'
18/09/2014;18/09/2014;'FRANKFURT LES LLETRES';-4,35 €;6.521,82 €;5800;-4,35;11.045,91 €;'sin fechas';18/09/2014;'FRANKFURT';'Gastos_Ocio y transporte';'Restaurantes';'VARIABLES'
18/09/2014;16/09/2014;'MERCADONA';-0,90 €;6.520,92 €;5801;-0,90;11.045,01 €;'sin fechas';16/09/2014;'MERCADONA';'Gastos_Compras';'Supermercado';'VARIABLES'
18/09/2014;18/09/2014;'VIENA';-15,80 €;6.505,12 €;5802;-15,80;11.029,21 €;'sin fechas';18/09/2014;'VIENA';'Gastos_Ocio y transporte';'Restaurantes';'VARIABLES'
19/09/2014;15/09/2014;'AUTOPISTA TERR';-1,25 €;6.503,87 €;5803;-1,25;11.027,96 €;'sin fechas';15/09/2014;'AUTOPISTA';'Gastos_Ocio y transporte';'Parking y peaje';'VARIABLES'
19/09/2014;15/09/2014;'AUTOPISTA TERR';-1,39 €;6.502,48 €;5804;-1,39;11.026,57 €;'sin fechas';15/09/2014;'AUTOPISTA';'Gastos_Ocio y transporte';'Parking y peaje';'VARIABLES'
19/09/2014;19/09/2014;'CAFET.C T PRAT';-3,45 €;6.499,03 €;5805;-3,45;11.023,12 €;'sin fechas';19/09/2014;'CAFETC';'Gastos_Ocio y transporte';'Restaurantes';'VARIABLES'
19/09/2014;19/09/2014;'CAPRABO';-9,41 €;6.489,62 €;5806;-9,41;11.013,71 €;'sin fechas';19/09/2014;'CAPRABO';'Gastos_Compras';'Supermercado';'VARIABLES'
19/09/2014;12/09/2014;'COCHE&PARKING';-2,85 €;6.486,77 €;5807;-2,85;11.010,86 €;'sin fechas';12/09/2014;'COCHEPARKING';'Gastos_Ocio y transporte';'Parking y peaje';'VARIABLES'
19/09/2014;19/09/2014;'RESTAURANTES';-6,20 €;6.480,57 €;5808;-6,20;11.004,66 €;'sin fechas';19/09/2014;'RESTAURANTES';'Gastos_Ocio y transporte';'Restaurantes';'VARIABLES'
20/09/2014;16/09/2014;'AUTOPISTA TERR';-1,25 €;6.479,32 €;5809;-1,25;11.003,41 €;'sin fechas';16/09/2014;'AUTOPISTA';'Gastos_Ocio y transporte';'Parking y peaje';'VARIABLES'
20/09/2014;16/09/2014;'AUTOPISTA TERR';-1,25 €;6.478,07 €;5810;-1,25;11.002,16 €;'sin fechas';16/09/2014;'AUTOPISTA';'Gastos_Ocio y transporte';'Parking y peaje';'VARIABLES'
20/09/2014;20/09/2014;'CAFET.C T PRAT';-3,90 €;6.474,17 €;5811;-3,90;10.998,26 €;'sin fechas';20/09/2014;'CAFETC';'Gastos_Ocio y transporte';'Restaurantes';'VARIABLES'
20/09/2014;20/09/2014;'FRUITES I VERDURES';-7,85 €;6.466,32 €;5812;-7,85;10.990,41 €;'sin fechas';20/09/2014;'FRUITES';'Gastos_Compras';'Supermercado';'VARIABLES'
20/09/2014;20/09/2014;'HOGAR&OTROS';-10,75 €;6.455,57 €;5813;-10,75;10.979,66 €;'sin fechas';20/09/2014;'HOGAROTROS';'Gastos_Vivienda y vehiculo';'Otros vivienda';'VARIABLES'
20/09/2014;20/09/2014;'HOGAR&OTROS';-20,30 €;6.435,27 €;5814;-20,30;10.959,36 €;'sin fechas';20/09/2014;'HOGAROTROS';'Gastos_Vivienda y vehiculo';'Otros vivienda';'VARIABLES'
20/09/2014;20/09/2014;'TRANSPORTS MUNICIP';-18,00 €;6.417,27 €;5815;-18,00;10.941,36 €;'sin fechas';20/09/2014;'TRANSPORTS';'Gastos_Ocio y transporte';'Transporte';'VARIABLES'
20/09/2014;20/09/2014;'VIENA';-3,30 €;6.413,97 €;5816;-3,30;10.938,06 €;'sin fechas';20/09/2014;'VIENA';'Gastos_Ocio y transporte';'Restaurantes';'VARIABLES'
21/09/2014;21/09/2014;'BON AREA';-31,52 €;6.382,45 €;5817;-31,52;10.906,54 €;'sin fechas';21/09/2014;'BON';'Gastos_Compras';'Supermercado';'VARIABLES'
21/09/2014;21/09/2014;'CAFET.C T PRAT';-3,15 €;6.379,30 €;5818;-3,15;10.903,39 €;'sin fechas';21/09/2014;'CAFETC';'Gastos_Ocio y transporte';'Restaurantes';'VARIABLES'
21/09/2014;21/09/2014;'CARREFOUR-[COMIDA]';-34,45 €;6.344,85 €;5819;-34,45;10.868,94 €;'sin fechas';21/09/2014;'CARREFOURCOMIDA';'Gastos_Compras';'Supermercado';'VARIABLES'
21/09/2014;21/09/2014;'REINT.CAJERO';-20,00 €;6.324,85 €;5820;-20,00;10.848,94 €;'sin fechas';21/09/2014;'REINTCAJERO';'Gastos_Gastos varios';'Efectivo';'VARIABLES'
22/09/2014;22/09/2014;'CAFET.C T PRAT';-4,10 €;6.320,75 €;5821;-4,10;10.844,84 €;'sin fechas';22/09/2014;'CAFETC';'Gastos_Ocio y transporte';'Restaurantes';'VARIABLES'
22/09/2014;22/09/2014;'FRUITES I VERDURES';-7,10 €;6.313,65 €;5822;-7,10;10.837,74 €;'sin fechas';22/09/2014;'FRUITES';'Gastos_Compras';'Supermercado';'VARIABLES'
22/09/2014;22/09/2014;'REINT.CAJERO';-20,00 €;6.293,65 €;5823;-20,00;10.817,74 €;'sin fechas';22/09/2014;'REINTCAJERO';'Gastos_Gastos varios';'Efectivo';'VARIABLES'
23/09/2014;18/09/2014;'AUTOPISTA TERR';-1,25 €;6.292,40 €;5824;-1,25;10.816,49 €;'sin fechas';18/09/2014;'AUTOPISTA';'Gastos_Ocio y transporte';'Parking y peaje';'VARIABLES'
23/09/2014;18/09/2014;'AUTOPISTA TERR';-1,25 €;6.291,15 €;5825;-1,25;10.815,24 €;'sin fechas';18/09/2014;'AUTOPISTA';'Gastos_Ocio y transporte';'Parking y peaje';'VARIABLES'
23/09/2014;17/09/2014;'AUTOPISTA TERR';-1,25 €;6.289,90 €;5826;-1,25;10.813,99 €;'sin fechas';17/09/2014;'AUTOPISTA';'Gastos_Ocio y transporte';'Parking y peaje';'VARIABLES'
23/09/2014;17/09/2014;'AUTOPISTA TERR';-1,39 €;6.288,51 €;5827;-1,39;10.812,60 €;'sin fechas';17/09/2014;'AUTOPISTA';'Gastos_Ocio y transporte';'Parking y peaje';'VARIABLES'
25/09/2014;19/09/2014;'AUTOPISTA TERR';-1,25 €;6.287,26 €;5828;-1,25;10.811,35 €;'sin fechas';19/09/2014;'AUTOPISTA';'Gastos_Ocio y transporte';'Parking y peaje';'VARIABLES'
25/09/2014;19/09/2014;'AUTOPISTA TERR';-1,25 €;6.286,01 €;5829;-1,25;10.810,10 €;'sin fechas';19/09/2014;'AUTOPISTA';'Gastos_Ocio y transporte';'Parking y peaje';'VARIABLES'
25/09/2014;25/09/2014;'BON AREA';-21,91 €;6.264,10 €;5830;-21,91;10.788,19 €;'sin fechas';25/09/2014;'BON';'Gastos_Compras';'Supermercado';'VARIABLES'
25/09/2014;25/09/2014;'CAFET.C T PRAT';-3,90 €;6.260,20 €;5831;-3,90;10.784,29 €;'sin fechas';25/09/2014;'CAFETC';'Gastos_Ocio y transporte';'Restaurantes';'VARIABLES'
25/09/2014;25/09/2014;'FRUITES I VERDURES';-3,25 €;6.256,95 €;5832;-3,25;10.781,04 €;'sin fechas';25/09/2014;'FRUITES';'Gastos_Compras';'Supermercado';'VARIABLES'
26/09/2014;22/09/2014;'AUTOPISTA TERR';-1,25 €;6.255,70 €;5833;-1,25;10.779,79 €;'sin fechas';22/09/2014;'AUTOPISTA';'Gastos_Ocio y transporte';'Parking y peaje';'VARIABLES'
26/09/2014;22/09/2014;'AUTOPISTA TERR';-1,39 €;6.254,31 €;5834;-1,39;10.778,40 €;'sin fechas';22/09/2014;'AUTOPISTA';'Gastos_Ocio y transporte';'Parking y peaje';'VARIABLES'
26/09/2014;22/09/2014;'AUTOPISTA TERR';-1,25 €;6.253,06 €;5835;-1,25;10.777,15 €;'sin fechas';22/09/2014;'AUTOPISTA';'Gastos_Ocio y transporte';'Parking y peaje';'VARIABLES'
26/09/2014;22/09/2014;'AUTOPISTA TERR';-1,39 €;6.251,67 €;5836;-1,39;10.775,76 €;'sin fechas';22/09/2014;'AUTOPISTA';'Gastos_Ocio y transporte';'Parking y peaje';'VARIABLES'
26/09/2014;26/09/2014;'CAFET.C T PRAT';-2,90 €;6.248,77 €;5837;-2,90;10.772,86 €;'sin fechas';26/09/2014;'CAFETC';'Gastos_Ocio y transporte';'Restaurantes';'VARIABLES'
26/09/2014;26/09/2014;'FOMENT DE TERRASSA, S.A. FOMEN';1.524,04 €;7.772,81 €;5838;1.524,04;12.296,90 €;'sin fechas';26/09/2014;'FOMENT';'Ingresos';'Nomina';'FIJO'
26/09/2014;26/09/2014;'FRUITES I VERDURES';-4,92 €;7.767,89 €;5839;-4,92;12.291,98 €;'sin fechas';26/09/2014;'FRUITES';'Gastos_Compras';'Supermercado';'VARIABLES'
27/09/2014;27/09/2014;'BON AREA';-18,96 €;7.748,93 €;5840;-18,96;12.273,02 €;'sin fechas';27/09/2014;'BON';'Gastos_Compras';'Supermercado';'VARIABLES'
28/09/2014;28/09/2014;'CAFET.C T PRAT';-3,60 €;7.745,33 €;5841;-3,60;12.269,42 €;'sin fechas';28/09/2014;'CAFETC';'Gastos_Ocio y transporte';'Restaurantes';'VARIABLES'
28/09/2014;28/09/2014;'FARMACIA-DIETA';-20,00 €;7.725,33 €;5842;-20,00;12.249,42 €;'sin fechas';28/09/2014;'FARMACIADIETA';'Gastos_Salud, saber y deporte';'Farmacia';'VARIABLES'
29/09/2014;29/09/2014;'BON AREA';-22,74 €;7.702,59 €;5844;-22,74;12.226,68 €;'sin fechas';29/09/2014;'BON';'Gastos_Compras';'Supermercado';'VARIABLES'
29/09/2014;29/09/2014;'BON AREA';-35,57 €;7.667,02 €;5845;-35,57;12.191,11 €;'sin fechas';29/09/2014;'BON';'Gastos_Compras';'Supermercado';'VARIABLES'
29/09/2014;29/09/2014;'CAFET.C T PRAT';-3,65 €;7.663,37 €;5846;-3,65;12.187,46 €;'sin fechas';29/09/2014;'CAFETC';'Gastos_Ocio y transporte';'Restaurantes';'VARIABLES'
29/09/2014;29/09/2014;'CAFET.C T PRAT';-0,90 €;7.662,47 €;5847;-0,90;12.186,56 €;'sin fechas';29/09/2014;'CAFETC';'Gastos_Ocio y transporte';'Restaurantes';'VARIABLES'
29/09/2014;29/09/2014;'ES STA. MARGARITA';-48,72 €;7.613,75 €;5848;-48,72;12.137,84 €;'sin fechas';29/09/2014;'STA';'Gastos_Ocio y transporte';'Gasolina';'VARIABLES'
29/09/2014;29/09/2014;'INFORMACIO I TECNOLOGIA DE CAT';1.576,66 €;9.190,41 €;5852;1.576,66;13.714,50 €;'sin fechas';29/09/2014;'INFORMACIO';'Ingresos';'Nomina';'FIJO'
29/09/2014;29/09/2014;'SALA BADRINAS - QUOTA';-85,00 €;9.105,41 €;5855;-85,00;13.629,50 €;'sin fechas';29/09/2014;'SALA';'Gastos_Salud, saber y deporte';'Estudios';'VARIABLES'
29/09/2014;29/09/2014;'SALA BADRINAS - UNIFORME';-59,20 €;9.046,21 €;5856;-59,20;13.570,30 €;'sin fechas';29/09/2014;'SALA';'Gastos_Salud, saber y deporte';'Estudios';'VARIABLES'
30/09/2014;25/09/2014;'AUTOPISTA TERR';-1,11 €;9.045,10 €;5857;-1,11;13.569,19 €;'sin fechas';25/09/2014;'AUTOPISTA';'Gastos_Ocio y transporte';'Parking y peaje';'VARIABLES'
30/09/2014;25/09/2014;'AUTOPISTA TERR';-1,11 €;9.043,99 €;5858;-1,11;13.568,08 €;'sin fechas';25/09/2014;'AUTOPISTA';'Gastos_Ocio y transporte';'Parking y peaje';'VARIABLES'
30/09/2014;01/10/2014;'ESCOLA BRESSOL EINA';-460,32 €;8.583,67 €;5859;-460,32;13.107,76 €;'sin fechas';01/10/2014;'ESCOLA';'Gastos_Salud, saber y deporte';'Estudios';'VARIABLES'
30/09/2014;30/09/2014;'IBI';-44,87 €;8.538,80 €;5860;-44,87;13.062,89 €;'sin fechas';30/09/2014;'IBI';'Gastos_Banco y organismos';'Ayuntamiento';'FIJO'
30/09/2014;30/09/2014;'MERCADONA';-2,49 €;8.536,31 €;5861;-2,49;13.060,40 €;'sin fechas';30/09/2014;'MERCADONA';'Gastos_Compras';'Supermercado';'VARIABLES'
30/09/2014;30/09/2014;'RECIBO PTMOS. 3061-0960001518';-547,25 €;7.989,06 €;5862;-547,25;12.513,15 €;'sin fechas';30/09/2014;'RECIBO';'Gastos_Banco y organismos';'Hipoteca';'FIJO'
30/09/2014;30/09/2014;'SALA BADRINAS - MENJADOR';-74,40 €;7.914,66 €;5863;-74,40;12.438,75 €;'sin fechas';30/09/2014;'SALA';'Gastos_Salud, saber y deporte';'Estudios';'VARIABLES'
30/09/2014;30/09/2014;'SALA BADRINAS - QUOTA';-85,00 €;7.829,66 €;5864;-85,00;12.353,75 €;'sin fechas';30/09/2014;'SALA';'Gastos_Salud, saber y deporte';'Estudios';'VARIABLES'
01/10/2014;01/10/2014;'REINT.CAJERO';-50,00 €;7.779,66 €;5866;-50,00;12.303,75 €;'sin fechas';01/10/2014;'REINTCAJERO';'Gastos_Gastos varios';'Efectivo';'VARIABLES'
02/10/2014;26/09/2014;'AUTOPISTA TERR';-1,11 €;7.778,55 €;5868;-1,11;12.302,64 €;'sin fechas';26/09/2014;'AUTOPISTA';'Gastos_Ocio y transporte';'Parking y peaje';'VARIABLES'
02/10/2014;26/09/2014;'AUTOPISTA TERR';-1,11 €;7.777,44 €;5869;-1,11;12.301,53 €;'sin fechas';26/09/2014;'AUTOPISTA';'Gastos_Ocio y transporte';'Parking y peaje';'VARIABLES'
02/10/2014;02/10/2014;'CAFET.C T PRAT';-3,65 €;7.773,79 €;5870;-3,65;12.297,88 €;'sin fechas';02/10/2014;'CAFETC';'Gastos_Ocio y transporte';'Restaurantes';'VARIABLES'
02/10/2014;02/10/2014;'IKEA';-40,96 €;7.732,83 €;5871;-40,96;12.256,92 €;'sin fechas';02/10/2014;'IKEA';'Gastos_Vivienda y vehiculo';'Mnto. hogar';'VARIABLES'
02/10/2014;02/10/2014;'VIENA';-5,85 €;7.726,98 €;5872;-5,85;12.251,07 €;'sin fechas';02/10/2014;'VIENA';'Gastos_Ocio y transporte';'Restaurantes';'VARIABLES'
03/10/2014;29/09/2014;'AUTOPISTA TERR';-1,39 €;7.725,59 €;5873;-1,39;12.249,68 €;'sin fechas';29/09/2014;'AUTOPISTA';'Gastos_Ocio y transporte';'Parking y peaje';'VARIABLES'
03/10/2014;03/10/2014;'CAFET.C T PRAT';-2,55 €;7.723,04 €;5874;-2,55;12.247,13 €;'sin fechas';03/10/2014;'CAFETC';'Gastos_Ocio y transporte';'Restaurantes';'VARIABLES'
03/10/2014;03/10/2014;'MERCADONA';-11,57 €;7.711,47 €;5875;-11,57;12.235,56 €;'sin fechas';03/10/2014;'MERCADONA';'Gastos_Compras';'Supermercado';'VARIABLES'
03/10/2014;03/10/2014;'REINT.CAJERO';-20,00 €;7.691,47 €;5876;-20,00;12.215,56 €;'sin fechas';03/10/2014;'REINTCAJERO';'Gastos_Gastos varios';'Efectivo';'VARIABLES'
03/10/2014;03/10/2014;'SEGUROS CATALANA';-306,94 €;7.384,53 €;5878;-306,94;11.908,62 €;'sin fechas';03/10/2014;'CATALANA';'Gastos_Ocio y transporte';'Parking y peaje';'VARIABLES'
04/10/2014;30/09/2014;'AUTOPISTA TERR';-1,39 €;7.383,14 €;5879;-1,39;11.907,23 €;'sin fechas';30/09/2014;'AUTOPISTA';'Gastos_Ocio y transporte';'Parking y peaje';'VARIABLES'
04/10/2014;30/09/2014;'AUTOPISTA TERR';-1,11 €;7.382,03 €;5880;-1,11;11.906,12 €;'sin fechas';30/09/2014;'AUTOPISTA';'Gastos_Ocio y transporte';'Parking y peaje';'VARIABLES'
04/10/2014;04/10/2014;'CAFET.C T PRAT';-3,60 €;7.378,43 €;5881;-3,60;11.902,52 €;'sin fechas';04/10/2014;'CAFETC';'Gastos_Ocio y transporte';'Restaurantes';'VARIABLES'
04/10/2014;04/10/2014;'CAPRABO';-17,77 €;7.360,66 €;5882;-17,77;11.884,75 €;'sin fechas';04/10/2014;'CAPRABO';'Gastos_Compras';'Supermercado';'VARIABLES'
04/10/2014;03/10/2014;'MERCADONA';-114,21 €;7.246,45 €;5883;-114,21;11.770,54 €;'sin fechas';03/10/2014;'MERCADONA';'Gastos_Compras';'Supermercado';'VARIABLES'
04/10/2014;04/10/2014;'VIENA';-14,50 €;7.231,95 €;5884;-14,50;11.756,04 €;'sin fechas';04/10/2014;'VIENA';'Gastos_Ocio y transporte';'Restaurantes';'VARIABLES'
05/10/2014;05/10/2014;'CAFET.C T PRAT';-3,15 €;7.228,80 €;5885;-3,15;11.752,89 €;'sin fechas';05/10/2014;'CAFETC';'Gastos_Ocio y transporte';'Restaurantes';'VARIABLES'
05/10/2014;05/10/2014;'RESTAURANTES';-16,50 €;7.212,30 €;5886;-16,50;11.736,39 €;'sin fechas';05/10/2014;'RESTAURANTES';'Gastos_Ocio y transporte';'Restaurantes';'VARIABLES'
05/10/2014;05/10/2014;'RESTAURANTES';-21,15 €;7.191,15 €;5887;-21,15;11.715,24 €;'sin fechas';05/10/2014;'RESTAURANTES';'Gastos_Ocio y transporte';'Restaurantes';'VARIABLES'
06/10/2014;06/10/2014;'BLITZ';-72,50 €;7.118,65 €;5888;-72,50;11.642,74 €;'sin fechas';06/10/2014;'BLITZ';'Gastos_Vivienda y vehiculo';'Alquiler Parking';'FIJO'
06/10/2014;06/10/2014;'CAFET.C T PRAT';-4,50 €;7.114,15 €;5889;-4,50;11.638,24 €;'sin fechas';06/10/2014;'CAFETC';'Gastos_Ocio y transporte';'Restaurantes';'VARIABLES'
06/10/2014;06/10/2014;'CAFET.C T PRAT';-3,65 €;7.110,50 €;5890;-3,65;11.634,59 €;'sin fechas';06/10/2014;'CAFETC';'Gastos_Ocio y transporte';'Restaurantes';'VARIABLES'
06/10/2014;06/10/2014;'FARMACIA-DIETA';-30,00 €;7.080,50 €;5891;-30,00;11.604,59 €;'sin fechas';06/10/2014;'FARMACIADIETA';'Gastos_Salud, saber y deporte';'Farmacia';'VARIABLES'
06/10/2014;06/10/2014;'FRANKFURT LES LLETRES';-4,35 €;7.076,15 €;5892;-4,35;11.600,24 €;'sin fechas';06/10/2014;'FRANKFURT';'Gastos_Ocio y transporte';'Restaurantes';'VARIABLES'
07/10/2014;02/10/2014;'AUTOPISTA TERR';-1,39 €;7.074,76 €;5893;-1,39;11.598,85 €;'sin fechas';02/10/2014;'AUTOPISTA';'Gastos_Ocio y transporte';'Parking y peaje';'VARIABLES'
07/10/2014;02/10/2014;'AUTOPISTA TERR';-1,39 €;7.073,37 €;5894;-1,39;11.597,46 €;'sin fechas';02/10/2014;'AUTOPISTA';'Gastos_Ocio y transporte';'Parking y peaje';'VARIABLES'
07/10/2014;01/10/2014;'AUTOPISTA TERR';-1,39 €;7.071,98 €;5895;-1,39;11.596,07 €;'sin fechas';01/10/2014;'AUTOPISTA';'Gastos_Ocio y transporte';'Parking y peaje';'VARIABLES'
07/10/2014;07/10/2014;'TOCINERIES VENTURA';-14,83 €;7.057,15 €;5896;-14,83;11.581,24 €;'sin fechas';07/10/2014;'TOCINERIES';'Gastos_Compras';'Supermercado';'VARIABLES'
07/10/2014;07/10/2014;'VIRGIN-ACTIVE';-55,95 €;7.001,20 €;5897;-55,95;11.525,29 €;'sin fechas';07/10/2014;'VIRGINACTIVE';'Gastos_Salud, saber y deporte';'Deportes';'VARIABLES'
07/10/2014;07/10/2014;'VIRGIN-ACTIVE';-55,95 €;6.945,25 €;5898;-55,95;11.469,34 €;'sin fechas';07/10/2014;'VIRGINACTIVE';'Gastos_Salud, saber y deporte';'Deportes';'VARIABLES'
08/10/2014;08/10/2014;'ADESLAS CENTRAL 006662671613';-110,99 €;6.834,26 €;5899;-110,99;11.358,35 €;'sin fechas';08/10/2014;'ADESLAS';'Gastos_Salud, saber y deporte';'Medico';'VARIABLES'
08/10/2014;08/10/2014;'FRANKFURT LES LLETRES';-7,60 €;6.826,66 €;5900;-7,60;11.350,75 €;'sin fechas';08/10/2014;'FRANKFURT';'Gastos_Ocio y transporte';'Restaurantes';'VARIABLES'
08/10/2014;08/10/2014;'REINT.CAJERO';-50,00 €;6.776,66 €;5901;-50,00;11.300,75 €;'sin fechas';08/10/2014;'REINTCAJERO';'Gastos_Gastos varios';'Efectivo';'VARIABLES'
09/10/2014;09/10/2014;'CAFET.C T PRAT';-3,45 €;6.773,21 €;5902;-3,45;11.297,30 €;'sin fechas';09/10/2014;'CAFETC';'Gastos_Ocio y transporte';'Restaurantes';'VARIABLES'
09/10/2014;09/10/2014;'FARMACIA';-14,95 €;6.758,26 €;5903;-14,95;11.282,35 €;'sin fechas';09/10/2014;'FARMACIA';'Gastos_Salud, saber y deporte';'Farmacia';'VARIABLES'
09/10/2014;09/10/2014;'FRUITES I VERDURES';-9,50 €;6.748,76 €;5904;-9,50;11.272,85 €;'sin fechas';09/10/2014;'FRUITES';'Gastos_Compras';'Supermercado';'VARIABLES'
09/10/2014;09/10/2014;'REINT.CAJERO';-50,00 €;6.698,76 €;5905;-50,00;11.222,85 €;'sin fechas';09/10/2014;'REINTCAJERO';'Gastos_Gastos varios';'Efectivo';'VARIABLES'
09/10/2014;09/10/2014;'REINT.CAJERO';-20,00 €;6.678,76 €;5906;-20,00;11.202,85 €;'sin fechas';09/10/2014;'REINTCAJERO';'Gastos_Gastos varios';'Efectivo';'VARIABLES'
09/10/2014;07/10/2014;'RESTAURANTES';-25,00 €;6.653,76 €;5907;-25,00;11.177,85 €;'sin fechas';07/10/2014;'RESTAURANTES';'Gastos_Ocio y transporte';'Restaurantes';'VARIABLES'
10/10/2014;04/10/2014;'AUTOPISTA TERR';-1,39 €;6.652,37 €;5908;-1,39;11.176,46 €;'sin fechas';04/10/2014;'AUTOPISTA';'Gastos_Ocio y transporte';'Parking y peaje';'VARIABLES'
10/10/2014;06/10/2014;'AUTOPISTA TERR';-1,32 €;6.651,05 €;5909;-1,32;11.175,14 €;'sin fechas';06/10/2014;'AUTOPISTA';'Gastos_Ocio y transporte';'Parking y peaje';'VARIABLES'
10/10/2014;06/10/2014;'AUTOPISTA TERR';-1,39 €;6.649,66 €;5910;-1,39;11.173,75 €;'sin fechas';06/10/2014;'AUTOPISTA';'Gastos_Ocio y transporte';'Parking y peaje';'VARIABLES'
10/10/2014;03/10/2014;'AUTOPISTA TERR';-1,39 €;6.648,27 €;5911;-1,39;11.172,36 €;'sin fechas';03/10/2014;'AUTOPISTA';'Gastos_Ocio y transporte';'Parking y peaje';'VARIABLES'
10/10/2014;03/10/2014;'AUTOPISTA TERR';-1,39 €;6.646,88 €;5912;-1,39;11.170,97 €;'sin fechas';03/10/2014;'AUTOPISTA';'Gastos_Ocio y transporte';'Parking y peaje';'VARIABLES'
10/10/2014;10/10/2014;'CAFET.C T PRAT';-2,70 €;6.644,18 €;5913;-2,70;11.168,27 €;'sin fechas';10/10/2014;'CAFETC';'Gastos_Ocio y transporte';'Restaurantes';'VARIABLES'
11/10/2014;09/10/2014;'AUTOPISTA TERR';-1,39 €;6.642,79 €;5914;-1,39;11.166,88 €;'sin fechas';09/10/2014;'AUTOPISTA';'Gastos_Ocio y transporte';'Parking y peaje';'VARIABLES'
11/10/2014;07/10/2014;'AUTOPISTA TERR';-1,32 €;6.641,47 €;5915;-1,32;11.165,56 €;'sin fechas';07/10/2014;'AUTOPISTA';'Gastos_Ocio y transporte';'Parking y peaje';'VARIABLES'
11/10/2014;07/10/2014;'AUTOPISTA TERR';-1,39 €;6.640,08 €;5916;-1,39;11.164,17 €;'sin fechas';07/10/2014;'AUTOPISTA';'Gastos_Ocio y transporte';'Parking y peaje';'VARIABLES'
11/10/2014;11/10/2014;'CAFET.C T PRAT';-3,45 €;6.636,63 €;5917;-3,45;11.160,72 €;'sin fechas';11/10/2014;'CAFETC';'Gastos_Ocio y transporte';'Restaurantes';'VARIABLES'
12/10/2014;12/10/2014;'CAFET.C T PRAT';-3,45 €;6.633,18 €;5918;-3,45;11.157,27 €;'sin fechas';12/10/2014;'CAFETC';'Gastos_Ocio y transporte';'Restaurantes';'VARIABLES'
13/10/2014;13/10/2014;'CAFET.C T PRAT';-4,10 €;6.629,08 €;5919;-4,10;11.153,17 €;'sin fechas';13/10/2014;'CAFETC';'Gastos_Ocio y transporte';'Restaurantes';'VARIABLES'
13/10/2014;13/10/2014;'ES STA. MARGARITA';-30,07 €;6.599,01 €;5920;-30,07;11.123,10 €;'sin fechas';13/10/2014;'STA';'Gastos_Ocio y transporte';'Gasolina';'VARIABLES'
13/10/2014;13/10/2014;'FARMACIA';-18,50 €;6.580,51 €;5921;-18,50;11.104,60 €;'sin fechas';13/10/2014;'FARMACIA';'Gastos_Salud, saber y deporte';'Farmacia';'VARIABLES'
13/10/2014;13/10/2014;'GAS NATURAL';-152,91 €;6.427,60 €;5922;-152,91;10.951,69 €;'sin fechas';13/10/2014;'GAS';'Gastos_Servicios tipicos';'Gas';'FIJO'
13/10/2014;13/10/2014;'FRANKFURT LES LLETRES';-4,70 €;6.422,90 €;5924;-4,70;10.946,99 €;'sin fechas';13/10/2014;'FRANKFURT';'Gastos_Ocio y transporte';'Restaurantes';'VARIABLES'
14/10/2014;10/10/2014;'AUTOPISTA TERR';-1,39 €;6.421,51 €;5925;-1,39;10.945,60 €;'sin fechas';10/10/2014;'AUTOPISTA';'Gastos_Ocio y transporte';'Parking y peaje';'VARIABLES'
14/10/2014;10/10/2014;'AUTOPISTA TERR';-1,39 €;6.420,12 €;5926;-1,39;10.944,21 €;'sin fechas';10/10/2014;'AUTOPISTA';'Gastos_Ocio y transporte';'Parking y peaje';'VARIABLES'
14/10/2014;10/10/2014;'AUTOPISTA TERR';-1,39 €;6.418,73 €;5927;-1,39;10.942,82 €;'sin fechas';10/10/2014;'AUTOPISTA';'Gastos_Ocio y transporte';'Parking y peaje';'VARIABLES'
14/10/2014;10/10/2014;'AUTOPISTA TERR';-1,39 €;6.417,34 €;5928;-1,39;10.941,43 €;'sin fechas';10/10/2014;'AUTOPISTA';'Gastos_Ocio y transporte';'Parking y peaje';'VARIABLES'
14/10/2014;09/10/2014;'AUTOPISTA TERR';-1,39 €;6.415,95 €;5929;-1,39;10.940,04 €;'sin fechas';09/10/2014;'AUTOPISTA';'Gastos_Ocio y transporte';'Parking y peaje';'VARIABLES'
14/10/2014;08/10/2014;'AUTOPISTA TERR';-1,32 €;6.414,63 €;5930;-1,32;10.938,72 €;'sin fechas';08/10/2014;'AUTOPISTA';'Gastos_Ocio y transporte';'Parking y peaje';'VARIABLES'
14/10/2014;08/10/2014;'AUTOPISTA TERR';-1,32 €;6.413,31 €;5931;-1,32;10.937,40 €;'sin fechas';08/10/2014;'AUTOPISTA';'Gastos_Ocio y transporte';'Parking y peaje';'VARIABLES'
14/10/2014;14/10/2014;'BON AREA';-15,69 €;6.397,62 €;5932;-15,69;10.921,71 €;'sin fechas';14/10/2014;'BON';'Gastos_Compras';'Supermercado';'VARIABLES'
14/10/2014;14/10/2014;'REINT.CAJERO';-50,00 €;6.347,62 €;5933;-50,00;10.871,71 €;'sin fechas';14/10/2014;'REINTCAJERO';'Gastos_Gastos varios';'Efectivo';'VARIABLES'
15/10/2014;13/10/2014;'AUTOPISTA TERR';-1,39 €;6.346,23 €;5934;-1,39;10.870,32 €;'sin fechas';13/10/2014;'AUTOPISTA';'Gastos_Ocio y transporte';'Parking y peaje';'VARIABLES'
15/10/2014;13/10/2014;'AUTOPISTA TERR';-1,39 €;6.344,84 €;5935;-1,39;10.868,93 €;'sin fechas';13/10/2014;'AUTOPISTA';'Gastos_Ocio y transporte';'Parking y peaje';'VARIABLES'
16/10/2014;14/10/2014;'AUTOPISTA TERR';-1,39 €;6.343,45 €;5936;-1,39;10.867,54 €;'sin fechas';14/10/2014;'AUTOPISTA';'Gastos_Ocio y transporte';'Parking y peaje';'VARIABLES'
16/10/2014;14/10/2014;'AUTOPISTA TERR';-1,39 €;6.342,06 €;5937;-1,39;10.866,15 €;'sin fechas';14/10/2014;'AUTOPISTA';'Gastos_Ocio y transporte';'Parking y peaje';'VARIABLES'
16/10/2014;16/10/2014;'CAFET.C T PRAT';-4,10 €;6.337,96 €;5938;-4,10;10.862,05 €;'sin fechas';16/10/2014;'CAFETC';'Gastos_Ocio y transporte';'Restaurantes';'VARIABLES'
16/10/2014;16/10/2014;'CCM VIDA Y P SEGURO PRESTAMO';-23,44 €;6.314,52 €;5939;-23,44;10.838,61 €;'sin fechas';16/10/2014;'CCM';'Gastos_Seguros';'Seguro vida';'FIJO'
16/10/2014;16/10/2014;'CCM VIDA Y PENSIO 000000493358';-17,69 €;6.296,83 €;5940;-17,69;10.820,92 €;'sin fechas';16/10/2014;'CCM';'Gastos_Seguros';'Seguro vida';'FIJO'
16/10/2014;14/10/2014;'FARMACIA';-11,30 €;6.285,53 €;5941;-11,30;10.809,62 €;'sin fechas';14/10/2014;'FARMACIA';'Gastos_Salud, saber y deporte';'Farmacia';'VARIABLES'
16/10/2014;14/10/2014;'HOGAR&COMIDA';-35,65 €;6.249,88 €;5942;-35,65;10.773,97 €;'sin fechas';14/10/2014;'HOGARCOMIDA';'Gastos_Compras';'Supermercado';'VARIABLES'
16/10/2014;14/10/2014;'RESTAURANTES';-11,50 €;6.238,38 €;5943;-11,50;10.762,47 €;'sin fechas';14/10/2014;'RESTAURANTES';'Gastos_Ocio y transporte';'Restaurantes';'VARIABLES'
16/10/2014;14/10/2014;'RESTAURANTES';-21,01 €;6.217,37 €;5944;-21,01;10.741,46 €;'sin fechas';14/10/2014;'RESTAURANTES';'Gastos_Ocio y transporte';'Restaurantes';'VARIABLES'
16/10/2014;15/10/2014;'RESTAURANTES';-35,50 €;6.181,87 €;5945;-35,50;10.705,96 €;'sin fechas';15/10/2014;'RESTAURANTES';'Gastos_Ocio y transporte';'Restaurantes';'VARIABLES'
16/10/2014;14/10/2014;'TRANSPORTS MUNICIP';-10,30 €;6.171,57 €;5946;-10,30;10.695,66 €;'sin fechas';14/10/2014;'TRANSPORTS';'Gastos_Ocio y transporte';'Transporte';'VARIABLES'
17/10/2014;17/10/2014;'DECATHLON';-30,85 €;6.140,72 €;5947;-30,85;10.664,81 €;'sin fechas';17/10/2014;'DECATHLON';'Gastos_Compras';'Deportivo';'VARIABLES'
17/10/2014;17/10/2014;'ONO';-112,41 €;6.028,31 €;5948;-112,41;10.552,40 €;'sin fechas';17/10/2014;'ONO';'Gastos_Servicios tipicos';'Telecomunicaciones';'FIJO'
20/10/2014;20/10/2014;'FARMACIA-DIETA';-30,00 €;5.998,31 €;5950;-30,00;10.522,40 €;'sin fechas';20/10/2014;'FARMACIADIETA';'Gastos_Salud, saber y deporte';'Farmacia';'VARIABLES'
22/10/2014;20/10/2014;'AUTOPISTA TERR';-1,39 €;5.996,92 €;5951;-1,39;10.521,01 €;'sin fechas';20/10/2014;'AUTOPISTA';'Gastos_Ocio y transporte';'Parking y peaje';'VARIABLES'
22/10/2014;20/10/2014;'AUTOPISTA TERR';-1,39 €;5.995,53 €;5952;-1,39;10.519,62 €;'sin fechas';20/10/2014;'AUTOPISTA';'Gastos_Ocio y transporte';'Parking y peaje';'VARIABLES'
23/10/2014;21/10/2014;'AUTOPISTA TERR';-1,32 €;5.994,21 €;5953;-1,32;10.518,30 €;'sin fechas';21/10/2014;'AUTOPISTA';'Gastos_Ocio y transporte';'Parking y peaje';'VARIABLES'
23/10/2014;21/10/2014;'AUTOPISTA TERR';-1,32 €;5.992,89 €;5954;-1,32;10.516,98 €;'sin fechas';21/10/2014;'AUTOPISTA';'Gastos_Ocio y transporte';'Parking y peaje';'VARIABLES'
23/10/2014;23/10/2014;'CAFET.C T PRAT';-3,65 €;5.989,24 €;5955;-3,65;10.513,33 €;'sin fechas';23/10/2014;'CAFETC';'Gastos_Ocio y transporte';'Restaurantes';'VARIABLES'
23/10/2014;21/10/2014;'FARMACIA';-13,32 €;5.975,92 €;5956;-13,32;10.500,01 €;'sin fechas';21/10/2014;'FARMACIA';'Gastos_Salud, saber y deporte';'Farmacia';'VARIABLES'
23/10/2014;21/10/2014;'FARMACIA';-6,00 €;5.969,92 €;5957;-6,00;10.494,01 €;'sin fechas';21/10/2014;'FARMACIA';'Gastos_Salud, saber y deporte';'Farmacia';'VARIABLES'
23/10/2014;21/10/2014;'MERCADONA';-32,29 €;5.937,63 €;5958;-32,29;10.461,72 €;'sin fechas';21/10/2014;'MERCADONA';'Gastos_Compras';'Supermercado';'VARIABLES'
23/10/2014;23/10/2014;'SALA BADRINAS - MENJADOR';-135,22 €;5.802,41 €;5959;-135,22;10.326,50 €;'sin fechas';23/10/2014;'SALA';'Gastos_Salud, saber y deporte';'Estudios';'VARIABLES'
24/10/2014;22/10/2014;'AUTOPISTA TERR';-1,32 €;5.801,09 €;5960;-1,32;10.325,18 €;'sin fechas';22/10/2014;'AUTOPISTA';'Gastos_Ocio y transporte';'Parking y peaje';'VARIABLES'
24/10/2014;22/10/2014;'AUTOPISTA TERR';-1,39 €;5.799,70 €;5961;-1,39;10.323,79 €;'sin fechas';22/10/2014;'AUTOPISTA';'Gastos_Ocio y transporte';'Parking y peaje';'VARIABLES'
24/10/2014;24/10/2014;'CAFET.C T PRAT';-2,90 €;5.796,80 €;5962;-2,90;10.320,89 €;'sin fechas';24/10/2014;'CAFETC';'Gastos_Ocio y transporte';'Restaurantes';'VARIABLES'
24/10/2014;24/10/2014;'CARREFOUR-[OTROS]';-14,75 €;5.782,05 €;5963;-14,75;10.306,14 €;'sin fechas';24/10/2014;'CARREFOUROTROS';'Gastos_Compras';'Supermercado';'VARIABLES'
24/10/2014;24/10/2014;'CARREFOUR-[OTROS]';-12,64 €;5.769,41 €;5964;-12,64;10.293,50 €;'sin fechas';24/10/2014;'CARREFOUROTROS';'Gastos_Compras';'Supermercado';'VARIABLES'
24/10/2014;24/10/2014;'REINT.CAJERO';-30,00 €;5.739,41 €;5965;-30,00;10.263,50 €;'sin fechas';24/10/2014;'REINTCAJERO';'Gastos_Gastos varios';'Efectivo';'VARIABLES'
25/10/2014;23/10/2014;'AUTOPISTA TERR';-1,32 €;5.738,09 €;5966;-1,32;10.262,18 €;'sin fechas';23/10/2014;'AUTOPISTA';'Gastos_Ocio y transporte';'Parking y peaje';'VARIABLES'
25/10/2014;23/10/2014;'AUTOPISTA TERR';-1,39 €;5.736,70 €;5967;-1,39;10.260,79 €;'sin fechas';23/10/2014;'AUTOPISTA';'Gastos_Ocio y transporte';'Parking y peaje';'VARIABLES'
25/10/2014;25/10/2014;'CAFET.C T PRAT';-4,50 €;5.732,20 €;5968;-4,50;10.256,29 €;'sin fechas';25/10/2014;'CAFETC';'Gastos_Ocio y transporte';'Restaurantes';'VARIABLES'
25/10/2014;25/10/2014;'CAFET.C T PRAT';-2,70 €;5.729,50 €;5969;-2,70;10.253,59 €;'sin fechas';25/10/2014;'CAFETC';'Gastos_Ocio y transporte';'Restaurantes';'VARIABLES'
25/10/2014;25/10/2014;'ES STA. MARGARITA';-50,03 €;5.679,47 €;5970;-50,03;10.203,56 €;'sin fechas';25/10/2014;'STA';'Gastos_Ocio y transporte';'Gasolina';'VARIABLES'
25/10/2014;25/10/2014;'FRUITES I VERDURES';-19,25 €;5.660,22 €;5971;-19,25;10.184,31 €;'sin fechas';25/10/2014;'FRUITES';'Gastos_Compras';'Supermercado';'VARIABLES'
26/10/2014;26/10/2014;'BON AREA';-21,13 €;5.639,09 €;5972;-21,13;10.163,18 €;'sin fechas';26/10/2014;'BON';'Gastos_Compras';'Supermercado';'VARIABLES'
27/10/2014;23/10/2014;'AUTOPISTA TERR';-4,19 €;5.634,90 €;5973;-4,19;10.158,99 €;'sin fechas';23/10/2014;'AUTOPISTA';'Gastos_Ocio y transporte';'Parking y peaje';'VARIABLES'
27/10/2014;27/10/2014;'BON AREA';-32,20 €;5.602,70 €;5974;-32,20;10.126,79 €;'sin fechas';27/10/2014;'BON';'Gastos_Compras';'Supermercado';'VARIABLES'
27/10/2014;27/10/2014;'CAFET.C T PRAT';-3,65 €;5.599,05 €;5975;-3,65;10.123,14 €;'sin fechas';27/10/2014;'CAFETC';'Gastos_Ocio y transporte';'Restaurantes';'VARIABLES'
27/10/2014;27/10/2014;'FARMACIA';-20,30 €;5.578,75 €;5976;-20,30;10.102,84 €;'sin fechas';27/10/2014;'FARMACIA';'Gastos_Salud, saber y deporte';'Farmacia';'VARIABLES'
27/10/2014;27/10/2014;'REINT.CAJERO';-20,00 €;5.558,75 €;5977;-20,00;10.082,84 €;'sin fechas';27/10/2014;'REINTCAJERO';'Gastos_Gastos varios';'Efectivo';'VARIABLES'
27/10/2014;27/10/2014;'TOYOTA ORIENT CARS';-189,04 €;5.369,71 €;5978;-189,04;9.893,80 €;'sin fechas';27/10/2014;'TOYOTA';'Gastos_Vivienda y vehiculo';'Mnto. vehiculo';'VARIABLE'
28/10/2014;28/10/2014;'FOMENT DE TERRASSA, S.A. FOMEN';1.524,04 €;6.893,75 €;5979;1.524,04;11.417,84 €;'sin fechas';28/10/2014;'FOMENT';'Ingresos';'Nomina';'FIJO'
28/10/2014;28/10/2014;'FRANKFURT LES LLETRES';-4,35 €;6.889,40 €;5980;-4,35;11.413,49 €;'sin fechas';28/10/2014;'FRANKFURT';'Gastos_Ocio y transporte';'Restaurantes';'VARIABLES'
28/10/2014;28/10/2014;'SALA BADRINAS - UNIFORME';-62,20 €;6.827,20 €;5981;-62,20;11.351,29 €;'sin fechas';28/10/2014;'SALA';'Gastos_Salud, saber y deporte';'Estudios';'VARIABLES'
29/10/2014;27/10/2014;'AUTOPISTA TERR';-1,25 €;6.825,95 €;5982;-1,25;11.350,04 €;'sin fechas';27/10/2014;'AUTOPISTA';'Gastos_Ocio y transporte';'Parking y peaje';'VARIABLES'
29/10/2014;27/10/2014;'AUTOPISTA TERR';-1,39 €;6.824,56 €;5983;-1,39;11.348,65 €;'sin fechas';27/10/2014;'AUTOPISTA';'Gastos_Ocio y transporte';'Parking y peaje';'VARIABLES'
29/10/2014;24/10/2014;'AUTOPISTA TERR';-1,25 €;6.823,31 €;5984;-1,25;11.347,40 €;'sin fechas';24/10/2014;'AUTOPISTA';'Gastos_Ocio y transporte';'Parking y peaje';'VARIABLES'
29/10/2014;24/10/2014;'AUTOPISTA TERR';-1,32 €;6.821,99 €;5985;-1,32;11.346,08 €;'sin fechas';24/10/2014;'AUTOPISTA';'Gastos_Ocio y transporte';'Parking y peaje';'VARIABLES'
29/10/2014;29/10/2014;'INFORMACIO I TECNOLOGIA DE CAT';1.576,66 €;8.398,65 €;5986;1.576,66;12.922,74 €;'sin fechas';29/10/2014;'INFORMACIO';'Ingresos';'Nomina';'FIJO'
30/10/2014;26/10/2014;'AUTOPISTA TERR';-4,19 €;8.394,46 €;5987;-4,19;12.918,55 €;'sin fechas';26/10/2014;'AUTOPISTA';'Gastos_Ocio y transporte';'Parking y peaje';'VARIABLES'
30/10/2014;28/10/2014;'AUTOPISTA TERR';-1,25 €;8.393,21 €;5988;-1,25;12.917,30 €;'sin fechas';28/10/2014;'AUTOPISTA';'Gastos_Ocio y transporte';'Parking y peaje';'VARIABLES'
30/10/2014;28/10/2014;'AUTOPISTA TERR';-1,39 €;8.391,82 €;5989;-1,39;12.915,91 €;'sin fechas';28/10/2014;'AUTOPISTA';'Gastos_Ocio y transporte';'Parking y peaje';'VARIABLES'
30/10/2014;30/10/2014;'CAFET.C T PRAT';-3,65 €;8.388,17 €;5991;-3,65;12.912,26 €;'sin fechas';30/10/2014;'CAFETC';'Gastos_Ocio y transporte';'Restaurantes';'VARIABLES'
30/10/2014;28/10/2014;'DECATHLON';-53,22 €;8.334,95 €;5992;-53,22;12.859,04 €;'sin fechas';28/10/2014;'DECATHLON';'Gastos_Compras';'Deportivo';'VARIABLES'
30/10/2014;30/10/2014;'FRUITES I VERDURES';-3,40 €;8.331,55 €;5995;-3,40;12.855,64 €;'sin fechas';30/10/2014;'FRUITES';'Gastos_Compras';'Supermercado';'VARIABLES'
30/10/2014;28/10/2014;'IKEA';-22,60 €;8.308,95 €;5996;-22,60;12.833,04 €;'sin fechas';28/10/2014;'IKEA';'Gastos_Vivienda y vehiculo';'Mnto. hogar';'VARIABLES'
30/10/2014;28/10/2014;'IKEA';-145,38 €;8.163,57 €;5997;-145,38;12.687,66 €;'sin fechas';28/10/2014;'IKEA';'Gastos_Vivienda y vehiculo';'Mnto. hogar';'VARIABLES'
30/10/2014;28/10/2014;'IKEA';-28,51 €;8.135,06 €;5998;-28,51;12.659,15 €;'sin fechas';28/10/2014;'IKEA';'Gastos_Vivienda y vehiculo';'Mnto. hogar';'VARIABLES'
30/10/2014;30/10/2014;'FRANKFURT LES LLETRES';-5,15 €;8.129,91 €;6000;-5,15;12.654,00 €;'sin fechas';30/10/2014;'FRANKFURT';'Gastos_Ocio y transporte';'Restaurantes';'VARIABLES'
30/10/2014;28/10/2014;'MERCADONA';-9,71 €;8.120,20 €;6001;-9,71;12.644,29 €;'sin fechas';28/10/2014;'MERCADONA';'Gastos_Compras';'Supermercado';'VARIABLES'
30/10/2014;30/10/2014;'RESTAURANTES';-2,50 €;8.117,70 €;6002;-2,50;12.641,79 €;'sin fechas';30/10/2014;'RESTAURANTES';'Gastos_Ocio y transporte';'Restaurantes';'VARIABLES'
30/10/2014;30/10/2014;'TOCINERIES VENTURA';-8,64 €;8.109,06 €;6004;-8,64;12.633,15 €;'sin fechas';30/10/2014;'TOCINERIES';'Gastos_Compras';'Supermercado';'VARIABLES'
31/10/2014;29/10/2014;'AUTOPISTA TERR';-1,25 €;8.107,81 €;6005;-1,25;12.631,90 €;'sin fechas';29/10/2014;'AUTOPISTA';'Gastos_Ocio y transporte';'Parking y peaje';'VARIABLES'
31/10/2014;29/10/2014;'AUTOPISTA TERR';-1,25 €;8.106,56 €;6006;-1,25;12.630,65 €;'sin fechas';29/10/2014;'AUTOPISTA';'Gastos_Ocio y transporte';'Parking y peaje';'VARIABLES'
31/10/2014;31/10/2014;'BON AREA';-13,17 €;8.093,39 €;6007;-13,17;12.617,48 €;'sin fechas';31/10/2014;'BON';'Gastos_Compras';'Supermercado';'VARIABLES'
31/10/2014;01/11/2014;'ESCOLA BRESSOL EINA';-501,80 €;7.591,59 €;6008;-501,80;12.115,68 €;'sin fechas';01/11/2014;'ESCOLA';'Gastos_Salud, saber y deporte';'Estudios';'VARIABLES'
31/10/2014;31/10/2014;'FRUITES I VERDURES';-6,20 €;7.585,39 €;6009;-6,20;12.109,48 €;'sin fechas';31/10/2014;'FRUITES';'Gastos_Compras';'Supermercado';'VARIABLES'
31/10/2014;31/10/2014;'FRANKFURT LES LLETRES';-6,15 €;7.579,24 €;6010;-6,15;12.103,33 €;'sin fechas';31/10/2014;'FRANKFURT';'Gastos_Ocio y transporte';'Restaurantes';'VARIABLES'
31/10/2014;31/10/2014;'RECIBO PTMOS. 3061-0960001518';-547,25 €;7.031,99 €;6011;-547,25;11.556,08 €;'sin fechas';31/10/2014;'RECIBO';'Gastos_Banco y organismos';'Hipoteca';'FIJO'
31/10/2014;31/10/2014;'REDPIZZA';-13,95 €;7.018,04 €;6012;-13,95;11.542,13 €;'sin fechas';31/10/2014;'REDPIZZA';'Gastos_Ocio y transporte';'Restaurantes';'VARIABLES'
31/10/2014;31/10/2014;'VIENA';-3,50 €;7.014,54 €;6013;-3,50;11.538,63 €;'sin fechas';31/10/2014;'VIENA';'Gastos_Ocio y transporte';'Restaurantes';'VARIABLES'
01/11/2014;01/11/2014;'CAFET.C T PRAT';-3,15 €;7.011,39 €;6014;-3,15;11.535,48 €;'sin fechas';01/11/2014;'CAFETC';'Gastos_Ocio y transporte';'Restaurantes';'VARIABLES'
01/11/2014;01/11/2014;'CAFET.C T PRAT';-4,50 €;7.006,89 €;6015;-4,50;11.530,98 €;'sin fechas';01/11/2014;'CAFETC';'Gastos_Ocio y transporte';'Restaurantes';'VARIABLES'
01/11/2014;01/11/2014;'CREDITO';-114,09 €;6.892,80 €;6016;-114,09;11.416,89 €;'sin fechas';01/11/2014;'CREDITO';'No computable';'Recibo Tarjeta';
01/11/2014;01/11/2014;'REINT.CAJERO';-20,00 €;6.872,80 €;6017;-20,00;11.396,89 €;'sin fechas';01/11/2014;'REINTCAJERO';'Gastos_Gastos varios';'Efectivo';'VARIABLES'
02/11/2014;30/10/2014;'AUTOPISTA TERR';-4,19 €;6.868,61 €;6018;-4,19;11.392,70 €;'sin fechas';30/10/2014;'AUTOPISTA';'Gastos_Ocio y transporte';'Parking y peaje';'VARIABLES'
02/11/2014;02/11/2014;'CAFET.C T PRAT';-2,60 €;6.866,01 €;6019;-2,60;11.390,10 €;'sin fechas';02/11/2014;'CAFETC';'Gastos_Ocio y transporte';'Restaurantes';'VARIABLES'
03/11/2014;03/11/2014;'CAFET.C T PRAT';-3,65 €;6.862,36 €;6020;-3,65;11.386,45 €;'sin fechas';03/11/2014;'CAFETC';'Gastos_Ocio y transporte';'Restaurantes';'VARIABLES'
03/11/2014;03/11/2014;'FRANKFURT LES LLETRES';-4,70 €;6.857,66 €;6021;-4,70;11.381,75 €;'sin fechas';03/11/2014;'FRANKFURT';'Gastos_Ocio y transporte';'Restaurantes';'VARIABLES'
05/11/2014;31/10/2014;'AUTOPISTA TERR';-1,25 €;6.856,41 €;6022;-1,25;11.380,50 €;'sin fechas';31/10/2014;'AUTOPISTA';'Gastos_Ocio y transporte';'Parking y peaje';'VARIABLES'
05/11/2014;31/10/2014;'AUTOPISTA TERR';-1,39 €;6.855,02 €;6023;-1,39;11.379,11 €;'sin fechas';31/10/2014;'AUTOPISTA';'Gastos_Ocio y transporte';'Parking y peaje';'VARIABLES'
05/11/2014;30/10/2014;'AUTOPISTA TERR';-1,25 €;6.853,77 €;6024;-1,25;11.377,86 €;'sin fechas';30/10/2014;'AUTOPISTA';'Gastos_Ocio y transporte';'Parking y peaje';'VARIABLES'
05/11/2014;30/10/2014;'AUTOPISTA TERR';-1,25 €;6.852,52 €;6025;-1,25;11.376,61 €;'sin fechas';30/10/2014;'AUTOPISTA';'Gastos_Ocio y transporte';'Parking y peaje';'VARIABLES'
06/11/2014;06/11/2014;'ADESLAS CENTRAL 006662671613';-110,99 €;6.741,53 €;6026;-110,99;11.265,62 €;'sin fechas';06/11/2014;'ADESLAS';'Gastos_Salud, saber y deporte';'Medico';'VARIABLES'
06/11/2014;03/11/2014;'AUTOPISTA TERR';-1,39 €;6.740,14 €;6027;-1,39;11.264,23 €;'sin fechas';03/11/2014;'AUTOPISTA';'Gastos_Ocio y transporte';'Parking y peaje';'VARIABLES'
06/11/2014;03/11/2014;'AUTOPISTA TERR';-1,39 €;6.738,75 €;6028;-1,39;11.262,84 €;'sin fechas';03/11/2014;'AUTOPISTA';'Gastos_Ocio y transporte';'Parking y peaje';'VARIABLES'
06/11/2014;06/11/2014;'BLITZ';-72,50 €;6.666,25 €;6029;-72,50;11.190,34 €;'sin fechas';06/11/2014;'BLITZ';'Gastos_Vivienda y vehiculo';'Alquiler Parking';'FIJO'
06/11/2014;06/11/2014;'CAFET.C T PRAT';-3,65 €;6.662,60 €;6030;-3,65;11.186,69 €;'sin fechas';06/11/2014;'CAFETC';'Gastos_Ocio y transporte';'Restaurantes';'VARIABLES'
06/11/2014;06/11/2014;'FRUITES I VERDURES';-18,70 €;6.643,90 €;6031;-18,70;11.167,99 €;'sin fechas';06/11/2014;'FRUITES';'Gastos_Compras';'Supermercado';'VARIABLES'
06/11/2014;06/11/2014;'REINT.CAJERO';-20,00 €;6.623,90 €;6032;-20,00;11.147,99 €;'sin fechas';06/11/2014;'REINTCAJERO';'Gastos_Gastos varios';'Efectivo';'VARIABLES'
06/11/2014;05/11/2014;'VIENA';-9,85 €;6.614,05 €;6033;-9,85;11.138,14 €;'sin fechas';05/11/2014;'VIENA';'Gastos_Ocio y transporte';'Restaurantes';'VARIABLES'
07/11/2014;05/11/2014;'AUTOPISTA TERR';-1,39 €;6.612,66 €;6034;-1,39;11.136,75 €;'sin fechas';05/11/2014;'AUTOPISTA';'Gastos_Ocio y transporte';'Parking y peaje';'VARIABLES'
07/11/2014;05/11/2014;'AUTOPISTA TERR';-1,39 €;6.611,27 €;6035;-1,39;11.135,36 €;'sin fechas';05/11/2014;'AUTOPISTA';'Gastos_Ocio y transporte';'Parking y peaje';'VARIABLES'
07/11/2014;07/11/2014;'BON AREA';-18,30 €;6.592,97 €;6036;-18,30;11.117,06 €;'sin fechas';07/11/2014;'BON';'Gastos_Compras';'Supermercado';'VARIABLES'
07/11/2014;07/11/2014;'HOGAR&COMIDA';-29,26 €;6.563,71 €;6037;-29,26;11.087,80 €;'sin fechas';07/11/2014;'HOGARCOMIDA';'Gastos_Compras';'Supermercado';'VARIABLES'
08/11/2014;06/11/2014;'AUTOPISTA TERR';-1,39 €;6.562,32 €;6038;-1,39;11.086,41 €;'sin fechas';06/11/2014;'AUTOPISTA';'Gastos_Ocio y transporte';'Parking y peaje';'VARIABLES'
08/11/2014;06/11/2014;'AUTOPISTA TERR';-1,39 €;6.560,93 €;6039;-1,39;11.085,02 €;'sin fechas';06/11/2014;'AUTOPISTA';'Gastos_Ocio y transporte';'Parking y peaje';'VARIABLES'
08/11/2014;03/11/2014;'AUTOPISTA TERR';-4,19 €;6.556,74 €;6040;-4,19;11.080,83 €;'sin fechas';03/11/2014;'AUTOPISTA';'Gastos_Ocio y transporte';'Parking y peaje';'VARIABLES'
08/11/2014;08/11/2014;'CAFET.C T PRAT';-3,15 €;6.553,59 €;6041;-3,15;11.077,68 €;'sin fechas';08/11/2014;'CAFETC';'Gastos_Ocio y transporte';'Restaurantes';'VARIABLES'
08/11/2014;08/11/2014;'CAFET.C T PRAT';-0,75 €;6.552,84 €;6042;-0,75;11.076,93 €;'sin fechas';08/11/2014;'CAFETC';'Gastos_Ocio y transporte';'Restaurantes';'VARIABLES'
08/11/2014;08/11/2014;'CARREFOUR-[COMIDA]';-25,87 €;6.526,97 €;6043;-25,87;11.051,06 €;'sin fechas';08/11/2014;'CARREFOURCOMIDA';'Gastos_Compras';'Supermercado';'VARIABLES'
08/11/2014;08/11/2014;'ES STA. MARGARITA';-39,30 €;6.487,67 €;6044;-39,30;11.011,76 €;'sin fechas';08/11/2014;'STA';'Gastos_Ocio y transporte';'Gasolina';'VARIABLES'
08/11/2014;08/11/2014;'REINT.CAJERO';-3,50 €;6.484,17 €;6045;-3,50;11.008,26 €;'sin fechas';08/11/2014;'REINTCAJERO';'Gastos_Gastos varios';'Efectivo';'VARIABLES'
08/11/2014;08/11/2014;'REINT.CAJERO';-80,00 €;6.404,17 €;6046;-80,00;10.928,26 €;'sin fechas';08/11/2014;'REINTCAJERO';'Gastos_Gastos varios';'Efectivo';'VARIABLES'
08/11/2014;08/11/2014;'REINT.CAJERO';-3,50 €;6.400,67 €;6047;-3,50;10.924,76 €;'sin fechas';08/11/2014;'REINTCAJERO';'Gastos_Gastos varios';'Efectivo';'VARIABLES'
08/11/2014;08/11/2014;'RESTAURANTES';-15,40 €;6.385,27 €;6048;-15,40;10.909,36 €;'sin fechas';08/11/2014;'RESTAURANTES';'Gastos_Ocio y transporte';'Restaurantes';'VARIABLES'
09/11/2014;09/11/2014;'CAFET.C T PRAT';-5,85 €;6.379,42 €;6049;-5,85;10.903,51 €;'sin fechas';09/11/2014;'CAFETC';'Gastos_Ocio y transporte';'Restaurantes';'VARIABLES'
09/11/2014;09/11/2014;'CAFET.C T PRAT';-4,50 €;6.374,92 €;6050;-4,50;10.899,01 €;'sin fechas';09/11/2014;'CAFETC';'Gastos_Ocio y transporte';'Restaurantes';'VARIABLES'
09/11/2014;09/11/2014;'CAFET.C T PRAT';-4,10 €;6.370,82 €;6051;-4,10;10.894,91 €;'sin fechas';09/11/2014;'CAFETC';'Gastos_Ocio y transporte';'Restaurantes';'VARIABLES'
09/11/2014;09/11/2014;'TOCINERIES VENTURA';-16,03 €;6.354,79 €;6052;-16,03;10.878,88 €;'sin fechas';09/11/2014;'TOCINERIES';'Gastos_Compras';'Supermercado';'VARIABLES'
10/11/2014;10/11/2014;'CAFET.C T PRAT';-4,10 €;6.350,69 €;6053;-4,10;10.874,78 €;'sin fechas';10/11/2014;'CAFETC';'Gastos_Ocio y transporte';'Restaurantes';'VARIABLES'
10/11/2014;10/11/2014;'HOGAR&COMIDA';-16,55 €;6.334,14 €;6054;-16,55;10.858,23 €;'sin fechas';10/11/2014;'HOGARCOMIDA';'Gastos_Compras';'Supermercado';'VARIABLES'
10/11/2014;10/11/2014;'FRANKFURT LES LLETRES';-16,40 €;6.317,74 €;6055;-16,40;10.841,83 €;'sin fechas';10/11/2014;'FRANKFURT';'Gastos_Ocio y transporte';'Restaurantes';'VARIABLES'
10/11/2014;10/11/2014;'VIENA';-16,40 €;6.301,34 €;6056;-16,40;10.825,43 €;'sin fechas';10/11/2014;'VIENA';'Gastos_Ocio y transporte';'Restaurantes';'VARIABLES'
10/11/2014;10/11/2014;'VIRGIN-ACTIVE';-55,95 €;6.245,39 €;6058;-55,95;10.769,48 €;'sin fechas';10/11/2014;'VIRGINACTIVE';'Gastos_Salud, saber y deporte';'Deportes';'VARIABLES'
10/11/2014;10/11/2014;'VIRGIN-ACTIVE';-55,95 €;6.189,44 €;6059;-55,95;10.713,53 €;'sin fechas';10/11/2014;'VIRGINACTIVE';'Gastos_Salud, saber y deporte';'Deportes';'VARIABLES'
11/11/2014;11/11/2014;'MERCADONA';-121,52 €;6.067,92 €;6060;-121,52;10.592,01 €;'sin fechas';11/11/2014;'MERCADONA';'Gastos_Compras';'Supermercado';'VARIABLES'
11/11/2014;11/11/2014;'SALA BADRINAS - MENJADOR';-124,00 €;5.943,92 €;6061;-124,00;10.468,01 €;'sin fechas';11/11/2014;'SALA';'Gastos_Salud, saber y deporte';'Estudios';'VARIABLES'
12/11/2014;10/11/2014;'AUTOPISTA TERR';-1,32 €;5.942,60 €;6062;-1,32;10.466,69 €;'sin fechas';10/11/2014;'AUTOPISTA';'Gastos_Ocio y transporte';'Parking y peaje';'VARIABLES'
12/11/2014;10/11/2014;'AUTOPISTA TERR';-1,39 €;5.941,21 €;6063;-1,39;10.465,30 €;'sin fechas';10/11/2014;'AUTOPISTA';'Gastos_Ocio y transporte';'Parking y peaje';'VARIABLES'
12/11/2014;09/11/2014;'AUTOPISTA TERR';-2,53 €;5.938,68 €;6064;-2,53;10.462,77 €;'sin fechas';09/11/2014;'AUTOPISTA';'Gastos_Ocio y transporte';'Parking y peaje';'VARIABLES'
12/11/2014;07/11/2014;'AUTOPISTA TERR';-1,39 €;5.937,29 €;6065;-1,39;10.461,38 €;'sin fechas';07/11/2014;'AUTOPISTA';'Gastos_Ocio y transporte';'Parking y peaje';'VARIABLES'
12/11/2014;07/11/2014;'AUTOPISTA TERR';-1,39 €;5.935,90 €;6066;-1,39;10.459,99 €;'sin fechas';07/11/2014;'AUTOPISTA';'Gastos_Ocio y transporte';'Parking y peaje';'VARIABLES'
12/11/2014;07/11/2014;'AUTOPISTA TERR';-1,39 €;5.934,51 €;6067;-1,39;10.458,60 €;'sin fechas';07/11/2014;'AUTOPISTA';'Gastos_Ocio y transporte';'Parking y peaje';'VARIABLES'
12/11/2014;12/11/2014;'FRANKFURT LES LLETRES';-2,50 €;5.932,01 €;6068;-2,50;10.456,10 €;'sin fechas';12/11/2014;'FRANKFURT';'Gastos_Ocio y transporte';'Restaurantes';'VARIABLES'
13/11/2014;11/11/2014;'AUTOPISTA TERR';-1,32 €;5.930,69 €;6069;-1,32;10.454,78 €;'sin fechas';11/11/2014;'AUTOPISTA';'Gastos_Ocio y transporte';'Parking y peaje';'VARIABLES'
13/11/2014;11/11/2014;'AUTOPISTA TERR';-1,32 €;5.929,37 €;6070;-1,32;10.453,46 €;'sin fechas';11/11/2014;'AUTOPISTA';'Gastos_Ocio y transporte';'Parking y peaje';'VARIABLES'
13/11/2014;08/11/2014;'AUTOPISTA TERR';-4,19 €;5.925,18 €;6071;-4,19;10.449,27 €;'sin fechas';08/11/2014;'AUTOPISTA';'Gastos_Ocio y transporte';'Parking y peaje';'VARIABLES'
13/11/2014;13/11/2014;'CAFET.C T PRAT';-3,15 €;5.922,03 €;6072;-3,15;10.446,12 €;'sin fechas';13/11/2014;'CAFETC';'Gastos_Ocio y transporte';'Restaurantes';'VARIABLES'
13/11/2014;12/11/2014;'ES STA. MARGARITA';-12,75 €;5.909,28 €;6073;-12,75;10.433,37 €;'sin fechas';12/11/2014;'STA';'Gastos_Ocio y transporte';'Gasolina';'VARIABLES'
13/11/2014;13/11/2014;'FRUITES I VERDURES';-5,38 €;5.903,90 €;6074;-5,38;10.427,99 €;'sin fechas';13/11/2014;'FRUITES';'Gastos_Compras';'Supermercado';'VARIABLES'
13/11/2014;13/11/2014;'FRANKFURT LES LLETRES';-2,50 €;5.901,40 €;6075;-2,50;10.425,49 €;'sin fechas';13/11/2014;'FRANKFURT';'Gastos_Ocio y transporte';'Restaurantes';'VARIABLES'
14/11/2014;10/11/2014;'AUTOPISTA TERR';-10,60 €;5.890,80 €;6076;-10,60;10.414,89 €;'sin fechas';10/11/2014;'AUTOPISTA';'Gastos_Ocio y transporte';'Parking y peaje';'VARIABLES'
14/11/2014;10/11/2014;'AUTOPISTA TERR';-7,15 €;5.883,65 €;6077;-7,15;10.407,74 €;'sin fechas';10/11/2014;'AUTOPISTA';'Gastos_Ocio y transporte';'Parking y peaje';'VARIABLES'
14/11/2014;12/11/2014;'AUTOPISTA TERR';-1,32 €;5.882,33 €;6078;-1,32;10.406,42 €;'sin fechas';12/11/2014;'AUTOPISTA';'Gastos_Ocio y transporte';'Parking y peaje';'VARIABLES'
14/11/2014;12/11/2014;'AUTOPISTA TERR';-1,39 €;5.880,94 €;6079;-1,39;10.405,03 €;'sin fechas';12/11/2014;'AUTOPISTA';'Gastos_Ocio y transporte';'Parking y peaje';'VARIABLES'
14/11/2014;14/11/2014;'CAFET.C T PRAT';-2,70 €;5.878,24 €;6080;-2,70;10.402,33 €;'sin fechas';14/11/2014;'CAFETC';'Gastos_Ocio y transporte';'Restaurantes';'VARIABLES'
14/11/2014;14/11/2014;'FRANKFURT LES LLETRES';-2,50 €;5.875,74 €;6081;-2,50;10.399,83 €;'sin fechas';14/11/2014;'FRANKFURT';'Gastos_Ocio y transporte';'Restaurantes';'VARIABLES'
14/11/2014;14/11/2014;'REINT.CAJERO';-30,00 €;5.845,74 €;6082;-30,00;10.369,83 €;'sin fechas';14/11/2014;'REINTCAJERO';'Gastos_Gastos varios';'Efectivo';'VARIABLES'
14/11/2014;14/11/2014;'REINT.CAJERO';-30,00 €;5.815,74 €;6083;-30,00;10.339,83 €;'sin fechas';14/11/2014;'REINTCAJERO';'Gastos_Gastos varios';'Efectivo';'VARIABLES'
14/11/2014;14/11/2014;'TOCINERIES VENTURA';-15,37 €;5.800,37 €;6084;-15,37;10.324,46 €;'sin fechas';14/11/2014;'TOCINERIES';'Gastos_Compras';'Supermercado';'VARIABLES'
15/11/2014;13/11/2014;'AUTOPISTA TERR';-1,25 €;5.799,12 €;6085;-1,25;10.323,21 €;'sin fechas';13/11/2014;'AUTOPISTA';'Gastos_Ocio y transporte';'Parking y peaje';'VARIABLES'
15/11/2014;13/11/2014;'AUTOPISTA TERR';-1,32 €;5.797,80 €;6086;-1,32;10.321,89 €;'sin fechas';13/11/2014;'AUTOPISTA';'Gastos_Ocio y transporte';'Parking y peaje';'VARIABLES'
15/11/2014;15/11/2014;'CAFET.C T PRAT';-3,65 €;5.794,15 €;6087;-3,65;10.318,24 €;'sin fechas';15/11/2014;'CAFETC';'Gastos_Ocio y transporte';'Restaurantes';'VARIABLES'
15/11/2014;15/11/2014;'CAFET.C T PRAT';-4,50 €;5.789,65 €;6088;-4,50;10.313,74 €;'sin fechas';15/11/2014;'CAFETC';'Gastos_Ocio y transporte';'Restaurantes';'VARIABLES'
15/11/2014;15/11/2014;'CARREFOUR-[COMIDA]';-32,05 €;5.757,60 €;6089;-32,05;10.281,69 €;'sin fechas';15/11/2014;'CARREFOURCOMIDA';'Gastos_Compras';'Supermercado';'VARIABLES'
15/11/2014;15/11/2014;'ES STA. MARGARITA';-20,00 €;5.737,60 €;6090;-20,00;10.261,69 €;'sin fechas';15/11/2014;'STA';'Gastos_Ocio y transporte';'Gasolina';'VARIABLES'
15/11/2014;15/11/2014;'FRUITES I VERDURES';-8,07 €;5.729,53 €;6091;-8,07;10.253,62 €;'sin fechas';15/11/2014;'FRUITES';'Gastos_Compras';'Supermercado';'VARIABLES'
16/11/2014;16/11/2014;'VIENA';-19,65 €;5.709,88 €;6092;-19,65;10.233,97 €;'sin fechas';16/11/2014;'VIENA';'Gastos_Ocio y transporte';'Restaurantes';'VARIABLES'
17/11/2014;12/11/2014;'AUTOPISTA TERR';-10,60 €;5.699,28 €;6093;-10,60;10.223,37 €;'sin fechas';12/11/2014;'AUTOPISTA';'Gastos_Ocio y transporte';'Parking y peaje';'VARIABLES'
17/11/2014;12/11/2014;'AUTOPISTA TERR';-7,15 €;5.692,13 €;6094;-7,15;10.216,22 €;'sin fechas';12/11/2014;'AUTOPISTA';'Gastos_Ocio y transporte';'Parking y peaje';'VARIABLES'
17/11/2014;13/11/2014;'AUTOPISTA TERR';-4,19 €;5.687,94 €;6095;-4,19;10.212,03 €;'sin fechas';13/11/2014;'AUTOPISTA';'Gastos_Ocio y transporte';'Parking y peaje';'VARIABLES'
17/11/2014;17/11/2014;'CAFET.C T PRAT';-3,65 €;5.684,29 €;6096;-3,65;10.208,38 €;'sin fechas';17/11/2014;'CAFETC';'Gastos_Ocio y transporte';'Restaurantes';'VARIABLES'
17/11/2014;17/11/2014;'CCM VIDA Y P SEGURO PRESTAMO';-17,65 €;5.666,64 €;6097;-17,65;10.190,73 €;'sin fechas';17/11/2014;'CCM';'Gastos_Seguros';'Seguro vida';'FIJO'
17/11/2014;17/11/2014;'CCM VIDA Y PENSIO 000000493358';-23,37 €;5.643,27 €;6098;-23,37;10.167,36 €;'sin fechas';17/11/2014;'CCM';'Gastos_Seguros';'Seguro vida';'FIJO'
17/11/2014;17/11/2014;'FRANKFURT LES LLETRES';-2,50 €;5.640,77 €;6099;-2,50;10.164,86 €;'sin fechas';17/11/2014;'FRANKFURT';'Gastos_Ocio y transporte';'Restaurantes';'VARIABLES'
17/11/2014;17/11/2014;'ONO';-112,41 €;5.528,36 €;6100;-112,41;10.052,45 €;'sin fechas';17/11/2014;'ONO';'Gastos_Servicios tipicos';'Telecomunicaciones';'FIJO'
17/11/2014;17/11/2014;'REINT.CAJERO';-40,00 €;5.488,36 €;6101;-40,00;10.012,45 €;'sin fechas';17/11/2014;'REINTCAJERO';'Gastos_Gastos varios';'Efectivo';'VARIABLES'
18/11/2014;14/11/2014;'AUTOPISTA TERR';-1,25 €;5.487,11 €;6102;-1,25;10.011,20 €;'sin fechas';14/11/2014;'AUTOPISTA';'Gastos_Ocio y transporte';'Parking y peaje';'VARIABLES'
18/11/2014;14/11/2014;'AUTOPISTA TERR';-1,39 €;5.485,72 €;6103;-1,39;10.009,81 €;'sin fechas';14/11/2014;'AUTOPISTA';'Gastos_Ocio y transporte';'Parking y peaje';'VARIABLES'
19/11/2014;17/11/2014;'AUTOPISTA TERR';-1,25 €;5.484,47 €;6104;-1,25;10.008,56 €;'sin fechas';17/11/2014;'AUTOPISTA';'Gastos_Ocio y transporte';'Parking y peaje';'VARIABLES'
19/11/2014;17/11/2014;'AUTOPISTA TERR';-1,39 €;5.483,08 €;6105;-1,39;10.007,17 €;'sin fechas';17/11/2014;'AUTOPISTA';'Gastos_Ocio y transporte';'Parking y peaje';'VARIABLES'
19/11/2014;19/11/2014;'SALA BADRINAS - QUOTA';-57,00 €;5.426,08 €;6106;-57,00;9.950,17 €;'sin fechas';19/11/2014;'SALA';'Gastos_Salud, saber y deporte';'Estudios';'VARIABLES'
20/11/2014;18/11/2014;'AUTOPISTA TERR';-1,25 €;5.424,83 €;6107;-1,25;9.948,92 €;'sin fechas';18/11/2014;'AUTOPISTA';'Gastos_Ocio y transporte';'Parking y peaje';'VARIABLES'
20/11/2014;18/11/2014;'AUTOPISTA TERR';-1,39 €;5.423,44 €;6108;-1,39;9.947,53 €;'sin fechas';18/11/2014;'AUTOPISTA';'Gastos_Ocio y transporte';'Parking y peaje';'VARIABLES'
20/11/2014;20/11/2014;'CAFET.C T PRAT';-3,65 €;5.419,79 €;6109;-3,65;9.943,88 €;'sin fechas';20/11/2014;'CAFETC';'Gastos_Ocio y transporte';'Restaurantes';'VARIABLES'
20/11/2014;19/11/2014;'ES STA. MARGARITA';-40,11 €;5.379,68 €;6110;-40,11;9.903,77 €;'sin fechas';19/11/2014;'STA';'Gastos_Ocio y transporte';'Gasolina';'VARIABLES'
20/11/2014;18/11/2014;'RESTAURANTES';-21,15 €;5.358,53 €;6111;-21,15;9.882,62 €;'sin fechas';18/11/2014;'RESTAURANTES';'Gastos_Ocio y transporte';'Restaurantes';'VARIABLES'
21/11/2014;19/11/2014;'AUTOPISTA TERR';-1,25 €;5.357,28 €;6112;-1,25;9.881,37 €;'sin fechas';19/11/2014;'AUTOPISTA';'Gastos_Ocio y transporte';'Parking y peaje';'VARIABLES'
21/11/2014;19/11/2014;'AUTOPISTA TERR';-1,25 €;5.356,03 €;6113;-1,25;9.880,12 €;'sin fechas';19/11/2014;'AUTOPISTA';'Gastos_Ocio y transporte';'Parking y peaje';'VARIABLES'
21/11/2014;21/11/2014;'CAFET.C T PRAT';-2,25 €;5.353,78 €;6114;-2,25;9.877,87 €;'sin fechas';21/11/2014;'CAFETC';'Gastos_Ocio y transporte';'Restaurantes';'VARIABLES'
21/11/2014;21/11/2014;'REINT.CAJERO';-100,00 €;5.253,78 €;6115;-100,00;9.777,87 €;'sin fechas';21/11/2014;'REINTCAJERO';'Gastos_Gastos varios';'Efectivo';'VARIABLES'
22/11/2014;20/11/2014;'AUTOPISTA TERR';-1,25 €;5.252,53 €;6116;-1,25;9.776,62 €;'sin fechas';20/11/2014;'AUTOPISTA';'Gastos_Ocio y transporte';'Parking y peaje';'VARIABLES'
22/11/2014;20/11/2014;'AUTOPISTA TERR';-1,39 €;5.251,14 €;6117;-1,39;9.775,23 €;'sin fechas';20/11/2014;'AUTOPISTA';'Gastos_Ocio y transporte';'Parking y peaje';'VARIABLES'
22/11/2014;22/11/2014;'CAFET.C T PRAT';-3,50 €;5.247,64 €;6118;-3,50;9.771,73 €;'sin fechas';22/11/2014;'CAFETC';'Gastos_Ocio y transporte';'Restaurantes';'VARIABLES'
22/11/2014;22/11/2014;'FRANKFURT LES LLETRES';-5,00 €;5.242,64 €;6119;-5,00;9.766,73 €;'sin fechas';22/11/2014;'FRANKFURT';'Gastos_Ocio y transporte';'Restaurantes';'VARIABLES'
22/11/2014;22/11/2014;'FRANKFURT LES LLETRES';-5,50 €;5.237,14 €;6120;-5,50;9.761,23 €;'sin fechas';22/11/2014;'FRANKFURT';'Gastos_Ocio y transporte';'Restaurantes';'VARIABLES'
23/11/2014;20/11/2014;'AUTOPISTA TERR';-4,19 €;5.232,95 €;6121;-4,19;9.757,04 €;'sin fechas';20/11/2014;'AUTOPISTA';'Gastos_Ocio y transporte';'Parking y peaje';'VARIABLES'
23/11/2014;23/11/2014;'BON AREA';-27,92 €;5.205,03 €;6122;-27,92;9.729,12 €;'sin fechas';23/11/2014;'BON';'Gastos_Compras';'Supermercado';'VARIABLES'
23/11/2014;23/11/2014;'CAFET.C T PRAT';-2,70 €;5.202,33 €;6123;-2,70;9.726,42 €;'sin fechas';23/11/2014;'CAFETC';'Gastos_Ocio y transporte';'Restaurantes';'VARIABLES'
23/11/2014;23/11/2014;'FRANKFURT LES LLETRES';-2,50 €;5.199,83 €;6124;-2,50;9.723,92 €;'sin fechas';23/11/2014;'FRANKFURT';'Gastos_Ocio y transporte';'Restaurantes';'VARIABLES'
23/11/2014;23/11/2014;'VILAR RURAL';-65,00 €;5.134,83 €;6125;-65,00;9.658,92 €;'sin fechas';23/11/2014;'VILAR';'Gastos_Ocio y transporte';'Vacaciones';'VARIABLES'
24/11/2014;24/11/2014;'CAFET.C T PRAT';-3,60 €;5.131,23 €;6126;-3,60;9.655,32 €;'sin fechas';24/11/2014;'CAFETC';'Gastos_Ocio y transporte';'Restaurantes';'VARIABLES'
25/11/2014;22/11/2014;'AUTOPISTA TERR';-2,53 €;5.128,70 €;6127;-2,53;9.652,79 €;'sin fechas';22/11/2014;'AUTOPISTA';'Gastos_Ocio y transporte';'Parking y peaje';'VARIABLES'
25/11/2014;21/11/2014;'AUTOPISTA TERR';-1,25 €;5.127,45 €;6128;-1,25;9.651,54 €;'sin fechas';21/11/2014;'AUTOPISTA';'Gastos_Ocio y transporte';'Parking y peaje';'VARIABLES'
25/11/2014;21/11/2014;'AUTOPISTA TERR';-1,25 €;5.126,20 €;6129;-1,25;9.650,29 €;'sin fechas';21/11/2014;'AUTOPISTA';'Gastos_Ocio y transporte';'Parking y peaje';'VARIABLES'
26/11/2014;24/11/2014;'AUTOPISTA TERR';-1,25 €;5.124,95 €;6130;-1,25;9.649,04 €;'sin fechas';24/11/2014;'AUTOPISTA';'Gastos_Ocio y transporte';'Parking y peaje';'VARIABLES'
26/11/2014;24/11/2014;'AUTOPISTA TERR';-1,39 €;5.123,56 €;6131;-1,39;9.647,65 €;'sin fechas';24/11/2014;'AUTOPISTA';'Gastos_Ocio y transporte';'Parking y peaje';'VARIABLES'
27/11/2014;25/11/2014;'AUTOPISTA TERR';-1,11 €;5.122,45 €;6132;-1,11;9.646,54 €;'sin fechas';25/11/2014;'AUTOPISTA';'Gastos_Ocio y transporte';'Parking y peaje';'VARIABLES'
27/11/2014;25/11/2014;'AUTOPISTA TERR';-1,39 €;5.121,06 €;6133;-1,39;9.645,15 €;'sin fechas';25/11/2014;'AUTOPISTA';'Gastos_Ocio y transporte';'Parking y peaje';'VARIABLES'
27/11/2014;27/11/2014;'CAFET.C T PRAT';-3,65 €;5.117,41 €;6134;-3,65;9.641,50 €;'sin fechas';27/11/2014;'CAFETC';'Gastos_Ocio y transporte';'Restaurantes';'VARIABLES'
27/11/2014;25/11/2014;'COCHE&PARKING';-11,80 €;5.105,61 €;6135;-11,80;9.629,70 €;'sin fechas';25/11/2014;'COCHEPARKING';'Gastos_Ocio y transporte';'Parking y peaje';'VARIABLES'
27/11/2014;25/11/2014;'RESTAURANTES';-22,80 €;5.082,81 €;6136;-22,80;9.606,90 €;'sin fechas';25/11/2014;'RESTAURANTES';'Gastos_Ocio y transporte';'Restaurantes';'VARIABLES'
28/11/2014;28/11/2014;'AJUNTAMENT DE TER 850000031046';-44,87 €;5.037,94 €;6137;-44,87;9.562,03 €;'sin fechas';28/11/2014;'AJUNTAMENT';'Gastos_Banco y organismos';'Ayuntamiento';'FIJO'
28/11/2014;26/11/2014;'AUTOPISTA TERR';-1,11 €;5.036,83 €;6138;-1,11;9.560,92 €;'sin fechas';26/11/2014;'AUTOPISTA';'Gastos_Ocio y transporte';'Parking y peaje';'VARIABLES'
28/11/2014;26/11/2014;'AUTOPISTA TERR';-1,39 €;5.035,44 €;6139;-1,39;9.559,53 €;'sin fechas';26/11/2014;'AUTOPISTA';'Gastos_Ocio y transporte';'Parking y peaje';'VARIABLES'
28/11/2014;28/11/2014;'CAFET.C T PRAT';-2,15 €;5.033,29 €;6140;-2,15;9.557,38 €;'sin fechas';28/11/2014;'CAFETC';'Gastos_Ocio y transporte';'Restaurantes';'VARIABLES'
28/11/2014;28/11/2014;'FOMENT DE TERRASSA, S.A. FOMEN';1.528,97 €;6.562,26 €;6141;1.528,97;11.086,35 €;'sin fechas';28/11/2014;'FOMENT';'Ingresos';'Nomina';'FIJO'
28/11/2014;28/11/2014;'FRUITES I VERDURES';-7,99 €;6.554,27 €;6142;-7,99;11.078,36 €;'sin fechas';28/11/2014;'FRUITES';'Gastos_Compras';'Supermercado';'VARIABLES'
28/11/2014;28/11/2014;'INFORMACIO I TECNOLOGIA DE CAT';1.573,85 €;8.128,12 €;6143;1.573,85;12.652,21 €;'sin fechas';28/11/2014;'INFORMACIO';'Ingresos';'Nomina';'FIJO'
28/11/2014;28/11/2014;'REINT.CAJERO';-80,00 €;8.048,12 €;6144;-80,00;12.572,21 €;'sin fechas';28/11/2014;'REINTCAJERO';'Gastos_Gastos varios';'Efectivo';'VARIABLES'
29/11/2014;25/11/2014;'AUTOPISTA TERR';-3,73 €;8.044,39 €;6145;-3,73;12.568,48 €;'sin fechas';25/11/2014;'AUTOPISTA';'Gastos_Ocio y transporte';'Parking y peaje';'VARIABLES'
29/11/2014;27/11/2014;'AUTOPISTA TERR';-1,11 €;8.043,28 €;6146;-1,11;12.567,37 €;'sin fechas';27/11/2014;'AUTOPISTA';'Gastos_Ocio y transporte';'Parking y peaje';'VARIABLES'
29/11/2014;27/11/2014;'AUTOPISTA TERR';-1,11 €;8.042,17 €;6147;-1,11;12.566,26 €;'sin fechas';27/11/2014;'AUTOPISTA';'Gastos_Ocio y transporte';'Parking y peaje';'VARIABLES'
29/11/2014;29/11/2014;'CAFET.C T PRAT';-3,65 €;8.038,52 €;6149;-3,65;12.562,61 €;'sin fechas';29/11/2014;'CAFETC';'Gastos_Ocio y transporte';'Restaurantes';'VARIABLES'
29/11/2014;25/11/2014;'COCHE&PARKING';-7,55 €;8.030,97 €;6150;-7,55;12.555,06 €;'sin fechas';25/11/2014;'COCHEPARKING';'Gastos_Ocio y transporte';'Parking y peaje';'VARIABLES'
29/11/2014;29/11/2014;'ES STA. MARGARITA';-47,40 €;7.983,57 €;6151;-47,40;12.507,66 €;'sin fechas';29/11/2014;'STA';'Gastos_Ocio y transporte';'Gasolina';'VARIABLES'
29/11/2014;29/11/2014;'FRUITES I VERDURES';-4,20 €;7.979,37 €;6154;-4,20;12.503,46 €;'sin fechas';29/11/2014;'FRUITES';'Gastos_Compras';'Supermercado';'VARIABLES'
29/11/2014;29/11/2014;'MERCADONA';-20,71 €;7.958,66 €;6156;-20,71;12.482,75 €;'sin fechas';29/11/2014;'MERCADONA';'Gastos_Compras';'Supermercado';'VARIABLES'
30/11/2014;27/11/2014;'AUTOPISTA TERR';-4,19 €;7.954,47 €;6160;-4,19;12.478,56 €;'sin fechas';27/11/2014;'AUTOPISTA';'Gastos_Ocio y transporte';'Parking y peaje';'VARIABLES'
30/11/2014;30/11/2014;'CAFET.C T PRAT';-2,70 €;7.951,77 €;6161;-2,70;12.475,86 €;'sin fechas';30/11/2014;'CAFETC';'Gastos_Ocio y transporte';'Restaurantes';'VARIABLES'
30/11/2014;30/11/2014;'RECIBO PTMOS. 3061-0960001518';-547,25 €;7.404,52 €;6162;-547,25;11.928,61 €;'sin fechas';30/11/2014;'RECIBO';'Gastos_Banco y organismos';'Hipoteca';'FIJO'
30/11/2014;30/11/2014;'VILAR RURAL';-252,30 €;7.152,22 €;6163;-252,30;11.676,31 €;'sin fechas';30/11/2014;'VILAR';'Gastos_Ocio y transporte';'Vacaciones';'VARIABLES'
01/12/2014;28/11/2014;'AUTOPISTA TERR';-4,19 €;7.148,03 €;6164;-4,19;11.672,12 €;'sin fechas';28/11/2014;'AUTOPISTA';'Gastos_Ocio y transporte';'Parking y peaje';'VARIABLES'
01/12/2014;01/12/2014;'CAFET.C T PRAT';-3,65 €;7.144,38 €;6165;-3,65;11.668,47 €;'sin fechas';01/12/2014;'CAFETC';'Gastos_Ocio y transporte';'Restaurantes';'VARIABLES'
01/12/2014;01/12/2014;'ESCOLA BRESSOL EINA';-463,75 €;6.680,63 €;6166;-463,75;11.204,72 €;'sin fechas';01/12/2014;'ESCOLA';'Gastos_Salud, saber y deporte';'Estudios';'VARIABLES'
01/12/2014;01/12/2014;'FARMACIA';-12,00 €;6.668,63 €;6167;-12,00;11.192,72 €;'sin fechas';01/12/2014;'FARMACIA';'Gastos_Salud, saber y deporte';'Farmacia';'VARIABLES'
01/12/2014;01/12/2014;'FRANKFURT LES LLETRES';-3,70 €;6.664,93 €;6168;-3,70;11.189,02 €;'sin fechas';01/12/2014;'FRANKFURT';'Gastos_Ocio y transporte';'Restaurantes';'VARIABLES'
02/12/2014;29/11/2014;'AUTOPISTA TERR';-4,19 €;6.660,74 €;6170;-4,19;11.184,83 €;'sin fechas';29/11/2014;'AUTOPISTA';'Gastos_Ocio y transporte';'Parking y peaje';'VARIABLES'
02/12/2014;30/11/2014;'AUTOPISTA TERR';-7,73 €;6.653,01 €;6171;-7,73;11.177,10 €;'sin fechas';30/11/2014;'AUTOPISTA';'Gastos_Ocio y transporte';'Parking y peaje';'VARIABLES'
02/12/2014;28/11/2014;'AUTOPISTA TERR';-1,39 €;6.651,62 €;6172;-1,39;11.175,71 €;'sin fechas';28/11/2014;'AUTOPISTA';'Gastos_Ocio y transporte';'Parking y peaje';'VARIABLES'
02/12/2014;28/11/2014;'AUTOPISTA TERR';-1,11 €;6.650,51 €;6173;-1,11;11.174,60 €;'sin fechas';28/11/2014;'AUTOPISTA';'Gastos_Ocio y transporte';'Parking y peaje';'VARIABLES'
02/12/2014;28/11/2014;'AUTOPISTA TERR';-1,11 €;6.649,40 €;6174;-1,11;11.173,49 €;'sin fechas';28/11/2014;'AUTOPISTA';'Gastos_Ocio y transporte';'Parking y peaje';'VARIABLES'
02/12/2014;28/11/2014;'AUTOPISTA TERR';-1,11 €;6.648,29 €;6175;-1,11;11.172,38 €;'sin fechas';28/11/2014;'AUTOPISTA';'Gastos_Ocio y transporte';'Parking y peaje';'VARIABLES'
02/12/2014;28/11/2014;'AUTOPISTA TERR';-4,25 €;6.644,04 €;6176;-4,25;11.168,13 €;'sin fechas';28/11/2014;'AUTOPISTA';'Gastos_Ocio y transporte';'Parking y peaje';'VARIABLES'
03/12/2014;01/12/2014;'AUTOPISTA TERR';-3,73 €;6.640,31 €;6177;-3,73;11.164,40 €;'sin fechas';01/12/2014;'AUTOPISTA';'Gastos_Ocio y transporte';'Parking y peaje';'VARIABLES'
03/12/2014;03/12/2014;'CAJA DE SEGUROS R 300045047898';-394,54 €;6.245,77 €;6178;-394,54;10.769,86 €;'sin fechas';03/12/2014;'CAJA';'Gastos_Seguros';'Seguro hogar';'FIJO'
04/12/2014;04/12/2014;'AUTOPISTA TERR';-4,19 €;6.241,58 €;6179;-4,19;10.765,67 €;'sin fechas';04/12/2014;'AUTOPISTA';'Gastos_Ocio y transporte';'Parking y peaje';'VARIABLES'
04/12/2014;01/12/2014;'AUTOPISTA TERR';-1,39 €;6.240,19 €;6180;-1,39;10.764,28 €;'sin fechas';01/12/2014;'AUTOPISTA';'Gastos_Ocio y transporte';'Parking y peaje';'VARIABLES'
04/12/2014;01/12/2014;'AUTOPISTA TERR';-1,39 €;6.238,80 €;6181;-1,39;10.762,89 €;'sin fechas';01/12/2014;'AUTOPISTA';'Gastos_Ocio y transporte';'Parking y peaje';'VARIABLES'
04/12/2014;04/12/2014;'CAFET.C T PRAT';-3,50 €;6.235,30 €;6182;-3,50;10.759,39 €;'sin fechas';04/12/2014;'CAFETC';'Gastos_Ocio y transporte';'Restaurantes';'VARIABLES'
04/12/2014;04/12/2014;'FRUITES I VERDURES';-8,69 €;6.226,61 €;6183;-8,69;10.750,70 €;'sin fechas';04/12/2014;'FRUITES';'Gastos_Compras';'Supermercado';'VARIABLES'
04/12/2014;04/12/2014;'REINT.CAJERO';-50,00 €;6.176,61 €;6184;-50,00;10.700,70 €;'sin fechas';04/12/2014;'REINTCAJERO';'Gastos_Gastos varios';'Efectivo';'VARIABLES'
05/12/2014;05/12/2014;'ADESLAS CENTRAL 006662671613';-110,99 €;6.065,62 €;6185;-110,99;10.589,71 €;'sin fechas';05/12/2014;'ADESLAS';'Gastos_Salud, saber y deporte';'Medico';'VARIABLES'
05/12/2014;05/12/2014;'AUTOPISTA TERR';-4,19 €;6.061,43 €;6186;-4,19;10.585,52 €;'sin fechas';05/12/2014;'AUTOPISTA';'Gastos_Ocio y transporte';'Parking y peaje';'VARIABLES'
05/12/2014;03/12/2014;'AUTOPISTA TERR';-1,39 €;6.060,04 €;6187;-1,39;10.584,13 €;'sin fechas';03/12/2014;'AUTOPISTA';'Gastos_Ocio y transporte';'Parking y peaje';'VARIABLES'
05/12/2014;03/12/2014;'AUTOPISTA TERR';-1,39 €;6.058,65 €;6188;-1,39;10.582,74 €;'sin fechas';03/12/2014;'AUTOPISTA';'Gastos_Ocio y transporte';'Parking y peaje';'VARIABLES'
05/12/2014;02/12/2014;'AUTOPISTA TERR';-1,39 €;6.057,26 €;6189;-1,39;10.581,35 €;'sin fechas';02/12/2014;'AUTOPISTA';'Gastos_Ocio y transporte';'Parking y peaje';'VARIABLES'
05/12/2014;02/12/2014;'AUTOPISTA TERR';-1,39 €;6.055,87 €;6190;-1,39;10.579,96 €;'sin fechas';02/12/2014;'AUTOPISTA';'Gastos_Ocio y transporte';'Parking y peaje';'VARIABLES'
05/12/2014;05/12/2014;'BON AREA';-37,22 €;6.018,65 €;6191;-37,22;10.542,74 €;'sin fechas';05/12/2014;'BON';'Gastos_Compras';'Supermercado';'VARIABLES'
05/12/2014;05/12/2014;'CAFET.C T PRAT';-3,60 €;6.015,05 €;6192;-3,60;10.539,14 €;'sin fechas';05/12/2014;'CAFETC';'Gastos_Ocio y transporte';'Restaurantes';'VARIABLES'
05/12/2014;05/12/2014;'FRANKFURT LES LLETRES';-5,15 €;6.009,90 €;6193;-5,15;10.533,99 €;'sin fechas';05/12/2014;'FRANKFURT';'Gastos_Ocio y transporte';'Restaurantes';'VARIABLES'
05/12/2014;05/12/2014;'REINT.CAJERO';-30,00 €;5.979,90 €;6194;-30,00;10.503,99 €;'sin fechas';05/12/2014;'REINTCAJERO';'Gastos_Gastos varios';'Efectivo';'VARIABLES'
05/12/2014;05/12/2014;'VIRGIN-ACTIVE';-55,95 €;5.923,95 €;6195;-55,95;10.448,04 €;'sin fechas';05/12/2014;'VIRGINACTIVE';'Gastos_Salud, saber y deporte';'Deportes';'VARIABLES'
05/12/2014;05/12/2014;'VIRGIN-ACTIVE';-55,95 €;5.868,00 €;6196;-55,95;10.392,09 €;'sin fechas';05/12/2014;'VIRGINACTIVE';'Gastos_Salud, saber y deporte';'Deportes';'VARIABLES'
06/12/2014;04/12/2014;'AUTOPISTA TERR';-1,39 €;5.866,61 €;6197;-1,39;10.390,70 €;'sin fechas';04/12/2014;'AUTOPISTA';'Gastos_Ocio y transporte';'Parking y peaje';'VARIABLES'
06/12/2014;06/12/2014;'CAFET.C T PRAT';-3,65 €;5.862,96 €;6198;-3,65;10.387,05 €;'sin fechas';06/12/2014;'CAFETC';'Gastos_Ocio y transporte';'Restaurantes';'VARIABLES'
06/12/2014;06/12/2014;'MEDIA MARKT';-89,00 €;5.773,96 €;6199;-89,00;10.298,05 €;'sin fechas';06/12/2014;'MEDIA';'Gastos_Compras';'Hobbys';'VARIABLES'
06/12/2014;06/12/2014;'PERRUQUERIA';-17,40 €;5.756,56 €;6200;-17,40;10.280,65 €;'sin fechas';06/12/2014;'PERRUQUERIA';'Gastos_Salud, saber y deporte';'Belleza';'VARIABLES'
06/12/2014;06/12/2014;'RESTAURANTES';-10,00 €;5.746,56 €;6201;-10,00;10.270,65 €;'sin fechas';06/12/2014;'RESTAURANTES';'Gastos_Ocio y transporte';'Restaurantes';'VARIABLES'
07/12/2014;07/12/2014;'CAFET.C T PRAT';-3,60 €;5.742,96 €;6202;-3,60;10.267,05 €;'sin fechas';07/12/2014;'CAFETC';'Gastos_Ocio y transporte';'Restaurantes';'VARIABLES'
07/12/2014;07/12/2014;'FARMACIA';-39,50 €;5.703,46 €;6203;-39,50;10.227,55 €;'sin fechas';07/12/2014;'FARMACIA';'Gastos_Salud, saber y deporte';'Farmacia';'VARIABLES'
07/12/2014;07/12/2014;'INTERKITS';-59,99 €;5.643,47 €;6204;-59,99;10.167,56 €;'sin fechas';07/12/2014;'INTERKITS';'Gastos_Compras';'Niños';'VARIABLES'
08/12/2014;08/12/2014;'CAFET.C T PRAT';-4,50 €;5.638,97 €;6205;-4,50;10.163,06 €;'sin fechas';08/12/2014;'CAFETC';'Gastos_Ocio y transporte';'Restaurantes';'VARIABLES'
08/12/2014;08/12/2014;'CAFET.C T PRAT';-3,65 €;5.635,32 €;6206;-3,65;10.159,41 €;'sin fechas';08/12/2014;'CAFETC';'Gastos_Ocio y transporte';'Restaurantes';'VARIABLES'
09/12/2014;06/12/2014;'ASDA HOME SHOPPING';-438,58 €;5.196,74 €;6207;-438,58;9.720,83 €;'sin fechas';06/12/2014;'ASDA';'Gastos_Gastos varios';'Otros gastos';'VARIABLES'
09/12/2014;05/12/2014;'BLINKBOX';-7,31 €;5.189,43 €;6208;-7,31;9.713,52 €;'sin fechas';05/12/2014;'BLINKBOX';'Gastos_Gastos varios';'Otros gastos';'VARIABLES'
09/12/2014;05/12/2014;'BLINKBOX';-1,33 €;5.188,10 €;6209;-1,33;9.712,19 €;'sin fechas';05/12/2014;'BLINKBOX';'Gastos_Gastos varios';'Otros gastos';'VARIABLES'
09/12/2014;06/12/2014;'ECHST.NET';-2,14 €;5.185,96 €;6210;-2,14;9.710,05 €;'sin fechas';06/12/2014;'ECHSTNET';'Gastos_Gastos varios';'Otros gastos';'VARIABLES'
09/12/2014;09/12/2014;'EROSKI-[OTROS]';-7,44 €;5.178,52 €;6211;-7,44;9.702,61 €;'sin fechas';09/12/2014;'EROSKIOTROS';'Gastos_Compras';'Supermercado';'VARIABLES'
09/12/2014;09/12/2014;'ES STA. MARGARITA';-45,54 €;5.132,98 €;6212;-45,54;9.657,07 €;'sin fechas';09/12/2014;'STA';'Gastos_Ocio y transporte';'Gasolina';'VARIABLES'
09/12/2014;09/12/2014;'GAS NATURAL';-195,20 €;4.937,78 €;6213;-195,20;9.461,87 €;'sin fechas';09/12/2014;'GAS';'Gastos_Servicios tipicos';'Gas';'FIJO'
09/12/2014;09/12/2014;'RESTAURANTES';-21,20 €;4.916,58 €;6214;-21,20;9.440,67 €;'sin fechas';09/12/2014;'RESTAURANTES';'Gastos_Ocio y transporte';'Restaurantes';'VARIABLES'
09/12/2014;09/12/2014;'SALA BADRINAS - MENJADOR';-93,00 €;4.823,58 €;6215;-93,00;9.347,67 €;'sin fechas';09/12/2014;'SALA';'Gastos_Salud, saber y deporte';'Estudios';'VARIABLES'
09/12/2014;09/12/2014;'VIENA';-22,60 €;4.800,98 €;6216;-22,60;9.325,07 €;'sin fechas';09/12/2014;'VIENA';'Gastos_Ocio y transporte';'Restaurantes';'VARIABLES'
10/12/2014;06/12/2014;'AUTOPISTA TERR';-2,53 €;4.798,45 €;6217;-2,53;9.322,54 €;'sin fechas';06/12/2014;'AUTOPISTA';'Gastos_Ocio y transporte';'Parking y peaje';'VARIABLES'
10/12/2014;06/12/2014;'AUTOPISTA TERR';-2,53 €;4.795,92 €;6218;-2,53;9.320,01 €;'sin fechas';06/12/2014;'AUTOPISTA';'Gastos_Ocio y transporte';'Parking y peaje';'VARIABLES'
10/12/2014;05/12/2014;'AUTOPISTA TERR';-1,32 €;4.794,60 €;6219;-1,32;9.318,69 €;'sin fechas';05/12/2014;'AUTOPISTA';'Gastos_Ocio y transporte';'Parking y peaje';'VARIABLES'
10/12/2014;05/12/2014;'AUTOPISTA TERR';-1,32 €;4.793,28 €;6220;-1,32;9.317,37 €;'sin fechas';05/12/2014;'AUTOPISTA';'Gastos_Ocio y transporte';'Parking y peaje';'VARIABLES'
10/12/2014;10/12/2014;'BLITZ';-72,50 €;4.720,78 €;6221;-72,50;9.244,87 €;'sin fechas';10/12/2014;'BLITZ';'Gastos_Vivienda y vehiculo';'Alquiler Parking';'FIJO'
10/12/2014;09/12/2014;'COCHE&PARKING';-9,40 €;4.711,38 €;6222;-9,40;9.235,47 €;'sin fechas';09/12/2014;'COCHEPARKING';'Gastos_Ocio y transporte';'Parking y peaje';'VARIABLES'
11/12/2014;09/12/2014;'AUTOPISTA TERR';-1,32 €;4.710,06 €;6223;-1,32;9.234,15 €;'sin fechas';09/12/2014;'AUTOPISTA';'Gastos_Ocio y transporte';'Parking y peaje';'VARIABLES'
11/12/2014;09/12/2014;'AUTOPISTA TERR';-1,39 €;4.708,67 €;6224;-1,39;9.232,76 €;'sin fechas';09/12/2014;'AUTOPISTA';'Gastos_Ocio y transporte';'Parking y peaje';'VARIABLES'
11/12/2014;11/12/2014;'COMISIONES';-3,50 €;4.705,17 €;6225;-3,50;9.229,26 €;'sin fechas';11/12/2014;'COMISIONES';'Gastos_Banco y organismos';'Cargos banco';'FIJO'
11/12/2014;11/12/2014;'REINT.CAJERO';-30,00 €;4.675,17 €;6226;-30,00;9.199,26 €;'sin fechas';11/12/2014;'REINTCAJERO';'Gastos_Gastos varios';'Efectivo';'VARIABLES'
12/12/2014;12/12/2014;'AUTOPISTA TERR';-4,19 €;4.670,98 €;6227;-4,19;9.195,07 €;'sin fechas';12/12/2014;'AUTOPISTA';'Gastos_Ocio y transporte';'Parking y peaje';'VARIABLES'
12/12/2014;10/12/2014;'AUTOPISTA TERR';-1,32 €;4.669,66 €;6228;-1,32;9.193,75 €;'sin fechas';10/12/2014;'AUTOPISTA';'Gastos_Ocio y transporte';'Parking y peaje';'VARIABLES'
12/12/2014;10/12/2014;'AUTOPISTA TERR';-1,39 €;4.668,27 €;6229;-1,39;9.192,36 €;'sin fechas';10/12/2014;'AUTOPISTA';'Gastos_Ocio y transporte';'Parking y peaje';'VARIABLES'
12/12/2014;12/12/2014;'CAFET.C T PRAT';-2,55 €;4.665,72 €;6230;-2,55;9.189,81 €;'sin fechas';12/12/2014;'CAFETC';'Gastos_Ocio y transporte';'Restaurantes';'VARIABLES'
13/12/2014;11/12/2014;'AUTOPISTA TERR';-1,32 €;4.664,40 €;6231;-1,32;9.188,49 €;'sin fechas';11/12/2014;'AUTOPISTA';'Gastos_Ocio y transporte';'Parking y peaje';'VARIABLES'
13/12/2014;11/12/2014;'AUTOPISTA TERR';-1,39 €;4.663,01 €;6232;-1,39;9.187,10 €;'sin fechas';11/12/2014;'AUTOPISTA';'Gastos_Ocio y transporte';'Parking y peaje';'VARIABLES'
13/12/2014;10/12/2014;'AUTOPISTA TERR';-4,19 €;4.658,82 €;6233;-4,19;9.182,91 €;'sin fechas';10/12/2014;'AUTOPISTA';'Gastos_Ocio y transporte';'Parking y peaje';'VARIABLES'
13/12/2014;13/12/2014;'CAFET.C T PRAT';-3,60 €;4.655,22 €;6234;-3,60;9.179,31 €;'sin fechas';13/12/2014;'CAFETC';'Gastos_Ocio y transporte';'Restaurantes';'VARIABLES'
13/12/2014;13/12/2014;'CAPRABO';-22,43 €;4.632,79 €;6235;-22,43;9.156,88 €;'sin fechas';13/12/2014;'CAPRABO';'Gastos_Compras';'Supermercado';'VARIABLES'
13/12/2014;13/12/2014;'DRIM';-19,99 €;4.612,80 €;6236;-19,99;9.136,89 €;'sin fechas';13/12/2014;'DRIM';'Gastos_Compras';'Niños';'VARIABLES'
13/12/2014;13/12/2014;'FRUITES I VERDURES';-4,92 €;4.607,88 €;6237;-4,92;9.131,97 €;'sin fechas';13/12/2014;'FRUITES';'Gastos_Compras';'Supermercado';'VARIABLES'
13/12/2014;13/12/2014;'INTERKITS';-10,76 €;4.597,12 €;6238;-10,76;9.121,21 €;'sin fechas';13/12/2014;'INTERKITS';'Gastos_Compras';'Niños';'VARIABLES'
13/12/2014;13/12/2014;'JUGUETILANDIA TERR';-86,65 €;4.510,47 €;6239;-86,65;9.034,56 €;'sin fechas';13/12/2014;'JUGUETILANDIA';'Gastos_Compras';'Niños';'VARIABLES'
13/12/2014;13/12/2014;'MERCADONA';-9,15 €;4.501,32 €;6240;-9,15;9.025,41 €;'sin fechas';13/12/2014;'MERCADONA';'Gastos_Compras';'Supermercado';'VARIABLES'
13/12/2014;13/12/2014;'OCIO&CINES';-14,00 €;4.487,32 €;6241;-14,00;9.011,41 €;'sin fechas';13/12/2014;'OCIOCINES';'Gastos_Ocio y transporte';'Espectáculos';'VARIABLES'
13/12/2014;13/12/2014;'RESTAURANTES';-37,25 €;4.450,07 €;6242;-37,25;8.974,16 €;'sin fechas';13/12/2014;'RESTAURANTES';'Gastos_Ocio y transporte';'Restaurantes';'VARIABLES'
14/12/2014;14/12/2014;'CAFET.C T PRAT';-3,65 €;4.446,42 €;6243;-3,65;8.970,51 €;'sin fechas';14/12/2014;'CAFETC';'Gastos_Ocio y transporte';'Restaurantes';'VARIABLES'
14/12/2014;14/12/2014;'MERCADONA';-152,35 €;4.294,07 €;6244;-152,35;8.818,16 €;'sin fechas';14/12/2014;'MERCADONA';'Gastos_Compras';'Supermercado';'VARIABLES'
14/12/2014;14/12/2014;'PERRUQUERIA';-10,00 €;4.284,07 €;6245;-10,00;8.808,16 €;'sin fechas';14/12/2014;'PERRUQUERIA';'Gastos_Salud, saber y deporte';'Belleza';'VARIABLES'
15/12/2014;15/12/2014;'AUTOPISTA TERR';-3,65 €;4.280,42 €;6246;-3,65;8.804,51 €;'sin fechas';15/12/2014;'AUTOPISTA';'Gastos_Ocio y transporte';'Parking y peaje';'VARIABLES'
15/12/2014;15/12/2014;'CAFET.C T PRAT';-2,70 €;4.277,72 €;6247;-2,70;8.801,81 €;'sin fechas';15/12/2014;'CAFETC';'Gastos_Ocio y transporte';'Restaurantes';'VARIABLES'
15/12/2014;15/12/2014;'REINT.CAJERO';-70,00 €;4.207,72 €;6248;-70,00;8.731,81 €;'sin fechas';15/12/2014;'REINTCAJERO';'Gastos_Gastos varios';'Efectivo';'VARIABLES'
16/12/2014;12/12/2014;'AUTOPISTA TERR';-1,25 €;4.206,47 €;6249;-1,25;8.730,56 €;'sin fechas';12/12/2014;'AUTOPISTA';'Gastos_Ocio y transporte';'Parking y peaje';'VARIABLES'
16/12/2014;12/12/2014;'AUTOPISTA TERR';-1,39 €;4.205,08 €;6250;-1,39;8.729,17 €;'sin fechas';12/12/2014;'AUTOPISTA';'Gastos_Ocio y transporte';'Parking y peaje';'VARIABLES'
16/12/2014;16/12/2014;'CCM VIDA Y P SEGURO PRESTAMO';-23,30 €;4.181,78 €;6251;-23,30;8.705,87 €;'sin fechas';16/12/2014;'CCM';'Gastos_Seguros';'Seguro vida';'FIJO'
16/12/2014;16/12/2014;'CCM VIDA Y PENSIO 000000493358';-18,28 €;4.163,50 €;6252;-18,28;8.687,59 €;'sin fechas';16/12/2014;'CCM';'Gastos_Seguros';'Seguro vida';'FIJO'
16/12/2014;16/12/2014;'HOGAR&OTROS';-6,90 €;4.156,60 €;6253;-6,90;8.680,69 €;'sin fechas';16/12/2014;'HOGAROTROS';'Gastos_Vivienda y vehiculo';'Otros vivienda';'VARIABLES'
16/12/2014;16/12/2014;'VIENA';-10,80 €;4.145,80 €;6254;-10,80;8.669,89 €;'sin fechas';16/12/2014;'VIENA';'Gastos_Ocio y transporte';'Restaurantes';'VARIABLES'
17/12/2014;15/12/2014;'AUTOPISTA TERR';-1,25 €;4.144,55 €;6255;-1,25;8.668,64 €;'sin fechas';15/12/2014;'AUTOPISTA';'Gastos_Ocio y transporte';'Parking y peaje';'VARIABLES'
17/12/2014;15/12/2014;'AUTOPISTA TERR';-1,39 €;4.143,16 €;6256;-1,39;8.667,25 €;'sin fechas';15/12/2014;'AUTOPISTA';'Gastos_Ocio y transporte';'Parking y peaje';'VARIABLES'
17/12/2014;17/12/2014;'MINA PUBLICA AIGUES T.01A75789';-36,37 €;4.106,79 €;6257;-36,37;8.630,88 €;'sin fechas';17/12/2014;'MINA';'Gastos_Servicios tipicos';'Agua';'FIJO'
17/12/2014;17/12/2014;'ONO';-111,68 €;3.995,11 €;6258;-111,68;8.519,20 €;'sin fechas';17/12/2014;'ONO';'Gastos_Servicios tipicos';'Telecomunicaciones';'FIJO'
18/12/2014;18/12/2014;'AUTOPISTA TERR';-4,19 €;3.990,92 €;6259;-4,19;8.515,01 €;'sin fechas';18/12/2014;'AUTOPISTA';'Gastos_Ocio y transporte';'Parking y peaje';'VARIABLES'
18/12/2014;16/12/2014;'AUTOPISTA TERR';-1,25 €;3.989,67 €;6260;-1,25;8.513,76 €;'sin fechas';16/12/2014;'AUTOPISTA';'Gastos_Ocio y transporte';'Parking y peaje';'VARIABLES'
18/12/2014;16/12/2014;'AUTOPISTA TERR';-1,25 €;3.988,42 €;6261;-1,25;8.512,51 €;'sin fechas';16/12/2014;'AUTOPISTA';'Gastos_Ocio y transporte';'Parking y peaje';'VARIABLES'
18/12/2014;15/12/2014;'FARMACIA';-36,50 €;3.951,92 €;6262;-36,50;8.476,01 €;'sin fechas';15/12/2014;'FARMACIA';'Gastos_Salud, saber y deporte';'Farmacia';'VARIABLES'
18/12/2014;18/12/2014;'GAME';-9,95 €;3.941,97 €;6263;-9,95;8.466,06 €;'sin fechas';18/12/2014;'GAME';'Gastos_Compras';'Hobbys';'VARIABLES'
18/12/2014;18/12/2014;'INFORMACIO I TECNOLOGIA DE CAT';1.789,44 €;5.731,41 €;6264;1.789,44;10.255,50 €;'sin fechas';18/12/2014;'INFORMACIO';'Ingresos';'Nomina';'FIJO'
19/12/2014;17/12/2014;'AUTOPISTA TERR';-1,25 €;5.730,16 €;6265;-1,25;10.254,25 €;'sin fechas';17/12/2014;'AUTOPISTA';'Gastos_Ocio y transporte';'Parking y peaje';'VARIABLES'
19/12/2014;17/12/2014;'AUTOPISTA TERR';-1,39 €;5.728,77 €;6266;-1,39;10.252,86 €;'sin fechas';17/12/2014;'AUTOPISTA';'Gastos_Ocio y transporte';'Parking y peaje';'VARIABLES'
19/12/2014;19/12/2014;'CAFET.C T PRAT';-3,60 €;5.725,17 €;6267;-3,60;10.249,26 €;'sin fechas';19/12/2014;'CAFETC';'Gastos_Ocio y transporte';'Restaurantes';'VARIABLES'
19/12/2014;19/12/2014;'FOMENT DE TERRASSA, S.A. FOMEN';3.248,22 €;8.973,39 €;6268;3.248,22;13.497,48 €;'sin fechas';19/12/2014;'FOMENT';'Ingresos';'Nomina';'FIJO'
19/12/2014;19/12/2014;'HOGAR&OTROS';-14,99 €;8.958,40 €;6269;-14,99;13.482,49 €;'sin fechas';19/12/2014;'HOGAROTROS';'Gastos_Vivienda y vehiculo';'Otros vivienda';'VARIABLES'
19/12/2014;19/12/2014;'HOGAR&OTROS';-6,10 €;8.952,30 €;6270;-6,10;13.476,39 €;'sin fechas';19/12/2014;'HOGAROTROS';'Gastos_Vivienda y vehiculo';'Otros vivienda';'VARIABLES'
19/12/2014;19/12/2014;'IKEA';-93,18 €;8.859,12 €;6271;-93,18;13.383,21 €;'sin fechas';19/12/2014;'IKEA';'Gastos_Vivienda y vehiculo';'Mnto. hogar';'VARIABLES'
19/12/2014;19/12/2014;'RESTAURANTES';-14,65 €;8.844,47 €;6272;-14,65;13.368,56 €;'sin fechas';19/12/2014;'RESTAURANTES';'Gastos_Ocio y transporte';'Restaurantes';'VARIABLES'
20/12/2014;20/12/2014;'BCN HERON CITY';-3,15 €;8.841,32 €;6273;-3,15;13.365,41 €;'sin fechas';20/12/2014;'BCN';'Gastos_Vivienda y vehiculo';'Mnto. vehiculo';'VARIABLE'
20/12/2014;20/12/2014;'BON AREA';-22,62 €;8.818,70 €;6274;-22,62;13.342,79 €;'sin fechas';20/12/2014;'BON';'Gastos_Compras';'Supermercado';'VARIABLES'
20/12/2014;20/12/2014;'CAFET.C T PRAT';-2,65 €;8.816,05 €;6275;-2,65;13.340,14 €;'sin fechas';20/12/2014;'CAFETC';'Gastos_Ocio y transporte';'Restaurantes';'VARIABLES'
20/12/2014;20/12/2014;'FARMACIA';-9,37 €;8.806,68 €;6276;-9,37;13.330,77 €;'sin fechas';20/12/2014;'FARMACIA';'Gastos_Salud, saber y deporte';'Farmacia';'VARIABLES'
20/12/2014;20/12/2014;'RESTAURANTES';-27,00 €;8.779,68 €;6277;-27,00;13.303,77 €;'sin fechas';20/12/2014;'RESTAURANTES';'Gastos_Ocio y transporte';'Restaurantes';'VARIABLES'
21/12/2014;21/12/2014;'CAFET.C T PRAT';-4,50 €;8.775,18 €;6278;-4,50;13.299,27 €;'sin fechas';21/12/2014;'CAFETC';'Gastos_Ocio y transporte';'Restaurantes';'VARIABLES'
21/12/2014;21/12/2014;'CAFET.C T PRAT';-2,25 €;8.772,93 €;6279;-2,25;13.297,02 €;'sin fechas';21/12/2014;'CAFETC';'Gastos_Ocio y transporte';'Restaurantes';'VARIABLES'
21/12/2014;21/12/2014;'DECATHLON';-7,98 €;8.764,95 €;6280;-7,98;13.289,04 €;'sin fechas';21/12/2014;'DECATHLON';'Gastos_Compras';'Deportivo';'VARIABLES'
21/12/2014;21/12/2014;'ES STA. MARGARITA';-44,96 €;8.719,99 €;6281;-44,96;13.244,08 €;'sin fechas';21/12/2014;'STA';'Gastos_Ocio y transporte';'Gasolina';'VARIABLES'
21/12/2014;21/12/2014;'FARMACIA';-32,95 €;8.687,04 €;6282;-32,95;13.211,13 €;'sin fechas';21/12/2014;'FARMACIA';'Gastos_Salud, saber y deporte';'Farmacia';'VARIABLES'
22/12/2014;22/12/2014;'BON AREA';-10,50 €;8.676,54 €;6283;-10,50;13.200,63 €;'sin fechas';22/12/2014;'BON';'Gastos_Compras';'Supermercado';'VARIABLES'
22/12/2014;22/12/2014;'CLAIRES';-19,99 €;8.656,55 €;6284;-19,99;13.180,64 €;'sin fechas';22/12/2014;'CLAIRES';'Gastos_Compras';'Ropa';'VARIABLES'
22/12/2014;22/12/2014;'FRUITES I VERDURES';-5,48 €;8.651,07 €;6285;-5,48;13.175,16 €;'sin fechas';22/12/2014;'FRUITES';'Gastos_Compras';'Supermercado';'VARIABLES'
22/12/2014;22/12/2014;'HOGAR&OTROS';-16,95 €;8.634,12 €;6286;-16,95;13.158,21 €;'sin fechas';22/12/2014;'HOGAROTROS';'Gastos_Vivienda y vehiculo';'Otros vivienda';'VARIABLES'
22/12/2014;22/12/2014;'IKEA';-15,85 €;8.618,27 €;6287;-15,85;13.142,36 €;'sin fechas';22/12/2014;'IKEA';'Gastos_Vivienda y vehiculo';'Mnto. hogar';'VARIABLES'
22/12/2014;22/12/2014;'LIDL TERRASSA';-7,44 €;8.610,83 €;6288;-7,44;13.134,92 €;'sin fechas';22/12/2014;'LIDL';'Gastos_Compras';'Supermercado';'VARIABLES'
22/12/2014;22/12/2014;'PRIMARK';-11,00 €;8.599,83 €;6289;-11,00;13.123,92 €;'sin fechas';22/12/2014;'PRIMARK';'Gastos_Compras';'Ropa';'VARIABLES'
22/12/2014;22/12/2014;'SPLAU 1038 \\EL PRAT DE LL';-7,98 €;8.591,85 €;6290;-7,98;13.115,94 €;'sin fechas';22/12/2014;'SPLAU';'Gastos_Ocio y transporte';'Restaurantes';'VARIABLES'
22/12/2014;22/12/2014;'VIENA';-11,30 €;8.580,55 €;6291;-11,30;13.104,64 €;'sin fechas';22/12/2014;'VIENA';'Gastos_Ocio y transporte';'Restaurantes';'VARIABLES'
23/12/2014;23/12/2014;'AMC PARC VALLES';-10,35 €;8.570,20 €;6292;-10,35;13.094,29 €;'sin fechas';23/12/2014;'AMC';'Gastos_Ocio y transporte';'Espectáculos';'VARIABLES'
23/12/2014;23/12/2014;'AMC PARC VALLES';-19,00 €;8.551,20 €;6293;-19,00;13.075,29 €;'sin fechas';23/12/2014;'AMC';'Gastos_Ocio y transporte';'Espectáculos';'VARIABLES'
23/12/2014;19/12/2014;'AUTOPISTA TERR';-1,25 €;8.549,95 €;6294;-1,25;13.074,04 €;'sin fechas';19/12/2014;'AUTOPISTA';'Gastos_Ocio y transporte';'Parking y peaje';'VARIABLES'
23/12/2014;18/12/2014;'AUTOPISTA TERR';-1,25 €;8.548,70 €;6295;-1,25;13.072,79 €;'sin fechas';18/12/2014;'AUTOPISTA';'Gastos_Ocio y transporte';'Parking y peaje';'VARIABLES'
23/12/2014;18/12/2014;'AUTOPISTA TERR';-1,25 €;8.547,45 €;6296;-1,25;13.071,54 €;'sin fechas';18/12/2014;'AUTOPISTA';'Gastos_Ocio y transporte';'Parking y peaje';'VARIABLES'
23/12/2014;23/12/2014;'AUTOPISTA TERR';-1,39 €;8.546,06 €;6297;-1,39;13.070,15 €;'sin fechas';23/12/2014;'AUTOPISTA';'Gastos_Ocio y transporte';'Parking y peaje';'VARIABLES'
23/12/2014;23/12/2014;'AUTOPISTA TERR';-1,39 €;8.544,67 €;6298;-1,39;13.068,76 €;'sin fechas';23/12/2014;'AUTOPISTA';'Gastos_Ocio y transporte';'Parking y peaje';'VARIABLES'
23/12/2014;23/12/2014;'CAPRABO';-9,06 €;8.535,61 €;6299;-9,06;13.059,70 €;'sin fechas';23/12/2014;'CAPRABO';'Gastos_Compras';'Supermercado';'VARIABLES'
23/12/2014;23/12/2014;'ESCOLA BRESSOL EINA';-258,00 €;8.277,61 €;6300;-258,00;12.801,70 €;'sin fechas';23/12/2014;'ESCOLA';'Gastos_Salud, saber y deporte';'Estudios';'VARIABLES'
23/12/2014;23/12/2014;'MERCADONA';-16,88 €;8.260,73 €;6301;-16,88;12.784,82 €;'sin fechas';23/12/2014;'MERCADONA';'Gastos_Compras';'Supermercado';'VARIABLES'
23/12/2014;23/12/2014;'MERCADONA';-32,26 €;8.228,47 €;6302;-32,26;12.752,56 €;'sin fechas';23/12/2014;'MERCADONA';'Gastos_Compras';'Supermercado';'VARIABLES'
23/12/2014;23/12/2014;'REINT.CAJERO';-20,00 €;8.208,47 €;6303;-20,00;12.732,56 €;'sin fechas';23/12/2014;'REINTCAJERO';'Gastos_Gastos varios';'Efectivo';'VARIABLES'
23/12/2014;23/12/2014;'VIENA';-11,45 €;8.197,02 €;6305;-11,45;12.721,11 €;'sin fechas';23/12/2014;'VIENA';'Gastos_Ocio y transporte';'Restaurantes';'VARIABLES'
24/12/2014;22/12/2014;'AUTOPISTA TERR';-1,25 €;8.195,77 €;6306;-1,25;12.719,86 €;'sin fechas';22/12/2014;'AUTOPISTA';'Gastos_Ocio y transporte';'Parking y peaje';'VARIABLES'
24/12/2014;24/12/2014;'AUTOPISTA TERR';-1,39 €;8.194,38 €;6307;-1,39;12.718,47 €;'sin fechas';24/12/2014;'AUTOPISTA';'Gastos_Ocio y transporte';'Parking y peaje';'VARIABLES'
24/12/2014;24/12/2014;'AUTOPISTA TERR';-1,39 €;8.192,99 €;6308;-1,39;12.717,08 €;'sin fechas';24/12/2014;'AUTOPISTA';'Gastos_Ocio y transporte';'Parking y peaje';'VARIABLES'
24/12/2014;24/12/2014;'CAFET.C T PRAT';-3,65 €;8.189,34 €;6309;-3,65;12.713,43 €;'sin fechas';24/12/2014;'CAFETC';'Gastos_Ocio y transporte';'Restaurantes';'VARIABLES'
24/12/2014;24/12/2014;'CARREFOUR-[COMIDA]';-25,01 €;8.164,33 €;6310;-25,01;12.688,42 €;'sin fechas';24/12/2014;'CARREFOURCOMIDA';'Gastos_Compras';'Supermercado';'VARIABLES'
24/12/2014;24/12/2014;'GLT STORE HOME';-31,05 €;8.133,28 €;6311;-31,05;12.657,37 €;'sin fechas';24/12/2014;'GLT';'Gastos_Compras';'Otras compras';'VARIABLES'
24/12/2014;24/12/2014;'JUGUETILANDIA TERR';-13,70 €;8.119,58 €;6312;-13,70;12.643,67 €;'sin fechas';24/12/2014;'JUGUETILANDIA';'Gastos_Compras';'Niños';'VARIABLES'
24/12/2014;24/12/2014;'MEDIA MARKT';-49,99 €;8.069,59 €;6313;-49,99;12.593,68 €;'sin fechas';24/12/2014;'MEDIA';'Gastos_Compras';'Hobbys';'VARIABLES'
25/12/2014;25/12/2014;'AUTOPISTA TERR';-3,73 €;8.065,86 €;6314;-3,73;12.589,95 €;'sin fechas';25/12/2014;'AUTOPISTA';'Gastos_Ocio y transporte';'Parking y peaje';'VARIABLES'
25/12/2014;25/12/2014;'CAFET.C T PRAT';-3,65 €;8.062,21 €;6315;-3,65;12.586,30 €;'sin fechas';25/12/2014;'CAFETC';'Gastos_Ocio y transporte';'Restaurantes';'VARIABLES'
26/12/2014;26/12/2014;'AUTOPISTA TERR';-2,53 €;8.059,68 €;6316;-2,53;12.583,77 €;'sin fechas';26/12/2014;'AUTOPISTA';'Gastos_Ocio y transporte';'Parking y peaje';'VARIABLES'
26/12/2014;26/12/2014;'AUTOPISTA TERR';-2,53 €;8.057,15 €;6317;-2,53;12.581,24 €;'sin fechas';26/12/2014;'AUTOPISTA';'Gastos_Ocio y transporte';'Parking y peaje';'VARIABLES'
26/12/2014;26/12/2014;'DRIM';-11,99 €;8.045,16 €;6318;-11,99;12.569,25 €;'sin fechas';26/12/2014;'DRIM';'Gastos_Compras';'Niños';'VARIABLES'
26/12/2014;26/12/2014;'FRANKFURT LES LLETRES';-2,50 €;8.042,66 €;6319;-2,50;12.566,75 €;'sin fechas';26/12/2014;'FRANKFURT';'Gastos_Ocio y transporte';'Restaurantes';'VARIABLES'
27/12/2014;27/12/2014;'BON AREA';-30,24 €;8.012,42 €;6320;-30,24;12.536,51 €;'sin fechas';27/12/2014;'BON';'Gastos_Compras';'Supermercado';'VARIABLES'
27/12/2014;27/12/2014;'FARMACIA';-3,76 €;8.008,66 €;6321;-3,76;12.532,75 €;'sin fechas';27/12/2014;'FARMACIA';'Gastos_Salud, saber y deporte';'Farmacia';'VARIABLES'
27/12/2014;27/12/2014;'MERCADONA';-7,99 €;8.000,67 €;6322;-7,99;12.524,76 €;'sin fechas';27/12/2014;'MERCADONA';'Gastos_Compras';'Supermercado';'VARIABLES'
28/12/2014;28/12/2014;'CARREFOUR-[COMIDA]';-38,14 €;7.962,53 €;6323;-38,14;12.486,62 €;'sin fechas';28/12/2014;'CARREFOURCOMIDA';'Gastos_Compras';'Supermercado';'VARIABLES'
28/12/2014;28/12/2014;'CARREFOUR-[COMIDA]';-31,96 €;7.930,57 €;6324;-31,96;12.454,66 €;'sin fechas';28/12/2014;'CARREFOURCOMIDA';'Gastos_Compras';'Supermercado';'VARIABLES'
28/12/2014;28/12/2014;'RESTAURANTES';-55,80 €;7.874,77 €;6325;-55,80;12.398,86 €;'sin fechas';28/12/2014;'RESTAURANTES';'Gastos_Ocio y transporte';'Restaurantes';'VARIABLES'
29/12/2014;29/12/2014;'AJUNTAMENT D TAXA RESIDUS CA';-50,38 €;7.824,39 €;6326;-50,38;12.348,48 €;'sin fechas';29/12/2014;'AJUNTAMENT';'Gastos_Banco y organismos';'Ayuntamiento';'FIJO'
29/12/2014;29/12/2014;'AMC PARC VALLES';-22,80 €;7.801,59 €;6327;-22,80;12.325,68 €;'sin fechas';29/12/2014;'AMC';'Gastos_Ocio y transporte';'Espectáculos';'VARIABLES'
29/12/2014;29/12/2014;'AUTOPISTA TERR';-1,39 €;7.800,20 €;6328;-1,39;12.324,29 €;'sin fechas';29/12/2014;'AUTOPISTA';'Gastos_Ocio y transporte';'Parking y peaje';'VARIABLES'
29/12/2014;29/12/2014;'AUTOPISTA TERR';-1,39 €;7.798,81 €;6329;-1,39;12.322,90 €;'sin fechas';29/12/2014;'AUTOPISTA';'Gastos_Ocio y transporte';'Parking y peaje';'VARIABLES'
29/12/2014;29/12/2014;'CAFET.C T PRAT';-3,00 €;7.795,81 €;6330;-3,00;12.319,90 €;'sin fechas';29/12/2014;'CAFETC';'Gastos_Ocio y transporte';'Restaurantes';'VARIABLES'
29/12/2014;29/12/2014;'CAFET.C T PRAT';-0,90 €;7.794,91 €;6331;-0,90;12.319,00 €;'sin fechas';29/12/2014;'CAFETC';'Gastos_Ocio y transporte';'Restaurantes';'VARIABLES'
29/12/2014;29/12/2014;'VIENA';-11,35 €;7.783,56 €;6332;-11,35;12.307,65 €;'sin fechas';29/12/2014;'VIENA';'Gastos_Ocio y transporte';'Restaurantes';'VARIABLES'
30/12/2014;30/12/2014;'AUTOPISTA TERR';-1,39 €;7.782,17 €;6333;-1,39;12.306,26 €;'sin fechas';30/12/2014;'AUTOPISTA';'Gastos_Ocio y transporte';'Parking y peaje';'VARIABLES'
30/12/2014;30/12/2014;'ES STA. MARGARITA';-43,44 €;7.738,73 €;6336;-43,44;12.262,82 €;'sin fechas';30/12/2014;'STA';'Gastos_Ocio y transporte';'Gasolina';'VARIABLES'
30/12/2014;30/12/2014;'INFORMACIO I TECNOLOGIA DE CAT';1.589,00 €;9.327,73 €;6343;1.589,00;13.851,82 €;'sin fechas';30/12/2014;'INFORMACIO';'Ingresos';'Nomina';'FIJO'
30/12/2014;30/12/2014;'COMUNIDAD PAGO 4-3 DE ENERO A DICIEMBRE';-240,00 €;9.087,73 €;6345;-240,00;13.611,82 €;'sin fechas';30/12/2014;'COMUNIDAD';'Gastos_Vivienda y vehiculo';'Comunidad';'FIJO'
30/12/2014;30/12/2014;'RECIBO PTMOS. 3061-0960001518';-547,25 €;8.540,48 €;6346;-547,25;13.064,57 €;'sin fechas';30/12/2014;'RECIBO';'Gastos_Banco y organismos';'Hipoteca';'FIJO'
01/01/2015;01/01/2015;'AMC PARC VALLES';-8,20 €;8.532,28 €;6348;-8,20;13.056,37 €;'sin fechas';01/01/2015;'AMC';'Gastos_Ocio y transporte';'Espectáculos';'VARIABLES'
01/01/2015;01/01/2015;'CREDITO';-494,80 €;8.037,48 €;6349;-494,80;12.561,57 €;'sin fechas';01/01/2015;'CREDITO';'No computable';'Recibo Tarjeta';
02/01/2015;02/01/2015;'AUTOPISTAS';-2,40 €;8.035,08 €;6350;-2,40;12.559,17 €;'sin fechas';02/01/2015;'AUTOPISTAS';'Gastos_Ocio y transporte';'Parking y peaje';'VARIABLES'
02/01/2015;02/01/2015;'CAFETERIA';-2,70 €;8.032,38 €;6351;-2,70;12.556,47 €;'sin fechas';02/01/2015;'CAFETERIA';'Gastos_Compras';'Supermercado';'VARIABLES'
02/01/2015;02/01/2015;'SALA BADRINAS - QUOTA';-80,00 €;7.952,38 €;6352;-80,00;12.476,47 €;'sin fechas';02/01/2015;'SALA';'Gastos_Salud, saber y deporte';'Estudios';'VARIABLES'
03/01/2015;03/01/2015;'C&A';-28,50 €;7.923,88 €;6353;-28,50;12.447,97 €;'sin fechas';03/01/2015;'CA';'Gastos_Compras';'Ropa';'VARIABLES'
03/01/2015;03/01/2015;'CAFETERIA';-2,70 €;7.921,18 €;6354;-2,70;12.445,27 €;'sin fechas';03/01/2015;'CAFETERIA';'Gastos_Compras';'Supermercado';'VARIABLES'
03/01/2015;31/12/2014;'COMPRA CON TARJETA';-1,39 €;7.919,79 €;6355;-1,39;12.443,88 €;'sin fechas';31/12/2014;'COMPRA';'Gastos_Compras';'Supermercado';'VARIABLES'
03/01/2015;03/01/2015;'EROSKI-[COMIDA]';-40,92 €;7.878,87 €;6356;-40,92;12.402,96 €;'sin fechas';03/01/2015;'EROSKICOMIDA';'Gastos_Compras';'Supermercado';'VARIABLES'
03/01/2015;03/01/2015;'LIDL';-33,02 €;7.845,85 €;6357;-33,02;12.369,94 €;'sin fechas';03/01/2015;'LIDL';'Gastos_Compras';'Supermercado';'VARIABLES'
03/01/2015;03/01/2015;'MERCADONA';-130,86 €;7.714,99 €;6358;-130,86;12.239,08 €;'sin fechas';03/01/2015;'MERCADONA';'Gastos_Compras';'Supermercado';'VARIABLES'
05/01/2015;05/01/2015;'AMC PARC VALLES';-6,30 €;7.708,69 €;6359;-6,30;12.232,78 €;'sin fechas';05/01/2015;'AMC';'Gastos_Ocio y transporte';'Espectáculos';'VARIABLES'
05/01/2015;05/01/2015;'CAFETERIA';-3,65 €;7.705,04 €;6360;-3,65;12.229,13 €;'sin fechas';05/01/2015;'CAFETERIA';'Gastos_Compras';'Supermercado';'VARIABLES'
05/01/2015;05/01/2015;'RESTAURANTES';-28,40 €;7.676,64 €;6361;-28,40;12.200,73 €;'sin fechas';05/01/2015;'RESTAURANTES';'Gastos_Ocio y transporte';'Restaurantes';'VARIABLES'
05/01/2015;05/01/2015;'VIENA';-12,70 €;7.663,94 €;6362;-12,70;12.188,03 €;'sin fechas';05/01/2015;'VIENA';'Gastos_Ocio y transporte';'Restaurantes';'VARIABLES'
06/01/2015;06/01/2015;'PERRUQUERIA';-40,50 €;7.623,44 €;6363;-40,50;12.147,53 €;'sin fechas';06/01/2015;'PERRUQUERIA';'Gastos_Salud, saber y deporte';'Belleza';'VARIABLES'
06/01/2015;06/01/2015;'RESTAURANTES';-46,40 €;7.577,04 €;6364;-46,40;12.101,13 €;'sin fechas';06/01/2015;'RESTAURANTES';'Gastos_Ocio y transporte';'Restaurantes';'VARIABLES'
07/01/2015;02/01/2015;'COMPRA CON TARJETA';-1,39 €;7.575,65 €;6365;-1,39;12.099,74 €;'sin fechas';02/01/2015;'COMPRA';'Gastos_Compras';'Supermercado';'VARIABLES'
07/01/2015;02/01/2015;'COMPRA CON TARJETA';-1,39 €;7.574,26 €;6366;-1,39;12.098,35 €;'sin fechas';02/01/2015;'COMPRA';'Gastos_Compras';'Supermercado';'VARIABLES'
08/01/2015;08/01/2015;'BLITZ';-72,50 €;7.501,76 €;6367;-72,50;12.025,85 €;'sin fechas';08/01/2015;'BLITZ';'Gastos_Vivienda y vehiculo';'Alquiler Parking';'FIJO'
08/01/2015;08/01/2015;'CAFETERIA';-2,70 €;7.499,06 €;6368;-2,70;12.023,15 €;'sin fechas';08/01/2015;'CAFETERIA';'Gastos_Compras';'Supermercado';'VARIABLES'
08/01/2015;08/01/2015;'CARREFOUR-[comida]';-38,88 €;7.460,18 €;6369;-38,88;11.984,27 €;'sin fechas';08/01/2015;'CARREFOURCOMIDA';'Gastos_Compras';'Supermercado';'VARIABLES'
08/01/2015;08/01/2015;'FARMACIA';-3,70 €;7.456,48 €;6370;-3,70;11.980,57 €;'sin fechas';08/01/2015;'FARMACIA';'Gastos_Salud, saber y deporte';'Farmacia';'VARIABLES'
08/01/2015;08/01/2015;'JUGUETILANDIA TERR';-8,70 €;7.447,78 €;6371;-8,70;11.971,87 €;'sin fechas';08/01/2015;'JUGUETILANDIA';'Gastos_Compras';'Niños';'VARIABLES'
09/01/2015;05/01/2015;'COMPRA CON TARJETA';-1,39 €;7.446,39 €;6372;-1,39;11.970,48 €;'sin fechas';05/01/2015;'COMPRA';'Gastos_Compras';'Supermercado';'VARIABLES'
09/01/2015;05/01/2015;'COMPRA CON TARJETA';-1,39 €;7.445,00 €;6373;-1,39;11.969,09 €;'sin fechas';05/01/2015;'COMPRA';'Gastos_Compras';'Supermercado';'VARIABLES'
09/01/2015;05/01/2015;'COMPRA CON TARJETA';-1,39 €;7.443,61 €;6374;-1,39;11.967,70 €;'sin fechas';05/01/2015;'COMPRA';'Gastos_Compras';'Supermercado';'VARIABLES'
09/01/2015;05/01/2015;'COMPRA CON TARJETA';-1,39 €;7.442,22 €;6375;-1,39;11.966,31 €;'sin fechas';05/01/2015;'COMPRA';'Gastos_Compras';'Supermercado';'VARIABLES'
09/01/2015;07/01/2015;'COMPRA CON TARJETA';-36,97 €;7.405,25 €;6376;-36,97;11.929,34 €;'sin fechas';07/01/2015;'COMPRA';'Gastos_Compras';'Supermercado';'VARIABLES'
09/01/2015;07/01/2015;'COMPRA CON TARJETA';-1,39 €;7.403,86 €;6377;-1,39;11.927,95 €;'sin fechas';07/01/2015;'COMPRA';'Gastos_Compras';'Supermercado';'VARIABLES'
09/01/2015;07/01/2015;'COMPRA CON TARJETA';-1,39 €;7.402,47 €;6378;-1,39;11.926,56 €;'sin fechas';07/01/2015;'COMPRA';'Gastos_Compras';'Supermercado';'VARIABLES'
10/01/2015;10/01/2015;'CAFETERIA';-3,65 €;7.398,82 €;6379;-3,65;11.922,91 €;'sin fechas';10/01/2015;'CAFETERIA';'Gastos_Compras';'Supermercado';'VARIABLES'
10/01/2015;10/01/2015;'CAFETERIA';-4,50 €;7.394,32 €;6380;-4,50;11.918,41 €;'sin fechas';10/01/2015;'CAFETERIA';'Gastos_Compras';'Supermercado';'VARIABLES'
10/01/2015;08/01/2015;'COMPRA CON TARJETA';-1,32 €;7.393,00 €;6381;-1,32;11.917,09 €;'sin fechas';08/01/2015;'COMPRA';'Gastos_Compras';'Supermercado';'VARIABLES'
10/01/2015;08/01/2015;'COMPRA CON TARJETA';-1,39 €;7.391,61 €;6382;-1,39;11.915,70 €;'sin fechas';08/01/2015;'COMPRA';'Gastos_Compras';'Supermercado';'VARIABLES'
10/01/2015;10/01/2015;'WWW.JUST-EAT.ES';-19,70 €;7.371,91 €;6383;-19,70;11.896,00 €;'sin fechas';10/01/2015;'WWWJUSTEATES';'Gastos_Ocio y transporte';'Restaurantes';'VARIABLES'
11/01/2015;11/01/2015;'CAFETERIA';-2,70 €;7.369,21 €;6384;-2,70;11.893,30 €;'sin fechas';11/01/2015;'CAFETERIA';'Gastos_Compras';'Supermercado';'VARIABLES'
11/01/2015;11/01/2015;'FRUITES I VERDURES';-11,83 €;7.357,38 €;6385;-11,83;11.881,47 €;'sin fechas';11/01/2015;'FRUITES';'Gastos_Compras';'Supermercado';'VARIABLES'
12/01/2015;12/01/2015;'CAFETERIA';-3,65 €;7.353,73 €;6386;-3,65;11.877,82 €;'sin fechas';12/01/2015;'CAFETERIA';'Gastos_Compras';'Supermercado';'VARIABLES'
13/01/2015;13/01/2015;'ALCAMPO';-13,31 €;7.340,42 €;6387;-13,31;11.864,51 €;'sin fechas';13/01/2015;'ALCAMPO';'Gastos_Compras';'Supermercado';'VARIABLES'
13/01/2015;13/01/2015;'BOLIN SHIJIA, SCP';-41,50 €;7.298,92 €;6388;-41,50;11.823,01 €;'sin fechas';13/01/2015;'BOLIN';'Gastos_Ocio y transporte';'Restaurantes';'VARIABLES'
13/01/2015;13/01/2015;'BRICOMART';-2,90 €;7.296,02 €;6389;-2,90;11.820,11 €;'sin fechas';13/01/2015;'BRICOMART';'Gastos_Vivienda y vehiculo';'Mnto. hogar';'VARIABLES'
13/01/2015;09/01/2015;'COMPRA CON TARJETA';-1,32 €;7.294,70 €;6390;-1,32;11.818,79 €;'sin fechas';09/01/2015;'COMPRA';'Gastos_Compras';'Supermercado';'VARIABLES'
13/01/2015;09/01/2015;'COMPRA CON TARJETA';-1,39 €;7.293,31 €;6391;-1,39;11.817,40 €;'sin fechas';09/01/2015;'COMPRA';'Gastos_Compras';'Supermercado';'VARIABLES'
13/01/2015;13/01/2015;'RESTAURANTES';-16,35 €;7.276,96 €;6392;-16,35;11.801,05 €;'sin fechas';13/01/2015;'RESTAURANTES';'Gastos_Ocio y transporte';'Restaurantes';'VARIABLES'
13/01/2015;13/01/2015;'VIRGIN ACTIV';-55,95 €;7.221,01 €;6393;-55,95;11.745,10 €;'sin fechas';13/01/2015;'VIRGIN';'Gastos_Salud, saber y deporte';'Deportes';'VARIABLES'
13/01/2015;13/01/2015;'VIRGIN ACTIV';-55,95 €;7.165,06 €;6394;-55,95;11.689,15 €;'sin fechas';13/01/2015;'VIRGIN';'Gastos_Salud, saber y deporte';'Deportes';'VARIABLES'
14/01/2015;07/01/2015;'COMPRA CON TARJETA';-172,15 €;6.992,91 €;6395;-172,15;11.517,00 €;'sin fechas';07/01/2015;'COMPRA';'Gastos_Compras';'Supermercado';'VARIABLES'
14/01/2015;12/01/2015;'COMPRA CON TARJETA';-1,39 €;6.991,52 €;6396;-1,39;11.515,61 €;'sin fechas';12/01/2015;'COMPRA';'Gastos_Compras';'Supermercado';'VARIABLES'
15/01/2015;15/01/2015;'ADESLAS';-111,00 €;6.880,52 €;6397;-111,00;11.404,61 €;'sin fechas';15/01/2015;'ADESLAS';'Gastos_Salud, saber y deporte';'Medico';'VARIABLES'
15/01/2015;15/01/2015;'BON AREA';-10,20 €;6.870,32 €;6398;-10,20;11.394,41 €;'sin fechas';15/01/2015;'BON';'Gastos_Compras';'Supermercado';'VARIABLES'
15/01/2015;15/01/2015;'CAFETERIA';-3,60 €;6.866,72 €;6399;-3,60;11.390,81 €;'sin fechas';15/01/2015;'CAFETERIA';'Gastos_Compras';'Supermercado';'VARIABLES'
15/01/2015;08/01/2015;'COMPRA CON TARJETA';-95,51 €;6.771,21 €;6400;-95,51;11.295,30 €;'sin fechas';08/01/2015;'COMPRA';'Gastos_Compras';'Supermercado';'VARIABLES'
15/01/2015;15/01/2015;'FRANKFURT LES LLETRES';-2,50 €;6.768,71 €;6401;-2,50;11.292,80 €;'sin fechas';15/01/2015;'FRANKFURT';'Gastos_Ocio y transporte';'Restaurantes';'VARIABLES'
15/01/2015;15/01/2015;'RESTAURANTES';-24,25 €;6.744,46 €;6402;-24,25;11.268,55 €;'sin fechas';15/01/2015;'RESTAURANTES';'Gastos_Ocio y transporte';'Restaurantes';'VARIABLES'
15/01/2015;15/01/2015;'SALA BADRINAS - MENJADOR';-105,40 €;6.639,06 €;6403;-105,40;11.163,15 €;'sin fechas';15/01/2015;'SALA';'Gastos_Salud, saber y deporte';'Estudios';'VARIABLES'
16/01/2015;15/01/2015;'AUTOPISTAS';-4,19 €;6.634,87 €;6404;-4,19;11.158,96 €;'sin fechas';15/01/2015;'AUTOPISTAS';'Gastos_Ocio y transporte';'Parking y peaje';'VARIABLES'
16/01/2015;16/01/2015;'CCM VIDA Y P SEGURO PRESTAMO';-23,24 €;6.611,63 €;6405;-23,24;11.135,72 €;'sin fechas';16/01/2015;'CCM';'Gastos_Seguros';'Seguro vida';'FIJO'
16/01/2015;16/01/2015;'CCM VIDA Y PENSIO 000000493358';-18,21 €;6.593,42 €;6406;-18,21;11.117,51 €;'sin fechas';16/01/2015;'CCM';'Gastos_Seguros';'Seguro vida';'FIJO'
16/01/2015;16/01/2015;'GASOLINERA';-39,01 €;6.554,41 €;6407;-39,01;11.078,50 €;'sin fechas';16/01/2015;'GASOLINERA';'Gastos_Ocio y transporte';'Gasolina';'VARIABLES'
16/01/2015;16/01/2015;'FRANKFURT LES LLETRES';-2,50 €;6.551,91 €;6408;-2,50;11.076,00 €;'sin fechas';16/01/2015;'FRANKFURT';'Gastos_Ocio y transporte';'Restaurantes';'VARIABLES'
16/01/2015;15/01/2015;'PARKING';-17,40 €;6.534,51 €;6409;-17,40;11.058,60 €;'sin fechas';15/01/2015;'PARKING';'Gastos_Ocio y transporte';'Parking y peaje';'VARIABLES'
17/01/2015;17/01/2015;'BON AREA';-19,09 €;6.515,42 €;6410;-19,09;11.039,51 €;'sin fechas';17/01/2015;'BON';'Gastos_Compras';'Supermercado';'VARIABLES'
17/01/2015;15/01/2015;'COMPRA CON TARJETA';-1,32 €;6.514,10 €;6411;-1,32;11.038,19 €;'sin fechas';15/01/2015;'COMPRA';'Gastos_Compras';'Supermercado';'VARIABLES'
17/01/2015;15/01/2015;'COMPRA CON TARJETA';-1,32 €;6.512,78 €;6412;-1,32;11.036,87 €;'sin fechas';15/01/2015;'COMPRA';'Gastos_Compras';'Supermercado';'VARIABLES'
17/01/2015;16/01/2015;'PARKING';-6,65 €;6.506,13 €;6413;-6,65;11.030,22 €;'sin fechas';16/01/2015;'PARKING';'Gastos_Ocio y transporte';'Parking y peaje';'VARIABLES'
18/01/2015;18/01/2015;'CAFETERIA';-3,45 €;6.502,68 €;6414;-3,45;11.026,77 €;'sin fechas';18/01/2015;'CAFETERIA';'Gastos_Compras';'Supermercado';'VARIABLES'
18/01/2015;18/01/2015;'FRANKFURT LES LLETRES';-7,30 €;6.495,38 €;6415;-7,30;11.019,47 €;'sin fechas';18/01/2015;'FRANKFURT';'Gastos_Ocio y transporte';'Restaurantes';'VARIABLES'
18/01/2015;18/01/2015;'MERCADONA';-2,58 €;6.492,80 €;6416;-2,58;11.016,89 €;'sin fechas';18/01/2015;'MERCADONA';'Gastos_Compras';'Supermercado';'VARIABLES'
18/01/2015;17/01/2015;'PARKING';-10,70 €;6.482,10 €;6417;-10,70;11.006,19 €;'sin fechas';17/01/2015;'PARKING';'Gastos_Ocio y transporte';'Parking y peaje';'VARIABLES'
19/01/2015;19/01/2015;'CAFETERIA';-4,50 €;6.477,60 €;6418;-4,50;11.001,69 €;'sin fechas';19/01/2015;'CAFETERIA';'Gastos_Compras';'Supermercado';'VARIABLES'
19/01/2015;19/01/2015;'CAFETERIA';-3,65 €;6.473,95 €;6419;-3,65;10.998,04 €;'sin fechas';19/01/2015;'CAFETERIA';'Gastos_Compras';'Supermercado';'VARIABLES'
19/01/2015;19/01/2015;'ONO';-114,16 €;6.359,79 €;6420;-114,16;10.883,88 €;'sin fechas';19/01/2015;'ONO';'Gastos_Servicios tipicos';'Telecomunicaciones';'FIJO'
20/01/2015;20/01/2015;'BON AREA';-22,75 €;6.337,04 €;6421;-22,75;10.861,13 €;'sin fechas';20/01/2015;'BON';'Gastos_Compras';'Supermercado';'VARIABLES'
20/01/2015;16/01/2015;'COMPRA CON TARJETA';-1,32 €;6.335,72 €;6422;-1,32;10.859,81 €;'sin fechas';16/01/2015;'COMPRA';'Gastos_Compras';'Supermercado';'VARIABLES'
20/01/2015;16/01/2015;'COMPRA CON TARJETA';-1,39 €;6.334,33 €;6423;-1,39;10.858,42 €;'sin fechas';16/01/2015;'COMPRA';'Gastos_Compras';'Supermercado';'VARIABLES'
21/01/2015;19/01/2015;'COMPRA CON TARJETA';-1,25 €;6.333,08 €;6424;-1,25;10.857,17 €;'sin fechas';19/01/2015;'COMPRA';'Gastos_Compras';'Supermercado';'VARIABLES'
21/01/2015;19/01/2015;'COMPRA CON TARJETA';-1,39 €;6.331,69 €;6425;-1,39;10.855,78 €;'sin fechas';19/01/2015;'COMPRA';'Gastos_Compras';'Supermercado';'VARIABLES'
21/01/2015;21/01/2015;'REINT.CAJERO';-30,00 €;6.301,69 €;6426;-30,00;10.825,78 €;'sin fechas';21/01/2015;'REINTCAJERO';'Gastos_Gastos varios';'Efectivo';'VARIABLES'
22/01/2015;22/01/2015;'AUTOPISTAS';-4,19 €;6.297,50 €;6427;-4,19;10.821,59 €;'sin fechas';22/01/2015;'AUTOPISTAS';'Gastos_Ocio y transporte';'Parking y peaje';'VARIABLES'
22/01/2015;22/01/2015;'CAFETERIA';-3,65 €;6.293,85 €;6428;-3,65;10.817,94 €;'sin fechas';22/01/2015;'CAFETERIA';'Gastos_Compras';'Supermercado';'VARIABLES'
22/01/2015;20/01/2015;'COMPRA CON TARJETA';-1,25 €;6.292,60 €;6429;-1,25;10.816,69 €;'sin fechas';20/01/2015;'COMPRA';'Gastos_Compras';'Supermercado';'VARIABLES'
22/01/2015;20/01/2015;'COMPRA CON TARJETA';-1,25 €;6.291,35 €;6430;-1,25;10.815,44 €;'sin fechas';20/01/2015;'COMPRA';'Gastos_Compras';'Supermercado';'VARIABLES'
23/01/2015;23/01/2015;'BON AREA';-4,93 €;6.286,42 €;6431;-4,93;10.810,51 €;'sin fechas';23/01/2015;'BON';'Gastos_Compras';'Supermercado';'VARIABLES'
23/01/2015;23/01/2015;'CAFETERIA';-3,60 €;6.282,82 €;6432;-3,60;10.806,91 €;'sin fechas';23/01/2015;'CAFETERIA';'Gastos_Compras';'Supermercado';'VARIABLES'
23/01/2015;21/01/2015;'COMPRA CON TARJETA';-1,25 €;6.281,57 €;6433;-1,25;10.805,66 €;'sin fechas';21/01/2015;'COMPRA';'Gastos_Compras';'Supermercado';'VARIABLES'
23/01/2015;21/01/2015;'COMPRA CON TARJETA';-1,39 €;6.280,18 €;6434;-1,39;10.804,27 €;'sin fechas';21/01/2015;'COMPRA';'Gastos_Compras';'Supermercado';'VARIABLES'
24/01/2015;24/01/2015;'CAFETERIA';-3,60 €;6.276,58 €;6435;-3,60;10.800,67 €;'sin fechas';24/01/2015;'CAFETERIA';'Gastos_Compras';'Supermercado';'VARIABLES'
24/01/2015;22/01/2015;'COMPRA CON TARJETA';-1,25 €;6.275,33 €;6436;-1,25;10.799,42 €;'sin fechas';22/01/2015;'COMPRA';'Gastos_Compras';'Supermercado';'VARIABLES'
24/01/2015;22/01/2015;'COMPRA CON TARJETA';-1,39 €;6.273,94 €;6437;-1,39;10.798,03 €;'sin fechas';22/01/2015;'COMPRA';'Gastos_Compras';'Supermercado';'VARIABLES'
24/01/2015;24/01/2015;'FRANKFURT LES LLETRES';-2,50 €;6.271,44 €;6438;-2,50;10.795,53 €;'sin fechas';24/01/2015;'FRANKFURT';'Gastos_Ocio y transporte';'Restaurantes';'VARIABLES'
25/01/2015;25/01/2015;'CAFETERIA';-3,65 €;6.267,79 €;6439;-3,65;10.791,88 €;'sin fechas';25/01/2015;'CAFETERIA';'Gastos_Compras';'Supermercado';'VARIABLES'
25/01/2015;25/01/2015;'TOCINERIES VENTURA';-13,75 €;6.254,04 €;6440;-13,75;10.778,13 €;'sin fechas';25/01/2015;'TOCINERIES';'Gastos_Compras';'Supermercado';'VARIABLES'
26/01/2015;26/01/2015;'BON AREA';-29,50 €;6.224,54 €;6441;-29,50;10.748,63 €;'sin fechas';26/01/2015;'BON';'Gastos_Compras';'Supermercado';'VARIABLES'
26/01/2015;26/01/2015;'CAFETERIA';-3,65 €;6.220,89 €;6442;-3,65;10.744,98 €;'sin fechas';26/01/2015;'CAFETERIA';'Gastos_Compras';'Supermercado';'VARIABLES'
26/01/2015;26/01/2015;'FRANKFURT LES LLETRES';-2,50 €;6.218,39 €;6443;-2,50;10.742,48 €;'sin fechas';26/01/2015;'FRANKFURT';'Gastos_Ocio y transporte';'Restaurantes';'VARIABLES'
27/01/2015;23/01/2015;'COMPRA CON TARJETA';-1,25 €;6.217,14 €;6444;-1,25;10.741,23 €;'sin fechas';23/01/2015;'COMPRA';'Gastos_Compras';'Supermercado';'VARIABLES'
27/01/2015;23/01/2015;'COMPRA CON TARJETA';-1,25 €;6.215,89 €;6445;-1,25;10.739,98 €;'sin fechas';23/01/2015;'COMPRA';'Gastos_Compras';'Supermercado';'VARIABLES'
28/01/2015;28/01/2015;'FOMENT DE TERRASSA, SA';1.754,72 €;7.970,61 €;6446;1.754,72;12.494,70 €;'sin fechas';28/01/2015;'FOMENT';'Ingresos';'Nomina';'FIJO'
29/01/2015;29/01/2015;'CAFETERIA';-3,65 €;7.966,96 €;6447;-3,65;12.491,05 €;'sin fechas';29/01/2015;'CAFETERIA';'Gastos_Compras';'Supermercado';'VARIABLES'
29/01/2015;27/01/2015;'COMPRA CON TARJETA';-1,39 €;7.965,57 €;6448;-1,39;12.489,66 €;'sin fechas';27/01/2015;'COMPRA';'Gastos_Compras';'Supermercado';'VARIABLES'
29/01/2015;29/01/2015;'GASOLINERA';-36,90 €;7.928,67 €;6449;-36,90;12.452,76 €;'sin fechas';29/01/2015;'GASOLINERA';'Gastos_Ocio y transporte';'Gasolina';'VARIABLES'
29/01/2015;29/01/2015;'INFORMACIO I TECNOLOGIA DE CAT';1.585,61 €;9.514,28 €;6450;1.585,61;14.038,37 €;'sin fechas';29/01/2015;'INFORMACIO';'Ingresos';'Nomina';'FIJO'
29/01/2015;29/01/2015;'REINT.CAJERO';-50,00 €;9.464,28 €;6451;-50,00;13.988,37 €;'sin fechas';29/01/2015;'REINTCAJERO';'Gastos_Gastos varios';'Efectivo';'VARIABLES'
29/01/2015;29/01/2015;'RESTAURANTES';-10,00 €;9.454,28 €;6452;-10,00;13.978,37 €;'sin fechas';29/01/2015;'RESTAURANTES';'Gastos_Ocio y transporte';'Restaurantes';'VARIABLES'
30/01/2015;30/01/2015;'BON AREA';-16,89 €;9.437,39 €;6453;-16,89;13.961,48 €;'sin fechas';30/01/2015;'BON';'Gastos_Compras';'Supermercado';'VARIABLES'
30/01/2015;30/01/2015;'CAFETERIA';-3,60 €;9.433,79 €;6454;-3,60;13.957,88 €;'sin fechas';30/01/2015;'CAFETERIA';'Gastos_Compras';'Supermercado';'VARIABLES'
30/01/2015;25/01/2015;'COMPRA CON TARJETA';-74,94 €;9.358,85 €;6455;-74,94;13.882,94 €;'sin fechas';25/01/2015;'COMPRA';'Gastos_Compras';'Supermercado';'VARIABLES'
30/01/2015;30/01/2015;'ESCOLA BRESSOL EINA';-479,35 €;8.879,50 €;6456;-479,35;13.403,59 €;'sin fechas';30/01/2015;'ESCOLA';'Gastos_Salud, saber y deporte';'Estudios';'VARIABLES'
30/01/2015;30/01/2015;'FARMACIA';-6,24 €;8.873,26 €;6457;-6,24;13.397,35 €;'sin fechas';30/01/2015;'FARMACIA';'Gastos_Salud, saber y deporte';'Farmacia';'VARIABLES'
30/01/2015;30/01/2015;'IBI';-44,99 €;8.828,27 €;6458;-44,99;13.352,36 €;'sin fechas';30/01/2015;'IBI';'Gastos_Banco y organismos';'Ayuntamiento';'FIJO'
30/01/2015;30/01/2015;'FRANKFURT LES LLETRES';-2,50 €;8.825,77 €;6459;-2,50;13.349,86 €;'sin fechas';30/01/2015;'FRANKFURT';'Gastos_Ocio y transporte';'Restaurantes';'VARIABLES'
30/01/2015;30/01/2015;'PERRUQUERIA';-32,00 €;8.793,77 €;6460;-32,00;13.317,86 €;'sin fechas';30/01/2015;'PERRUQUERIA';'Gastos_Salud, saber y deporte';'Belleza';'VARIABLES'
31/01/2015;31/01/2015;'CAFETERIA';-3,65 €;8.790,12 €;6461;-3,65;13.314,21 €;'sin fechas';31/01/2015;'CAFETERIA';'Gastos_Compras';'Supermercado';'VARIABLES'
31/01/2015;29/01/2015;'COMPRA CON TARJETA';-2,82 €;8.787,30 €;6462;-2,82;13.311,39 €;'sin fechas';29/01/2015;'COMPRA';'Gastos_Compras';'Supermercado';'VARIABLES'
31/01/2015;31/01/2015;'FRANKFURT LES LLETRES';-2,50 €;8.784,80 €;6463;-2,50;13.308,89 €;'sin fechas';31/01/2015;'FRANKFURT';'Gastos_Ocio y transporte';'Restaurantes';'VARIABLES'
31/01/2015;31/01/2015;'REC. 6061.9600001223';-547,25 €;8.237,55 €;6464;-547,25;12.761,64 €;'sin fechas';31/01/2015;'REC';'Gastos_Banco y organismos';'Hipoteca';'FIJO'
01/02/2015;01/02/2015;'CAFETERIA';-3,05 €;8.234,50 €;6465;-3,05;12.758,59 €;'sin fechas';01/02/2015;'CAFETERIA';'Gastos_Compras';'Supermercado';'VARIABLES'
01/02/2015;01/02/2015;'CREDITO';-5,58 €;8.228,92 €;6466;-5,58;12.753,01 €;'sin fechas';01/02/2015;'CREDITO';'No computable';'Recibo Tarjeta';
01/02/2015;01/02/2015;'FRANKFURT LES LLETRES';-7,30 €;8.221,62 €;6467;-7,30;12.745,71 €;'sin fechas';01/02/2015;'FRANKFURT';'Gastos_Ocio y transporte';'Restaurantes';'VARIABLES'
01/02/2015;01/02/2015;'FRANKFURT LES LLETRES';-2,50 €;8.219,12 €;6468;-2,50;12.743,21 €;'sin fechas';01/02/2015;'FRANKFURT';'Gastos_Ocio y transporte';'Restaurantes';'VARIABLES'
01/02/2015;01/02/2015;'MERCADONA';-13,03 €;8.206,09 €;6469;-13,03;12.730,18 €;'sin fechas';01/02/2015;'MERCADONA';'Gastos_Compras';'Supermercado';'VARIABLES'
02/02/2015;02/02/2015;'CAFETERIA';-3,65 €;8.202,44 €;6470;-3,65;12.726,53 €;'sin fechas';02/02/2015;'CAFETERIA';'Gastos_Compras';'Supermercado';'VARIABLES'
02/02/2015;02/02/2015;'DEVOLUCION POR SEGURO TARJETA';438,58 €;8.641,02 €;6471;438,58;13.165,11 €;'sin fechas';02/02/2015;'DEVOLUCION';'Ingresos';'Devoluciones';'VARIABLES'
02/02/2015;02/02/2015;'FRANKFURT LES LLETRES';-2,50 €;8.638,52 €;6472;-2,50;13.162,61 €;'sin fechas';02/02/2015;'FRANKFURT';'Gastos_Ocio y transporte';'Restaurantes';'VARIABLES'
03/02/2015;31/01/2015;'COMPRA CON TARJETA';-2,53 €;8.635,99 €;6473;-2,53;13.160,08 €;'sin fechas';31/01/2015;'COMPRA';'Gastos_Compras';'Supermercado';'VARIABLES'
03/02/2015;31/01/2015;'COMPRA CON TARJETA';-2,53 €;8.633,46 €;6474;-2,53;13.157,55 €;'sin fechas';31/01/2015;'COMPRA';'Gastos_Compras';'Supermercado';'VARIABLES'
03/02/2015;03/02/2015;'EXNER DREAMS, S.L.';-39,99 €;8.593,47 €;6475;-39,99;13.117,56 €;'sin fechas';03/02/2015;'EXNER';'No computable';'No computable';'No computable'
03/02/2015;03/02/2015;'MAGICLAND';-18,30 €;8.575,17 €;6476;-18,30;13.099,26 €;'sin fechas';03/02/2015;'MAGICLAND';'Gastos_Ocio y transporte';'Vacaciones';'VARIABLES'
03/02/2015;03/02/2015;'MERCADONA';-19,56 €;8.555,61 €;6477;-19,56;13.079,70 €;'sin fechas';03/02/2015;'MERCADONA';'Gastos_Compras';'Supermercado';'VARIABLES'
03/02/2015;03/02/2015;'PERRUQUERIA';-18,50 €;8.537,11 €;6478;-18,50;13.061,20 €;'sin fechas';03/02/2015;'PERRUQUERIA';'Gastos_Salud, saber y deporte';'Belleza';'VARIABLES'
03/02/2015;03/02/2015;'VIENA';-19,50 €;8.517,61 €;6479;-19,50;13.041,70 €;'sin fechas';03/02/2015;'VIENA';'Gastos_Ocio y transporte';'Restaurantes';'VARIABLES'
05/02/2015;05/02/2015;'AUTOPISTAS';-4,19 €;8.513,42 €;6480;-4,19;13.037,51 €;'sin fechas';05/02/2015;'AUTOPISTAS';'Gastos_Ocio y transporte';'Parking y peaje';'VARIABLES'
05/02/2015;05/02/2015;'BLITZ';-72,50 €;8.440,92 €;6481;-72,50;12.965,01 €;'sin fechas';05/02/2015;'BLITZ';'Gastos_Vivienda y vehiculo';'Alquiler Parking';'FIJO'
05/02/2015;05/02/2015;'BON AREA';-19,27 €;8.421,65 €;6482;-19,27;12.945,74 €;'sin fechas';05/02/2015;'BON';'Gastos_Compras';'Supermercado';'VARIABLES'
05/02/2015;05/02/2015;'CAFETERIA';-4,10 €;8.417,55 €;6483;-4,10;12.941,64 €;'sin fechas';05/02/2015;'CAFETERIA';'Gastos_Compras';'Supermercado';'VARIABLES'
06/02/2015;06/02/2015;'ADESLAS';-111,00 €;8.306,55 €;6484;-111,00;12.830,64 €;'sin fechas';06/02/2015;'ADESLAS';'Gastos_Salud, saber y deporte';'Medico';'VARIABLES'
06/02/2015;06/02/2015;'CAFETERIA';-3,60 €;8.302,95 €;6485;-3,60;12.827,04 €;'sin fechas';06/02/2015;'CAFETERIA';'Gastos_Compras';'Supermercado';'VARIABLES'
06/02/2015;02/02/2015;'COMPRA CON TARJETA';-1,39 €;8.301,56 €;6486;-1,39;12.825,65 €;'sin fechas';02/02/2015;'COMPRA';'Gastos_Compras';'Supermercado';'VARIABLES'
06/02/2015;02/02/2015;'COMPRA CON TARJETA';-1,39 €;8.300,17 €;6487;-1,39;12.824,26 €;'sin fechas';02/02/2015;'COMPRA';'Gastos_Compras';'Supermercado';'VARIABLES'
06/02/2015;03/02/2015;'COMPRA CON TARJETA';-1,39 €;8.298,78 €;6488;-1,39;12.822,87 €;'sin fechas';03/02/2015;'COMPRA';'Gastos_Compras';'Supermercado';'VARIABLES'
06/02/2015;03/02/2015;'COMPRA CON TARJETA';-1,39 €;8.297,39 €;6489;-1,39;12.821,48 €;'sin fechas';03/02/2015;'COMPRA';'Gastos_Compras';'Supermercado';'VARIABLES'
06/02/2015;06/02/2015;'FRANKFURT LES LLETRES';-2,50 €;8.294,89 €;6490;-2,50;12.818,98 €;'sin fechas';06/02/2015;'FRANKFURT';'Gastos_Ocio y transporte';'Restaurantes';'VARIABLES'
06/02/2015;06/02/2015;'TACISA';-84,03 €;8.210,86 €;6491;-84,03;12.734,95 €;'sin fechas';06/02/2015;'TACISA';'Gastos_Compras';'Supermercado';'VARIABLES'
07/02/2015;07/02/2015;'BON AREA';-10,38 €;8.200,48 €;6492;-10,38;12.724,57 €;'sin fechas';07/02/2015;'BON';'Gastos_Compras';'Supermercado';'VARIABLES'
07/02/2015;04/02/2015;'COMPRA CON TARJETA';-1,39 €;8.199,09 €;6493;-1,39;12.723,18 €;'sin fechas';04/02/2015;'COMPRA';'Gastos_Compras';'Supermercado';'VARIABLES'
07/02/2015;05/02/2015;'COMPRA CON TARJETA';-1,39 €;8.197,70 €;6494;-1,39;12.721,79 €;'sin fechas';05/02/2015;'COMPRA';'Gastos_Compras';'Supermercado';'VARIABLES'
07/02/2015;05/02/2015;'COMPRA CON TARJETA';-1,39 €;8.196,31 €;6495;-1,39;12.720,40 €;'sin fechas';05/02/2015;'COMPRA';'Gastos_Compras';'Supermercado';'VARIABLES'
07/02/2015;07/02/2015;'GASOLINERA';-40,27 €;8.156,04 €;6496;-40,27;12.680,13 €;'sin fechas';07/02/2015;'GASOLINERA';'Gastos_Ocio y transporte';'Gasolina';'VARIABLES'
07/02/2015;07/02/2015;'FRANKFURT LES LLETRES';-6,70 €;8.149,34 €;6497;-6,70;12.673,43 €;'sin fechas';07/02/2015;'FRANKFURT';'Gastos_Ocio y transporte';'Restaurantes';'VARIABLES'
07/02/2015;07/02/2015;'LIDL';-48,93 €;8.100,41 €;6498;-48,93;12.624,50 €;'sin fechas';07/02/2015;'LIDL';'Gastos_Compras';'Supermercado';'VARIABLES'
08/02/2015;08/02/2015;'CAFETERIA';-3,60 €;8.096,81 €;6499;-3,60;12.620,90 €;'sin fechas';08/02/2015;'CAFETERIA';'Gastos_Compras';'Supermercado';'VARIABLES'
08/02/2015;08/02/2015;'CAFETERIA';-5,30 €;8.091,51 €;6500;-5,30;12.615,60 €;'sin fechas';08/02/2015;'CAFETERIA';'Gastos_Compras';'Supermercado';'VARIABLES'
08/02/2015;08/02/2015;'MERCADONA';-9,87 €;8.081,64 €;6501;-9,87;12.605,73 €;'sin fechas';08/02/2015;'MERCADONA';'Gastos_Compras';'Supermercado';'VARIABLES'
08/02/2015;08/02/2015;'MERCADONA';-93,28 €;7.988,36 €;6502;-93,28;12.512,45 €;'sin fechas';08/02/2015;'MERCADONA';'Gastos_Compras';'Supermercado';'VARIABLES'
08/02/2015;08/02/2015;'VIENA';-10,90 €;7.977,46 €;6503;-10,90;12.501,55 €;'sin fechas';08/02/2015;'VIENA';'Gastos_Ocio y transporte';'Restaurantes';'VARIABLES'
09/02/2015;09/02/2015;'CAFETERIA';-3,65 €;7.973,81 €;6504;-3,65;12.497,90 €;'sin fechas';09/02/2015;'CAFETERIA';'Gastos_Compras';'Supermercado';'VARIABLES'
09/02/2015;09/02/2015;'FRANKFURT LES LLETRES';-4,35 €;7.969,46 €;6505;-4,35;12.493,55 €;'sin fechas';09/02/2015;'FRANKFURT';'Gastos_Ocio y transporte';'Restaurantes';'VARIABLES'
09/02/2015;09/02/2015;'REINT.CAJERO';-80,00 €;7.889,46 €;6506;-80,00;12.413,55 €;'sin fechas';09/02/2015;'REINTCAJERO';'Gastos_Gastos varios';'Efectivo';'VARIABLES'
10/02/2015;10/02/2015;'ALDI';-22,17 €;7.867,29 €;6507;-22,17;12.391,38 €;'sin fechas';10/02/2015;'ALDI';'Gastos_Compras';'Supermercado';'VARIABLES'
10/02/2015;06/02/2015;'COMPRA CON TARJETA';-1,39 €;7.865,90 €;6508;-1,39;12.389,99 €;'sin fechas';06/02/2015;'COMPRA';'Gastos_Compras';'Supermercado';'VARIABLES'
10/02/2015;06/02/2015;'COMPRA CON TARJETA';-1,39 €;7.864,51 €;6509;-1,39;12.388,60 €;'sin fechas';06/02/2015;'COMPRA';'Gastos_Compras';'Supermercado';'VARIABLES'
10/02/2015;10/02/2015;'GLT STORE HOME';-6,05 €;7.858,46 €;6510;-6,05;12.382,55 €;'sin fechas';10/02/2015;'GLT';'Gastos_Compras';'Otras compras';'VARIABLES'
10/02/2015;10/02/2015;'H&M';-27,98 €;7.830,48 €;6511;-27,98;12.354,57 €;'sin fechas';10/02/2015;'HM';'Gastos_Compras';'Ropa';'VARIABLES'
10/02/2015;10/02/2015;'RESTAURANTES';-9,25 €;7.821,23 €;6512;-9,25;12.345,32 €;'sin fechas';10/02/2015;'RESTAURANTES';'Gastos_Ocio y transporte';'Restaurantes';'VARIABLES'
10/02/2015;10/02/2015;'UNIO PAPERS';-9,50 €;7.811,73 €;6513;-9,50;12.335,82 €;'sin fechas';10/02/2015;'UNIO';'Gastos_Compras';'Libreria';'VARIABLES'
11/02/2015;09/02/2015;'COMPRA CON TARJETA';-1,32 €;7.810,41 €;6514;-1,32;12.334,50 €;'sin fechas';09/02/2015;'COMPRA';'Gastos_Compras';'Supermercado';'VARIABLES'
11/02/2015;09/02/2015;'COMPRA CON TARJETA';-1,39 €;7.809,02 €;6515;-1,39;12.333,11 €;'sin fechas';09/02/2015;'COMPRA';'Gastos_Compras';'Supermercado';'VARIABLES'
11/02/2015;10/02/2015;'SATSA PL. VELLA TERRASSA';-4,05 €;7.804,97 €;6516;-4,05;12.329,06 €;'sin fechas';10/02/2015;'SATSA';'Gastos_Ocio y transporte';'Parking y peaje';'VARIABLES'
11/02/2015;11/02/2015;'VIRGIN ACTIV';-55,95 €;7.749,02 €;6517;-55,95;12.273,11 €;'sin fechas';11/02/2015;'VIRGIN';'Gastos_Salud, saber y deporte';'Deportes';'VARIABLES'
11/02/2015;11/02/2015;'VIRGIN ACTIV';-55,95 €;7.693,07 €;6518;-55,95;12.217,16 €;'sin fechas';11/02/2015;'VIRGIN';'Gastos_Salud, saber y deporte';'Deportes';'VARIABLES'
12/02/2015;12/02/2015;'BON AREA';-4,13 €;7.688,94 €;6519;-4,13;12.213,03 €;'sin fechas';12/02/2015;'BON';'Gastos_Compras';'Supermercado';'VARIABLES'
12/02/2015;12/02/2015;'CAFETERIA';-4,85 €;7.684,09 €;6520;-4,85;12.208,18 €;'sin fechas';12/02/2015;'CAFETERIA';'Gastos_Compras';'Supermercado';'VARIABLES'
12/02/2015;12/02/2015;'CAFETERIA';-3,65 €;7.680,44 €;6521;-3,65;12.204,53 €;'sin fechas';12/02/2015;'CAFETERIA';'Gastos_Compras';'Supermercado';'VARIABLES'
12/02/2015;10/02/2015;'COMPRA CON TARJETA';-1,32 €;7.679,12 €;6522;-1,32;12.203,21 €;'sin fechas';10/02/2015;'COMPRA';'Gastos_Compras';'Supermercado';'VARIABLES'
12/02/2015;10/02/2015;'COMPRA CON TARJETA';-1,32 €;7.677,80 €;6523;-1,32;12.201,89 €;'sin fechas';10/02/2015;'COMPRA';'Gastos_Compras';'Supermercado';'VARIABLES'
12/02/2015;12/02/2015;'FRUITES I VERDURES';-4,45 €;7.673,35 €;6524;-4,45;12.197,44 €;'sin fechas';12/02/2015;'FRUITES';'Gastos_Compras';'Supermercado';'VARIABLES'
12/02/2015;12/02/2015;'GAS NATURAL';-250,65 €;7.422,70 €;6525;-250,65;11.946,79 €;'sin fechas';12/02/2015;'GAS';'Gastos_Servicios tipicos';'Gas';'FIJO'
13/02/2015;11/02/2015;'AUTOPISTAS';-1,32 €;7.421,38 €;6526;-1,32;11.945,47 €;'sin fechas';11/02/2015;'AUTOPISTAS';'Gastos_Ocio y transporte';'Parking y peaje';'VARIABLES'
13/02/2015;11/02/2015;'AUTOPISTAS';-1,39 €;7.419,99 €;6527;-1,39;11.944,08 €;'sin fechas';11/02/2015;'AUTOPISTAS';'Gastos_Ocio y transporte';'Parking y peaje';'VARIABLES'
13/02/2015;13/02/2015;'CAFETERIA';-3,65 €;7.416,34 €;6528;-3,65;11.940,43 €;'sin fechas';13/02/2015;'CAFETERIA';'Gastos_Compras';'Supermercado';'VARIABLES'
13/02/2015;13/02/2015;'CAFETERIA';-0,90 €;7.415,44 €;6529;-0,90;11.939,53 €;'sin fechas';13/02/2015;'CAFETERIA';'Gastos_Compras';'Supermercado';'VARIABLES'
14/02/2015;12/02/2015;'AUTOPISTAS';-1,32 €;7.414,12 €;6530;-1,32;11.938,21 €;'sin fechas';12/02/2015;'AUTOPISTAS';'Gastos_Ocio y transporte';'Parking y peaje';'VARIABLES'
14/02/2015;12/02/2015;'AUTOPISTAS';-1,39 €;7.412,73 €;6531;-1,39;11.936,82 €;'sin fechas';12/02/2015;'AUTOPISTAS';'Gastos_Ocio y transporte';'Parking y peaje';'VARIABLES'
14/02/2015;14/02/2015;'CAFETERIA';-3,65 €;7.409,08 €;6532;-3,65;11.933,17 €;'sin fechas';14/02/2015;'CAFETERIA';'Gastos_Compras';'Supermercado';'VARIABLES'
14/02/2015;14/02/2015;'FRANKFURT LES LLETRES';-2,50 €;7.406,58 €;6533;-2,50;11.930,67 €;'sin fechas';14/02/2015;'FRANKFURT';'Gastos_Ocio y transporte';'Restaurantes';'VARIABLES'
15/02/2015;15/02/2015;'CAFETERIA';-3,60 €;7.402,98 €;6534;-3,60;11.927,07 €;'sin fechas';15/02/2015;'CAFETERIA';'Gastos_Compras';'Supermercado';'VARIABLES'
15/02/2015;15/02/2015;'JUGUETILANDIA TERR';-12,00 €;7.390,98 €;6535;-12,00;11.915,07 €;'sin fechas';15/02/2015;'JUGUETILANDIA';'Gastos_Compras';'Niños';'VARIABLES'
15/02/2015;15/02/2015;'RESTAURANTES';-10,00 €;7.380,98 €;6536;-10,00;11.905,07 €;'sin fechas';15/02/2015;'RESTAURANTES';'Gastos_Ocio y transporte';'Restaurantes';'VARIABLES'
15/02/2015;15/02/2015;'SONY ENT NETWORK';-49,99 €;7.330,99 €;6537;-49,99;11.855,08 €;'sin fechas';15/02/2015;'SONY';'Gastos_Servicios tipicos';'Servicios online';'FIJO'
15/02/2015;15/02/2015;'VIENA';-11,20 €;7.319,79 €;6538;-11,20;11.843,88 €;'sin fechas';15/02/2015;'VIENA';'Gastos_Ocio y transporte';'Restaurantes';'VARIABLES'
16/02/2015;16/02/2015;'CAFETERIA';-3,65 €;7.316,14 €;6539;-3,65;11.840,23 €;'sin fechas';16/02/2015;'CAFETERIA';'Gastos_Compras';'Supermercado';'VARIABLES'
16/02/2015;16/02/2015;'CCM VIDA Y P SEGURO PRESTAMO';-23,17 €;7.292,97 €;6540;-23,17;11.817,06 €;'sin fechas';16/02/2015;'CCM';'Gastos_Seguros';'Seguro vida';'FIJO'
16/02/2015;16/02/2015;'FRUITES I VERDURES';-7,99 €;7.284,98 €;6541;-7,99;11.809,07 €;'sin fechas';16/02/2015;'FRUITES';'Gastos_Compras';'Supermercado';'VARIABLES'
16/02/2015;16/02/2015;'FRANKFURT LES LLETRES';-2,50 €;7.282,48 €;6542;-2,50;11.806,57 €;'sin fechas';16/02/2015;'FRANKFURT';'Gastos_Ocio y transporte';'Restaurantes';'VARIABLES'
16/02/2015;16/02/2015;'REINT.CAJERO';-70,00 €;7.212,48 €;6543;-70,00;11.736,57 €;'sin fechas';16/02/2015;'REINTCAJERO';'Gastos_Gastos varios';'Efectivo';'VARIABLES'
16/02/2015;16/02/2015;'VIRGIN ACTIV';-78,00 €;7.134,48 €;6544;-78,00;11.658,57 €;'sin fechas';16/02/2015;'VIRGIN';'Gastos_Salud, saber y deporte';'Deportes';'VARIABLES'
17/02/2015;13/02/2015;'AUTOPISTAS';-1,25 €;7.133,23 €;6545;-1,25;11.657,32 €;'sin fechas';13/02/2015;'AUTOPISTAS';'Gastos_Ocio y transporte';'Parking y peaje';'VARIABLES'
17/02/2015;13/02/2015;'AUTOPISTAS';-1,39 €;7.131,84 €;6546;-1,39;11.655,93 €;'sin fechas';13/02/2015;'AUTOPISTAS';'Gastos_Ocio y transporte';'Parking y peaje';'VARIABLES'
17/02/2015;17/02/2015;'BOLIN SHIJIA, SCP';-50,00 €;7.081,84 €;6547;-50,00;11.605,93 €;'sin fechas';17/02/2015;'BOLIN';'Gastos_Ocio y transporte';'Restaurantes';'VARIABLES'
17/02/2015;17/02/2015;'CAPRABO';-10,45 €;7.071,39 €;6548;-10,45;11.595,48 €;'sin fechas';17/02/2015;'CAPRABO';'Gastos_Compras';'Supermercado';'VARIABLES'
17/02/2015;17/02/2015;'DECATHLON';-15,90 €;7.055,49 €;6549;-15,90;11.579,58 €;'sin fechas';17/02/2015;'DECATHLON';'Gastos_Compras';'Deportivo';'VARIABLES'
17/02/2015;17/02/2015;'FARMACIA';-9,30 €;7.046,19 €;6550;-9,30;11.570,28 €;'sin fechas';17/02/2015;'FARMACIA';'Gastos_Salud, saber y deporte';'Farmacia';'VARIABLES'
17/02/2015;17/02/2015;'ONO';-115,81 €;6.930,38 €;6551;-115,81;11.454,47 €;'sin fechas';17/02/2015;'ONO';'Gastos_Servicios tipicos';'Telecomunicaciones';'FIJO'
17/02/2015;17/02/2015;'REINT.CAJERO';-20,00 €;6.910,38 €;6552;-20,00;11.434,47 €;'sin fechas';17/02/2015;'REINTCAJERO';'Gastos_Gastos varios';'Efectivo';'VARIABLES'
17/02/2015;17/02/2015;'VIENA';-16,50 €;6.893,88 €;6553;-16,50;11.417,97 €;'sin fechas';17/02/2015;'VIENA';'Gastos_Ocio y transporte';'Restaurantes';'VARIABLES'
18/02/2015;18/02/2015;'CCM VIDA Y PENSIO 000000493358';-18,16 €;6.875,72 €;6554;-18,16;11.399,81 €;'sin fechas';18/02/2015;'CCM';'Gastos_Seguros';'Seguro vida';'FIJO'
18/02/2015;18/02/2015;'SALA BADRINAS - MENJADOR';-109,13 €;6.766,59 €;6555;-109,13;11.290,68 €;'sin fechas';18/02/2015;'SALA';'Gastos_Salud, saber y deporte';'Estudios';'VARIABLES'
19/02/2015;17/02/2015;'AUTOPISTAS';-1,25 €;6.765,34 €;6556;-1,25;11.289,43 €;'sin fechas';17/02/2015;'AUTOPISTAS';'Gastos_Ocio y transporte';'Parking y peaje';'VARIABLES'
19/02/2015;17/02/2015;'AUTOPISTAS';-1,39 €;6.763,95 €;6557;-1,39;11.288,04 €;'sin fechas';17/02/2015;'AUTOPISTAS';'Gastos_Ocio y transporte';'Parking y peaje';'VARIABLES'
19/02/2015;19/02/2015;'FRANKFURT LES LLETRES';-2,50 €;6.761,45 €;6558;-2,50;11.285,54 €;'sin fechas';19/02/2015;'FRANKFURT';'Gastos_Ocio y transporte';'Restaurantes';'VARIABLES'
19/02/2015;19/02/2015;'MERCADONA';-12,74 €;6.748,71 €;6559;-12,74;11.272,80 €;'sin fechas';19/02/2015;'MERCADONA';'Gastos_Compras';'Supermercado';'VARIABLES'
20/02/2015;18/02/2015;'AUTOPISTAS';-1,25 €;6.747,46 €;6560;-1,25;11.271,55 €;'sin fechas';18/02/2015;'AUTOPISTAS';'Gastos_Ocio y transporte';'Parking y peaje';'VARIABLES'
20/02/2015;18/02/2015;'AUTOPISTAS';-1,25 €;6.746,21 €;6561;-1,25;11.270,30 €;'sin fechas';18/02/2015;'AUTOPISTAS';'Gastos_Ocio y transporte';'Parking y peaje';'VARIABLES'
20/02/2015;20/02/2015;'AUTOPISTAS';-4,19 €;6.742,02 €;6562;-4,19;11.266,11 €;'sin fechas';20/02/2015;'AUTOPISTAS';'Gastos_Ocio y transporte';'Parking y peaje';'VARIABLES'
20/02/2015;20/02/2015;'CAFETERIA';-2,70 €;6.739,32 €;6563;-2,70;11.263,41 €;'sin fechas';20/02/2015;'CAFETERIA';'Gastos_Compras';'Supermercado';'VARIABLES'
20/02/2015;20/02/2015;'DEVOLUCION POR SEGURO TARJETA';2,19 €;6.741,51 €;6564;2,19;11.265,60 €;'sin fechas';20/02/2015;'DEVOLUCION';'Ingresos';'Devoluciones';'VARIABLES'
20/02/2015;20/02/2015;'GASOLINERA';-49,69 €;6.691,82 €;6565;-49,69;11.215,91 €;'sin fechas';20/02/2015;'GASOLINERA';'Gastos_Ocio y transporte';'Gasolina';'VARIABLES'
20/02/2015;20/02/2015;'FRANKFURT LES LLETRES';-3,55 €;6.688,27 €;6566;-3,55;11.212,36 €;'sin fechas';20/02/2015;'FRANKFURT';'Gastos_Ocio y transporte';'Restaurantes';'VARIABLES'
21/02/2015;19/02/2015;'AUTOPISTAS';-1,25 €;6.687,02 €;6567;-1,25;11.211,11 €;'sin fechas';19/02/2015;'AUTOPISTAS';'Gastos_Ocio y transporte';'Parking y peaje';'VARIABLES'
21/02/2015;19/02/2015;'AUTOPISTAS';-1,39 €;6.685,63 €;6568;-1,39;11.209,72 €;'sin fechas';19/02/2015;'AUTOPISTAS';'Gastos_Ocio y transporte';'Parking y peaje';'VARIABLES'
21/02/2015;21/02/2015;'BON AREA';-28,00 €;6.657,63 €;6569;-28,00;11.181,72 €;'sin fechas';21/02/2015;'BON';'Gastos_Compras';'Supermercado';'VARIABLES'
21/02/2015;21/02/2015;'CAFETERIA';-3,60 €;6.654,03 €;6570;-3,60;11.178,12 €;'sin fechas';21/02/2015;'CAFETERIA';'Gastos_Compras';'Supermercado';'VARIABLES'
21/02/2015;21/02/2015;'FARMACIA';-14,95 €;6.639,08 €;6571;-14,95;11.163,17 €;'sin fechas';21/02/2015;'FARMACIA';'Gastos_Salud, saber y deporte';'Farmacia';'VARIABLES'
22/02/2015;22/02/2015;'CAFETERIA';-2,70 €;6.636,38 €;6572;-2,70;11.160,47 €;'sin fechas';22/02/2015;'CAFETERIA';'Gastos_Compras';'Supermercado';'VARIABLES'
22/02/2015;22/02/2015;'FARMACIA';-29,07 €;6.607,31 €;6573;-29,07;11.131,40 €;'sin fechas';22/02/2015;'FARMACIA';'Gastos_Salud, saber y deporte';'Farmacia';'VARIABLES'
22/02/2015;22/02/2015;'FRANKFURT LES LLETRES';-5,50 €;6.601,81 €;6574;-5,50;11.125,90 €;'sin fechas';22/02/2015;'FRANKFURT';'Gastos_Ocio y transporte';'Restaurantes';'VARIABLES'
22/02/2015;22/02/2015;'PERRUQUERIA';-19,75 €;6.582,06 €;6575;-19,75;11.106,15 €;'sin fechas';22/02/2015;'PERRUQUERIA';'Gastos_Salud, saber y deporte';'Belleza';'VARIABLES'
23/02/2015;23/02/2015;'CAFETERIA';-2,85 €;6.579,21 €;6576;-2,85;11.103,30 €;'sin fechas';23/02/2015;'CAFETERIA';'Gastos_Compras';'Supermercado';'VARIABLES'
23/02/2015;23/02/2015;'DEVOLUCION POR SEGURO TARJETA';10,77 €;6.589,98 €;6577;10,77;11.114,07 €;'sin fechas';23/02/2015;'DEVOLUCION';'Ingresos';'Devoluciones';'VARIABLES'
23/02/2015;23/02/2015;'FRANKFURT LES LLETRES';-2,50 €;6.587,48 €;6578;-2,50;11.111,57 €;'sin fechas';23/02/2015;'FRANKFURT';'Gastos_Ocio y transporte';'Restaurantes';'VARIABLES'
23/02/2015;23/02/2015;'REINT.CAJERO';-40,00 €;6.547,48 €;6579;-40,00;11.071,57 €;'sin fechas';23/02/2015;'REINTCAJERO';'Gastos_Gastos varios';'Efectivo';'VARIABLES'
24/02/2015;20/02/2015;'AUTOPISTAS';-1,25 €;6.546,23 €;6580;-1,25;11.070,32 €;'sin fechas';20/02/2015;'AUTOPISTAS';'Gastos_Ocio y transporte';'Parking y peaje';'VARIABLES'
24/02/2015;20/02/2015;'AUTOPISTAS';-1,39 €;6.544,84 €;6581;-1,39;11.068,93 €;'sin fechas';20/02/2015;'AUTOPISTAS';'Gastos_Ocio y transporte';'Parking y peaje';'VARIABLES'
24/02/2015;24/02/2015;'BON AREA';-21,76 €;6.523,08 €;6582;-21,76;11.047,17 €;'sin fechas';24/02/2015;'BON';'Gastos_Compras';'Supermercado';'VARIABLES'
24/02/2015;24/02/2015;'EROSKI-[COMIDA]';-67,23 €;6.455,85 €;6583;-67,23;10.979,94 €;'sin fechas';24/02/2015;'EROSKICOMIDA';'Gastos_Compras';'Supermercado';'VARIABLES'
24/02/2015;24/02/2015;'RESTAURANTES';-3,90 €;6.451,95 €;6584;-3,90;10.976,04 €;'sin fechas';24/02/2015;'RESTAURANTES';'Gastos_Ocio y transporte';'Restaurantes';'VARIABLES'
24/02/2015;24/02/2015;'VIENA';-21,00 €;6.430,95 €;6585;-21,00;10.955,04 €;'sin fechas';24/02/2015;'VIENA';'Gastos_Ocio y transporte';'Restaurantes';'VARIABLES'
25/02/2015;23/02/2015;'AUTOPISTAS';-1,25 €;6.429,70 €;6586;-1,25;10.953,79 €;'sin fechas';23/02/2015;'AUTOPISTAS';'Gastos_Ocio y transporte';'Parking y peaje';'VARIABLES'
25/02/2015;23/02/2015;'AUTOPISTAS';-1,39 €;6.428,31 €;6587;-1,39;10.952,40 €;'sin fechas';23/02/2015;'AUTOPISTAS';'Gastos_Ocio y transporte';'Parking y peaje';'VARIABLES'
26/02/2015;26/02/2015;'A* CUOTA TARJETA PRINCIPAL';-33,00 €;6.395,31 €;6588;-33,00;10.919,40 €;'sin fechas';26/02/2015;'CUOTA';'Gastos_Banco y organismos';'Cargos banco';'FIJO'
26/02/2015;24/02/2015;'AUTOPISTAS';-1,25 €;6.394,06 €;6589;-1,25;10.918,15 €;'sin fechas';24/02/2015;'AUTOPISTAS';'Gastos_Ocio y transporte';'Parking y peaje';'VARIABLES'
26/02/2015;24/02/2015;'AUTOPISTAS';-1,39 €;6.392,67 €;6590;-1,39;10.916,76 €;'sin fechas';24/02/2015;'AUTOPISTAS';'Gastos_Ocio y transporte';'Parking y peaje';'VARIABLES'
26/02/2015;26/02/2015;'CAFETERIA';-3,65 €;6.389,02 €;6591;-3,65;10.913,11 €;'sin fechas';26/02/2015;'CAFETERIA';'Gastos_Compras';'Supermercado';'VARIABLES'
26/02/2015;26/02/2015;'FOMENT DE TERRASSA, SA';1.769,58 €;8.158,60 €;6592;1.769,58;12.682,69 €;'sin fechas';26/02/2015;'FOMENT';'Ingresos';'Nomina';'FIJO'
26/02/2015;26/02/2015;'INFORMACIO I TECNOLOGIA DE CAT';1.585,61 €;9.744,21 €;6593;1.585,61;14.268,30 €;'sin fechas';26/02/2015;'INFORMACIO';'Ingresos';'Nomina';'FIJO'
26/02/2015;26/02/2015;'FRANKFURT LES LLETRES';-5,00 €;9.739,21 €;6594;-5,00;14.263,30 €;'sin fechas';26/02/2015;'FRANKFURT';'Gastos_Ocio y transporte';'Restaurantes';'VARIABLES'
27/02/2015;25/02/2015;'AUTOPISTAS';-1,11 €;9.738,10 €;6595;-1,11;14.262,19 €;'sin fechas';25/02/2015;'AUTOPISTAS';'Gastos_Ocio y transporte';'Parking y peaje';'VARIABLES'
27/02/2015;25/02/2015;'AUTOPISTAS';-1,39 €;9.736,71 €;6596;-1,39;14.260,80 €;'sin fechas';25/02/2015;'AUTOPISTAS';'Gastos_Ocio y transporte';'Parking y peaje';'VARIABLES'
27/02/2015;25/02/2015;'AUTOPISTAS';-1,25 €;9.735,46 €;6597;-1,25;14.259,55 €;'sin fechas';25/02/2015;'AUTOPISTAS';'Gastos_Ocio y transporte';'Parking y peaje';'VARIABLES'
27/02/2015;25/02/2015;'AUTOPISTAS';-1,25 €;9.734,21 €;6598;-1,25;14.258,30 €;'sin fechas';25/02/2015;'AUTOPISTAS';'Gastos_Ocio y transporte';'Parking y peaje';'VARIABLES'
27/02/2015;27/02/2015;'CAFETERIA';-3,60 €;9.730,61 €;6599;-3,60;14.254,70 €;'sin fechas';27/02/2015;'CAFETERIA';'Gastos_Compras';'Supermercado';'VARIABLES'
27/02/2015;27/02/2015;'FRANKFURT LES LLETRES';-2,50 €;9.728,11 €;6600;-2,50;14.252,20 €;'sin fechas';27/02/2015;'FRANKFURT';'Gastos_Ocio y transporte';'Restaurantes';'VARIABLES'
27/02/2015;27/02/2015;'FRANKFURT LES LLETRES';-6,70 €;9.721,41 €;6601;-6,70;14.245,50 €;'sin fechas';27/02/2015;'FRANKFURT';'Gastos_Ocio y transporte';'Restaurantes';'VARIABLES'
28/02/2015;26/02/2015;'AUTOPISTAS';-1,11 €;9.720,30 €;6602;-1,11;14.244,39 €;'sin fechas';26/02/2015;'AUTOPISTAS';'Gastos_Ocio y transporte';'Parking y peaje';'VARIABLES'
28/02/2015;26/02/2015;'AUTOPISTAS';-1,11 €;9.719,19 €;6603;-1,11;14.243,28 €;'sin fechas';26/02/2015;'AUTOPISTAS';'Gastos_Ocio y transporte';'Parking y peaje';'VARIABLES'
28/02/2015;28/02/2015;'CAFETERIA';-3,65 €;9.715,54 €;6604;-3,65;14.239,63 €;'sin fechas';28/02/2015;'CAFETERIA';'Gastos_Compras';'Supermercado';'VARIABLES'
28/02/2015;28/02/2015;'FARMACIA';-1,81 €;9.713,73 €;6605;-1,81;14.237,82 €;'sin fechas';28/02/2015;'FARMACIA';'Gastos_Salud, saber y deporte';'Farmacia';'VARIABLES'
28/02/2015;28/02/2015;'MERCADONA';-1,30 €;9.712,43 €;6606;-1,30;14.236,52 €;'sin fechas';28/02/2015;'MERCADONA';'Gastos_Compras';'Supermercado';'VARIABLES'
28/02/2015;28/02/2015;'REC. 6061.9600001223';-547,25 €;9.165,18 €;6607;-547,25;13.689,27 €;'sin fechas';28/02/2015;'REC';'Gastos_Banco y organismos';'Hipoteca';'FIJO'
01/03/2015;01/03/2015;'CAFETERIA';-2,70 €;9.162,48 €;6608;-2,70;13.686,57 €;'sin fechas';01/03/2015;'CAFETERIA';'Gastos_Compras';'Supermercado';'VARIABLES'
01/03/2015;28/02/2015;'GASOLINERA';-40,57 €;9.121,91 €;6610;-40,57;13.646,00 €;'sin fechas';28/02/2015;'GASOLINERA';'Gastos_Ocio y transporte';'Gasolina';'VARIABLES'
01/03/2015;01/03/2015;'FRANKFURT LES LLETRES';-6,70 €;9.115,21 €;6611;-6,70;13.639,30 €;'sin fechas';01/03/2015;'FRANKFURT';'Gastos_Ocio y transporte';'Restaurantes';'VARIABLES'
01/03/2015;01/03/2015;'VIENA';-14,55 €;9.100,66 €;6612;-14,55;13.624,75 €;'sin fechas';01/03/2015;'VIENA';'Gastos_Ocio y transporte';'Restaurantes';'VARIABLES'
02/03/2015;02/03/2015;'CAFETERIA';-3,65 €;9.097,01 €;6613;-3,65;13.621,10 €;'sin fechas';02/03/2015;'CAFETERIA';'Gastos_Compras';'Supermercado';'VARIABLES'
02/03/2015;02/03/2015;'FARMACIA';-60,30 €;9.036,71 €;6614;-60,30;13.560,80 €;'sin fechas';02/03/2015;'FARMACIA';'Gastos_Salud, saber y deporte';'Farmacia';'VARIABLES'
03/03/2015;03/03/2015;'BON AREA';-35,96 €;9.000,75 €;6615;-35,96;13.524,84 €;'sin fechas';03/03/2015;'BON';'Gastos_Compras';'Supermercado';'VARIABLES'
03/03/2015;03/03/2015;'FARMACIA';-8,96 €;8.991,79 €;6616;-8,96;13.515,88 €;'sin fechas';03/03/2015;'FARMACIA';'Gastos_Salud, saber y deporte';'Farmacia';'VARIABLES'
03/03/2015;02/03/2015;'PARKING';-0,60 €;8.991,19 €;6617;-0,60;13.515,28 €;'sin fechas';02/03/2015;'PARKING';'Gastos_Ocio y transporte';'Parking y peaje';'VARIABLES'
04/03/2015;27/02/2015;'AUTOPISTAS';-1,39 €;8.989,80 €;6618;-1,39;13.513,89 €;'sin fechas';27/02/2015;'AUTOPISTAS';'Gastos_Ocio y transporte';'Parking y peaje';'VARIABLES'
04/03/2015;27/02/2015;'AUTOPISTAS';-1,39 €;8.988,41 €;6619;-1,39;13.512,50 €;'sin fechas';27/02/2015;'AUTOPISTAS';'Gastos_Ocio y transporte';'Parking y peaje';'VARIABLES'
04/03/2015;27/02/2015;'AUTOPISTAS';-1,39 €;8.987,02 €;6620;-1,39;13.511,11 €;'sin fechas';27/02/2015;'AUTOPISTAS';'Gastos_Ocio y transporte';'Parking y peaje';'VARIABLES'
04/03/2015;28/02/2015;'AUTOPISTAS';-2,53 €;8.984,49 €;6621;-2,53;13.508,58 €;'sin fechas';28/02/2015;'AUTOPISTAS';'Gastos_Ocio y transporte';'Parking y peaje';'VARIABLES'
04/03/2015;28/02/2015;'AUTOPISTAS';-2,53 €;8.981,96 €;6622;-2,53;13.506,05 €;'sin fechas';28/02/2015;'AUTOPISTAS';'Gastos_Ocio y transporte';'Parking y peaje';'VARIABLES'
04/03/2015;02/03/2015;'AUTOPISTAS';-1,39 €;8.980,57 €;6623;-1,39;13.504,66 €;'sin fechas';02/03/2015;'AUTOPISTAS';'Gastos_Ocio y transporte';'Parking y peaje';'VARIABLES'
04/03/2015;02/03/2015;'AUTOPISTAS';-1,39 €;8.979,18 €;6624;-1,39;13.503,27 €;'sin fechas';02/03/2015;'AUTOPISTAS';'Gastos_Ocio y transporte';'Parking y peaje';'VARIABLES'
04/03/2015;02/03/2015;'AUTOPISTAS';-1,39 €;8.977,79 €;6625;-1,39;13.501,88 €;'sin fechas';02/03/2015;'AUTOPISTAS';'Gastos_Ocio y transporte';'Parking y peaje';'VARIABLES'
04/03/2015;28/02/2015;'ESCOLA BRESSOL EINA';-459,15 €;8.518,64 €;6626;-459,15;13.042,73 €;'sin fechas';28/02/2015;'ESCOLA';'Gastos_Salud, saber y deporte';'Estudios';'VARIABLES'
05/03/2015;03/03/2015;'AUTOPISTAS';-1,39 €;8.517,25 €;6627;-1,39;13.041,34 €;'sin fechas';03/03/2015;'AUTOPISTAS';'Gastos_Ocio y transporte';'Parking y peaje';'VARIABLES'
05/03/2015;03/03/2015;'AUTOPISTAS';-1,39 €;8.515,86 €;6628;-1,39;13.039,95 €;'sin fechas';03/03/2015;'AUTOPISTAS';'Gastos_Ocio y transporte';'Parking y peaje';'VARIABLES'
05/03/2015;05/03/2015;'CAFETERIA';-3,60 €;8.512,26 €;6629;-3,60;13.036,35 €;'sin fechas';05/03/2015;'CAFETERIA';'Gastos_Compras';'Supermercado';'VARIABLES'
05/03/2015;05/03/2015;'FRANKFURT LES LLETRES';-2,50 €;8.509,76 €;6630;-2,50;13.033,85 €;'sin fechas';05/03/2015;'FRANKFURT';'Gastos_Ocio y transporte';'Restaurantes';'VARIABLES'
05/03/2015;02/03/2015;'MERCADONA';-151,75 €;8.358,01 €;6631;-151,75;12.882,10 €;'sin fechas';02/03/2015;'MERCADONA';'Gastos_Compras';'Supermercado';'VARIABLES'
05/03/2015;02/03/2015;'MERCADONA';-4,55 €;8.353,46 €;6632;-4,55;12.877,55 €;'sin fechas';02/03/2015;'MERCADONA';'Gastos_Compras';'Supermercado';'VARIABLES'
05/03/2015;05/03/2015;'REINT.CAJERO';-40,00 €;8.313,46 €;6633;-40,00;12.837,55 €;'sin fechas';05/03/2015;'REINTCAJERO';'Gastos_Gastos varios';'Efectivo';'VARIABLES'
05/03/2015;05/03/2015;'VIRGIN ACTIV';-55,95 €;8.257,51 €;6634;-55,95;12.781,60 €;'sin fechas';05/03/2015;'VIRGIN';'Gastos_Salud, saber y deporte';'Deportes';'VARIABLES'
05/03/2015;05/03/2015;'VIRGIN ACTIV';-55,95 €;8.201,56 €;6635;-55,95;12.725,65 €;'sin fechas';05/03/2015;'VIRGIN';'Gastos_Salud, saber y deporte';'Deportes';'VARIABLES'
06/03/2015;04/03/2015;'AUTOPISTAS';-1,39 €;8.200,17 €;6636;-1,39;12.724,26 €;'sin fechas';04/03/2015;'AUTOPISTAS';'Gastos_Ocio y transporte';'Parking y peaje';'VARIABLES'
06/03/2015;04/03/2015;'AUTOPISTAS';-1,39 €;8.198,78 €;6637;-1,39;12.722,87 €;'sin fechas';04/03/2015;'AUTOPISTAS';'Gastos_Ocio y transporte';'Parking y peaje';'VARIABLES'
06/03/2015;06/03/2015;'CAFETERIA';-3,60 €;8.195,18 €;6638;-3,60;12.719,27 €;'sin fechas';06/03/2015;'CAFETERIA';'Gastos_Compras';'Supermercado';'VARIABLES'
06/03/2015;06/03/2015;'FRANKFURT LES LLETRES';-11,20 €;8.183,98 €;6639;-11,20;12.708,07 €;'sin fechas';06/03/2015;'FRANKFURT';'Gastos_Ocio y transporte';'Restaurantes';'VARIABLES'
06/03/2015;06/03/2015;'FRANKFURT LES LLETRES';-6,40 €;8.177,58 €;6640;-6,40;12.701,67 €;'sin fechas';06/03/2015;'FRANKFURT';'Gastos_Ocio y transporte';'Restaurantes';'VARIABLES'
06/03/2015;06/03/2015;'MERCADONA';-6,49 €;8.171,09 €;6641;-6,49;12.695,18 €;'sin fechas';06/03/2015;'MERCADONA';'Gastos_Compras';'Supermercado';'VARIABLES'
07/03/2015;05/03/2015;'AUTOPISTAS';-1,32 €;8.169,77 €;6642;-1,32;12.693,86 €;'sin fechas';05/03/2015;'AUTOPISTAS';'Gastos_Ocio y transporte';'Parking y peaje';'VARIABLES'
07/03/2015;05/03/2015;'AUTOPISTAS';-1,39 €;8.168,38 €;6643;-1,39;12.692,47 €;'sin fechas';05/03/2015;'AUTOPISTAS';'Gastos_Ocio y transporte';'Parking y peaje';'VARIABLES'
07/03/2015;07/03/2015;'CAFETERIA';-3,60 €;8.164,78 €;6644;-3,60;12.688,87 €;'sin fechas';07/03/2015;'CAFETERIA';'Gastos_Compras';'Supermercado';'VARIABLES'
07/03/2015;07/03/2015;'FRUITES I VERDURES';-10,17 €;8.154,61 €;6645;-10,17;12.678,70 €;'sin fechas';07/03/2015;'FRUITES';'Gastos_Compras';'Supermercado';'VARIABLES'
08/03/2015;08/03/2015;'CAFETERIA';-4,50 €;8.150,11 €;6646;-4,50;12.674,20 €;'sin fechas';08/03/2015;'CAFETERIA';'Gastos_Compras';'Supermercado';'VARIABLES'
08/03/2015;08/03/2015;'FRANKFURT LES LLETRES';-6,70 €;8.143,41 €;6647;-6,70;12.667,50 €;'sin fechas';08/03/2015;'FRANKFURT';'Gastos_Ocio y transporte';'Restaurantes';'VARIABLES'
08/03/2015;08/03/2015;'FRANKFURT LES LLETRES';-2,50 €;8.140,91 €;6648;-2,50;12.665,00 €;'sin fechas';08/03/2015;'FRANKFURT';'Gastos_Ocio y transporte';'Restaurantes';'VARIABLES'
08/03/2015;08/03/2015;'REINT.CAJERO';-80,00 €;8.060,91 €;6649;-80,00;12.585,00 €;'sin fechas';08/03/2015;'REINTCAJERO';'Gastos_Gastos varios';'Efectivo';'VARIABLES'
08/03/2015;08/03/2015;'VIENA';-11,20 €;8.049,71 €;6650;-11,20;12.573,80 €;'sin fechas';08/03/2015;'VIENA';'Gastos_Ocio y transporte';'Restaurantes';'VARIABLES'
09/03/2015;09/03/2015;'ADESLAS';-111,00 €;7.938,71 €;6651;-111,00;12.462,80 €;'sin fechas';09/03/2015;'ADESLAS';'Gastos_Salud, saber y deporte';'Medico';'VARIABLES'
09/03/2015;09/03/2015;'CAFETERIA';-3,65 €;7.935,06 €;6652;-3,65;12.459,15 €;'sin fechas';09/03/2015;'CAFETERIA';'Gastos_Compras';'Supermercado';'VARIABLES'
09/03/2015;09/03/2015;'FARMACIA';-6,24 €;7.928,82 €;6653;-6,24;12.452,91 €;'sin fechas';09/03/2015;'FARMACIA';'Gastos_Salud, saber y deporte';'Farmacia';'VARIABLES'
09/03/2015;09/03/2015;'SALA BADRINAS - MENJADOR';-118,60 €;7.810,22 €;6654;-118,60;12.334,31 €;'sin fechas';09/03/2015;'SALA';'Gastos_Salud, saber y deporte';'Estudios';'VARIABLES'
09/03/2015;09/03/2015;'TACISA';-19,64 €;7.790,58 €;6655;-19,64;12.314,67 €;'sin fechas';09/03/2015;'TACISA';'Gastos_Compras';'Supermercado';'VARIABLES'
10/03/2015;06/03/2015;'AUTOPISTAS';-1,39 €;7.789,19 €;6656;-1,39;12.313,28 €;'sin fechas';06/03/2015;'AUTOPISTAS';'Gastos_Ocio y transporte';'Parking y peaje';'VARIABLES'
10/03/2015;06/03/2015;'AUTOPISTAS';-1,39 €;7.787,80 €;6657;-1,39;12.311,89 €;'sin fechas';06/03/2015;'AUTOPISTAS';'Gastos_Ocio y transporte';'Parking y peaje';'VARIABLES'
10/03/2015;06/03/2015;'AUTOPISTAS';-1,32 €;7.786,48 €;6658;-1,32;12.310,57 €;'sin fechas';06/03/2015;'AUTOPISTAS';'Gastos_Ocio y transporte';'Parking y peaje';'VARIABLES'
10/03/2015;06/03/2015;'AUTOPISTAS';-1,39 €;7.785,09 €;6659;-1,39;12.309,18 €;'sin fechas';06/03/2015;'AUTOPISTAS';'Gastos_Ocio y transporte';'Parking y peaje';'VARIABLES'
10/03/2015;10/03/2015;'BLITZ';-72,50 €;7.712,59 €;6660;-72,50;12.236,68 €;'sin fechas';10/03/2015;'BLITZ';'Gastos_Vivienda y vehiculo';'Alquiler Parking';'FIJO'
10/03/2015;10/03/2015;'IKEA';-3,95 €;7.708,64 €;6661;-3,95;12.232,73 €;'sin fechas';10/03/2015;'IKEA';'Gastos_Vivienda y vehiculo';'Mnto. hogar';'VARIABLES'
10/03/2015;10/03/2015;'IKEA';-20,90 €;7.687,74 €;6662;-20,90;12.211,83 €;'sin fechas';10/03/2015;'IKEA';'Gastos_Vivienda y vehiculo';'Mnto. hogar';'VARIABLES'
10/03/2015;10/03/2015;'IKEA';-34,92 €;7.652,82 €;6663;-34,92;12.176,91 €;'sin fechas';10/03/2015;'IKEA';'Gastos_Vivienda y vehiculo';'Mnto. hogar';'VARIABLES'
11/03/2015;09/03/2015;'AUTOPISTAS';-1,32 €;7.651,50 €;6664;-1,32;12.175,59 €;'sin fechas';09/03/2015;'AUTOPISTAS';'Gastos_Ocio y transporte';'Parking y peaje';'VARIABLES'
11/03/2015;09/03/2015;'AUTOPISTAS';-1,39 €;7.650,11 €;6665;-1,39;12.174,20 €;'sin fechas';09/03/2015;'AUTOPISTAS';'Gastos_Ocio y transporte';'Parking y peaje';'VARIABLES'
11/03/2015;09/03/2015;'PARKING';-4,15 €;7.645,96 €;6666;-4,15;12.170,05 €;'sin fechas';09/03/2015;'PARKING';'Gastos_Ocio y transporte';'Parking y peaje';'VARIABLES'
12/03/2015;12/03/2015;'CAFETERIA';-3,65 €;7.642,31 €;6667;-3,65;12.166,40 €;'sin fechas';12/03/2015;'CAFETERIA';'Gastos_Compras';'Supermercado';'VARIABLES'
12/03/2015;12/03/2015;'FRUITES I VERDURES';-7,53 €;7.634,78 €;6668;-7,53;12.158,87 €;'sin fechas';12/03/2015;'FRUITES';'Gastos_Compras';'Supermercado';'VARIABLES'
12/03/2015;12/03/2015;'FRANKFURT LES LLETRES';-5,10 €;7.629,68 €;6669;-5,10;12.153,77 €;'sin fechas';12/03/2015;'FRANKFURT';'Gastos_Ocio y transporte';'Restaurantes';'VARIABLES'
13/03/2015;11/03/2015;'AMAZON';-18,34 €;7.611,34 €;6670;-18,34;12.135,43 €;'sin fechas';11/03/2015;'AMAZON';'Gastos_Compras';'Hobbys';'VARIABLES'
13/03/2015;10/03/2015;'AUTOPISTAS';-1,32 €;7.610,02 €;6671;-1,32;12.134,11 €;'sin fechas';10/03/2015;'AUTOPISTAS';'Gastos_Ocio y transporte';'Parking y peaje';'VARIABLES'
13/03/2015;10/03/2015;'AUTOPISTAS';-1,39 €;7.608,63 €;6672;-1,39;12.132,72 €;'sin fechas';10/03/2015;'AUTOPISTAS';'Gastos_Ocio y transporte';'Parking y peaje';'VARIABLES'
13/03/2015;11/03/2015;'AUTOPISTAS';-1,32 €;7.607,31 €;6673;-1,32;12.131,40 €;'sin fechas';11/03/2015;'AUTOPISTAS';'Gastos_Ocio y transporte';'Parking y peaje';'VARIABLES'
13/03/2015;11/03/2015;'AUTOPISTAS';-1,39 €;7.605,92 €;6674;-1,39;12.130,01 €;'sin fechas';11/03/2015;'AUTOPISTAS';'Gastos_Ocio y transporte';'Parking y peaje';'VARIABLES'
13/03/2015;13/03/2015;'BON AREA';-21,96 €;7.583,96 €;6675;-21,96;12.108,05 €;'sin fechas';13/03/2015;'BON';'Gastos_Compras';'Supermercado';'VARIABLES'
13/03/2015;13/03/2015;'CAFETERIA';-2,70 €;7.581,26 €;6676;-2,70;12.105,35 €;'sin fechas';13/03/2015;'CAFETERIA';'Gastos_Compras';'Supermercado';'VARIABLES'
13/03/2015;13/03/2015;'FARMACIA';-5,46 €;7.575,80 €;6677;-5,46;12.099,89 €;'sin fechas';13/03/2015;'FARMACIA';'Gastos_Salud, saber y deporte';'Farmacia';'VARIABLES'
14/03/2015;12/03/2015;'AUTOPISTAS';-1,25 €;7.574,55 €;6678;-1,25;12.098,64 €;'sin fechas';12/03/2015;'AUTOPISTAS';'Gastos_Ocio y transporte';'Parking y peaje';'VARIABLES'
14/03/2015;12/03/2015;'AUTOPISTAS';-1,25 €;7.573,30 €;6679;-1,25;12.097,39 €;'sin fechas';12/03/2015;'AUTOPISTAS';'Gastos_Ocio y transporte';'Parking y peaje';'VARIABLES'
14/03/2015;14/03/2015;'CAFETERIA';-3,65 €;7.569,65 €;6680;-3,65;12.093,74 €;'sin fechas';14/03/2015;'CAFETERIA';'Gastos_Compras';'Supermercado';'VARIABLES'
14/03/2015;14/03/2015;'REINT.CAJERO';-80,00 €;7.489,65 €;6681;-80,00;12.013,74 €;'sin fechas';14/03/2015;'REINTCAJERO';'Gastos_Gastos varios';'Efectivo';'VARIABLES'
14/03/2015;14/03/2015;'RESTAURANTES';-6,25 €;7.483,40 €;6682;-6,25;12.007,49 €;'sin fechas';14/03/2015;'RESTAURANTES';'Gastos_Ocio y transporte';'Restaurantes';'VARIABLES'
15/03/2015;15/03/2015;'CAFETERIA';-2,70 €;7.480,70 €;6683;-2,70;12.004,79 €;'sin fechas';15/03/2015;'CAFETERIA';'Gastos_Compras';'Supermercado';'VARIABLES'
15/03/2015;15/03/2015;'FARMACIA';-2,32 €;7.478,38 €;6684;-2,32;12.002,47 €;'sin fechas';15/03/2015;'FARMACIA';'Gastos_Salud, saber y deporte';'Farmacia';'VARIABLES'
15/03/2015;15/03/2015;'FRUITES I VERDURES';-6,50 €;7.471,88 €;6685;-6,50;11.995,97 €;'sin fechas';15/03/2015;'FRUITES';'Gastos_Compras';'Supermercado';'VARIABLES'
15/03/2015;15/03/2015;'GASOLINERA';-47,71 €;7.424,17 €;6686;-47,71;11.948,26 €;'sin fechas';15/03/2015;'GASOLINERA';'Gastos_Ocio y transporte';'Gasolina';'VARIABLES'
16/03/2015;16/03/2015;'CAFETERIA';-3,65 €;7.420,52 €;6687;-3,65;11.944,61 €;'sin fechas';16/03/2015;'CAFETERIA';'Gastos_Compras';'Supermercado';'VARIABLES'
16/03/2015;16/03/2015;'CCM VIDA Y P SEGURO PRESTAMO';-23,07 €;7.397,45 €;6688;-23,07;11.921,54 €;'sin fechas';16/03/2015;'CCM';'Gastos_Seguros';'Seguro vida';'FIJO'
16/03/2015;16/03/2015;'CCM VIDA Y PENSIO 000000493358';-18,10 €;7.379,35 €;6689;-18,10;11.903,44 €;'sin fechas';16/03/2015;'CCM';'Gastos_Seguros';'Seguro vida';'FIJO'
17/03/2015;13/03/2015;'AUTOPISTAS';-1,25 €;7.378,10 €;6690;-1,25;11.902,19 €;'sin fechas';13/03/2015;'AUTOPISTAS';'Gastos_Ocio y transporte';'Parking y peaje';'VARIABLES'
17/03/2015;13/03/2015;'AUTOPISTAS';-1,39 €;7.376,71 €;6691;-1,39;11.900,80 €;'sin fechas';13/03/2015;'AUTOPISTAS';'Gastos_Ocio y transporte';'Parking y peaje';'VARIABLES'
17/03/2015;17/03/2015;'BON AREA';-23,91 €;7.352,80 €;6692;-23,91;11.876,89 €;'sin fechas';17/03/2015;'BON';'Gastos_Compras';'Supermercado';'VARIABLES'
17/03/2015;17/03/2015;'DRIM';-29,98 €;7.322,82 €;6693;-29,98;11.846,91 €;'sin fechas';17/03/2015;'DRIM';'Gastos_Compras';'Niños';'VARIABLES'
17/03/2015;17/03/2015;'MINA PUBLICA AIGUES T.01A75789';-40,79 €;7.282,03 €;6694;-40,79;11.806,12 €;'sin fechas';17/03/2015;'MINA';'Gastos_Servicios tipicos';'Agua';'FIJO'
17/03/2015;17/03/2015;'ONO';-115,94 €;7.166,09 €;6695;-115,94;11.690,18 €;'sin fechas';17/03/2015;'ONO';'Gastos_Servicios tipicos';'Telecomunicaciones';'FIJO'
18/03/2015;02/03/2015;'AUTOPISTAS';-2,40 €;7.163,69 €;6696;-2,40;11.687,78 €;'sin fechas';02/03/2015;'AUTOPISTAS';'Gastos_Ocio y transporte';'Parking y peaje';'VARIABLES'
18/03/2015;05/03/2015;'AUTOPISTAS';-3,72 €;7.159,97 €;6697;-3,72;11.684,06 €;'sin fechas';05/03/2015;'AUTOPISTAS';'Gastos_Ocio y transporte';'Parking y peaje';'VARIABLES'
18/03/2015;05/03/2015;'AUTOPISTAS';-3,72 €;7.156,25 €;6698;-3,72;11.680,34 €;'sin fechas';05/03/2015;'AUTOPISTAS';'Gastos_Ocio y transporte';'Parking y peaje';'VARIABLES'
18/03/2015;06/03/2015;'AUTOPISTAS';-3,72 €;7.152,53 €;6699;-3,72;11.676,62 €;'sin fechas';06/03/2015;'AUTOPISTAS';'Gastos_Ocio y transporte';'Parking y peaje';'VARIABLES'
18/03/2015;13/03/2015;'AUTOPISTAS';-4,19 €;7.148,34 €;6700;-4,19;11.672,43 €;'sin fechas';13/03/2015;'AUTOPISTAS';'Gastos_Ocio y transporte';'Parking y peaje';'VARIABLES'
18/03/2015;14/03/2015;'AUTOPISTAS';-4,19 €;7.144,15 €;6701;-4,19;11.668,24 €;'sin fechas';14/03/2015;'AUTOPISTAS';'Gastos_Ocio y transporte';'Parking y peaje';'VARIABLES'
18/03/2015;16/03/2015;'AUTOPISTAS';-1,25 €;7.142,90 €;6702;-1,25;11.666,99 €;'sin fechas';16/03/2015;'AUTOPISTAS';'Gastos_Ocio y transporte';'Parking y peaje';'VARIABLES'
18/03/2015;18/03/2015;'WWW.JUST-EAT.ES';-13,00 €;7.129,90 €;6703;-13,00;11.653,99 €;'sin fechas';18/03/2015;'WWWJUSTEATES';'Gastos_Ocio y transporte';'Restaurantes';'VARIABLES'
19/03/2015;17/03/2015;'AUTOPISTAS';-1,25 €;7.128,65 €;6704;-1,25;11.652,74 €;'sin fechas';17/03/2015;'AUTOPISTAS';'Gastos_Ocio y transporte';'Parking y peaje';'VARIABLES'
19/03/2015;17/03/2015;'AUTOPISTAS';-1,39 €;7.127,26 €;6705;-1,39;11.651,35 €;'sin fechas';17/03/2015;'AUTOPISTAS';'Gastos_Ocio y transporte';'Parking y peaje';'VARIABLES'
19/03/2015;19/03/2015;'AUTOPISTAS';-1,39 €;7.125,87 €;6706;-1,39;11.649,96 €;'sin fechas';19/03/2015;'AUTOPISTAS';'Gastos_Ocio y transporte';'Parking y peaje';'VARIABLES'
19/03/2015;19/03/2015;'CAFETERIA';-3,65 €;7.122,22 €;6707;-3,65;11.646,31 €;'sin fechas';19/03/2015;'CAFETERIA';'Gastos_Compras';'Supermercado';'VARIABLES'
19/03/2015;19/03/2015;'GAS NATURAL';-194,01 €;6.928,21 €;6708;-194,01;11.452,30 €;'sin fechas';19/03/2015;'GAS';'Gastos_Servicios tipicos';'Gas';'FIJO'
19/03/2015;19/03/2015;'MERCADONA';-7,61 €;6.920,60 €;6709;-7,61;11.444,69 €;'sin fechas';19/03/2015;'MERCADONA';'Gastos_Compras';'Supermercado';'VARIABLES'
20/03/2015;20/03/2015;'AUTOPISTAS';-1,39 €;6.919,21 €;6710;-1,39;11.443,30 €;'sin fechas';20/03/2015;'AUTOPISTAS';'Gastos_Ocio y transporte';'Parking y peaje';'VARIABLES'
20/03/2015;20/03/2015;'AUTOPISTAS';-1,39 €;6.917,82 €;6711;-1,39;11.441,91 €;'sin fechas';20/03/2015;'AUTOPISTAS';'Gastos_Ocio y transporte';'Parking y peaje';'VARIABLES'
20/03/2015;20/03/2015;'BON AREA';-10,54 €;6.907,28 €;6712;-10,54;11.431,37 €;'sin fechas';20/03/2015;'BON';'Gastos_Compras';'Supermercado';'VARIABLES'
20/03/2015;20/03/2015;'CAFETERIA';-2,70 €;6.904,58 €;6713;-2,70;11.428,67 €;'sin fechas';20/03/2015;'CAFETERIA';'Gastos_Compras';'Supermercado';'VARIABLES'
20/03/2015;20/03/2015;'CAFETERIA';-1,20 €;6.903,38 €;6714;-1,20;11.427,47 €;'sin fechas';20/03/2015;'CAFETERIA';'Gastos_Compras';'Supermercado';'VARIABLES'
20/03/2015;20/03/2015;'CAFETERIA';-4,10 €;6.899,28 €;6715;-4,10;11.423,37 €;'sin fechas';20/03/2015;'CAFETERIA';'Gastos_Compras';'Supermercado';'VARIABLES'
20/03/2015;20/03/2015;'MERCADONA';-82,40 €;6.816,88 €;6716;-82,40;11.340,97 €;'sin fechas';20/03/2015;'MERCADONA';'Gastos_Compras';'Supermercado';'VARIABLES'
20/03/2015;20/03/2015;'REINT.CAJERO';-20,00 €;6.796,88 €;6717;-20,00;11.320,97 €;'sin fechas';20/03/2015;'REINTCAJERO';'Gastos_Gastos varios';'Efectivo';'VARIABLES'
21/03/2015;18/03/2015;'AUTOPISTAS';-1,25 €;6.795,63 €;6718;-1,25;11.319,72 €;'sin fechas';18/03/2015;'AUTOPISTAS';'Gastos_Ocio y transporte';'Parking y peaje';'VARIABLES'
21/03/2015;18/03/2015;'AUTOPISTAS';-1,39 €;6.794,24 €;6719;-1,39;11.318,33 €;'sin fechas';18/03/2015;'AUTOPISTAS';'Gastos_Ocio y transporte';'Parking y peaje';'VARIABLES'
21/03/2015;19/03/2015;'AUTOPISTAS';-1,25 €;6.792,99 €;6720;-1,25;11.317,08 €;'sin fechas';19/03/2015;'AUTOPISTAS';'Gastos_Ocio y transporte';'Parking y peaje';'VARIABLES'
21/03/2015;19/03/2015;'AUTOPISTAS';-1,39 €;6.791,60 €;6721;-1,39;11.315,69 €;'sin fechas';19/03/2015;'AUTOPISTAS';'Gastos_Ocio y transporte';'Parking y peaje';'VARIABLES'
21/03/2015;21/03/2015;'MERCADONA';-3,47 €;6.788,13 €;6722;-3,47;11.312,22 €;'sin fechas';21/03/2015;'MERCADONA';'Gastos_Compras';'Supermercado';'VARIABLES'
22/03/2015;22/03/2015;'CAFETERIA';-3,60 €;6.784,53 €;6723;-3,60;11.308,62 €;'sin fechas';22/03/2015;'CAFETERIA';'Gastos_Compras';'Supermercado';'VARIABLES'
22/03/2015;22/03/2015;'FRANKFURT LES LLETRES';-3,90 €;6.780,63 €;6724;-3,90;11.304,72 €;'sin fechas';22/03/2015;'FRANKFURT';'Gastos_Ocio y transporte';'Restaurantes';'VARIABLES'
22/03/2015;22/03/2015;'FRANKFURT LES LLETRES';-2,50 €;6.778,13 €;6725;-2,50;11.302,22 €;'sin fechas';22/03/2015;'FRANKFURT';'Gastos_Ocio y transporte';'Restaurantes';'VARIABLES'
22/03/2015;22/03/2015;'REINT.CAJERO';-40,00 €;6.738,13 €;6726;-40,00;11.262,22 €;'sin fechas';22/03/2015;'REINTCAJERO';'Gastos_Gastos varios';'Efectivo';'VARIABLES'
22/03/2015;22/03/2015;'XANASCAT';-26,90 €;6.711,23 €;6727;-26,90;11.235,32 €;'sin fechas';22/03/2015;'XANASCAT';'Gastos_Ocio y transporte';'Vacaciones';'VARIABLES'
22/03/2015;22/03/2015;'XANASCAT';-107,60 €;6.603,63 €;6728;-107,60;11.127,72 €;'sin fechas';22/03/2015;'XANASCAT';'Gastos_Ocio y transporte';'Vacaciones';'VARIABLES'
23/03/2015;23/03/2015;'FRANKFURT LES LLETRES';-2,50 €;6.601,13 €;6729;-2,50;11.125,22 €;'sin fechas';23/03/2015;'FRANKFURT';'Gastos_Ocio y transporte';'Restaurantes';'VARIABLES'
24/03/2015;24/03/2015;'AUTOPISTAS';-1,39 €;6.599,74 €;6730;-1,39;11.123,83 €;'sin fechas';24/03/2015;'AUTOPISTAS';'Gastos_Ocio y transporte';'Parking y peaje';'VARIABLES'
24/03/2015;24/03/2015;'BOLIN SHIJIA, SCP';-31,20 €;6.568,54 €;6731;-31,20;11.092,63 €;'sin fechas';24/03/2015;'BOLIN';'Gastos_Ocio y transporte';'Restaurantes';'VARIABLES'
24/03/2015;24/03/2015;'CERTIO ITV VIL\\VILADECAVALL';-45,30 €;6.523,24 €;6732;-45,30;11.047,33 €;'sin fechas';24/03/2015;'CERTIO';'Gastos_Vivienda y vehiculo';'Mnto. vehiculo';'VARIABLE'
24/03/2015;24/03/2015;'GASOLINERA';-40,90 €;6.482,34 €;6733;-40,90;11.006,43 €;'sin fechas';24/03/2015;'GASOLINERA';'Gastos_Ocio y transporte';'Gasolina';'VARIABLES'
25/03/2015;23/03/2015;'AUTOPISTAS';-1,39 €;6.480,95 €;6734;-1,39;11.005,04 €;'sin fechas';23/03/2015;'AUTOPISTAS';'Gastos_Ocio y transporte';'Parking y peaje';'VARIABLES'
25/03/2015;23/03/2015;'AUTOPISTAS';-1,25 €;6.479,70 €;6735;-1,25;11.003,79 €;'sin fechas';23/03/2015;'AUTOPISTAS';'Gastos_Ocio y transporte';'Parking y peaje';'VARIABLES'
25/03/2015;23/03/2015;'AUTOPISTAS';-1,25 €;6.478,45 €;6736;-1,25;11.002,54 €;'sin fechas';23/03/2015;'AUTOPISTAS';'Gastos_Ocio y transporte';'Parking y peaje';'VARIABLES'
25/03/2015;23/03/2015;'AUTOPISTAS';-1,25 €;6.477,20 €;6737;-1,25;11.001,29 €;'sin fechas';23/03/2015;'AUTOPISTAS';'Gastos_Ocio y transporte';'Parking y peaje';'VARIABLES'
25/03/2015;25/03/2015;'AUTOPISTAS';-1,39 €;6.475,81 €;6738;-1,39;10.999,90 €;'sin fechas';25/03/2015;'AUTOPISTAS';'Gastos_Ocio y transporte';'Parking y peaje';'VARIABLES'
25/03/2015;25/03/2015;'AUTOPISTAS';-1,39 €;6.474,42 €;6739;-1,39;10.998,51 €;'sin fechas';25/03/2015;'AUTOPISTAS';'Gastos_Ocio y transporte';'Parking y peaje';'VARIABLES'
25/03/2015;25/03/2015;'REINT.CAJERO';-40,00 €;6.434,42 €;6740;-40,00;10.958,51 €;'sin fechas';25/03/2015;'REINTCAJERO';'Gastos_Gastos varios';'Efectivo';'VARIABLES'
25/03/2015;25/03/2015;'TABASA VALLVI S. C:2T';-4,19 €;6.430,23 €;6741;-4,19;10.954,32 €;'sin fechas';25/03/2015;'TABASA';'Gastos_Ocio y transporte';'Parking y peaje';'VARIABLES'
25/03/2015;25/03/2015;'VIENA';-10,55 €;6.419,68 €;6742;-10,55;10.943,77 €;'sin fechas';25/03/2015;'VIENA';'Gastos_Ocio y transporte';'Restaurantes';'VARIABLES'
26/03/2015;24/03/2015;'AUTOPISTAS';-1,39 €;6.418,29 €;6743;-1,39;10.942,38 €;'sin fechas';24/03/2015;'AUTOPISTAS';'Gastos_Ocio y transporte';'Parking y peaje';'VARIABLES'
26/03/2015;26/03/2015;'CAFETERIA';-3,65 €;6.414,64 €;6744;-3,65;10.938,73 €;'sin fechas';26/03/2015;'CAFETERIA';'Gastos_Compras';'Supermercado';'VARIABLES'
26/03/2015;26/03/2015;'FARMACIA';-28,29 €;6.386,35 €;6745;-28,29;10.910,44 €;'sin fechas';26/03/2015;'FARMACIA';'Gastos_Salud, saber y deporte';'Farmacia';'VARIABLES'
26/03/2015;26/03/2015;'TOCINERIES VENTURA';-5,31 €;6.381,04 €;6746;-5,31;10.905,13 €;'sin fechas';26/03/2015;'TOCINERIES';'Gastos_Compras';'Supermercado';'VARIABLES'
26/03/2015;26/03/2015;'VIENA';-10,45 €;6.370,59 €;6747;-10,45;10.894,68 €;'sin fechas';26/03/2015;'VIENA';'Gastos_Ocio y transporte';'Restaurantes';'VARIABLES'
26/03/2015;26/03/2015;'VIENA';-10,55 €;6.360,04 €;6748;-10,55;10.884,13 €;'sin fechas';26/03/2015;'VIENA';'Gastos_Ocio y transporte';'Restaurantes';'VARIABLES'
27/03/2015;27/03/2015;'CAFETERIA';-2,70 €;6.357,34 €;6749;-2,70;10.881,43 €;'sin fechas';27/03/2015;'CAFETERIA';'Gastos_Compras';'Supermercado';'VARIABLES'
27/03/2015;27/03/2015;'FOMENT DE TERRASSA, SA';1.774,20 €;8.131,54 €;6750;1.774,20;12.655,63 €;'sin fechas';27/03/2015;'FOMENT';'Ingresos';'Nomina';'FIJO'
27/03/2015;27/03/2015;'PERRUQUERIA';-60,00 €;8.071,54 €;6751;-60,00;12.595,63 €;'sin fechas';27/03/2015;'PERRUQUERIA';'Gastos_Salud, saber y deporte';'Belleza';'VARIABLES'
27/03/2015;26/03/2015;'SATSA PL. VELLA TERRASSA';-2,05 €;8.069,49 €;6752;-2,05;12.593,58 €;'sin fechas';26/03/2015;'SATSA';'Gastos_Ocio y transporte';'Parking y peaje';'VARIABLES'
28/03/2015;26/03/2015;'AUTOPISTAS';-1,11 €;8.068,38 €;6753;-1,11;12.592,47 €;'sin fechas';26/03/2015;'AUTOPISTAS';'Gastos_Ocio y transporte';'Parking y peaje';'VARIABLES'
28/03/2015;26/03/2015;'AUTOPISTAS';-1,39 €;8.066,99 €;6754;-1,39;12.591,08 €;'sin fechas';26/03/2015;'AUTOPISTAS';'Gastos_Ocio y transporte';'Parking y peaje';'VARIABLES'
28/03/2015;26/03/2015;'AUTOPISTAS';-1,39 €;8.065,60 €;6755;-1,39;12.589,69 €;'sin fechas';26/03/2015;'AUTOPISTAS';'Gastos_Ocio y transporte';'Parking y peaje';'VARIABLES'
28/03/2015;26/03/2015;'AUTOPISTAS';-1,11 €;8.064,49 €;6756;-1,11;12.588,58 €;'sin fechas';26/03/2015;'AUTOPISTAS';'Gastos_Ocio y transporte';'Parking y peaje';'VARIABLES'
28/03/2015;28/03/2015;'CAFETERIA';-3,65 €;8.060,84 €;6757;-3,65;12.584,93 €;'sin fechas';28/03/2015;'CAFETERIA';'Gastos_Compras';'Supermercado';'VARIABLES'
28/03/2015;28/03/2015;'REINT.CAJERO';-3,50 €;8.057,34 €;6758;-3,50;12.581,43 €;'sin fechas';28/03/2015;'REINTCAJERO';'Gastos_Gastos varios';'Efectivo';'VARIABLES'
28/03/2015;28/03/2015;'REINT.CAJERO';-80,00 €;7.977,34 €;6759;-80,00;12.501,43 €;'sin fechas';28/03/2015;'REINTCAJERO';'Gastos_Gastos varios';'Efectivo';'VARIABLES'
29/03/2015;29/03/2015;'AUTOPISTAS';-5,70 €;7.971,64 €;6760;-5,70;12.495,73 €;'sin fechas';29/03/2015;'AUTOPISTAS';'Gastos_Ocio y transporte';'Parking y peaje';'VARIABLES'
29/03/2015;29/03/2015;'FRUITES I VERDURES';-7,15 €;7.964,49 €;6761;-7,15;12.488,58 €;'sin fechas';29/03/2015;'FRUITES';'Gastos_Compras';'Supermercado';'VARIABLES'
29/03/2015;29/03/2015;'HOGAR&OTROS';-32,79 €;7.931,70 €;6762;-32,79;12.455,79 €;'sin fechas';29/03/2015;'HOGAROTROS';'Gastos_Vivienda y vehiculo';'Otros vivienda';'VARIABLES'
29/03/2015;29/03/2015;'VIENA';-10,55 €;7.921,15 €;6763;-10,55;12.445,24 €;'sin fechas';29/03/2015;'VIENA';'Gastos_Ocio y transporte';'Restaurantes';'VARIABLES'
30/03/2015;30/03/2015;'AUTOPISTAS';-1,39 €;7.919,76 €;6764;-1,39;12.443,85 €;'sin fechas';30/03/2015;'AUTOPISTAS';'Gastos_Ocio y transporte';'Parking y peaje';'VARIABLES'
30/03/2015;30/03/2015;'AUTOPISTAS';-1,39 €;7.918,37 €;6765;-1,39;12.442,46 €;'sin fechas';30/03/2015;'AUTOPISTAS';'Gastos_Ocio y transporte';'Parking y peaje';'VARIABLES'
30/03/2015;30/03/2015;'BON AREA';-13,44 €;7.904,93 €;6766;-13,44;12.429,02 €;'sin fechas';30/03/2015;'BON';'Gastos_Compras';'Supermercado';'VARIABLES'
30/03/2015;30/03/2015;'CAFETERIA';-3,65 €;7.901,28 €;6767;-3,65;12.425,37 €;'sin fechas';30/03/2015;'CAFETERIA';'Gastos_Compras';'Supermercado';'VARIABLES'
30/03/2015;30/03/2015;'CAFETERIA';-6,60 €;7.894,68 €;6768;-6,60;12.418,77 €;'sin fechas';30/03/2015;'CAFETERIA';'Gastos_Compras';'Supermercado';'VARIABLES'
30/03/2015;30/03/2015;'INFORMACIO I TECNOLOGIA DE CAT';1.586,02 €;9.480,70 €;6769;1.586,02;14.004,79 €;'sin fechas';30/03/2015;'INFORMACIO';'Ingresos';'Nomina';'FIJO'
30/03/2015;30/03/2015;'TABASA VALLVI S. C:2T';-4,19 €;9.476,51 €;6770;-4,19;14.000,60 €;'sin fechas';30/03/2015;'TABASA';'Gastos_Ocio y transporte';'Parking y peaje';'VARIABLES'
31/03/2015;31/03/2015;'ABACUS';-25,05 €;9.451,46 €;6771;-25,05;13.975,55 €;'sin fechas';31/03/2015;'ABACUS';'Gastos_Salud, saber y deporte';'Estudios';'VARIABLES'
31/03/2015;27/03/2015;'AUTOPISTAS';-1,11 €;9.450,35 €;6772;-1,11;13.974,44 €;'sin fechas';27/03/2015;'AUTOPISTAS';'Gastos_Ocio y transporte';'Parking y peaje';'VARIABLES'
31/03/2015;27/03/2015;'AUTOPISTAS';-1,39 €;9.448,96 €;6773;-1,39;13.973,05 €;'sin fechas';27/03/2015;'AUTOPISTAS';'Gastos_Ocio y transporte';'Parking y peaje';'VARIABLES'
31/03/2015;28/03/2015;'AUTOPISTAS';-2,53 €;9.446,43 €;6774;-2,53;13.970,52 €;'sin fechas';28/03/2015;'AUTOPISTAS';'Gastos_Ocio y transporte';'Parking y peaje';'VARIABLES'
31/03/2015;31/03/2015;'DECATHLON';-53,22 €;9.393,21 €;6775;-53,22;13.917,30 €;'sin fechas';31/03/2015;'DECATHLON';'Gastos_Compras';'Deportivo';'VARIABLES'
31/03/2015;31/03/2015;'ESCOLA BRESSOL EINA';-651,32 €;8.741,89 €;6776;-651,32;13.265,98 €;'sin fechas';31/03/2015;'ESCOLA';'Gastos_Salud, saber y deporte';'Estudios';'VARIABLES'
31/03/2015;31/03/2015;'IBI';-44,99 €;8.696,90 €;6777;-44,99;13.220,99 €;'sin fechas';31/03/2015;'IBI';'Gastos_Banco y organismos';'Ayuntamiento';'FIJO'
31/03/2015;31/03/2015;'MERCADONA';-12,00 €;8.684,90 €;6778;-12,00;13.208,99 €;'sin fechas';31/03/2015;'MERCADONA';'Gastos_Compras';'Supermercado';'VARIABLES'
31/03/2015;29/03/2015;'PARKING';-4,45 €;8.680,45 €;6779;-4,45;13.204,54 €;'sin fechas';29/03/2015;'PARKING';'Gastos_Ocio y transporte';'Parking y peaje';'VARIABLES'
31/03/2015;31/03/2015;'REC. 6061.9600001223';-547,25 €;8.133,20 €;6780;-547,25;12.657,29 €;'sin fechas';31/03/2015;'REC';'Gastos_Banco y organismos';'Hipoteca';'FIJO'
01/04/2015;01/04/2015;'A.C.E.S.A B.MART.-L.SAP7S';-10,60 €;8.122,60 €;6781;-10,60;12.646,69 €;'sin fechas';01/04/2015;'ACESA';'Gastos_Ocio y transporte';'Parking y peaje';'VARIABLES'
01/04/2015;01/04/2015;'AUTOPISTA MARE NOSTRUM';-7,15 €;8.115,45 €;6782;-7,15;12.639,54 €;'sin fechas';01/04/2015;'AUTOPISTA';'Gastos_Ocio y transporte';'Parking y peaje';'VARIABLES'
01/04/2015;30/03/2015;'AUTOPISTAS';-4,19 €;8.111,26 €;6783;-4,19;12.635,35 €;'sin fechas';30/03/2015;'AUTOPISTAS';'Gastos_Ocio y transporte';'Parking y peaje';'VARIABLES'
01/04/2015;31/03/2015;'AUTOPISTAS';-10,60 €;8.100,66 €;6784;-10,60;12.624,75 €;'sin fechas';31/03/2015;'AUTOPISTAS';'Gastos_Ocio y transporte';'Parking y peaje';'VARIABLES'
01/04/2015;31/03/2015;'AUTOPISTAS';-7,15 €;8.093,51 €;6785;-7,15;12.617,60 €;'sin fechas';31/03/2015;'AUTOPISTAS';'Gastos_Ocio y transporte';'Parking y peaje';'VARIABLES'
01/04/2015;01/04/2015;'AUTOPISTAS';-1,39 €;8.092,12 €;6786;-1,39;12.616,21 €;'sin fechas';01/04/2015;'AUTOPISTAS';'Gastos_Ocio y transporte';'Parking y peaje';'VARIABLES'
01/04/2015;01/04/2015;'VIRGIN ACTIV';-55,95 €;8.036,17 €;6788;-55,95;12.560,26 €;'sin fechas';01/04/2015;'VIRGIN';'Gastos_Salud, saber y deporte';'Deportes';'VARIABLES'
01/04/2015;01/04/2015;'VIRGIN ACTIV';-55,95 €;7.980,22 €;6789;-55,95;12.504,31 €;'sin fechas';01/04/2015;'VIRGIN';'Gastos_Salud, saber y deporte';'Deportes';'VARIABLES'
02/04/2015;02/04/2015;'ADESLAS';-111,00 €;7.869,22 €;6790;-111,00;12.393,31 €;'sin fechas';02/04/2015;'ADESLAS';'Gastos_Salud, saber y deporte';'Medico';'VARIABLES'
02/04/2015;31/03/2015;'AUTOPISTAS';-1,11 €;7.868,11 €;6791;-1,11;12.392,20 €;'sin fechas';31/03/2015;'AUTOPISTAS';'Gastos_Ocio y transporte';'Parking y peaje';'VARIABLES'
02/04/2015;31/03/2015;'AUTOPISTAS';-1,39 €;7.866,72 €;6792;-1,39;12.390,81 €;'sin fechas';31/03/2015;'AUTOPISTAS';'Gastos_Ocio y transporte';'Parking y peaje';'VARIABLES'
02/04/2015;02/04/2015;'CAFETERIA';-3,60 €;7.863,12 €;6793;-3,60;12.387,21 €;'sin fechas';02/04/2015;'CAFETERIA';'Gastos_Compras';'Supermercado';'VARIABLES'
02/04/2015;02/04/2015;'CASA DEL LLIBRE';-23,90 €;7.839,22 €;6794;-23,90;12.363,31 €;'sin fechas';02/04/2015;'CASA';'Gastos_Ocio y transporte';'Restaurantes';'VARIABLES'
02/04/2015;02/04/2015;'WWW.JUST-EAT.ES';-15,90 €;7.823,32 €;6795;-15,90;12.347,41 €;'sin fechas';02/04/2015;'WWWJUSTEATES';'Gastos_Ocio y transporte';'Restaurantes';'VARIABLES'
03/04/2015;01/04/2015;'AUTOPISTAS';-1,39 €;7.821,93 €;6796;-1,39;12.346,02 €;'sin fechas';01/04/2015;'AUTOPISTAS';'Gastos_Ocio y transporte';'Parking y peaje';'VARIABLES'
03/04/2015;01/04/2015;'AUTOPISTAS';-1,39 €;7.820,54 €;6797;-1,39;12.344,63 €;'sin fechas';01/04/2015;'AUTOPISTAS';'Gastos_Ocio y transporte';'Parking y peaje';'VARIABLES'
03/04/2015;03/04/2015;'CAFETERIA';-2,70 €;7.817,84 €;6798;-2,70;12.341,93 €;'sin fechas';03/04/2015;'CAFETERIA';'Gastos_Compras';'Supermercado';'VARIABLES'
03/04/2015;03/04/2015;'CARREFOUR-[comida]';-9,55 €;7.808,29 €;6799;-9,55;12.332,38 €;'sin fechas';03/04/2015;'CARREFOURCOMIDA';'Gastos_Compras';'Supermercado';'VARIABLES'
03/04/2015;03/04/2015;'PERRUQUERIA';-15,90 €;7.792,39 €;6800;-15,90;12.316,48 €;'sin fechas';03/04/2015;'PERRUQUERIA';'Gastos_Salud, saber y deporte';'Belleza';'VARIABLES'
03/04/2015;03/04/2015;'REINT.CAJERO';-4,00 €;7.788,39 €;6801;-4,00;12.312,48 €;'sin fechas';03/04/2015;'REINTCAJERO';'Gastos_Gastos varios';'Efectivo';'VARIABLES'
03/04/2015;03/04/2015;'REINT.CAJERO';-100,00 €;7.688,39 €;6802;-100,00;12.212,48 €;'sin fechas';03/04/2015;'REINTCAJERO';'Gastos_Gastos varios';'Efectivo';'VARIABLES'
03/04/2015;02/04/2015;'SATSA PL. VELLA TERRASSA';-1,60 €;7.686,79 €;6803;-1,60;12.210,88 €;'sin fechas';02/04/2015;'SATSA';'Gastos_Ocio y transporte';'Parking y peaje';'VARIABLES'
04/04/2015;04/04/2015;'CAFETERIA';-4,85 €;7.681,94 €;6804;-4,85;12.206,03 €;'sin fechas';04/04/2015;'CAFETERIA';'Gastos_Compras';'Supermercado';'VARIABLES'
04/04/2015;04/04/2015;'CAFETERIA';-3,65 €;7.678,29 €;6805;-3,65;12.202,38 €;'sin fechas';04/04/2015;'CAFETERIA';'Gastos_Compras';'Supermercado';'VARIABLES'
05/04/2015;05/04/2015;'A.C.E.S.A LSCAP7S.-B.MART';-10,60 €;7.667,69 €;6806;-10,60;12.191,78 €;'sin fechas';05/04/2015;'ACESA';'Gastos_Ocio y transporte';'Parking y peaje';'VARIABLES'
05/04/2015;05/04/2015;'AUTOPISTA MARE NOSTRUM';-4,60 €;7.663,09 €;6807;-4,60;12.187,18 €;'sin fechas';05/04/2015;'AUTOPISTA';'Gastos_Ocio y transporte';'Parking y peaje';'VARIABLES'
05/04/2015;05/04/2015;'AUTOPISTA MARE NOSTRUM';-2,70 €;7.660,39 €;6808;-2,70;12.184,48 €;'sin fechas';05/04/2015;'AUTOPISTA';'Gastos_Ocio y transporte';'Parking y peaje';'VARIABLES'
05/04/2015;05/04/2015;'AUTOPISTAS';-2,53 €;7.657,86 €;6809;-2,53;12.181,95 €;'sin fechas';05/04/2015;'AUTOPISTAS';'Gastos_Ocio y transporte';'Parking y peaje';'VARIABLES'
05/04/2015;05/04/2015;'CINES';-35,00 €;7.622,86 €;6810;-35,00;12.146,95 €;'sin fechas';05/04/2015;'CINES';'Gastos_Ocio y transporte';'Espectáculos';'VARIABLES'
06/04/2015;06/04/2015;'GASOLINERA';-36,00 €;7.586,86 €;6811;-36,00;12.110,95 €;'sin fechas';06/04/2015;'GASOLINERA';'Gastos_Ocio y transporte';'Gasolina';'VARIABLES'
07/04/2015;07/04/2015;'AUTOPISTAS';-1,39 €;7.585,47 €;6812;-1,39;12.109,56 €;'sin fechas';07/04/2015;'AUTOPISTAS';'Gastos_Ocio y transporte';'Parking y peaje';'VARIABLES'
07/04/2015;07/04/2015;'AUTOPISTAS';-1,39 €;7.584,08 €;6813;-1,39;12.108,17 €;'sin fechas';07/04/2015;'AUTOPISTAS';'Gastos_Ocio y transporte';'Parking y peaje';'VARIABLES'
07/04/2015;07/04/2015;'CAPRABO';-38,62 €;7.545,46 €;6814;-38,62;12.069,55 €;'sin fechas';07/04/2015;'CAPRABO';'Gastos_Compras';'Supermercado';'VARIABLES'
07/04/2015;07/04/2015;'GERMANS MARIN';-43,94 €;7.501,52 €;6815;-43,94;12.025,61 €;'sin fechas';07/04/2015;'GERMANS';'Gastos_Ocio y transporte';'Restaurantes';'VARIABLES'
07/04/2015;07/04/2015;'SEGUROS CATALANA';-302,46 €;7.199,06 €;6816;-302,46;11.723,15 €;'sin fechas';07/04/2015;'CATALANA';'Gastos_Ocio y transporte';'Parking y peaje';'VARIABLES'
07/04/2015;07/04/2015;'TABASA VALLVI S. C:2T';-4,19 €;7.194,87 €;6817;-4,19;11.718,96 €;'sin fechas';07/04/2015;'TABASA';'Gastos_Ocio y transporte';'Parking y peaje';'VARIABLES'
08/04/2015;08/04/2015;'AUTOPISTAS';-1,39 €;7.193,48 €;6818;-1,39;11.717,57 €;'sin fechas';08/04/2015;'AUTOPISTAS';'Gastos_Ocio y transporte';'Parking y peaje';'VARIABLES'
08/04/2015;08/04/2015;'AUTOPISTAS';-1,39 €;7.192,09 €;6819;-1,39;11.716,18 €;'sin fechas';08/04/2015;'AUTOPISTAS';'Gastos_Ocio y transporte';'Parking y peaje';'VARIABLES'
08/04/2015;28/02/2015;'REC. 6061.9600001223';-542,33 €;6.649,76 €;6820;-542,33;11.173,85 €;'sin fechas';28/02/2015;'REC';'Gastos_Banco y organismos';'Hipoteca';'FIJO'
08/04/2015;02/03/2015;'REC. 6061.9600001223';547,25 €;7.197,01 €;6821;547,25;11.721,10 €;'sin fechas';02/03/2015;'REC';'Gastos_Banco y organismos';'Hipoteca';'FIJO'
08/04/2015;31/03/2015;'REC. 6061.9600001223';-542,33 €;6.654,68 €;6822;-542,33;11.178,77 €;'sin fechas';31/03/2015;'REC';'Gastos_Banco y organismos';'Hipoteca';'FIJO'
08/04/2015;31/03/2015;'REC. 6061.9600001223';547,25 €;7.201,93 €;6823;547,25;11.726,02 €;'sin fechas';31/03/2015;'REC';'Gastos_Banco y organismos';'Hipoteca';'FIJO'
09/04/2015;09/04/2015;'GAS NATURAL';-465,45 €;6.736,48 €;6824;-465,45;11.260,57 €;'sin fechas';09/04/2015;'GAS';'Gastos_Servicios tipicos';'Gas';'FIJO'
09/04/2015;09/04/2015;'WWW.JUST-EAT.ES';-16,60 €;6.719,88 €;6825;-16,60;11.243,97 €;'sin fechas';09/04/2015;'WWWJUSTEATES';'Gastos_Ocio y transporte';'Restaurantes';'VARIABLES'
10/04/2015;10/04/2015;'AUTOPISTAS';-1,39 €;6.718,49 €;6826;-1,39;11.242,58 €;'sin fechas';10/04/2015;'AUTOPISTAS';'Gastos_Ocio y transporte';'Parking y peaje';'VARIABLES'
10/04/2015;10/04/2015;'BLITZ';-72,50 €;6.645,99 €;6827;-72,50;11.170,08 €;'sin fechas';10/04/2015;'BLITZ';'Gastos_Vivienda y vehiculo';'Alquiler Parking';'FIJO'
10/04/2015;10/04/2015;'CAFETERIA';-3,65 €;6.642,34 €;6828;-3,65;11.166,43 €;'sin fechas';10/04/2015;'CAFETERIA';'Gastos_Compras';'Supermercado';'VARIABLES'
11/04/2015;09/04/2015;'AUTOPISTAS';-1,39 €;6.640,95 €;6829;-1,39;11.165,04 €;'sin fechas';09/04/2015;'AUTOPISTAS';'Gastos_Ocio y transporte';'Parking y peaje';'VARIABLES'
11/04/2015;09/04/2015;'AUTOPISTAS';-1,39 €;6.639,56 €;6830;-1,39;11.163,65 €;'sin fechas';09/04/2015;'AUTOPISTAS';'Gastos_Ocio y transporte';'Parking y peaje';'VARIABLES'
11/04/2015;11/04/2015;'CAFETERIA';-3,50 €;6.636,06 €;6831;-3,50;11.160,15 €;'sin fechas';11/04/2015;'CAFETERIA';'Gastos_Compras';'Supermercado';'VARIABLES'
11/04/2015;11/04/2015;'CINES';-18,00 €;6.618,06 €;6832;-18,00;11.142,15 €;'sin fechas';11/04/2015;'CINES';'Gastos_Ocio y transporte';'Espectáculos';'VARIABLES'
11/04/2015;11/04/2015;'VERITAS';-13,59 €;6.604,47 €;6833;-13,59;11.128,56 €;'sin fechas';11/04/2015;'VERITAS';'Gastos_Compras';'Supermercado';'VARIABLES'
12/04/2015;12/04/2015;'VIENA';-6,40 €;6.598,07 €;6834;-6,40;11.122,16 €;'sin fechas';12/04/2015;'VIENA';'Gastos_Ocio y transporte';'Restaurantes';'VARIABLES'
12/04/2015;12/04/2015;'WWW.JUST-EAT.ES';-24,35 €;6.573,72 €;6835;-24,35;11.097,81 €;'sin fechas';12/04/2015;'WWWJUSTEATES';'Gastos_Ocio y transporte';'Restaurantes';'VARIABLES'
13/04/2015;13/04/2015;'AUTOPISTAS';-1,39 €;6.572,33 €;6836;-1,39;11.096,42 €;'sin fechas';13/04/2015;'AUTOPISTAS';'Gastos_Ocio y transporte';'Parking y peaje';'VARIABLES'
13/04/2015;13/04/2015;'AUTOPISTAS';-1,39 €;6.570,94 €;6837;-1,39;11.095,03 €;'sin fechas';13/04/2015;'AUTOPISTAS';'Gastos_Ocio y transporte';'Parking y peaje';'VARIABLES'
13/04/2015;13/04/2015;'AUTOPISTAS';-1,39 €;6.569,55 €;6838;-1,39;11.093,64 €;'sin fechas';13/04/2015;'AUTOPISTAS';'Gastos_Ocio y transporte';'Parking y peaje';'VARIABLES'
13/04/2015;13/04/2015;'BON AREA';-39,79 €;6.529,76 €;6839;-39,79;11.053,85 €;'sin fechas';13/04/2015;'BON';'Gastos_Compras';'Supermercado';'VARIABLES'
13/04/2015;13/04/2015;'CAFETERIA';-3,65 €;6.526,11 €;6840;-3,65;11.050,20 €;'sin fechas';13/04/2015;'CAFETERIA';'Gastos_Compras';'Supermercado';'VARIABLES'
13/04/2015;13/04/2015;'CATALANA DIAG.I CIRUR';-4,75 €;6.521,36 €;6841;-4,75;11.045,45 €;'sin fechas';13/04/2015;'CATALANA';'Gastos_Ocio y transporte';'Parking y peaje';'VARIABLES'
13/04/2015;13/04/2015;'CATALANA DIAG.I CIRUR';-2,80 €;6.518,56 €;6842;-2,80;11.042,65 €;'sin fechas';13/04/2015;'CATALANA';'Gastos_Ocio y transporte';'Parking y peaje';'VARIABLES'
13/04/2015;13/04/2015;'GASOLINERA';-39,03 €;6.479,53 €;6843;-39,03;11.003,62 €;'sin fechas';13/04/2015;'GASOLINERA';'Gastos_Ocio y transporte';'Gasolina';'VARIABLES'
13/04/2015;13/04/2015;'WWW.JUST-EAT.ES';-16,75 €;6.462,78 €;6844;-16,75;10.986,87 €;'sin fechas';13/04/2015;'WWWJUSTEATES';'Gastos_Ocio y transporte';'Restaurantes';'VARIABLES'
14/04/2015;10/04/2015;'AUTOPISTAS';-1,39 €;6.461,39 €;6845;-1,39;10.985,48 €;'sin fechas';10/04/2015;'AUTOPISTAS';'Gastos_Ocio y transporte';'Parking y peaje';'VARIABLES'
14/04/2015;14/04/2015;'C&A';-65,36 €;6.396,03 €;6846;-65,36;10.920,12 €;'sin fechas';14/04/2015;'CA';'Gastos_Compras';'Ropa';'VARIABLES'
14/04/2015;14/04/2015;'GERPLEX';-30,24 €;6.365,79 €;6847;-30,24;10.889,88 €;'sin fechas';14/04/2015;'GERPLEX';'Gastos_Compras';'Hogar';'VARIABLES'
14/04/2015;14/04/2015;'RESTAURANTES';-10,30 €;6.355,49 €;6848;-10,30;10.879,58 €;'sin fechas';14/04/2015;'RESTAURANTES';'Gastos_Ocio y transporte';'Restaurantes';'VARIABLES'
14/04/2015;14/04/2015;'RESTAURANTES';-44,47 €;6.311,02 €;6849;-44,47;10.835,11 €;'sin fechas';14/04/2015;'RESTAURANTES';'Gastos_Ocio y transporte';'Restaurantes';'VARIABLES'
15/04/2015;15/04/2015;'AUTOPISTAS';-1,39 €;6.309,63 €;6850;-1,39;10.833,72 €;'sin fechas';15/04/2015;'AUTOPISTAS';'Gastos_Ocio y transporte';'Parking y peaje';'VARIABLES'
15/04/2015;14/04/2015;'PARKING';-2,90 €;6.306,73 €;6851;-2,90;10.830,82 €;'sin fechas';14/04/2015;'PARKING';'Gastos_Ocio y transporte';'Parking y peaje';'VARIABLES'
16/04/2015;13/04/2015;'AUTOPISTAS';-1,39 €;6.305,34 €;6852;-1,39;10.829,43 €;'sin fechas';13/04/2015;'AUTOPISTAS';'Gastos_Ocio y transporte';'Parking y peaje';'VARIABLES'
16/04/2015;13/04/2015;'AUTOPISTAS';-1,39 €;6.303,95 €;6853;-1,39;10.828,04 €;'sin fechas';13/04/2015;'AUTOPISTAS';'Gastos_Ocio y transporte';'Parking y peaje';'VARIABLES'
16/04/2015;13/04/2015;'AUTOPISTAS';-1,39 €;6.302,56 €;6854;-1,39;10.826,65 €;'sin fechas';13/04/2015;'AUTOPISTAS';'Gastos_Ocio y transporte';'Parking y peaje';'VARIABLES'
16/04/2015;14/04/2015;'AUTOPISTAS';-1,39 €;6.301,17 €;6855;-1,39;10.825,26 €;'sin fechas';14/04/2015;'AUTOPISTAS';'Gastos_Ocio y transporte';'Parking y peaje';'VARIABLES'
16/04/2015;14/04/2015;'AUTOPISTAS';-1,39 €;6.299,78 €;6856;-1,39;10.823,87 €;'sin fechas';14/04/2015;'AUTOPISTAS';'Gastos_Ocio y transporte';'Parking y peaje';'VARIABLES'
16/04/2015;16/04/2015;'CAFETERIA';-8,10 €;6.291,68 €;6857;-8,10;10.815,77 €;'sin fechas';16/04/2015;'CAFETERIA';'Gastos_Compras';'Supermercado';'VARIABLES'
16/04/2015;16/04/2015;'CCM VIDA Y P SEGURO PRESTAMO';-23,01 €;6.268,67 €;6858;-23,01;10.792,76 €;'sin fechas';16/04/2015;'CCM';'Gastos_Seguros';'Seguro vida';'FIJO'
16/04/2015;16/04/2015;'CCM VIDA Y PENSIO 000000493358';-18,04 €;6.250,63 €;6859;-18,04;10.774,72 €;'sin fechas';16/04/2015;'CCM';'Gastos_Seguros';'Seguro vida';'FIJO'
16/04/2015;16/04/2015;'FARMACIA';-21,05 €;6.229,58 €;6860;-21,05;10.753,67 €;'sin fechas';16/04/2015;'FARMACIA';'Gastos_Salud, saber y deporte';'Farmacia';'VARIABLES'
16/04/2015;16/04/2015;'REINT.CAJERO';-60,00 €;6.169,58 €;6861;-60,00;10.693,67 €;'sin fechas';16/04/2015;'REINTCAJERO';'Gastos_Gastos varios';'Efectivo';'VARIABLES'
16/04/2015;16/04/2015;'SALA BADRINAS - MENJADOR';-100,97 €;6.068,61 €;6862;-100,97;10.592,70 €;'sin fechas';16/04/2015;'SALA';'Gastos_Salud, saber y deporte';'Estudios';'VARIABLES'
16/04/2015;16/04/2015;'VIENA';-10,55 €;6.058,06 €;6863;-10,55;10.582,15 €;'sin fechas';16/04/2015;'VIENA';'Gastos_Ocio y transporte';'Restaurantes';'VARIABLES'
17/04/2015;15/04/2015;'AUTOPISTAS';-1,32 €;6.056,74 €;6864;-1,32;10.580,83 €;'sin fechas';15/04/2015;'AUTOPISTAS';'Gastos_Ocio y transporte';'Parking y peaje';'VARIABLES'
17/04/2015;17/04/2015;'CAFETERIA';-4,10 €;6.052,64 €;6865;-4,10;10.576,73 €;'sin fechas';17/04/2015;'CAFETERIA';'Gastos_Compras';'Supermercado';'VARIABLES'
17/04/2015;17/04/2015;'COMUNIDAD';-240,00 €;5.812,64 €;6866;-240,00;10.336,73 €;'sin fechas';17/04/2015;'COMUNIDAD';'Gastos_Vivienda y vehiculo';'Comunidad';'FIJO'
17/04/2015;17/04/2015;'ONO';-115,23 €;5.697,41 €;6867;-115,23;10.221,50 €;'sin fechas';17/04/2015;'ONO';'Gastos_Servicios tipicos';'Telecomunicaciones';'FIJO'
18/04/2015;18/04/2015;'AMC PARC VALLES';-18,10 €;5.679,31 €;6868;-18,10;10.203,40 €;'sin fechas';18/04/2015;'AMC';'Gastos_Ocio y transporte';'Espectáculos';'VARIABLES'
18/04/2015;18/04/2015;'CAFETERIA';-3,65 €;5.675,66 €;6869;-3,65;10.199,75 €;'sin fechas';18/04/2015;'CAFETERIA';'Gastos_Compras';'Supermercado';'VARIABLES'
18/04/2015;18/04/2015;'GLT STORE HOME';-16,73 €;5.658,93 €;6870;-16,73;10.183,02 €;'sin fechas';18/04/2015;'GLT';'Gastos_Compras';'Otras compras';'VARIABLES'
18/04/2015;18/04/2015;'MERCADONA';-155,83 €;5.503,10 €;6871;-155,83;10.027,19 €;'sin fechas';18/04/2015;'MERCADONA';'Gastos_Compras';'Supermercado';'VARIABLES'
18/04/2015;18/04/2015;'VIENA';-11,15 €;5.491,95 €;6872;-11,15;10.016,04 €;'sin fechas';18/04/2015;'VIENA';'Gastos_Ocio y transporte';'Restaurantes';'VARIABLES'
19/04/2015;19/04/2015;'CAFETERIA';-3,60 €;5.488,35 €;6873;-3,60;10.012,44 €;'sin fechas';19/04/2015;'CAFETERIA';'Gastos_Compras';'Supermercado';'VARIABLES'
19/04/2015;19/04/2015;'FRANKFURT LES LLETRES';-5,50 €;5.482,85 €;6874;-5,50;10.006,94 €;'sin fechas';19/04/2015;'FRANKFURT';'Gastos_Ocio y transporte';'Restaurantes';'VARIABLES'
19/04/2015;19/04/2015;'VIENA';-12,40 €;5.470,45 €;6875;-12,40;9.994,54 €;'sin fechas';19/04/2015;'VIENA';'Gastos_Ocio y transporte';'Restaurantes';'VARIABLES'
20/04/2015;16/04/2015;'AUTOPISTAS';-1,32 €;5.469,13 €;6876;-1,32;9.993,22 €;'sin fechas';16/04/2015;'AUTOPISTAS';'Gastos_Ocio y transporte';'Parking y peaje';'VARIABLES'
20/04/2015;16/04/2015;'AUTOPISTAS';-1,32 €;5.467,81 €;6877;-1,32;9.991,90 €;'sin fechas';16/04/2015;'AUTOPISTAS';'Gastos_Ocio y transporte';'Parking y peaje';'VARIABLES'
20/04/2015;20/04/2015;'CAFETERIA';-3,65 €;5.464,16 €;6878;-3,65;9.988,25 €;'sin fechas';20/04/2015;'CAFETERIA';'Gastos_Compras';'Supermercado';'VARIABLES'
20/04/2015;20/04/2015;'MERKALZADOS';-20,00 €;5.444,16 €;6879;-20,00;9.968,25 €;'sin fechas';20/04/2015;'MERKALZADOS';'Gastos_Compras';'Ropa';'VARIABLES'
20/04/2015;14/04/2015;'PARKING';-7,95 €;5.436,21 €;6880;-7,95;9.960,30 €;'sin fechas';14/04/2015;'PARKING';'Gastos_Ocio y transporte';'Parking y peaje';'VARIABLES'
20/04/2015;20/04/2015;'REINT.CAJERO';-100,00 €;5.336,21 €;6881;-100,00;9.860,30 €;'sin fechas';20/04/2015;'REINTCAJERO';'Gastos_Gastos varios';'Efectivo';'VARIABLES'
21/04/2015;17/04/2015;'AUTOPISTAS';-1,32 €;5.334,89 €;6882;-1,32;9.858,98 €;'sin fechas';17/04/2015;'AUTOPISTAS';'Gastos_Ocio y transporte';'Parking y peaje';'VARIABLES'
21/04/2015;17/04/2015;'AUTOPISTAS';-1,39 €;5.333,50 €;6883;-1,39;9.857,59 €;'sin fechas';17/04/2015;'AUTOPISTAS';'Gastos_Ocio y transporte';'Parking y peaje';'VARIABLES'
21/04/2015;21/04/2015;'VIENA';-18,00 €;5.315,50 €;6884;-18,00;9.839,59 €;'sin fechas';21/04/2015;'VIENA';'Gastos_Ocio y transporte';'Restaurantes';'VARIABLES'
22/04/2015;20/04/2015;'AUTOPISTAS';-1,25 €;5.314,25 €;6885;-1,25;9.838,34 €;'sin fechas';20/04/2015;'AUTOPISTAS';'Gastos_Ocio y transporte';'Parking y peaje';'VARIABLES'
22/04/2015;20/04/2015;'AUTOPISTAS';-1,32 €;5.312,93 €;6886;-1,32;9.837,02 €;'sin fechas';20/04/2015;'AUTOPISTAS';'Gastos_Ocio y transporte';'Parking y peaje';'VARIABLES'
23/04/2015;21/04/2015;'AUTOPISTAS';-1,25 €;5.311,68 €;6887;-1,25;9.835,77 €;'sin fechas';21/04/2015;'AUTOPISTAS';'Gastos_Ocio y transporte';'Parking y peaje';'VARIABLES'
23/04/2015;21/04/2015;'AUTOPISTAS';-1,25 €;5.310,43 €;6888;-1,25;9.834,52 €;'sin fechas';21/04/2015;'AUTOPISTAS';'Gastos_Ocio y transporte';'Parking y peaje';'VARIABLES'
23/04/2015;23/04/2015;'CAFETERIA';-3,60 €;5.306,83 €;6889;-3,60;9.830,92 €;'sin fechas';23/04/2015;'CAFETERIA';'Gastos_Compras';'Supermercado';'VARIABLES'
23/04/2015;23/04/2015;'FARMACIA';-29,90 €;5.276,93 €;6890;-29,90;9.801,02 €;'sin fechas';23/04/2015;'FARMACIA';'Gastos_Salud, saber y deporte';'Farmacia';'VARIABLES'
24/04/2015;22/04/2015;'AUTOPISTAS';-1,25 €;5.275,68 €;6891;-1,25;9.799,77 €;'sin fechas';22/04/2015;'AUTOPISTAS';'Gastos_Ocio y transporte';'Parking y peaje';'VARIABLES'
24/04/2015;22/04/2015;'AUTOPISTAS';-1,39 €;5.274,29 €;6892;-1,39;9.798,38 €;'sin fechas';22/04/2015;'AUTOPISTAS';'Gastos_Ocio y transporte';'Parking y peaje';'VARIABLES'
24/04/2015;24/04/2015;'CAFETERIA';-3,65 €;5.270,64 €;6893;-3,65;9.794,73 €;'sin fechas';24/04/2015;'CAFETERIA';'Gastos_Compras';'Supermercado';'VARIABLES'
24/04/2015;24/04/2015;'FRANKFURT LES LLETRES';-2,50 €;5.268,14 €;6894;-2,50;9.792,23 €;'sin fechas';24/04/2015;'FRANKFURT';'Gastos_Ocio y transporte';'Restaurantes';'VARIABLES'
24/04/2015;24/04/2015;'MERCADONA';-3,10 €;5.265,04 €;6895;-3,10;9.789,13 €;'sin fechas';24/04/2015;'MERCADONA';'Gastos_Compras';'Supermercado';'VARIABLES'
25/04/2015;23/04/2015;'AUTOPISTAS';-1,25 €;5.263,79 €;6896;-1,25;9.787,88 €;'sin fechas';23/04/2015;'AUTOPISTAS';'Gastos_Ocio y transporte';'Parking y peaje';'VARIABLES'
25/04/2015;25/04/2015;'CATALANA DIAG.I CIRUR';-2,90 €;5.260,89 €;6897;-2,90;9.784,98 €;'sin fechas';25/04/2015;'CATALANA';'Gastos_Ocio y transporte';'Parking y peaje';'VARIABLES'
26/04/2015;26/04/2015;'FARMACIA';-29,90 €;5.230,99 €;6898;-29,90;9.755,08 €;'sin fechas';26/04/2015;'FARMACIA';'Gastos_Salud, saber y deporte';'Farmacia';'VARIABLES'
26/04/2015;26/04/2015;'FARMACIA';-29,90 €;5.201,09 €;6899;-29,90;9.725,18 €;'sin fechas';26/04/2015;'FARMACIA';'Gastos_Salud, saber y deporte';'Farmacia';'VARIABLES'
26/04/2015;26/04/2015;'FARMACIA';-8,53 €;5.192,56 €;6900;-8,53;9.716,65 €;'sin fechas';26/04/2015;'FARMACIA';'Gastos_Salud, saber y deporte';'Farmacia';'VARIABLES'
26/04/2015;26/04/2015;'FRANKFURT LES LLETRES';-2,50 €;5.190,06 €;6901;-2,50;9.714,15 €;'sin fechas';26/04/2015;'FRANKFURT';'Gastos_Ocio y transporte';'Restaurantes';'VARIABLES'
26/04/2015;26/04/2015;'WWW.JUST-EAT.ES';-19,80 €;5.170,26 €;6902;-19,80;9.694,35 €;'sin fechas';26/04/2015;'WWWJUSTEATES';'Gastos_Ocio y transporte';'Restaurantes';'VARIABLES'
27/04/2015;27/04/2015;'FRANKFURT LES LLETRES';-6,75 €;5.163,51 €;6903;-6,75;9.687,60 €;'sin fechas';27/04/2015;'FRANKFURT';'Gastos_Ocio y transporte';'Restaurantes';'VARIABLES'
27/04/2015;27/04/2015;'TOCINERIES VENTURA';-25,17 €;5.138,34 €;6904;-25,17;9.662,43 €;'sin fechas';27/04/2015;'TOCINERIES';'Gastos_Compras';'Supermercado';'VARIABLES'
27/04/2015;27/04/2015;'VIENA';-2,80 €;5.135,54 €;6905;-2,80;9.659,63 €;'sin fechas';27/04/2015;'VIENA';'Gastos_Ocio y transporte';'Restaurantes';'VARIABLES'
28/04/2015;28/04/2015;'CARREFOUR-[comida]';-43,30 €;5.092,24 €;6906;-43,30;9.616,33 €;'sin fechas';28/04/2015;'CARREFOURCOMIDA';'Gastos_Compras';'Supermercado';'VARIABLES'
28/04/2015;28/04/2015;'FOMENT DE TERRASSA, SA';1.769,58 €;6.861,82 €;6907;1.769,58;11.385,91 €;'sin fechas';28/04/2015;'FOMENT';'Ingresos';'Nomina';'FIJO'
28/04/2015;28/04/2015;'INFORMACIO I TECNOLOGIA DE CAT';1.585,98 €;8.447,80 €;6908;1.585,98;12.971,89 €;'sin fechas';28/04/2015;'INFORMACIO';'Ingresos';'Nomina';'FIJO'
28/04/2015;25/04/2015;'PARKING';-5,90 €;8.441,90 €;6909;-5,90;12.965,99 €;'sin fechas';25/04/2015;'PARKING';'Gastos_Ocio y transporte';'Parking y peaje';'VARIABLES'
28/04/2015;25/04/2015;'PARKING';-4,35 €;8.437,55 €;6910;-4,35;12.961,64 €;'sin fechas';25/04/2015;'PARKING';'Gastos_Ocio y transporte';'Parking y peaje';'VARIABLES'
30/04/2015;30/04/2015;'BON AREA';-18,78 €;8.418,77 €;6911;-18,78;12.942,86 €;'sin fechas';30/04/2015;'BON';'Gastos_Compras';'Supermercado';'VARIABLES'
30/04/2015;30/04/2015;'IBI';-44,99 €;8.373,78 €;6912;-44,99;12.897,87 €;'sin fechas';30/04/2015;'IBI';'Gastos_Banco y organismos';'Ayuntamiento';'FIJO'
30/04/2015;30/04/2015;'FRANKFURT LES LLETRES';-2,50 €;8.371,28 €;6913;-2,50;12.895,37 €;'sin fechas';30/04/2015;'FRANKFURT';'Gastos_Ocio y transporte';'Restaurantes';'VARIABLES'
30/04/2015;30/04/2015;'REC. 6061.9600001223';-542,33 €;7.828,95 €;6914;-542,33;12.353,04 €;'sin fechas';30/04/2015;'REC';'Gastos_Banco y organismos';'Hipoteca';'FIJO'
30/04/2015;30/04/2015;'REINT.CAJERO';-200,00 €;7.628,95 €;6915;-200,00;12.153,04 €;'sin fechas';30/04/2015;'REINTCAJERO';'Gastos_Gastos varios';'Efectivo';'VARIABLES'
01/05/2015;01/05/2015;'FRUITES I VERDURES';-6,19 €;7.622,76 €;6917;-6,19;12.146,85 €;'sin fechas';01/05/2015;'FRUITES';'Gastos_Compras';'Supermercado';'VARIABLES'
01/05/2015;01/05/2015;'FRANKFURT LES LLETRES';-2,50 €;7.620,26 €;6918;-2,50;12.144,35 €;'sin fechas';01/05/2015;'FRANKFURT';'Gastos_Ocio y transporte';'Restaurantes';'VARIABLES'
02/05/2015;02/05/2015;'MERCADONA';-163,21 €;7.457,05 €;6919;-163,21;11.981,14 €;'sin fechas';02/05/2015;'MERCADONA';'Gastos_Compras';'Supermercado';'VARIABLES'
03/05/2015;03/05/2015;'FRANKFURT LES LLETRES';-7,35 €;7.449,70 €;6920;-7,35;11.973,79 €;'sin fechas';03/05/2015;'FRANKFURT';'Gastos_Ocio y transporte';'Restaurantes';'VARIABLES'
03/05/2015;03/05/2015;'WWW.JUST-EAT.ES';-27,46 €;7.422,24 €;6921;-27,46;11.946,33 €;'sin fechas';03/05/2015;'WWWJUSTEATES';'Gastos_Ocio y transporte';'Restaurantes';'VARIABLES'
04/05/2015;30/04/2015;'ESCOLA BRESSOL EINA';-487,70 €;6.934,54 €;6922;-487,70;11.458,63 €;'sin fechas';30/04/2015;'ESCOLA';'Gastos_Salud, saber y deporte';'Estudios';'VARIABLES'
04/05/2015;04/05/2015;'IMPOST VEHICLE';-62,78 €;6.871,76 €;6923;-62,78;11.395,85 €;'sin fechas';04/05/2015;'IMPOST';'Gastos_Banco y organismos';'Impuestos';'FIJO'
04/05/2015;04/05/2015;'WWW.JUST-EAT.ES';-13,00 €;6.858,76 €;6924;-13,00;11.382,85 €;'sin fechas';04/05/2015;'WWWJUSTEATES';'Gastos_Ocio y transporte';'Restaurantes';'VARIABLES'
06/05/2015;06/05/2015;'WWW.JUST-EAT.ES';-18,50 €;6.840,26 €;6925;-18,50;11.364,35 €;'sin fechas';06/05/2015;'WWWJUSTEATES';'Gastos_Ocio y transporte';'Restaurantes';'VARIABLES'
07/05/2015;07/05/2015;'BLITZ';-72,50 €;6.767,76 €;6926;-72,50;11.291,85 €;'sin fechas';07/05/2015;'BLITZ';'Gastos_Vivienda y vehiculo';'Alquiler Parking';'FIJO'
07/05/2015;07/05/2015;'CARREFOUR-[comida]';-33,95 €;6.733,81 €;6927;-33,95;11.257,90 €;'sin fechas';07/05/2015;'CARREFOURCOMIDA';'Gastos_Compras';'Supermercado';'VARIABLES'
07/05/2015;07/05/2015;'CARREFOUR-[comida]';-7,80 €;6.726,01 €;6928;-7,80;11.250,10 €;'sin fechas';07/05/2015;'CARREFOURCOMIDA';'Gastos_Compras';'Supermercado';'VARIABLES'
07/05/2015;07/05/2015;'RESTAURANTES';-14,80 €;6.711,21 €;6929;-14,80;11.235,30 €;'sin fechas';07/05/2015;'RESTAURANTES';'Gastos_Ocio y transporte';'Restaurantes';'VARIABLES'
07/05/2015;07/05/2015;'VIRGIN ACTIV';-55,95 €;6.655,26 €;6930;-55,95;11.179,35 €;'sin fechas';07/05/2015;'VIRGIN';'Gastos_Salud, saber y deporte';'Deportes';'VARIABLES'
07/05/2015;07/05/2015;'VIRGIN ACTIV';-55,95 €;6.599,31 €;6931;-55,95;11.123,40 €;'sin fechas';07/05/2015;'VIRGIN';'Gastos_Salud, saber y deporte';'Deportes';'VARIABLES'
08/05/2015;08/05/2015;'ADESLAS';-111,00 €;6.488,31 €;6932;-111,00;11.012,40 €;'sin fechas';08/05/2015;'ADESLAS';'Gastos_Salud, saber y deporte';'Medico';'VARIABLES'
08/05/2015;08/05/2015;'BON AREA';-14,19 €;6.474,12 €;6933;-14,19;10.998,21 €;'sin fechas';08/05/2015;'BON';'Gastos_Compras';'Supermercado';'VARIABLES'
08/05/2015;08/05/2015;'REINT.CAJERO';-20,00 €;6.454,12 €;6934;-20,00;10.978,21 €;'sin fechas';08/05/2015;'REINTCAJERO';'Gastos_Gastos varios';'Efectivo';'VARIABLES'
09/05/2015;06/05/2015;'AUTOPISTAS';-1,39 €;6.452,73 €;6935;-1,39;10.976,82 €;'sin fechas';06/05/2015;'AUTOPISTAS';'Gastos_Ocio y transporte';'Parking y peaje';'VARIABLES'
09/05/2015;06/05/2015;'AUTOPISTAS';-1,39 €;6.451,34 €;6936;-1,39;10.975,43 €;'sin fechas';06/05/2015;'AUTOPISTAS';'Gastos_Ocio y transporte';'Parking y peaje';'VARIABLES'
10/05/2015;10/05/2015;'RESTAURANTES';-11,70 €;6.439,64 €;6937;-11,70;10.963,73 €;'sin fechas';10/05/2015;'RESTAURANTES';'Gastos_Ocio y transporte';'Restaurantes';'VARIABLES'
11/05/2015;11/05/2015;'BON AREA';-17,12 €;6.422,52 €;6938;-17,12;10.946,61 €;'sin fechas';11/05/2015;'BON';'Gastos_Compras';'Supermercado';'VARIABLES'
11/05/2015;11/05/2015;'VIENA';-6,15 €;6.416,37 €;6939;-6,15;10.940,46 €;'sin fechas';11/05/2015;'VIENA';'Gastos_Ocio y transporte';'Restaurantes';'VARIABLES'
12/05/2015;12/05/2015;'RESTAURANTES';-20,60 €;6.395,77 €;6940;-20,60;10.919,86 €;'sin fechas';12/05/2015;'RESTAURANTES';'Gastos_Ocio y transporte';'Restaurantes';'VARIABLES'
13/05/2015;13/05/2015;'A.E.A.T. DEVOLUCIONES TRIBUTAR';115,95 €;6.511,72 €;6941;115,95;11.035,81 €;'sin fechas';13/05/2015;'AEAT';'Ingresos';'Devoluciones';'VARIABLES'
13/05/2015;13/05/2015;'SALA BADRINAS - MENJADOR';-106,74 €;6.404,98 €;6942;-106,74;10.929,07 €;'sin fechas';13/05/2015;'SALA';'Gastos_Salud, saber y deporte';'Estudios';'VARIABLES'
14/05/2015;14/05/2015;'FRUITES I VERDURES';-7,72 €;6.397,26 €;6943;-7,72;10.921,35 €;'sin fechas';14/05/2015;'FRUITES';'Gastos_Compras';'Supermercado';'VARIABLES'
14/05/2015;14/05/2015;'VIENA';-6,50 €;6.390,76 €;6944;-6,50;10.914,85 €;'sin fechas';14/05/2015;'VIENA';'Gastos_Ocio y transporte';'Restaurantes';'VARIABLES'
15/05/2015;15/05/2015;'A.E.A.T. DEVOLUCIONES TRIBUTAR';2.475,56 €;8.866,32 €;6945;2.475,56;13.390,41 €;'sin fechas';15/05/2015;'AEAT';'Ingresos';'Devoluciones';'VARIABLES'
15/05/2015;15/05/2015;'VIENA';-6,95 €;8.859,37 €;6946;-6,95;13.383,46 €;'sin fechas';15/05/2015;'VIENA';'Gastos_Ocio y transporte';'Restaurantes';'VARIABLES'
16/05/2015;16/05/2015;'BON AREA';-18,95 €;8.840,42 €;6947;-18,95;13.364,51 €;'sin fechas';16/05/2015;'BON';'Gastos_Compras';'Supermercado';'VARIABLES'
16/05/2015;16/05/2015;'FRANKFURT LES LLETRES';-5,60 €;8.834,82 €;6948;-5,60;13.358,91 €;'sin fechas';16/05/2015;'FRANKFURT';'Gastos_Ocio y transporte';'Restaurantes';'VARIABLES'
16/05/2015;16/05/2015;'VIENA';-6,15 €;8.828,67 €;6949;-6,15;13.352,76 €;'sin fechas';16/05/2015;'VIENA';'Gastos_Ocio y transporte';'Restaurantes';'VARIABLES'
17/05/2015;17/05/2015;'FRANKFURT LES LLETRES';-6,40 €;8.822,27 €;6950;-6,40;13.346,36 €;'sin fechas';17/05/2015;'FRANKFURT';'Gastos_Ocio y transporte';'Restaurantes';'VARIABLES'
17/05/2015;17/05/2015;'VIENA';-6,95 €;8.815,32 €;6951;-6,95;13.339,41 €;'sin fechas';17/05/2015;'VIENA';'Gastos_Ocio y transporte';'Restaurantes';'VARIABLES'
18/05/2015;18/05/2015;'CASAL D ESTIU CAN PALET';-294,00 €;8.521,32 €;6952;-294,00;13.045,41 €;'sin fechas';18/05/2015;'CASAL';'Gastos_Salud, saber y deporte';'Estudios';'VARIABLES'
18/05/2015;18/05/2015;'CCM VIDA Y P SEGURO PRESTAMO';-22,94 €;8.498,38 €;6953;-22,94;13.022,47 €;'sin fechas';18/05/2015;'CCM';'Gastos_Seguros';'Seguro vida';'FIJO'
18/05/2015;18/05/2015;'CCM VIDA Y PENSIO 000000493358';-17,99 €;8.480,39 €;6954;-17,99;13.004,48 €;'sin fechas';18/05/2015;'CCM';'Gastos_Seguros';'Seguro vida';'FIJO'
18/05/2015;18/05/2015;'FRUITES I VERDURES';-11,00 €;8.469,39 €;6955;-11,00;12.993,48 €;'sin fechas';18/05/2015;'FRUITES';'Gastos_Compras';'Supermercado';'VARIABLES'
18/05/2015;18/05/2015;'ONO';-140,12 €;8.329,27 €;6956;-140,12;12.853,36 €;'sin fechas';18/05/2015;'ONO';'Gastos_Servicios tipicos';'Telecomunicaciones';'FIJO'
18/05/2015;18/05/2015;'TOYOTA ORIENT CARS';-221,78 €;8.107,49 €;6957;-221,78;12.631,58 €;'sin fechas';18/05/2015;'TOYOTA';'Gastos_Vivienda y vehiculo';'Mnto. vehiculo';'VARIABLE'
18/05/2015;18/05/2015;'VIENA';-4,95 €;8.102,54 €;6958;-4,95;12.626,63 €;'sin fechas';18/05/2015;'VIENA';'Gastos_Ocio y transporte';'Restaurantes';'VARIABLES'
19/05/2015;19/05/2015;'TOYOTA ORIENT CARS';-190,16 €;7.912,38 €;6959;-190,16;12.436,47 €;'sin fechas';19/05/2015;'TOYOTA';'Gastos_Vivienda y vehiculo';'Mnto. vehiculo';'VARIABLE'
20/05/2015;15/05/2015;'AUTOPISTAS';-1,39 €;7.910,99 €;6960;-1,39;12.435,08 €;'sin fechas';15/05/2015;'AUTOPISTAS';'Gastos_Ocio y transporte';'Parking y peaje';'VARIABLES'
20/05/2015;15/05/2015;'AUTOPISTAS';-1,39 €;7.909,60 €;6961;-1,39;12.433,69 €;'sin fechas';15/05/2015;'AUTOPISTAS';'Gastos_Ocio y transporte';'Parking y peaje';'VARIABLES'
20/05/2015;18/05/2015;'AUTOPISTAS';-4,19 €;7.905,41 €;6962;-4,19;12.429,50 €;'sin fechas';18/05/2015;'AUTOPISTAS';'Gastos_Ocio y transporte';'Parking y peaje';'VARIABLES'
20/05/2015;18/05/2015;'AUTOPISTAS';-3,72 €;7.901,69 €;6963;-3,72;12.425,78 €;'sin fechas';18/05/2015;'AUTOPISTAS';'Gastos_Ocio y transporte';'Parking y peaje';'VARIABLES'
20/05/2015;20/05/2015;'WWW.JUST-EAT.ES';-15,72 €;7.885,97 €;6964;-15,72;12.410,06 €;'sin fechas';20/05/2015;'WWWJUSTEATES';'Gastos_Ocio y transporte';'Restaurantes';'VARIABLES'
21/05/2015;21/05/2015;'GASOLINERA';-20,00 €;7.865,97 €;6965;-20,00;12.390,06 €;'sin fechas';21/05/2015;'GASOLINERA';'Gastos_Ocio y transporte';'Gasolina';'VARIABLES'
21/05/2015;14/05/2015;'KIABI';-109,65 €;7.756,32 €;6966;-109,65;12.280,41 €;'sin fechas';14/05/2015;'KIABI';'Gastos_Compras';'Ropa';'VARIABLES'
21/05/2015;21/05/2015;'MERCADONA';-19,95 €;7.736,37 €;6967;-19,95;12.260,46 €;'sin fechas';21/05/2015;'MERCADONA';'Gastos_Compras';'Supermercado';'VARIABLES'
21/05/2015;21/05/2015;'REINT.CAJERO';-40,00 €;7.696,37 €;6968;-40,00;12.220,46 €;'sin fechas';21/05/2015;'REINTCAJERO';'Gastos_Gastos varios';'Efectivo';'VARIABLES'
21/05/2015;21/05/2015;'VIENA';-7,35 €;7.689,02 €;6969;-7,35;12.213,11 €;'sin fechas';21/05/2015;'VIENA';'Gastos_Ocio y transporte';'Restaurantes';'VARIABLES'
22/05/2015;20/05/2015;'AUTOPISTAS';-1,39 €;7.687,63 €;6970;-1,39;12.211,72 €;'sin fechas';20/05/2015;'AUTOPISTAS';'Gastos_Ocio y transporte';'Parking y peaje';'VARIABLES'
22/05/2015;22/05/2015;'FRUITES I VERDURES';-1,23 €;7.686,40 €;6971;-1,23;12.210,49 €;'sin fechas';22/05/2015;'FRUITES';'Gastos_Compras';'Supermercado';'VARIABLES'
22/05/2015;22/05/2015;'FRANKFURT LES LLETRES';-5,00 €;7.681,40 €;6972;-5,00;12.205,49 €;'sin fechas';22/05/2015;'FRANKFURT';'Gastos_Ocio y transporte';'Restaurantes';'VARIABLES'
22/05/2015;22/05/2015;'VIENA';-5,40 €;7.676,00 €;6973;-5,40;12.200,09 €;'sin fechas';22/05/2015;'VIENA';'Gastos_Ocio y transporte';'Restaurantes';'VARIABLES'
22/05/2015;22/05/2015;'WWW.JUST-EAT.ES';-17,82 €;7.658,18 €;6974;-17,82;12.182,27 €;'sin fechas';22/05/2015;'WWWJUSTEATES';'Gastos_Ocio y transporte';'Restaurantes';'VARIABLES'
23/05/2015;23/05/2015;'BON AREA';-26,89 €;7.631,29 €;6975;-26,89;12.155,38 €;'sin fechas';23/05/2015;'BON';'Gastos_Compras';'Supermercado';'VARIABLES'
23/05/2015;23/05/2015;'CAFETERIA';-0,90 €;7.630,39 €;6976;-0,90;12.154,48 €;'sin fechas';23/05/2015;'CAFETERIA';'Gastos_Compras';'Supermercado';'VARIABLES'
23/05/2015;23/05/2015;'REINT.CAJERO';-100,00 €;7.530,39 €;6977;-100,00;12.054,48 €;'sin fechas';23/05/2015;'REINTCAJERO';'Gastos_Gastos varios';'Efectivo';'VARIABLES'
23/05/2015;23/05/2015;'VIENA';-5,40 €;7.524,99 €;6978;-5,40;12.049,08 €;'sin fechas';23/05/2015;'VIENA';'Gastos_Ocio y transporte';'Restaurantes';'VARIABLES'
23/05/2015;23/05/2015;'WWW.JUST-EAT.ES';-25,60 €;7.499,39 €;6979;-25,60;12.023,48 €;'sin fechas';23/05/2015;'WWWJUSTEATES';'Gastos_Ocio y transporte';'Restaurantes';'VARIABLES'
24/05/2015;24/05/2015;'FRUITES I VERDURES';-5,00 €;7.494,39 €;6980;-5,00;12.018,48 €;'sin fechas';24/05/2015;'FRUITES';'Gastos_Compras';'Supermercado';'VARIABLES'
24/05/2015;24/05/2015;'FRANKFURT LES LLETRES';-2,50 €;7.491,89 €;6981;-2,50;12.015,98 €;'sin fechas';24/05/2015;'FRANKFURT';'Gastos_Ocio y transporte';'Restaurantes';'VARIABLES'
24/05/2015;24/05/2015;'FRANKFURT LES LLETRES';-2,50 €;7.489,39 €;6982;-2,50;12.013,48 €;'sin fechas';24/05/2015;'FRANKFURT';'Gastos_Ocio y transporte';'Restaurantes';'VARIABLES'
24/05/2015;24/05/2015;'PERRUQUERIA';-10,00 €;7.479,39 €;6983;-10,00;12.003,48 €;'sin fechas';24/05/2015;'PERRUQUERIA';'Gastos_Salud, saber y deporte';'Belleza';'VARIABLES'
24/05/2015;24/05/2015;'PERRUQUERIA';-12,90 €;7.466,49 €;6984;-12,90;11.990,58 €;'sin fechas';24/05/2015;'PERRUQUERIA';'Gastos_Salud, saber y deporte';'Belleza';'VARIABLES'
24/05/2015;24/05/2015;'VIENA';-1,55 €;7.464,94 €;6985;-1,55;11.989,03 €;'sin fechas';24/05/2015;'VIENA';'Gastos_Ocio y transporte';'Restaurantes';'VARIABLES'
25/05/2015;25/05/2015;'FRANKFURT LES LLETRES';-6,95 €;7.457,99 €;6986;-6,95;11.982,08 €;'sin fechas';25/05/2015;'FRANKFURT';'Gastos_Ocio y transporte';'Restaurantes';'VARIABLES'
25/05/2015;25/05/2015;'MERCADONA';-134,66 €;7.323,33 €;6987;-134,66;11.847,42 €;'sin fechas';25/05/2015;'MERCADONA';'Gastos_Compras';'Supermercado';'VARIABLES'
25/05/2015;25/05/2015;'VIENA';-6,95 €;7.316,38 €;6988;-6,95;11.840,47 €;'sin fechas';25/05/2015;'VIENA';'Gastos_Ocio y transporte';'Restaurantes';'VARIABLES'
26/05/2015;26/05/2015;'PERRUQUERIA';-60,00 €;7.256,38 €;6989;-60,00;11.780,47 €;'sin fechas';26/05/2015;'PERRUQUERIA';'Gastos_Salud, saber y deporte';'Belleza';'VARIABLES'
28/05/2015;28/05/2015;'FOMENT DE TERRASSA, SA';1.764,71 €;9.021,09 €;6990;1.764,71;13.545,18 €;'sin fechas';28/05/2015;'FOMENT';'Ingresos';'Nomina';'FIJO'
28/05/2015;28/05/2015;'INFORMACIO I TECNOLOGIA DE CAT';1.585,88 €;10.606,97 €;6991;1.585,88;15.131,06 €;'sin fechas';28/05/2015;'INFORMACIO';'Ingresos';'Nomina';'FIJO'
28/05/2015;28/05/2015;'FRANKFURT LES LLETRES';-2,50 €;10.604,47 €;6992;-2,50;15.128,56 €;'sin fechas';28/05/2015;'FRANKFURT';'Gastos_Ocio y transporte';'Restaurantes';'VARIABLES'
29/05/2015;29/05/2015;'FARMACIA';-19,80 €;10.584,67 €;6993;-19,80;15.108,76 €;'sin fechas';29/05/2015;'FARMACIA';'Gastos_Salud, saber y deporte';'Farmacia';'VARIABLES'
29/05/2015;29/05/2015;'FRANKFURT LES LLETRES';-2,50 €;10.582,17 €;6994;-2,50;15.106,26 €;'sin fechas';29/05/2015;'FRANKFURT';'Gastos_Ocio y transporte';'Restaurantes';'VARIABLES'
29/05/2015;29/05/2015;'TRANSPORTS MUNICIP';-18,00 €;10.564,17 €;6995;-18,00;15.088,26 €;'sin fechas';29/05/2015;'TRANSPORTS';'Gastos_Ocio y transporte';'Transporte';'VARIABLES'
29/05/2015;29/05/2015;'VIENA';-7,85 €;10.556,32 €;6996;-7,85;15.080,41 €;'sin fechas';29/05/2015;'VIENA';'Gastos_Ocio y transporte';'Restaurantes';'VARIABLES'
30/05/2015;28/05/2015;'AUTOPISTAS';-1,39 €;10.554,93 €;6997;-1,39;15.079,02 €;'sin fechas';28/05/2015;'AUTOPISTAS';'Gastos_Ocio y transporte';'Parking y peaje';'VARIABLES'
30/05/2015;28/05/2015;'AUTOPISTAS';-1,39 €;10.553,54 €;6998;-1,39;15.077,63 €;'sin fechas';28/05/2015;'AUTOPISTAS';'Gastos_Ocio y transporte';'Parking y peaje';'VARIABLES'
30/05/2015;30/05/2015;'CRACK';-9,94 €;10.543,60 €;6999;-9,94;15.067,69 €;'sin fechas';30/05/2015;'CRACK';'Gastos_Compras';'Otras compras';'VARIABLES'
30/05/2015;30/05/2015;'DECATHLON';-147,50 €;10.396,10 €;7000;-147,50;14.920,19 €;'sin fechas';30/05/2015;'DECATHLON';'Gastos_Compras';'Deportivo';'VARIABLES'
30/05/2015;30/05/2015;'H&M';-17,98 €;10.378,12 €;7001;-17,98;14.902,21 €;'sin fechas';30/05/2015;'HM';'Gastos_Compras';'Ropa';'VARIABLES'
30/05/2015;30/05/2015;'H&M';-28,96 €;10.349,16 €;7002;-28,96;14.873,25 €;'sin fechas';30/05/2015;'HM';'Gastos_Compras';'Ropa';'VARIABLES'
30/05/2015;30/05/2015;'FRANKFURT LES LLETRES';-2,50 €;10.346,66 €;7003;-2,50;14.870,75 €;'sin fechas';30/05/2015;'FRANKFURT';'Gastos_Ocio y transporte';'Restaurantes';'VARIABLES'
30/05/2015;30/05/2015;'RESTAURANTES';-8,90 €;10.337,76 €;7004;-8,90;14.861,85 €;'sin fechas';30/05/2015;'RESTAURANTES';'Gastos_Ocio y transporte';'Restaurantes';'VARIABLES'
30/05/2015;30/05/2015;'RESTAURANTES';-41,65 €;10.296,11 €;7005;-41,65;14.820,20 €;'sin fechas';30/05/2015;'RESTAURANTES';'Gastos_Ocio y transporte';'Restaurantes';'VARIABLES'
30/05/2015;30/05/2015;'UNIO PAPERS';-42,19 €;10.253,92 €;7006;-42,19;14.778,01 €;'sin fechas';30/05/2015;'UNIO';'Gastos_Compras';'Libreria';'VARIABLES'
30/05/2015;30/05/2015;'VIENA';-5,40 €;10.248,52 €;7007;-5,40;14.772,61 €;'sin fechas';30/05/2015;'VIENA';'Gastos_Ocio y transporte';'Restaurantes';'VARIABLES'
30/05/2015;30/05/2015;'VIENA';-14,55 €;10.233,97 €;7008;-14,55;14.758,06 €;'sin fechas';30/05/2015;'VIENA';'Gastos_Ocio y transporte';'Restaurantes';'VARIABLES'
31/05/2015;31/05/2015;'AUTOPISTAS';-3,72 €;10.230,25 €;7009;-3,72;14.754,34 €;'sin fechas';31/05/2015;'AUTOPISTAS';'Gastos_Ocio y transporte';'Parking y peaje';'VARIABLES'
31/05/2015;31/05/2015;'AUTOPISTAS';-3,72 €;10.226,53 €;7010;-3,72;14.750,62 €;'sin fechas';31/05/2015;'AUTOPISTAS';'Gastos_Ocio y transporte';'Parking y peaje';'VARIABLES'
31/05/2015;31/05/2015;'CARREFOUR-[comida]';-9,55 €;10.216,98 €;7011;-9,55;14.741,07 €;'sin fechas';31/05/2015;'CARREFOURCOMIDA';'Gastos_Compras';'Supermercado';'VARIABLES'
31/05/2015;31/05/2015;'FRANKFURT LES LLETRES';-4,65 €;10.212,33 €;7012;-4,65;14.736,42 €;'sin fechas';31/05/2015;'FRANKFURT';'Gastos_Ocio y transporte';'Restaurantes';'VARIABLES'
31/05/2015;31/05/2015;'FRANKFURT LES LLETRES';-4,85 €;10.207,48 €;7013;-4,85;14.731,57 €;'sin fechas';31/05/2015;'FRANKFURT';'Gastos_Ocio y transporte';'Restaurantes';'VARIABLES'
31/05/2015;31/05/2015;'FRANKFURT LES LLETRES';-5,60 €;10.201,88 €;7014;-5,60;14.725,97 €;'sin fechas';31/05/2015;'FRANKFURT';'Gastos_Ocio y transporte';'Restaurantes';'VARIABLES'
31/05/2015;31/05/2015;'REC. 6061.9600001223';-542,33 €;9.659,55 €;7015;-542,33;14.183,64 €;'sin fechas';31/05/2015;'REC';'Gastos_Banco y organismos';'Hipoteca';'FIJO'
31/05/2015;31/05/2015;'VIENA';-6,35 €;9.653,20 €;7016;-6,35;14.177,29 €;'sin fechas';31/05/2015;'VIENA';'Gastos_Ocio y transporte';'Restaurantes';'VARIABLES'
31/05/2015;31/05/2015;'WWW.JUST-EAT.ES';-22,20 €;9.631,00 €;7017;-22,20;14.155,09 €;'sin fechas';31/05/2015;'WWWJUSTEATES';'Gastos_Ocio y transporte';'Restaurantes';'VARIABLES'
01/06/2015;30/05/2015;'ESCOLA BRESSOL EINA';-477,70 €;9.153,30 €;7019;-477,70;13.677,39 €;'sin fechas';30/05/2015;'ESCOLA';'Gastos_Salud, saber y deporte';'Estudios';'VARIABLES'
01/06/2015;01/06/2015;'ESCOLA DE MUSICA';-90,00 €;9.063,30 €;7020;-90,00;13.587,39 €;'sin fechas';01/06/2015;'ESCOLA';'Gastos_Salud, saber y deporte';'Estudios';'VARIABLES'
01/06/2015;01/06/2015;'FRANKFURT LES LLETRES';-1,65 €;9.061,65 €;7021;-1,65;13.585,74 €;'sin fechas';01/06/2015;'FRANKFURT';'Gastos_Ocio y transporte';'Restaurantes';'VARIABLES'
01/06/2015;01/06/2015;'VIENA';-5,40 €;9.056,25 €;7022;-5,40;13.580,34 €;'sin fechas';01/06/2015;'VIENA';'Gastos_Ocio y transporte';'Restaurantes';'VARIABLES'
02/06/2015;02/06/2015;'MERCADONA';-23,45 €;9.032,80 €;7023;-23,45;13.556,89 €;'sin fechas';02/06/2015;'MERCADONA';'Gastos_Compras';'Supermercado';'VARIABLES'
02/06/2015;02/06/2015;'REINT.CAJERO';-40,00 €;8.992,80 €;7024;-40,00;13.516,89 €;'sin fechas';02/06/2015;'REINTCAJERO';'Gastos_Gastos varios';'Efectivo';'VARIABLES'
02/06/2015;02/06/2015;'VIRGIN ACTIV';-55,95 €;8.936,85 €;7025;-55,95;13.460,94 €;'sin fechas';02/06/2015;'VIRGIN';'Gastos_Salud, saber y deporte';'Deportes';'VARIABLES'
02/06/2015;02/06/2015;'VIRGIN ACTIV';-55,95 €;8.880,90 €;7026;-55,95;13.404,99 €;'sin fechas';02/06/2015;'VIRGIN';'Gastos_Salud, saber y deporte';'Deportes';'VARIABLES'
03/06/2015;03/06/2015;'WWW.JUST-EAT.ES';-9,00 €;8.871,90 €;7027;-9,00;13.395,99 €;'sin fechas';03/06/2015;'WWWJUSTEATES';'Gastos_Ocio y transporte';'Restaurantes';'VARIABLES'
04/06/2015;04/06/2015;'ADESLAS';-111,00 €;8.760,90 €;7028;-111,00;13.284,99 €;'sin fechas';04/06/2015;'ADESLAS';'Gastos_Salud, saber y deporte';'Medico';'VARIABLES'
04/06/2015;04/06/2015;'BON AREA';-14,81 €;8.746,09 €;7029;-14,81;13.270,18 €;'sin fechas';04/06/2015;'BON';'Gastos_Compras';'Supermercado';'VARIABLES'
04/06/2015;04/06/2015;'FRUITES I VERDURES';-6,28 €;8.739,81 €;7030;-6,28;13.263,90 €;'sin fechas';04/06/2015;'FRUITES';'Gastos_Compras';'Supermercado';'VARIABLES'
04/06/2015;04/06/2015;'MERCACHINA';-19,85 €;8.719,96 €;7031;-19,85;13.244,05 €;'sin fechas';04/06/2015;'MERCACHINA';'Gastos_Compras';'Otras compras';'VARIABLES'
04/06/2015;31/05/2015;'PARKING';-6,10 €;8.713,86 €;7032;-6,10;13.237,95 €;'sin fechas';31/05/2015;'PARKING';'Gastos_Ocio y transporte';'Parking y peaje';'VARIABLES'
05/06/2015;02/06/2015;'AUTOPISTAS';-1,39 €;8.712,47 €;7033;-1,39;13.236,56 €;'sin fechas';02/06/2015;'AUTOPISTAS';'Gastos_Ocio y transporte';'Parking y peaje';'VARIABLES'
05/06/2015;02/06/2015;'AUTOPISTAS';-1,39 €;8.711,08 €;7034;-1,39;13.235,17 €;'sin fechas';02/06/2015;'AUTOPISTAS';'Gastos_Ocio y transporte';'Parking y peaje';'VARIABLES'
05/06/2015;03/06/2015;'AUTOPISTAS';-1,39 €;8.709,69 €;7035;-1,39;13.233,78 €;'sin fechas';03/06/2015;'AUTOPISTAS';'Gastos_Ocio y transporte';'Parking y peaje';'VARIABLES'
05/06/2015;03/06/2015;'AUTOPISTAS';-1,39 €;8.708,30 €;7036;-1,39;13.232,39 €;'sin fechas';03/06/2015;'AUTOPISTAS';'Gastos_Ocio y transporte';'Parking y peaje';'VARIABLES'
05/06/2015;03/06/2015;'AUTOPISTAS';-1,39 €;8.706,91 €;7037;-1,39;13.231,00 €;'sin fechas';03/06/2015;'AUTOPISTAS';'Gastos_Ocio y transporte';'Parking y peaje';'VARIABLES'
05/06/2015;03/06/2015;'AUTOPISTAS';-1,39 €;8.705,52 €;7038;-1,39;13.229,61 €;'sin fechas';03/06/2015;'AUTOPISTAS';'Gastos_Ocio y transporte';'Parking y peaje';'VARIABLES'
05/06/2015;05/06/2015;'CAFETERIA';-2,10 €;8.703,42 €;7039;-2,10;13.227,51 €;'sin fechas';05/06/2015;'CAFETERIA';'Gastos_Compras';'Supermercado';'VARIABLES'
05/06/2015;05/06/2015;'CAFETERIA';-3,60 €;8.699,82 €;7040;-3,60;13.223,91 €;'sin fechas';05/06/2015;'CAFETERIA';'Gastos_Compras';'Supermercado';'VARIABLES'
05/06/2015;05/06/2015;'RESTAURANTES';-68,40 €;8.631,42 €;7041;-68,40;13.155,51 €;'sin fechas';05/06/2015;'RESTAURANTES';'Gastos_Ocio y transporte';'Restaurantes';'VARIABLES'
06/06/2015;04/06/2015;'AUTOPISTAS';-1,32 €;8.630,10 €;7042;-1,32;13.154,19 €;'sin fechas';04/06/2015;'AUTOPISTAS';'Gastos_Ocio y transporte';'Parking y peaje';'VARIABLES'
06/06/2015;04/06/2015;'AUTOPISTAS';-1,39 €;8.628,71 €;7043;-1,39;13.152,80 €;'sin fechas';04/06/2015;'AUTOPISTAS';'Gastos_Ocio y transporte';'Parking y peaje';'VARIABLES'
06/06/2015;06/06/2015;'AUTOPISTAS';-4,19 €;8.624,52 €;7044;-4,19;13.148,61 €;'sin fechas';06/06/2015;'AUTOPISTAS';'Gastos_Ocio y transporte';'Parking y peaje';'VARIABLES'
06/06/2015;06/06/2015;'CAFETERIA';-3,00 €;8.621,52 €;7045;-3,00;13.145,61 €;'sin fechas';06/06/2015;'CAFETERIA';'Gastos_Compras';'Supermercado';'VARIABLES'
06/06/2015;06/06/2015;'DECATHLON';-24,90 €;8.596,62 €;7046;-24,90;13.120,71 €;'sin fechas';06/06/2015;'DECATHLON';'Gastos_Compras';'Deportivo';'VARIABLES'
06/06/2015;06/06/2015;'GASOLINERA';-52,42 €;8.544,20 €;7047;-52,42;13.068,29 €;'sin fechas';06/06/2015;'GASOLINERA';'Gastos_Ocio y transporte';'Gasolina';'VARIABLES'
06/06/2015;06/06/2015;'VIENA';-6,25 €;8.537,95 €;7048;-6,25;13.062,04 €;'sin fechas';06/06/2015;'VIENA';'Gastos_Ocio y transporte';'Restaurantes';'VARIABLES'
07/06/2015;07/06/2015;'CAFETERIA';-2,90 €;8.535,05 €;7049;-2,90;13.059,14 €;'sin fechas';07/06/2015;'CAFETERIA';'Gastos_Compras';'Supermercado';'VARIABLES'
07/06/2015;07/06/2015;'FRANKFURT LES LLETRES';-11,15 €;8.523,90 €;7050;-11,15;13.047,99 €;'sin fechas';07/06/2015;'FRANKFURT';'Gastos_Ocio y transporte';'Restaurantes';'VARIABLES'
07/06/2015;07/06/2015;'RESTAURANTES';-35,26 €;8.488,64 €;7051;-35,26;13.012,73 €;'sin fechas';07/06/2015;'RESTAURANTES';'Gastos_Ocio y transporte';'Restaurantes';'VARIABLES'
07/06/2015;07/06/2015;'VIENA';-7,35 €;8.481,29 €;7052;-7,35;13.005,38 €;'sin fechas';07/06/2015;'VIENA';'Gastos_Ocio y transporte';'Restaurantes';'VARIABLES'
08/06/2015;08/06/2015;'BLITZ';-72,50 €;8.408,79 €;7053;-72,50;12.932,88 €;'sin fechas';08/06/2015;'BLITZ';'Gastos_Vivienda y vehiculo';'Alquiler Parking';'FIJO'
08/06/2015;08/06/2015;'CAFETERIA';-2,70 €;8.406,09 €;7054;-2,70;12.930,18 €;'sin fechas';08/06/2015;'CAFETERIA';'Gastos_Compras';'Supermercado';'VARIABLES'
08/06/2015;08/06/2015;'CAPRABO';-28,25 €;8.377,84 €;7055;-28,25;12.901,93 €;'sin fechas';08/06/2015;'CAPRABO';'Gastos_Compras';'Supermercado';'VARIABLES'
08/06/2015;08/06/2015;'FRANKFURT LES LLETRES';-2,50 €;8.375,34 €;7056;-2,50;12.899,43 €;'sin fechas';08/06/2015;'FRANKFURT';'Gastos_Ocio y transporte';'Restaurantes';'VARIABLES'
08/06/2015;08/06/2015;'RESTAURANTES';-6,70 €;8.368,64 €;7057;-6,70;12.892,73 €;'sin fechas';08/06/2015;'RESTAURANTES';'Gastos_Ocio y transporte';'Restaurantes';'VARIABLES'
09/06/2015;05/06/2015;'AUTOPISTAS';-1,32 €;8.367,32 €;7058;-1,32;12.891,41 €;'sin fechas';05/06/2015;'AUTOPISTAS';'Gastos_Ocio y transporte';'Parking y peaje';'VARIABLES'
09/06/2015;05/06/2015;'AUTOPISTAS';-1,32 €;8.366,00 €;7059;-1,32;12.890,09 €;'sin fechas';05/06/2015;'AUTOPISTAS';'Gastos_Ocio y transporte';'Parking y peaje';'VARIABLES'
09/06/2015;09/06/2015;'CARREFOUR-[comida]';-37,00 €;8.329,00 €;7060;-37,00;12.853,09 €;'sin fechas';09/06/2015;'CARREFOURCOMIDA';'Gastos_Compras';'Supermercado';'VARIABLES'
09/06/2015;09/06/2015;'DECATHLON';-18,89 €;8.310,11 €;7061;-18,89;12.834,20 €;'sin fechas';09/06/2015;'DECATHLON';'Gastos_Compras';'Deportivo';'VARIABLES'
09/06/2015;09/06/2015;'H&M';-38,45 €;8.271,66 €;7062;-38,45;12.795,75 €;'sin fechas';09/06/2015;'HM';'Gastos_Compras';'Ropa';'VARIABLES'
09/06/2015;09/06/2015;'RESTAURANTES';-116,45 €;8.155,21 €;7063;-116,45;12.679,30 €;'sin fechas';09/06/2015;'RESTAURANTES';'Gastos_Ocio y transporte';'Restaurantes';'VARIABLES'
10/06/2015;08/06/2015;'AUTOPISTAS';-3,72 €;8.151,49 €;7064;-3,72;12.675,58 €;'sin fechas';08/06/2015;'AUTOPISTAS';'Gastos_Ocio y transporte';'Parking y peaje';'VARIABLES'
10/06/2015;08/06/2015;'AUTOPISTAS';-1,32 €;8.150,17 €;7065;-1,32;12.674,26 €;'sin fechas';08/06/2015;'AUTOPISTAS';'Gastos_Ocio y transporte';'Parking y peaje';'VARIABLES'
10/06/2015;08/06/2015;'AUTOPISTAS';-1,32 €;8.148,85 €;7066;-1,32;12.672,94 €;'sin fechas';08/06/2015;'AUTOPISTAS';'Gastos_Ocio y transporte';'Parking y peaje';'VARIABLES'
10/06/2015;10/06/2015;'SALA BADRINAS - MENJADOR';-88,95 €;8.059,90 €;7067;-88,95;12.583,99 €;'sin fechas';10/06/2015;'SALA';'Gastos_Salud, saber y deporte';'Estudios';'VARIABLES'
11/06/2015;09/06/2015;'AUTOPISTAS';-1,25 €;8.058,65 €;7068;-1,25;12.582,74 €;'sin fechas';09/06/2015;'AUTOPISTAS';'Gastos_Ocio y transporte';'Parking y peaje';'VARIABLES'
11/06/2015;09/06/2015;'AUTOPISTAS';-1,39 €;8.057,26 €;7069;-1,39;12.581,35 €;'sin fechas';09/06/2015;'AUTOPISTAS';'Gastos_Ocio y transporte';'Parking y peaje';'VARIABLES'
11/06/2015;11/06/2015;'CAFETERIA';-4,10 €;8.053,16 €;7070;-4,10;12.577,25 €;'sin fechas';11/06/2015;'CAFETERIA';'Gastos_Compras';'Supermercado';'VARIABLES'
11/06/2015;11/06/2015;'GAS NATURAL';-364,67 €;7.688,49 €;7071;-364,67;12.212,58 €;'sin fechas';11/06/2015;'GAS';'Gastos_Servicios tipicos';'Gas';'FIJO'
11/06/2015;11/06/2015;'MERCADONA';-27,14 €;7.661,35 €;7072;-27,14;12.185,44 €;'sin fechas';11/06/2015;'MERCADONA';'Gastos_Compras';'Supermercado';'VARIABLES'
11/06/2015;11/06/2015;'Regalos';-22,00 €;7.639,35 €;7073;-22,00;12.163,44 €;'sin fechas';11/06/2015;'REGALOS';'Gastos_Compras';'Regalos';'VARIABLES'
11/06/2015;11/06/2015;'REINT.CAJERO';-40,00 €;7.599,35 €;7074;-40,00;12.123,44 €;'sin fechas';11/06/2015;'REINTCAJERO';'Gastos_Gastos varios';'Efectivo';'VARIABLES'
12/06/2015;10/06/2015;'AUTOPISTAS';-1,25 €;7.598,10 €;7075;-1,25;12.122,19 €;'sin fechas';10/06/2015;'AUTOPISTAS';'Gastos_Ocio y transporte';'Parking y peaje';'VARIABLES'
12/06/2015;10/06/2015;'AUTOPISTAS';-1,25 €;7.596,85 €;7076;-1,25;12.120,94 €;'sin fechas';10/06/2015;'AUTOPISTAS';'Gastos_Ocio y transporte';'Parking y peaje';'VARIABLES'
12/06/2015;12/06/2015;'AUTOPISTAS';-4,19 €;7.592,66 €;7077;-4,19;12.116,75 €;'sin fechas';12/06/2015;'AUTOPISTAS';'Gastos_Ocio y transporte';'Parking y peaje';'VARIABLES'
12/06/2015;12/06/2015;'BON AREA';-12,50 €;7.580,16 €;7078;-12,50;12.104,25 €;'sin fechas';12/06/2015;'BON';'Gastos_Compras';'Supermercado';'VARIABLES'
12/06/2015;12/06/2015;'CAFETERIA';-3,60 €;7.576,56 €;7079;-3,60;12.100,65 €;'sin fechas';12/06/2015;'CAFETERIA';'Gastos_Compras';'Supermercado';'VARIABLES'
12/06/2015;11/06/2015;'SATSA PL. VELLA TERRASSA';-3,55 €;7.573,01 €;7080;-3,55;12.097,10 €;'sin fechas';11/06/2015;'SATSA';'Gastos_Ocio y transporte';'Parking y peaje';'VARIABLES'
13/06/2015;11/06/2015;'AUTOPISTAS';-1,25 €;7.571,76 €;7081;-1,25;12.095,85 €;'sin fechas';11/06/2015;'AUTOPISTAS';'Gastos_Ocio y transporte';'Parking y peaje';'VARIABLES'
13/06/2015;11/06/2015;'AUTOPISTAS';-1,25 €;7.570,51 €;7082;-1,25;12.094,60 €;'sin fechas';11/06/2015;'AUTOPISTAS';'Gastos_Ocio y transporte';'Parking y peaje';'VARIABLES'
13/06/2015;13/06/2015;'CAFETERIA';-2,60 €;7.567,91 €;7083;-2,60;12.092,00 €;'sin fechas';13/06/2015;'CAFETERIA';'Gastos_Compras';'Supermercado';'VARIABLES'
13/06/2015;13/06/2015;'FRANKFURT LES LLETRES';-5,00 €;7.562,91 €;7084;-5,00;12.087,00 €;'sin fechas';13/06/2015;'FRANKFURT';'Gastos_Ocio y transporte';'Restaurantes';'VARIABLES'
13/06/2015;12/06/2015;'SATSA PL. VELLA TERRASSA';-2,45 €;7.560,46 €;7085;-2,45;12.084,55 €;'sin fechas';12/06/2015;'SATSA';'Gastos_Ocio y transporte';'Parking y peaje';'VARIABLES'
13/06/2015;13/06/2015;'VIENA';-19,20 €;7.541,26 €;7086;-19,20;12.065,35 €;'sin fechas';13/06/2015;'VIENA';'Gastos_Ocio y transporte';'Restaurantes';'VARIABLES'
14/06/2015;14/06/2015;'AUTOPISTAS';-3,72 €;7.537,54 €;7087;-3,72;12.061,63 €;'sin fechas';14/06/2015;'AUTOPISTAS';'Gastos_Ocio y transporte';'Parking y peaje';'VARIABLES'
14/06/2015;14/06/2015;'CAFETERIA';-2,70 €;7.534,84 €;7088;-2,70;12.058,93 €;'sin fechas';14/06/2015;'CAFETERIA';'Gastos_Compras';'Supermercado';'VARIABLES'
14/06/2015;14/06/2015;'HOGAR&OTROS';-8,20 €;7.526,64 €;7089;-8,20;12.050,73 €;'sin fechas';14/06/2015;'HOGAROTROS';'Gastos_Vivienda y vehiculo';'Otros vivienda';'VARIABLES'
14/06/2015;14/06/2015;'FRANKFURT LES LLETRES';-2,50 €;7.524,14 €;7090;-2,50;12.048,23 €;'sin fechas';14/06/2015;'FRANKFURT';'Gastos_Ocio y transporte';'Restaurantes';'VARIABLES'
14/06/2015;14/06/2015;'RESTAURANTES';-15,80 €;7.508,34 €;7091;-15,80;12.032,43 €;'sin fechas';14/06/2015;'RESTAURANTES';'Gastos_Ocio y transporte';'Restaurantes';'VARIABLES'
14/06/2015;13/06/2015;'SATSA PL. VELLA TERRASSA';-4,10 €;7.504,24 €;7092;-4,10;12.028,33 €;'sin fechas';13/06/2015;'SATSA';'Gastos_Ocio y transporte';'Parking y peaje';'VARIABLES'
15/06/2015;15/06/2015;'AUTOPISTAS';-1,39 €;7.502,85 €;7093;-1,39;12.026,94 €;'sin fechas';15/06/2015;'AUTOPISTAS';'Gastos_Ocio y transporte';'Parking y peaje';'VARIABLES'
15/06/2015;15/06/2015;'CAFETERIA';-3,65 €;7.499,20 €;7094;-3,65;12.023,29 €;'sin fechas';15/06/2015;'CAFETERIA';'Gastos_Compras';'Supermercado';'VARIABLES'
15/06/2015;15/06/2015;'GASOLINERA';-34,47 €;7.464,73 €;7095;-34,47;11.988,82 €;'sin fechas';15/06/2015;'GASOLINERA';'Gastos_Ocio y transporte';'Gasolina';'VARIABLES'
15/06/2015;14/06/2015;'SATSA PL. VELLA TERRASSA';-2,90 €;7.461,83 €;7096;-2,90;11.985,92 €;'sin fechas';14/06/2015;'SATSA';'Gastos_Ocio y transporte';'Parking y peaje';'VARIABLES'
15/06/2015;15/06/2015;'SATSA PL. VELLA TERRASSA';-2,40 €;7.459,43 €;7097;-2,40;11.983,52 €;'sin fechas';15/06/2015;'SATSA';'Gastos_Ocio y transporte';'Parking y peaje';'VARIABLES'
15/06/2015;15/06/2015;'TABASA VALLVI S. C:2T';-4,19 €;7.455,24 €;7098;-4,19;11.979,33 €;'sin fechas';15/06/2015;'TABASA';'Gastos_Ocio y transporte';'Parking y peaje';'VARIABLES'
16/06/2015;12/06/2015;'AUTOPISTAS';-1,25 €;7.453,99 €;7099;-1,25;11.978,08 €;'sin fechas';12/06/2015;'AUTOPISTAS';'Gastos_Ocio y transporte';'Parking y peaje';'VARIABLES'
16/06/2015;12/06/2015;'AUTOPISTAS';-1,25 €;7.452,74 €;7100;-1,25;11.976,83 €;'sin fechas';12/06/2015;'AUTOPISTAS';'Gastos_Ocio y transporte';'Parking y peaje';'VARIABLES'
16/06/2015;14/06/2015;'AUTOPISTAS';-2,53 €;7.450,21 €;7101;-2,53;11.974,30 €;'sin fechas';14/06/2015;'AUTOPISTAS';'Gastos_Ocio y transporte';'Parking y peaje';'VARIABLES'
16/06/2015;16/06/2015;'AUTOPISTAS';-1,39 €;7.448,82 €;7102;-1,39;11.972,91 €;'sin fechas';16/06/2015;'AUTOPISTAS';'Gastos_Ocio y transporte';'Parking y peaje';'VARIABLES'
16/06/2015;16/06/2015;'AUTOPISTAS';-1,39 €;7.447,43 €;7103;-1,39;11.971,52 €;'sin fechas';16/06/2015;'AUTOPISTAS';'Gastos_Ocio y transporte';'Parking y peaje';'VARIABLES'
16/06/2015;16/06/2015;'CCM VIDA Y P SEGURO PRESTAMO';-22,86 €;7.424,57 €;7104;-22,86;11.948,66 €;'sin fechas';16/06/2015;'CCM';'Gastos_Seguros';'Seguro vida';'FIJO'
16/06/2015;16/06/2015;'CCM VIDA Y PENSIO 000000493358';-17,93 €;7.406,64 €;7105;-17,93;11.930,73 €;'sin fechas';16/06/2015;'CCM';'Gastos_Seguros';'Seguro vida';'FIJO'
16/06/2015;16/06/2015;'RESTAURANTES';-67,20 €;7.339,44 €;7106;-67,20;11.863,53 €;'sin fechas';16/06/2015;'RESTAURANTES';'Gastos_Ocio y transporte';'Restaurantes';'VARIABLES'
17/06/2015;15/06/2015;'AUTOPISTAS';-1,25 €;7.338,19 €;7107;-1,25;11.862,28 €;'sin fechas';15/06/2015;'AUTOPISTAS';'Gastos_Ocio y transporte';'Parking y peaje';'VARIABLES'
17/06/2015;17/06/2015;'AUTOPISTAS';-2,40 €;7.335,79 €;7108;-2,40;11.859,88 €;'sin fechas';17/06/2015;'AUTOPISTAS';'Gastos_Ocio y transporte';'Parking y peaje';'VARIABLES'
17/06/2015;17/06/2015;'AUTOPISTAS';-1,39 €;7.334,40 €;7109;-1,39;11.858,49 €;'sin fechas';17/06/2015;'AUTOPISTAS';'Gastos_Ocio y transporte';'Parking y peaje';'VARIABLES'
17/06/2015;17/06/2015;'AUTOPISTAS';-1,39 €;7.333,01 €;7110;-1,39;11.857,10 €;'sin fechas';17/06/2015;'AUTOPISTAS';'Gastos_Ocio y transporte';'Parking y peaje';'VARIABLES'
17/06/2015;17/06/2015;'HOGAR&OTROS';-8,40 €;7.324,61 €;7111;-8,40;11.848,70 €;'sin fechas';17/06/2015;'HOGAROTROS';'Gastos_Vivienda y vehiculo';'Otros vivienda';'VARIABLES'
17/06/2015;17/06/2015;'FRANKFURT LES LLETRES';-27,00 €;7.297,61 €;7112;-27,00;11.821,70 €;'sin fechas';17/06/2015;'FRANKFURT';'Gastos_Ocio y transporte';'Restaurantes';'VARIABLES'
17/06/2015;17/06/2015;'MINA PUBLICA AIGUES T.01A75789';-38,64 €;7.258,97 €;7113;-38,64;11.783,06 €;'sin fechas';17/06/2015;'MINA';'Gastos_Servicios tipicos';'Agua';'FIJO'
17/06/2015;17/06/2015;'ONO';-132,16 €;7.126,81 €;7114;-132,16;11.650,90 €;'sin fechas';17/06/2015;'ONO';'Gastos_Servicios tipicos';'Telecomunicaciones';'FIJO'
17/06/2015;17/06/2015;'REINT.CAJERO';-20,00 €;7.106,81 €;7115;-20,00;11.630,90 €;'sin fechas';17/06/2015;'REINTCAJERO';'Gastos_Gastos varios';'Efectivo';'VARIABLES'
18/06/2015;18/06/2015;'AUTOPISTAS';-1,32 €;7.105,49 €;7116;-1,32;11.629,58 €;'sin fechas';18/06/2015;'AUTOPISTAS';'Gastos_Ocio y transporte';'Parking y peaje';'VARIABLES'
18/06/2015;18/06/2015;'AUTOPISTAS';-1,39 €;7.104,10 €;7117;-1,39;11.628,19 €;'sin fechas';18/06/2015;'AUTOPISTAS';'Gastos_Ocio y transporte';'Parking y peaje';'VARIABLES'
18/06/2015;18/06/2015;'CAFETERIA';-4,50 €;7.099,60 €;7118;-4,50;11.623,69 €;'sin fechas';18/06/2015;'CAFETERIA';'Gastos_Compras';'Supermercado';'VARIABLES'
18/06/2015;18/06/2015;'CAFETERIA';-2,15 €;7.097,45 €;7119;-2,15;11.621,54 €;'sin fechas';18/06/2015;'CAFETERIA';'Gastos_Compras';'Supermercado';'VARIABLES'
18/06/2015;18/06/2015;'GASOLINERA';-47,51 €;7.049,94 €;7120;-47,51;11.574,03 €;'sin fechas';18/06/2015;'GASOLINERA';'Gastos_Ocio y transporte';'Gasolina';'VARIABLES'
18/06/2015;18/06/2015;'FRANKFURT LES LLETRES';-2,50 €;7.047,44 €;7121;-2,50;11.571,53 €;'sin fechas';18/06/2015;'FRANKFURT';'Gastos_Ocio y transporte';'Restaurantes';'VARIABLES'
18/06/2015;18/06/2015;'ONO';-140,12 €;6.907,32 €;7122;-140,12;11.431,41 €;'sin fechas';18/06/2015;'ONO';'Gastos_Servicios tipicos';'Telecomunicaciones';'FIJO'
18/06/2015;18/06/2015;'TABASA VALLVI S. C:2T';-4,19 €;6.903,13 €;7123;-4,19;11.427,22 €;'sin fechas';18/06/2015;'TABASA';'Gastos_Ocio y transporte';'Parking y peaje';'VARIABLES'
18/06/2015;18/06/2015;'VIENA';-12,80 €;6.890,33 €;7124;-12,80;11.414,42 €;'sin fechas';18/06/2015;'VIENA';'Gastos_Ocio y transporte';'Restaurantes';'VARIABLES'
18/06/2015;18/06/2015;'VIENA';-5,75 €;6.884,58 €;7125;-5,75;11.408,67 €;'sin fechas';18/06/2015;'VIENA';'Gastos_Ocio y transporte';'Restaurantes';'VARIABLES'
19/06/2015;19/06/2015;'BON AREA';-23,12 €;6.861,46 €;7126;-23,12;11.385,55 €;'sin fechas';19/06/2015;'BON';'Gastos_Compras';'Supermercado';'VARIABLES'
19/06/2015;19/06/2015;'CAFETERIA';-3,65 €;6.857,81 €;7127;-3,65;11.381,90 €;'sin fechas';19/06/2015;'CAFETERIA';'Gastos_Compras';'Supermercado';'VARIABLES'
19/06/2015;19/06/2015;'FOMENT DE TERRASSA, SA';3.613,30 €;10.471,11 €;7128;3.613,30;14.995,20 €;'sin fechas';19/06/2015;'FOMENT';'Ingresos';'Nomina';'FIJO'
19/06/2015;19/06/2015;'FRANKFURT LES LLETRES';-4,35 €;10.466,76 €;7129;-4,35;14.990,85 €;'sin fechas';19/06/2015;'FRANKFURT';'Gastos_Ocio y transporte';'Restaurantes';'VARIABLES'
19/06/2015;19/06/2015;'MERCADONA';-145,41 €;10.321,35 €;7130;-145,41;14.845,44 €;'sin fechas';19/06/2015;'MERCADONA';'Gastos_Compras';'Supermercado';'VARIABLES'
19/06/2015;19/06/2015;'REINT.CAJERO';-100,00 €;10.221,35 €;7131;-100,00;14.745,44 €;'sin fechas';19/06/2015;'REINTCAJERO';'Gastos_Gastos varios';'Efectivo';'VARIABLES'
20/06/2015;20/06/2015;'CAFETERIA';-2,60 €;10.218,75 €;7132;-2,60;14.742,84 €;'sin fechas';20/06/2015;'CAFETERIA';'Gastos_Compras';'Supermercado';'VARIABLES'
20/06/2015;20/06/2015;'CARREFOUR-[comida]';-5,90 €;10.212,85 €;7133;-5,90;14.736,94 €;'sin fechas';20/06/2015;'CARREFOURCOMIDA';'Gastos_Compras';'Supermercado';'VARIABLES'
20/06/2015;20/06/2015;'CARREFOUR-[comida]';-13,95 €;10.198,90 €;7134;-13,95;14.722,99 €;'sin fechas';20/06/2015;'CARREFOURCOMIDA';'Gastos_Compras';'Supermercado';'VARIABLES'
20/06/2015;20/06/2015;'LIDL';-69,38 €;10.129,52 €;7135;-69,38;14.653,61 €;'sin fechas';20/06/2015;'LIDL';'Gastos_Compras';'Supermercado';'VARIABLES'
21/06/2015;21/06/2015;'BON AREA';-15,69 €;10.113,83 €;7136;-15,69;14.637,92 €;'sin fechas';21/06/2015;'BON';'Gastos_Compras';'Supermercado';'VARIABLES'
21/06/2015;21/06/2015;'CAFETERIA';-4,10 €;10.109,73 €;7137;-4,10;14.633,82 €;'sin fechas';21/06/2015;'CAFETERIA';'Gastos_Compras';'Supermercado';'VARIABLES'
22/06/2015;22/06/2015;'CAFETERIA';-3,50 €;10.106,23 €;7138;-3,50;14.630,32 €;'sin fechas';22/06/2015;'CAFETERIA';'Gastos_Compras';'Supermercado';'VARIABLES'
22/06/2015;22/06/2015;'CINES';-18,70 €;10.087,53 €;7139;-18,70;14.611,62 €;'sin fechas';22/06/2015;'CINES';'Gastos_Ocio y transporte';'Espectáculos';'VARIABLES'
22/06/2015;22/06/2015;'EL CORTE INGLES';-1.320,58 €;8.766,95 €;7140;-1.320,58;13.291,04 €;'sin fechas';22/06/2015;'CORTE';'Gastos_Compras';'Supermercado';'VARIABLES'
22/06/2015;22/06/2015;'FRANKFURT LES LLETRES';-2,50 €;8.764,45 €;7141;-2,50;13.288,54 €;'sin fechas';22/06/2015;'FRANKFURT';'Gastos_Ocio y transporte';'Restaurantes';'VARIABLES'
22/06/2015;22/06/2015;'VIENA';-12,05 €;8.752,40 €;7142;-12,05;13.276,49 €;'sin fechas';22/06/2015;'VIENA';'Gastos_Ocio y transporte';'Restaurantes';'VARIABLES'
23/06/2015;23/06/2015;'1ER ORGANITZ Jornada Intensiva';-46,00 €;8.706,40 €;7143;-46,00;13.230,49 €;'sin fechas';23/06/2015;'ORGANITZ';'Gastos_Salud, saber y deporte';'Estudios';'VARIABLES'
23/06/2015;23/06/2015;'TACISA';-75,12 €;8.631,28 €;7144;-75,12;13.155,37 €;'sin fechas';23/06/2015;'TACISA';'Gastos_Compras';'Supermercado';'VARIABLES'
24/06/2015;19/06/2015;'AUTOPISTAS';-1,25 €;8.630,03 €;7145;-1,25;13.154,12 €;'sin fechas';19/06/2015;'AUTOPISTAS';'Gastos_Ocio y transporte';'Parking y peaje';'VARIABLES'
24/06/2015;19/06/2015;'AUTOPISTAS';-1,25 €;8.628,78 €;7146;-1,25;13.152,87 €;'sin fechas';19/06/2015;'AUTOPISTAS';'Gastos_Ocio y transporte';'Parking y peaje';'VARIABLES'
25/06/2015;25/06/2015;'AKI 104 - TERRASSA';-18,89 €;8.609,89 €;7147;-18,89;13.133,98 €;'sin fechas';25/06/2015;'AKI';'Gastos_Vivienda y vehiculo';'Mnto. hogar';'VARIABLES'
25/06/2015;25/06/2015;'HOGAR&OTROS';-23,75 €;8.586,14 €;7148;-23,75;13.110,23 €;'sin fechas';25/06/2015;'HOGAROTROS';'Gastos_Vivienda y vehiculo';'Otros vivienda';'VARIABLES'
25/06/2015;25/06/2015;'HOGAR&OTROS';-16,85 €;8.569,29 €;7149;-16,85;13.093,38 €;'sin fechas';25/06/2015;'HOGAROTROS';'Gastos_Vivienda y vehiculo';'Otros vivienda';'VARIABLES'
25/06/2015;25/06/2015;'LIDL';-19,43 €;8.549,86 €;7150;-19,43;13.073,95 €;'sin fechas';25/06/2015;'LIDL';'Gastos_Compras';'Supermercado';'VARIABLES'
25/06/2015;25/06/2015;'RESTAURANTES';-30,50 €;8.519,36 €;7151;-30,50;13.043,45 €;'sin fechas';25/06/2015;'RESTAURANTES';'Gastos_Ocio y transporte';'Restaurantes';'VARIABLES'
25/06/2015;25/06/2015;'VIENA';-10,60 €;8.508,76 €;7152;-10,60;13.032,85 €;'sin fechas';25/06/2015;'VIENA';'Gastos_Ocio y transporte';'Restaurantes';'VARIABLES'
26/06/2015;23/06/2015;'AUTOPISTAS';-1,11 €;8.507,65 €;7153;-1,11;13.031,74 €;'sin fechas';23/06/2015;'AUTOPISTAS';'Gastos_Ocio y transporte';'Parking y peaje';'VARIABLES'
26/06/2015;23/06/2015;'AUTOPISTAS';-1,39 €;8.506,26 €;7154;-1,39;13.030,35 €;'sin fechas';23/06/2015;'AUTOPISTAS';'Gastos_Ocio y transporte';'Parking y peaje';'VARIABLES'
26/06/2015;26/06/2015;'PERRUQUERIA';-12,00 €;8.494,26 €;7155;-12,00;13.018,35 €;'sin fechas';26/06/2015;'PERRUQUERIA';'Gastos_Salud, saber y deporte';'Belleza';'VARIABLES'
26/06/2015;26/06/2015;'SEGUROS CATALANA';200,00 €;8.694,26 €;7156;200,00;13.218,35 €;'sin fechas';26/06/2015;'CATALANA';'Gastos_Ocio y transporte';'Parking y peaje';'VARIABLES'
27/06/2015;25/06/2015;'AUTOPISTAS';-1,11 €;8.693,15 €;7157;-1,11;13.217,24 €;'sin fechas';25/06/2015;'AUTOPISTAS';'Gastos_Ocio y transporte';'Parking y peaje';'VARIABLES'
27/06/2015;25/06/2015;'AUTOPISTAS';-1,11 €;8.692,04 €;7158;-1,11;13.216,13 €;'sin fechas';25/06/2015;'AUTOPISTAS';'Gastos_Ocio y transporte';'Parking y peaje';'VARIABLES'
28/06/2015;28/06/2015;'BON AREA';-9,12 €;8.682,92 €;7159;-9,12;13.207,01 €;'sin fechas';28/06/2015;'BON';'Gastos_Compras';'Supermercado';'VARIABLES'
28/06/2015;28/06/2015;'CAFETERIA';-2,15 €;8.680,77 €;7160;-2,15;13.204,86 €;'sin fechas';28/06/2015;'CAFETERIA';'Gastos_Compras';'Supermercado';'VARIABLES'
28/06/2015;28/06/2015;'FRANKFURT LES LLETRES';-2,50 €;8.678,27 €;7161;-2,50;13.202,36 €;'sin fechas';28/06/2015;'FRANKFURT';'Gastos_Ocio y transporte';'Restaurantes';'VARIABLES'
28/06/2015;28/06/2015;'FRANKFURT LES LLETRES';-5,15 €;8.673,12 €;7162;-5,15;13.197,21 €;'sin fechas';28/06/2015;'FRANKFURT';'Gastos_Ocio y transporte';'Restaurantes';'VARIABLES'
28/06/2015;28/06/2015;'REINT.CAJERO';-100,00 €;8.573,12 €;7163;-100,00;13.097,21 €;'sin fechas';28/06/2015;'REINTCAJERO';'Gastos_Gastos varios';'Efectivo';'VARIABLES'
29/06/2015;29/06/2015;'CAFETERIA';-3,65 €;8.569,47 €;7164;-3,65;13.093,56 €;'sin fechas';29/06/2015;'CAFETERIA';'Gastos_Compras';'Supermercado';'VARIABLES'
29/06/2015;29/06/2015;'INFORMACIO I TECNOLOGIA DE CAT';1.586,23 €;10.155,70 €;7165;1.586,23;14.679,79 €;'sin fechas';29/06/2015;'INFORMACIO';'Ingresos';'Nomina';'FIJO'
29/06/2015;29/06/2015;'FRANKFURT LES LLETRES';-3,70 €;10.152,00 €;7166;-3,70;14.676,09 €;'sin fechas';29/06/2015;'FRANKFURT';'Gastos_Ocio y transporte';'Restaurantes';'VARIABLES'
30/06/2015;26/06/2015;'AUTOPISTAS';-1,11 €;10.150,89 €;7167;-1,11;14.674,98 €;'sin fechas';26/06/2015;'AUTOPISTAS';'Gastos_Ocio y transporte';'Parking y peaje';'VARIABLES'
30/06/2015;26/06/2015;'AUTOPISTAS';-1,11 €;10.149,78 €;7168;-1,11;14.673,87 €;'sin fechas';26/06/2015;'AUTOPISTAS';'Gastos_Ocio y transporte';'Parking y peaje';'VARIABLES'
30/06/2015;30/06/2015;'AUTOPISTAS';-1,39 €;10.148,39 €;7169;-1,39;14.672,48 €;'sin fechas';30/06/2015;'AUTOPISTAS';'Gastos_Ocio y transporte';'Parking y peaje';'VARIABLES'
30/06/2015;30/06/2015;'AUTOPISTAS';-4,19 €;10.144,20 €;7170;-4,19;14.668,29 €;'sin fechas';30/06/2015;'AUTOPISTAS';'Gastos_Ocio y transporte';'Parking y peaje';'VARIABLES'
30/06/2015;30/06/2015;'DRIM';-15,99 €;10.128,21 €;7171;-15,99;14.652,30 €;'sin fechas';30/06/2015;'DRIM';'Gastos_Compras';'Niños';'VARIABLES'
30/06/2015;30/06/2015;'DRIM';-22,98 €;10.105,23 €;7172;-22,98;14.629,32 €;'sin fechas';30/06/2015;'DRIM';'Gastos_Compras';'Niños';'VARIABLES'
30/06/2015;30/06/2015;'IBI';-44,99 €;10.060,24 €;7173;-44,99;14.584,33 €;'sin fechas';30/06/2015;'IBI';'Gastos_Banco y organismos';'Ayuntamiento';'FIJO'
30/06/2015;30/06/2015;'REC. 6061.9600001223';-542,33 €;9.517,91 €;7174;-542,33;14.042,00 €;'sin fechas';30/06/2015;'REC';'Gastos_Banco y organismos';'Hipoteca';'FIJO'
30/06/2015;30/06/2015;'RESTAURANTES';-39,80 €;9.478,11 €;7175;-39,80;14.002,20 €;'sin fechas';30/06/2015;'RESTAURANTES';'Gastos_Ocio y transporte';'Restaurantes';'VARIABLES'
30/06/2015;30/06/2015;'TOCINERIES VENTURA';-54,40 €;9.423,71 €;7176;-54,40;13.947,80 €;'sin fechas';30/06/2015;'TOCINERIES';'Gastos_Compras';'Supermercado';'VARIABLES'
30/06/2015;30/06/2015;'VIENA';-21,10 €;9.402,61 €;7177;-21,10;13.926,70 €;'sin fechas';30/06/2015;'VIENA';'Gastos_Ocio y transporte';'Restaurantes';'VARIABLES'
01/07/2015;29/06/2015;'AUTOPISTAS';-1,11 €;9.401,50 €;7178;-1,11;13.925,59 €;'sin fechas';29/06/2015;'AUTOPISTAS';'Gastos_Ocio y transporte';'Parking y peaje';'VARIABLES'
01/07/2015;29/06/2015;'AUTOPISTAS';-1,39 €;9.400,11 €;7179;-1,39;13.924,20 €;'sin fechas';29/06/2015;'AUTOPISTAS';'Gastos_Ocio y transporte';'Parking y peaje';'VARIABLES'
01/07/2015;01/07/2015;'ESCOLA BRESSOL EINA';-509,40 €;8.890,71 €;7181;-509,40;13.414,80 €;'sin fechas';01/07/2015;'ESCOLA';'Gastos_Salud, saber y deporte';'Estudios';'VARIABLES'
01/07/2015;01/07/2015;'GASOLINERA';-35,32 €;8.855,39 €;7182;-35,32;13.379,48 €;'sin fechas';01/07/2015;'GASOLINERA';'Gastos_Ocio y transporte';'Gasolina';'VARIABLES'
01/07/2015;01/07/2015;'VIENA';-19,40 €;8.835,99 €;7183;-19,40;13.360,08 €;'sin fechas';01/07/2015;'VIENA';'Gastos_Ocio y transporte';'Restaurantes';'VARIABLES'
02/07/2015;30/06/2015;'AUTOPISTAS';-1,11 €;8.834,88 €;7184;-1,11;13.358,97 €;'sin fechas';30/06/2015;'AUTOPISTAS';'Gastos_Ocio y transporte';'Parking y peaje';'VARIABLES'
02/07/2015;02/07/2015;'VIRGIN ACTIV';-55,95 €;8.778,93 €;7185;-55,95;13.303,02 €;'sin fechas';02/07/2015;'VIRGIN';'Gastos_Salud, saber y deporte';'Deportes';'VARIABLES'
02/07/2015;02/07/2015;'VIRGIN ACTIV';-55,95 €;8.722,98 €;7186;-55,95;13.247,07 €;'sin fechas';02/07/2015;'VIRGIN';'Gastos_Salud, saber y deporte';'Deportes';'VARIABLES'
03/07/2015;01/07/2015;'AUTOPISTAS';-2,15 €;8.720,83 €;7187;-2,15;13.244,92 €;'sin fechas';01/07/2015;'AUTOPISTAS';'Gastos_Ocio y transporte';'Parking y peaje';'VARIABLES'
03/07/2015;01/07/2015;'AUTOPISTAS';-2,15 €;8.718,68 €;7188;-2,15;13.242,77 €;'sin fechas';01/07/2015;'AUTOPISTAS';'Gastos_Ocio y transporte';'Parking y peaje';'VARIABLES'
03/07/2015;03/07/2015;'REINT.CAJERO';-20,00 €;8.698,68 €;7189;-20,00;13.222,77 €;'sin fechas';03/07/2015;'REINTCAJERO';'Gastos_Gastos varios';'Efectivo';'VARIABLES'
04/07/2015;01/07/2015;'AUTOPISTAS';-1,39 €;8.697,29 €;7190;-1,39;13.221,38 €;'sin fechas';01/07/2015;'AUTOPISTAS';'Gastos_Ocio y transporte';'Parking y peaje';'VARIABLES'
04/07/2015;01/07/2015;'AUTOPISTAS';-1,39 €;8.695,90 €;7191;-1,39;13.219,99 €;'sin fechas';01/07/2015;'AUTOPISTAS';'Gastos_Ocio y transporte';'Parking y peaje';'VARIABLES'
04/07/2015;02/07/2015;'AUTOPISTAS';-1,39 €;8.694,51 €;7192;-1,39;13.218,60 €;'sin fechas';02/07/2015;'AUTOPISTAS';'Gastos_Ocio y transporte';'Parking y peaje';'VARIABLES'
04/07/2015;02/07/2015;'AUTOPISTAS';-1,39 €;8.693,12 €;7193;-1,39;13.217,21 €;'sin fechas';02/07/2015;'AUTOPISTAS';'Gastos_Ocio y transporte';'Parking y peaje';'VARIABLES'
04/07/2015;04/07/2015;'CAFETERIA';-3,60 €;8.689,52 €;7194;-3,60;13.213,61 €;'sin fechas';04/07/2015;'CAFETERIA';'Gastos_Compras';'Supermercado';'VARIABLES'
04/07/2015;04/07/2015;'FRUITES I VERDURES';-6,16 €;8.683,36 €;7195;-6,16;13.207,45 €;'sin fechas';04/07/2015;'FRUITES';'Gastos_Compras';'Supermercado';'VARIABLES'
04/07/2015;02/07/2015;'GASOLINERA';-2,60 €;8.680,76 €;7196;-2,60;13.204,85 €;'sin fechas';02/07/2015;'GASOLINERA';'Gastos_Ocio y transporte';'Gasolina';'VARIABLES'
04/07/2015;04/07/2015;'KIABI';-244,71 €;8.436,05 €;7197;-244,71;12.960,14 €;'sin fechas';04/07/2015;'KIABI';'Gastos_Compras';'Ropa';'VARIABLES'
04/07/2015;04/07/2015;'MERCADONA';-15,00 €;8.421,05 €;7198;-15,00;12.945,14 €;'sin fechas';04/07/2015;'MERCADONA';'Gastos_Compras';'Supermercado';'VARIABLES'
05/07/2015;05/07/2015;'CAFETERIA';-2,60 €;8.418,45 €;7199;-2,60;12.942,54 €;'sin fechas';05/07/2015;'CAFETERIA';'Gastos_Compras';'Supermercado';'VARIABLES'
05/07/2015;05/07/2015;'CAFETERIA';-4,50 €;8.413,95 €;7200;-4,50;12.938,04 €;'sin fechas';05/07/2015;'CAFETERIA';'Gastos_Compras';'Supermercado';'VARIABLES'
06/07/2015;06/07/2015;'ADESLAS';-111,00 €;8.302,95 €;7201;-111,00;12.827,04 €;'sin fechas';06/07/2015;'ADESLAS';'Gastos_Salud, saber y deporte';'Medico';'VARIABLES'
06/07/2015;06/07/2015;'CAFETERIA';-3,65 €;8.299,30 €;7202;-3,65;12.823,39 €;'sin fechas';06/07/2015;'CAFETERIA';'Gastos_Compras';'Supermercado';'VARIABLES'
06/07/2015;06/07/2015;'REINT.CAJERO';-40,00 €;8.259,30 €;7203;-40,00;12.783,39 €;'sin fechas';06/07/2015;'REINTCAJERO';'Gastos_Gastos varios';'Efectivo';'VARIABLES'
07/07/2015;07/07/2015;'CAPRABO';-30,26 €;8.229,04 €;7204;-30,26;12.753,13 €;'sin fechas';07/07/2015;'CAPRABO';'Gastos_Compras';'Supermercado';'VARIABLES'
07/07/2015;07/07/2015;'CINES';-12,90 €;8.216,14 €;7205;-12,90;12.740,23 €;'sin fechas';07/07/2015;'CINES';'Gastos_Ocio y transporte';'Espectáculos';'VARIABLES'
07/07/2015;07/07/2015;'CINES';-18,70 €;8.197,44 €;7206;-18,70;12.721,53 €;'sin fechas';07/07/2015;'CINES';'Gastos_Ocio y transporte';'Espectáculos';'VARIABLES'
08/07/2015;08/07/2015;'BLITZ';-72,50 €;8.124,94 €;7207;-72,50;12.649,03 €;'sin fechas';08/07/2015;'BLITZ';'Gastos_Vivienda y vehiculo';'Alquiler Parking';'FIJO'
08/07/2015;08/07/2015;'REINT.CAJERO';-40,00 €;8.084,94 €;7208;-40,00;12.609,03 €;'sin fechas';08/07/2015;'REINTCAJERO';'Gastos_Gastos varios';'Efectivo';'VARIABLES'
09/07/2015;03/07/2015;'AUTOPISTAS';-1,39 €;8.083,55 €;7209;-1,39;12.607,64 €;'sin fechas';03/07/2015;'AUTOPISTAS';'Gastos_Ocio y transporte';'Parking y peaje';'VARIABLES'
09/07/2015;03/07/2015;'AUTOPISTAS';-1,39 €;8.082,16 €;7210;-1,39;12.606,25 €;'sin fechas';03/07/2015;'AUTOPISTAS';'Gastos_Ocio y transporte';'Parking y peaje';'VARIABLES'
09/07/2015;06/07/2015;'AUTOPISTAS';-1,32 €;8.080,84 €;7211;-1,32;12.604,93 €;'sin fechas';06/07/2015;'AUTOPISTAS';'Gastos_Ocio y transporte';'Parking y peaje';'VARIABLES'
09/07/2015;06/07/2015;'AUTOPISTAS';-1,32 €;8.079,52 €;7212;-1,32;12.603,61 €;'sin fechas';06/07/2015;'AUTOPISTAS';'Gastos_Ocio y transporte';'Parking y peaje';'VARIABLES'
09/07/2015;07/07/2015;'AUTOPISTAS';-1,32 €;8.078,20 €;7213;-1,32;12.602,29 €;'sin fechas';07/07/2015;'AUTOPISTAS';'Gastos_Ocio y transporte';'Parking y peaje';'VARIABLES'
09/07/2015;07/07/2015;'AUTOPISTAS';-1,39 €;8.076,81 €;7214;-1,39;12.600,90 €;'sin fechas';07/07/2015;'AUTOPISTAS';'Gastos_Ocio y transporte';'Parking y peaje';'VARIABLES'
09/07/2015;09/07/2015;'CAFETERIA';-3,65 €;8.073,16 €;7215;-3,65;12.597,25 €;'sin fechas';09/07/2015;'CAFETERIA';'Gastos_Compras';'Supermercado';'VARIABLES'
09/07/2015;09/07/2015;'CAFETERIA';-2,70 €;8.070,46 €;7216;-2,70;12.594,55 €;'sin fechas';09/07/2015;'CAFETERIA';'Gastos_Compras';'Supermercado';'VARIABLES'
09/07/2015;09/07/2015;'FARMACIA';-14,95 €;8.055,51 €;7217;-14,95;12.579,60 €;'sin fechas';09/07/2015;'FARMACIA';'Gastos_Salud, saber y deporte';'Farmacia';'VARIABLES'
09/07/2015;09/07/2015;'LIDL';-15,49 €;8.040,02 €;7218;-15,49;12.564,11 €;'sin fechas';09/07/2015;'LIDL';'Gastos_Compras';'Supermercado';'VARIABLES'
10/07/2015;08/07/2015;'AUTOPISTAS';-1,32 €;8.038,70 €;7219;-1,32;12.562,79 €;'sin fechas';08/07/2015;'AUTOPISTAS';'Gastos_Ocio y transporte';'Parking y peaje';'VARIABLES'
10/07/2015;08/07/2015;'AUTOPISTAS';-1,39 €;8.037,31 €;7220;-1,39;12.561,40 €;'sin fechas';08/07/2015;'AUTOPISTAS';'Gastos_Ocio y transporte';'Parking y peaje';'VARIABLES'
10/07/2015;10/07/2015;'CAFETERIA';-2,15 €;8.035,16 €;7221;-2,15;12.559,25 €;'sin fechas';10/07/2015;'CAFETERIA';'Gastos_Compras';'Supermercado';'VARIABLES'
10/07/2015;10/07/2015;'IKEA';-5,97 €;8.029,19 €;7222;-5,97;12.553,28 €;'sin fechas';10/07/2015;'IKEA';'Gastos_Vivienda y vehiculo';'Mnto. hogar';'VARIABLES'
10/07/2015;10/07/2015;'IKEA';-9,90 €;8.019,29 €;7223;-9,90;12.543,38 €;'sin fechas';10/07/2015;'IKEA';'Gastos_Vivienda y vehiculo';'Mnto. hogar';'VARIABLES'
10/07/2015;10/07/2015;'FRANKFURT LES LLETRES';-4,90 €;8.014,39 €;7224;-4,90;12.538,48 €;'sin fechas';10/07/2015;'FRANKFURT';'Gastos_Ocio y transporte';'Restaurantes';'VARIABLES'
10/07/2015;10/07/2015;'MERCADONA';-19,26 €;7.995,13 €;7225;-19,26;12.519,22 €;'sin fechas';10/07/2015;'MERCADONA';'Gastos_Compras';'Supermercado';'VARIABLES'
10/07/2015;10/07/2015;'MERCADONA';-77,13 €;7.918,00 €;7226;-77,13;12.442,09 €;'sin fechas';10/07/2015;'MERCADONA';'Gastos_Compras';'Supermercado';'VARIABLES'
10/07/2015;10/07/2015;'REINT.CAJERO';-40,00 €;7.878,00 €;7227;-40,00;12.402,09 €;'sin fechas';10/07/2015;'REINTCAJERO';'Gastos_Gastos varios';'Efectivo';'VARIABLES'
11/07/2015;09/07/2015;'AUTOPISTAS';-1,25 €;7.876,75 €;7228;-1,25;12.400,84 €;'sin fechas';09/07/2015;'AUTOPISTAS';'Gastos_Ocio y transporte';'Parking y peaje';'VARIABLES'
11/07/2015;09/07/2015;'AUTOPISTAS';-1,32 €;7.875,43 €;7229;-1,32;12.399,52 €;'sin fechas';09/07/2015;'AUTOPISTAS';'Gastos_Ocio y transporte';'Parking y peaje';'VARIABLES'
11/07/2015;11/07/2015;'CAFETERIA';-3,50 €;7.871,93 €;7230;-3,50;12.396,02 €;'sin fechas';11/07/2015;'CAFETERIA';'Gastos_Compras';'Supermercado';'VARIABLES'
11/07/2015;11/07/2015;'GASOLINERA';-47,93 €;7.824,00 €;7231;-47,93;12.348,09 €;'sin fechas';11/07/2015;'GASOLINERA';'Gastos_Ocio y transporte';'Gasolina';'VARIABLES'
12/07/2015;12/07/2015;'CAFETERIA';-4,50 €;7.819,50 €;7232;-4,50;12.343,59 €;'sin fechas';12/07/2015;'CAFETERIA';'Gastos_Compras';'Supermercado';'VARIABLES'
13/07/2015;13/07/2015;'BON AREA';-26,63 €;7.792,87 €;7233;-26,63;12.316,96 €;'sin fechas';13/07/2015;'BON';'Gastos_Compras';'Supermercado';'VARIABLES'
13/07/2015;13/07/2015;'CAFETERIA';-3,65 €;7.789,22 €;7234;-3,65;12.313,31 €;'sin fechas';13/07/2015;'CAFETERIA';'Gastos_Compras';'Supermercado';'VARIABLES'
13/07/2015;13/07/2015;'FRANKFURT LES LLETRES';-4,90 €;7.784,32 €;7235;-4,90;12.308,41 €;'sin fechas';13/07/2015;'FRANKFURT';'Gastos_Ocio y transporte';'Restaurantes';'VARIABLES'
13/07/2015;13/07/2015;'FRANKFURT LES LLETRES';-11,55 €;7.772,77 €;7236;-11,55;12.296,86 €;'sin fechas';13/07/2015;'FRANKFURT';'Gastos_Ocio y transporte';'Restaurantes';'VARIABLES'
13/07/2015;13/07/2015;'FRANKFURT LES LLETRES';-4,90 €;7.767,87 €;7237;-4,90;12.291,96 €;'sin fechas';13/07/2015;'FRANKFURT';'Gastos_Ocio y transporte';'Restaurantes';'VARIABLES'
13/07/2015;13/07/2015;'VIENA';-15,70 €;7.752,17 €;7238;-15,70;12.276,26 €;'sin fechas';13/07/2015;'VIENA';'Gastos_Ocio y transporte';'Restaurantes';'VARIABLES'
14/07/2015;10/07/2015;'AUTOPISTAS';-1,25 €;7.750,92 €;7239;-1,25;12.275,01 €;'sin fechas';10/07/2015;'AUTOPISTAS';'Gastos_Ocio y transporte';'Parking y peaje';'VARIABLES'
14/07/2015;10/07/2015;'AUTOPISTAS';-1,25 €;7.749,67 €;7240;-1,25;12.273,76 €;'sin fechas';10/07/2015;'AUTOPISTAS';'Gastos_Ocio y transporte';'Parking y peaje';'VARIABLES'
14/07/2015;14/07/2015;'RESTAURANTES';-30,55 €;7.719,12 €;7241;-30,55;12.243,21 €;'sin fechas';14/07/2015;'RESTAURANTES';'Gastos_Ocio y transporte';'Restaurantes';'VARIABLES'
15/07/2015;13/07/2015;'AUTOPISTAS';-1,25 €;7.717,87 €;7242;-1,25;12.241,96 €;'sin fechas';13/07/2015;'AUTOPISTAS';'Gastos_Ocio y transporte';'Parking y peaje';'VARIABLES'
15/07/2015;13/07/2015;'AUTOPISTAS';-1,39 €;7.716,48 €;7243;-1,39;12.240,57 €;'sin fechas';13/07/2015;'AUTOPISTAS';'Gastos_Ocio y transporte';'Parking y peaje';'VARIABLES'
15/07/2015;15/07/2015;'REINT.CAJERO';-30,00 €;7.686,48 €;7244;-30,00;12.210,57 €;'sin fechas';15/07/2015;'REINTCAJERO';'Gastos_Gastos varios';'Efectivo';'VARIABLES'
15/07/2015;13/07/2015;'SATSA PL. VELLA TERRASSA';-4,50 €;7.681,98 €;7245;-4,50;12.206,07 €;'sin fechas';13/07/2015;'SATSA';'Gastos_Ocio y transporte';'Parking y peaje';'VARIABLES'
16/07/2015;14/07/2015;'AUTOPISTAS';-1,25 €;7.680,73 €;7246;-1,25;12.204,82 €;'sin fechas';14/07/2015;'AUTOPISTAS';'Gastos_Ocio y transporte';'Parking y peaje';'VARIABLES'
16/07/2015;14/07/2015;'AUTOPISTAS';-1,39 €;7.679,34 €;7247;-1,39;12.203,43 €;'sin fechas';14/07/2015;'AUTOPISTAS';'Gastos_Ocio y transporte';'Parking y peaje';'VARIABLES'
16/07/2015;16/07/2015;'AUTOPISTAS';-4,19 €;7.675,15 €;7248;-4,19;12.199,24 €;'sin fechas';16/07/2015;'AUTOPISTAS';'Gastos_Ocio y transporte';'Parking y peaje';'VARIABLES'
16/07/2015;16/07/2015;'CAFETERIA';-3,65 €;7.671,50 €;7249;-3,65;12.195,59 €;'sin fechas';16/07/2015;'CAFETERIA';'Gastos_Compras';'Supermercado';'VARIABLES'
16/07/2015;16/07/2015;'CARREFOUR-[comida]';-34,42 €;7.637,08 €;7250;-34,42;12.161,17 €;'sin fechas';16/07/2015;'CARREFOURCOMIDA';'Gastos_Compras';'Supermercado';'VARIABLES'
16/07/2015;16/07/2015;'CARREFOUR-[comida]';-7,80 €;7.629,28 €;7251;-7,80;12.153,37 €;'sin fechas';16/07/2015;'CARREFOURCOMIDA';'Gastos_Compras';'Supermercado';'VARIABLES'
16/07/2015;16/07/2015;'CCM VIDA Y P SEGURO PRESTAMO';-23,38 €;7.605,90 €;7252;-23,38;12.129,99 €;'sin fechas';16/07/2015;'CCM';'Gastos_Seguros';'Seguro vida';'FIJO'
16/07/2015;16/07/2015;'CCM VIDA Y PENSIO 000000493358';-17,87 €;7.588,03 €;7253;-17,87;12.112,12 €;'sin fechas';16/07/2015;'CCM';'Gastos_Seguros';'Seguro vida';'FIJO'
17/07/2015;15/07/2015;'AUTOPISTAS';-1,25 €;7.586,78 €;7254;-1,25;12.110,87 €;'sin fechas';15/07/2015;'AUTOPISTAS';'Gastos_Ocio y transporte';'Parking y peaje';'VARIABLES'
17/07/2015;15/07/2015;'AUTOPISTAS';-1,39 €;7.585,39 €;7255;-1,39;12.109,48 €;'sin fechas';15/07/2015;'AUTOPISTAS';'Gastos_Ocio y transporte';'Parking y peaje';'VARIABLES'
17/07/2015;17/07/2015;'CAFETERIA';-3,60 €;7.581,79 €;7256;-3,60;12.105,88 €;'sin fechas';17/07/2015;'CAFETERIA';'Gastos_Compras';'Supermercado';'VARIABLES'
17/07/2015;17/07/2015;'FRUITES I VERDURES';-12,67 €;7.569,12 €;7257;-12,67;12.093,21 €;'sin fechas';17/07/2015;'FRUITES';'Gastos_Compras';'Supermercado';'VARIABLES'
17/07/2015;17/07/2015;'INFORMACIO I TECNOLOGIA DE CAT';1.735,22 €;9.304,34 €;7258;1.735,22;13.828,43 €;'sin fechas';17/07/2015;'INFORMACIO';'Ingresos';'Nomina';'FIJO'
17/07/2015;17/07/2015;'ONO';-133,41 €;9.170,93 €;7259;-133,41;13.695,02 €;'sin fechas';17/07/2015;'ONO';'Gastos_Servicios tipicos';'Telecomunicaciones';'FIJO'
17/07/2015;17/07/2015;'PARKING';-1,25 €;9.169,68 €;7260;-1,25;13.693,77 €;'sin fechas';17/07/2015;'PARKING';'Gastos_Ocio y transporte';'Parking y peaje';'VARIABLES'
17/07/2015;17/07/2015;'RESTAURANTES';-21,00 €;9.148,68 €;7261;-21,00;13.672,77 €;'sin fechas';17/07/2015;'RESTAURANTES';'Gastos_Ocio y transporte';'Restaurantes';'VARIABLES'
18/07/2015;16/07/2015;'AUTOPISTAS';-1,25 €;9.147,43 €;7262;-1,25;13.671,52 €;'sin fechas';16/07/2015;'AUTOPISTAS';'Gastos_Ocio y transporte';'Parking y peaje';'VARIABLES'
18/07/2015;16/07/2015;'AUTOPISTAS';-1,25 €;9.146,18 €;7263;-1,25;13.670,27 €;'sin fechas';16/07/2015;'AUTOPISTAS';'Gastos_Ocio y transporte';'Parking y peaje';'VARIABLES'
18/07/2015;18/07/2015;'CAFETERIA';-2,60 €;9.143,58 €;7264;-2,60;13.667,67 €;'sin fechas';18/07/2015;'CAFETERIA';'Gastos_Compras';'Supermercado';'VARIABLES'
18/07/2015;18/07/2015;'DECATHLON';-1,99 €;9.141,59 €;7265;-1,99;13.665,68 €;'sin fechas';18/07/2015;'DECATHLON';'Gastos_Compras';'Deportivo';'VARIABLES'
18/07/2015;18/07/2015;'PERRUQUERIA';-74,61 €;9.066,98 €;7266;-74,61;13.591,07 €;'sin fechas';18/07/2015;'PERRUQUERIA';'Gastos_Salud, saber y deporte';'Belleza';'VARIABLES'
18/07/2015;18/07/2015;'REINT.CAJERO';-40,00 €;9.026,98 €;7267;-40,00;13.551,07 €;'sin fechas';18/07/2015;'REINTCAJERO';'Gastos_Gastos varios';'Efectivo';'VARIABLES'
18/07/2015;18/07/2015;'RESTAURANTES';-66,40 €;8.960,58 €;7268;-66,40;13.484,67 €;'sin fechas';18/07/2015;'RESTAURANTES';'Gastos_Ocio y transporte';'Restaurantes';'VARIABLES'
19/07/2015;19/07/2015;'CAFETERIA';-3,65 €;8.956,93 €;7269;-3,65;13.481,02 €;'sin fechas';19/07/2015;'CAFETERIA';'Gastos_Compras';'Supermercado';'VARIABLES'
19/07/2015;19/07/2015;'FRANKFURT LES LLETRES';-2,50 €;8.954,43 €;7270;-2,50;13.478,52 €;'sin fechas';19/07/2015;'FRANKFURT';'Gastos_Ocio y transporte';'Restaurantes';'VARIABLES'
20/07/2015;20/07/2015;'CAFETERIA';-3,65 €;8.950,78 €;7271;-3,65;13.474,87 €;'sin fechas';20/07/2015;'CAFETERIA';'Gastos_Compras';'Supermercado';'VARIABLES'
20/07/2015;20/07/2015;'CINES';-12,90 €;8.937,88 €;7272;-12,90;13.461,97 €;'sin fechas';20/07/2015;'CINES';'Gastos_Ocio y transporte';'Espectáculos';'VARIABLES'
20/07/2015;20/07/2015;'CINES';-23,60 €;8.914,28 €;7273;-23,60;13.438,37 €;'sin fechas';20/07/2015;'CINES';'Gastos_Ocio y transporte';'Espectáculos';'VARIABLES'
20/07/2015;20/07/2015;'DECATHLON';-62,71 €;8.851,57 €;7274;-62,71;13.375,66 €;'sin fechas';20/07/2015;'DECATHLON';'Gastos_Compras';'Deportivo';'VARIABLES'
20/07/2015;20/07/2015;'FRANKFURT LES LLETRES';-3,90 €;8.847,67 €;7275;-3,90;13.371,76 €;'sin fechas';20/07/2015;'FRANKFURT';'Gastos_Ocio y transporte';'Restaurantes';'VARIABLES'
20/07/2015;20/07/2015;'RESTAURANTES';-10,20 €;8.837,47 €;7276;-10,20;13.361,56 €;'sin fechas';20/07/2015;'RESTAURANTES';'Gastos_Ocio y transporte';'Restaurantes';'VARIABLES'
20/07/2015;20/07/2015;'VIENA';-12,95 €;8.824,52 €;7277;-12,95;13.348,61 €;'sin fechas';20/07/2015;'VIENA';'Gastos_Ocio y transporte';'Restaurantes';'VARIABLES'
21/07/2015;21/07/2015;'FARMACIA';-12,00 €;8.812,52 €;7278;-12,00;13.336,61 €;'sin fechas';21/07/2015;'FARMACIA';'Gastos_Salud, saber y deporte';'Farmacia';'VARIABLES'
22/07/2015;22/07/2015;'REINT.CAJERO';-30,00 €;8.782,52 €;7279;-30,00;13.306,61 €;'sin fechas';22/07/2015;'REINTCAJERO';'Gastos_Gastos varios';'Efectivo';'VARIABLES'
22/07/2015;22/07/2015;'RESTAURANTES';-23,20 €;8.759,32 €;7280;-23,20;13.283,41 €;'sin fechas';22/07/2015;'RESTAURANTES';'Gastos_Ocio y transporte';'Restaurantes';'VARIABLES'
22/07/2015;22/07/2015;'RESTAURANTES';-11,90 €;8.747,42 €;7281;-11,90;13.271,51 €;'sin fechas';22/07/2015;'RESTAURANTES';'Gastos_Ocio y transporte';'Restaurantes';'VARIABLES'
23/07/2015;17/07/2015;'AUTOPISTAS';-1,39 €;8.746,03 €;7282;-1,39;13.270,12 €;'sin fechas';17/07/2015;'AUTOPISTAS';'Gastos_Ocio y transporte';'Parking y peaje';'VARIABLES'
23/07/2015;17/07/2015;'AUTOPISTAS';-1,39 €;8.744,64 €;7283;-1,39;13.268,73 €;'sin fechas';17/07/2015;'AUTOPISTAS';'Gastos_Ocio y transporte';'Parking y peaje';'VARIABLES'
23/07/2015;20/07/2015;'AUTOPISTAS';-1,39 €;8.743,25 €;7284;-1,39;13.267,34 €;'sin fechas';20/07/2015;'AUTOPISTAS';'Gastos_Ocio y transporte';'Parking y peaje';'VARIABLES'
23/07/2015;20/07/2015;'AUTOPISTAS';-1,39 €;8.741,86 €;7285;-1,39;13.265,95 €;'sin fechas';20/07/2015;'AUTOPISTAS';'Gastos_Ocio y transporte';'Parking y peaje';'VARIABLES'
23/07/2015;21/07/2015;'AUTOPISTAS';-1,39 €;8.740,47 €;7286;-1,39;13.264,56 €;'sin fechas';21/07/2015;'AUTOPISTAS';'Gastos_Ocio y transporte';'Parking y peaje';'VARIABLES'
23/07/2015;21/07/2015;'AUTOPISTAS';-1,39 €;8.739,08 €;7287;-1,39;13.263,17 €;'sin fechas';21/07/2015;'AUTOPISTAS';'Gastos_Ocio y transporte';'Parking y peaje';'VARIABLES'
23/07/2015;23/07/2015;'CAFETERIA';-3,05 €;8.736,03 €;7288;-3,05;13.260,12 €;'sin fechas';23/07/2015;'CAFETERIA';'Gastos_Compras';'Supermercado';'VARIABLES'
23/07/2015;23/07/2015;'RESTAURANTES';-15,80 €;8.720,23 €;7289;-15,80;13.244,32 €;'sin fechas';23/07/2015;'RESTAURANTES';'Gastos_Ocio y transporte';'Restaurantes';'VARIABLES'
23/07/2015;23/07/2015;'RESTAURANTES';-5,00 €;8.715,23 €;7290;-5,00;13.239,32 €;'sin fechas';23/07/2015;'RESTAURANTES';'Gastos_Ocio y transporte';'Restaurantes';'VARIABLES'
23/07/2015;23/07/2015;'TOCINERIES VENTURA';-17,56 €;8.697,67 €;7291;-17,56;13.221,76 €;'sin fechas';23/07/2015;'TOCINERIES';'Gastos_Compras';'Supermercado';'VARIABLES'
24/07/2015;22/07/2015;'AUTOPISTAS';-1,39 €;8.696,28 €;7292;-1,39;13.220,37 €;'sin fechas';22/07/2015;'AUTOPISTAS';'Gastos_Ocio y transporte';'Parking y peaje';'VARIABLES'
24/07/2015;22/07/2015;'AUTOPISTAS';-1,39 €;8.694,89 €;7293;-1,39;13.218,98 €;'sin fechas';22/07/2015;'AUTOPISTAS';'Gastos_Ocio y transporte';'Parking y peaje';'VARIABLES'
24/07/2015;24/07/2015;'AUTOPISTAS';-4,19 €;8.690,70 €;7294;-4,19;13.214,79 €;'sin fechas';24/07/2015;'AUTOPISTAS';'Gastos_Ocio y transporte';'Parking y peaje';'VARIABLES'
24/07/2015;24/07/2015;'AUTOPISTAS';-1,39 €;8.689,31 €;7295;-1,39;13.213,40 €;'sin fechas';24/07/2015;'AUTOPISTAS';'Gastos_Ocio y transporte';'Parking y peaje';'VARIABLES'
24/07/2015;24/07/2015;'AUTOPISTAS';-4,19 €;8.685,12 €;7296;-4,19;13.209,21 €;'sin fechas';24/07/2015;'AUTOPISTAS';'Gastos_Ocio y transporte';'Parking y peaje';'VARIABLES'
24/07/2015;24/07/2015;'AUTOPISTAS';-1,39 €;8.683,73 €;7297;-1,39;13.207,82 €;'sin fechas';24/07/2015;'AUTOPISTAS';'Gastos_Ocio y transporte';'Parking y peaje';'VARIABLES'
24/07/2015;24/07/2015;'CAFETERIA';-2,70 €;8.681,03 €;7298;-2,70;13.205,12 €;'sin fechas';24/07/2015;'CAFETERIA';'Gastos_Compras';'Supermercado';'VARIABLES'
24/07/2015;24/07/2015;'CAFETERIA';-3,65 €;8.677,38 €;7299;-3,65;13.201,47 €;'sin fechas';24/07/2015;'CAFETERIA';'Gastos_Compras';'Supermercado';'VARIABLES'
24/07/2015;24/07/2015;'CINES';-18,75 €;8.658,63 €;7300;-18,75;13.182,72 €;'sin fechas';24/07/2015;'CINES';'Gastos_Ocio y transporte';'Espectáculos';'VARIABLES'
24/07/2015;24/07/2015;'CINES';-17,00 €;8.641,63 €;7301;-17,00;13.165,72 €;'sin fechas';24/07/2015;'CINES';'Gastos_Ocio y transporte';'Espectáculos';'VARIABLES'
24/07/2015;24/07/2015;'GASOLINERA';-41,76 €;8.599,87 €;7302;-41,76;13.123,96 €;'sin fechas';24/07/2015;'GASOLINERA';'Gastos_Ocio y transporte';'Gasolina';'VARIABLES'
24/07/2015;24/07/2015;'LIDL';-39,82 €;8.560,05 €;7303;-39,82;13.084,14 €;'sin fechas';24/07/2015;'LIDL';'Gastos_Compras';'Supermercado';'VARIABLES'
25/07/2015;23/07/2015;'AUTOPISTAS';-1,39 €;8.558,66 €;7304;-1,39;13.082,75 €;'sin fechas';23/07/2015;'AUTOPISTAS';'Gastos_Ocio y transporte';'Parking y peaje';'VARIABLES'
25/07/2015;23/07/2015;'AUTOPISTAS';-1,39 €;8.557,27 €;7305;-1,39;13.081,36 €;'sin fechas';23/07/2015;'AUTOPISTAS';'Gastos_Ocio y transporte';'Parking y peaje';'VARIABLES'
25/07/2015;25/07/2015;'CAFETERIA';-2,70 €;8.554,57 €;7306;-2,70;13.078,66 €;'sin fechas';25/07/2015;'CAFETERIA';'Gastos_Compras';'Supermercado';'VARIABLES'
25/07/2015;25/07/2015;'MERCADONA';-14,16 €;8.540,41 €;7307;-14,16;13.064,50 €;'sin fechas';25/07/2015;'MERCADONA';'Gastos_Compras';'Supermercado';'VARIABLES'
25/07/2015;25/07/2015;'PARKING';-4,50 €;8.535,91 €;7308;-4,50;13.060,00 €;'sin fechas';25/07/2015;'PARKING';'Gastos_Ocio y transporte';'Parking y peaje';'VARIABLES'
25/07/2015;25/07/2015;'RESTAURANTES';-6,95 €;8.528,96 €;7309;-6,95;13.053,05 €;'sin fechas';25/07/2015;'RESTAURANTES';'Gastos_Ocio y transporte';'Restaurantes';'VARIABLES'
25/07/2015;25/07/2015;'RESTAURANTES';-11,10 €;8.517,86 €;7310;-11,10;13.041,95 €;'sin fechas';25/07/2015;'RESTAURANTES';'Gastos_Ocio y transporte';'Restaurantes';'VARIABLES'
26/07/2015;26/07/2015;'CAFETERIA';-2,70 €;8.515,16 €;7311;-2,70;13.039,25 €;'sin fechas';26/07/2015;'CAFETERIA';'Gastos_Compras';'Supermercado';'VARIABLES'
26/07/2015;26/07/2015;'SALA BADRINAS - AMPA';-30,00 €;8.485,16 €;7312;-30,00;13.009,25 €;'sin fechas';26/07/2015;'SALA';'Gastos_Salud, saber y deporte';'Estudios';'VARIABLES'
27/07/2015;27/07/2015;'MERCADONA';-134,78 €;8.350,38 €;7313;-134,78;12.874,47 €;'sin fechas';27/07/2015;'MERCADONA';'Gastos_Compras';'Supermercado';'VARIABLES'
28/07/2015;25/07/2015;'AUTOPISTAS';-2,53 €;8.347,85 €;7314;-2,53;12.871,94 €;'sin fechas';25/07/2015;'AUTOPISTAS';'Gastos_Ocio y transporte';'Parking y peaje';'VARIABLES'
28/07/2015;28/07/2015;'FOMENT DE TERRASSA, SA';1.776,37 €;10.124,22 €;7316;1.776,37;14.648,31 €;'sin fechas';28/07/2015;'FOMENT';'Ingresos';'Nomina';'FIJO'
28/07/2015;28/07/2015;'RENFE';-15,35 €;10.108,87 €;7317;-15,35;14.632,96 €;'sin fechas';28/07/2015;'RENFE';'Gastos_Ocio y transporte';'Transporte';'VARIABLES'
28/07/2015;28/07/2015;'RESTAURANTES';-4,95 €;10.103,92 €;7318;-4,95;14.628,01 €;'sin fechas';28/07/2015;'RESTAURANTES';'Gastos_Ocio y transporte';'Restaurantes';'VARIABLES'
28/07/2015;28/07/2015;'TRANSFAVOR';2.500,00 €;12.603,92 €;7319;2.500,00;17.128,01 €;'sin fechas';28/07/2015;'TRANSFAVOR';'Ingresos';'Transferencias';'VARIABLES'
29/07/2015;27/07/2015;'AUTOPISTAS';-1,39 €;12.602,53 €;7320;-1,39;17.126,62 €;'sin fechas';27/07/2015;'AUTOPISTAS';'Gastos_Ocio y transporte';'Parking y peaje';'VARIABLES'
29/07/2015;29/07/2015;'INFORMACIO I TECNOLOGIA DE CAT';1.586,22 €;14.188,75 €;7321;1.586,22;18.712,84 €;'sin fechas';29/07/2015;'INFORMACIO';'Ingresos';'Nomina';'FIJO'
29/07/2015;29/07/2015;'REINT.CAJERO';-140,00 €;14.048,75 €;7322;-140,00;18.572,84 €;'sin fechas';29/07/2015;'REINTCAJERO';'Gastos_Gastos varios';'Efectivo';'VARIABLES'
30/07/2015;28/07/2015;'AUTOPISTAS';-1,39 €;14.047,36 €;7323;-1,39;18.571,45 €;'sin fechas';28/07/2015;'AUTOPISTAS';'Gastos_Ocio y transporte';'Parking y peaje';'VARIABLES'
30/07/2015;28/07/2015;'AUTOPISTAS';-1,39 €;14.045,97 €;7324;-1,39;18.570,06 €;'sin fechas';28/07/2015;'AUTOPISTAS';'Gastos_Ocio y transporte';'Parking y peaje';'VARIABLES'
30/07/2015;30/07/2015;'CAFETERIA';-2,70 €;14.043,27 €;7325;-2,70;18.567,36 €;'sin fechas';30/07/2015;'CAFETERIA';'Gastos_Compras';'Supermercado';'VARIABLES'
30/07/2015;30/07/2015;'DECATHLON';-51,84 €;13.991,43 €;7326;-51,84;18.515,52 €;'sin fechas';30/07/2015;'DECATHLON';'Gastos_Compras';'Deportivo';'VARIABLES'
30/07/2015;30/07/2015;'HOGAR&OTROS';-14,82 €;13.976,61 €;7327;-14,82;18.500,70 €;'sin fechas';30/07/2015;'HOGAROTROS';'Gastos_Vivienda y vehiculo';'Otros vivienda';'VARIABLES'
30/07/2015;30/07/2015;'VIENA';-5,20 €;13.971,41 €;7328;-5,20;18.495,50 €;'sin fechas';30/07/2015;'VIENA';'Gastos_Ocio y transporte';'Restaurantes';'VARIABLES'
31/07/2015;31/07/2015;'AJUNTAMENT D TAXA RESIDUS CA';-51,24 €;13.920,17 €;7329;-51,24;18.444,26 €;'sin fechas';31/07/2015;'AJUNTAMENT';'Gastos_Banco y organismos';'Ayuntamiento';'FIJO'
31/07/2015;29/07/2015;'AUTOPISTAS';-1,39 €;13.918,78 €;7330;-1,39;18.442,87 €;'sin fechas';29/07/2015;'AUTOPISTAS';'Gastos_Ocio y transporte';'Parking y peaje';'VARIABLES'
31/07/2015;29/07/2015;'AUTOPISTAS';-1,39 €;13.917,39 €;7331;-1,39;18.441,48 €;'sin fechas';29/07/2015;'AUTOPISTAS';'Gastos_Ocio y transporte';'Parking y peaje';'VARIABLES'
31/07/2015;31/07/2015;'CAFETERIA';-2,70 €;13.914,69 €;7332;-2,70;18.438,78 €;'sin fechas';31/07/2015;'CAFETERIA';'Gastos_Compras';'Supermercado';'VARIABLES'
31/07/2015;31/07/2015;'REC. 6061.9600001223';-542,33 €;13.372,36 €;7333;-542,33;17.896,45 €;'sin fechas';31/07/2015;'REC';'Gastos_Banco y organismos';'Hipoteca';'FIJO'
01/08/2015;30/07/2015;'AUTOPISTAS';-1,39 €;13.370,97 €;7334;-1,39;17.895,06 €;'sin fechas';30/07/2015;'AUTOPISTAS';'Gastos_Ocio y transporte';'Parking y peaje';'VARIABLES'
01/08/2015;30/07/2015;'AUTOPISTAS';-1,39 €;13.369,58 €;7335;-1,39;17.893,67 €;'sin fechas';30/07/2015;'AUTOPISTAS';'Gastos_Ocio y transporte';'Parking y peaje';'VARIABLES'
01/08/2015;01/08/2015;'CAFETERIA';-2,25 €;13.367,33 €;7336;-2,25;17.891,42 €;'sin fechas';01/08/2015;'CAFETERIA';'Gastos_Compras';'Supermercado';'VARIABLES'
01/08/2015;01/08/2015;'PERRUQUERIA';-13,50 €;13.353,83 €;7338;-13,50;17.877,92 €;'sin fechas';01/08/2015;'PERRUQUERIA';'Gastos_Salud, saber y deporte';'Belleza';'VARIABLES'
01/08/2015;01/08/2015;'RESTAURANTES';-160,00 €;13.193,83 €;7339;-160,00;17.717,92 €;'sin fechas';01/08/2015;'RESTAURANTES';'Gastos_Ocio y transporte';'Restaurantes';'VARIABLES'
02/08/2015;02/08/2015;'CAFETERIA';-3,60 €;13.190,23 €;7340;-3,60;17.714,32 €;'sin fechas';02/08/2015;'CAFETERIA';'Gastos_Compras';'Supermercado';'VARIABLES'
02/08/2015;02/08/2015;'IMAGINARIUM';-36,90 €;13.153,33 €;7341;-36,90;17.677,42 €;'sin fechas';02/08/2015;'IMAGINARIUM';'Gastos_Compras';'Niños';'VARIABLES'
02/08/2015;02/08/2015;'MEDIA MARKT';-66,06 €;13.087,27 €;7342;-66,06;17.611,36 €;'sin fechas';02/08/2015;'MEDIA';'Gastos_Compras';'Hobbys';'VARIABLES'
03/08/2015;03/08/2015;'CAFETERIA';-3,60 €;13.083,67 €;7343;-3,60;17.607,76 €;'sin fechas';03/08/2015;'CAFETERIA';'Gastos_Compras';'Supermercado';'VARIABLES'
03/08/2015;03/08/2015;'GASOLINERA';-30,00 €;13.053,67 €;7344;-30,00;17.577,76 €;'sin fechas';03/08/2015;'GASOLINERA';'Gastos_Ocio y transporte';'Gasolina';'VARIABLES'
03/08/2015;03/08/2015;'RESTAURANTES';-13,50 €;13.040,17 €;7345;-13,50;17.564,26 €;'sin fechas';03/08/2015;'RESTAURANTES';'Gastos_Ocio y transporte';'Restaurantes';'VARIABLES'
03/08/2015;03/08/2015;'VIRGIN ACTIV';-55,95 €;12.984,22 €;7346;-55,95;17.508,31 €;'sin fechas';03/08/2015;'VIRGIN';'Gastos_Salud, saber y deporte';'Deportes';'VARIABLES'
03/08/2015;03/08/2015;'VIRGIN ACTIV';-55,95 €;12.928,27 €;7347;-55,95;17.452,36 €;'sin fechas';03/08/2015;'VIRGIN';'Gastos_Salud, saber y deporte';'Deportes';'VARIABLES'
04/08/2015;04/08/2015;'ADESLAS';-111,00 €;12.817,27 €;7348;-111,00;17.341,36 €;'sin fechas';04/08/2015;'ADESLAS';'Gastos_Salud, saber y deporte';'Medico';'VARIABLES'
04/08/2015;31/07/2015;'AUTOPISTAS';-1,39 €;12.815,88 €;7349;-1,39;17.339,97 €;'sin fechas';31/07/2015;'AUTOPISTAS';'Gastos_Ocio y transporte';'Parking y peaje';'VARIABLES'
04/08/2015;04/08/2015;'GAS NATURAL';-73,54 €;12.742,34 €;7350;-73,54;17.266,43 €;'sin fechas';04/08/2015;'GAS';'Gastos_Servicios tipicos';'Gas';'FIJO'
04/08/2015;04/08/2015;'HOGAR&OTROS';-28,80 €;12.713,54 €;7351;-28,80;17.237,63 €;'sin fechas';04/08/2015;'HOGAROTROS';'Gastos_Vivienda y vehiculo';'Otros vivienda';'VARIABLES'
04/08/2015;04/08/2015;'VIENA';-17,10 €;12.696,44 €;7352;-17,10;17.220,53 €;'sin fechas';04/08/2015;'VIENA';'Gastos_Ocio y transporte';'Restaurantes';'VARIABLES'
05/08/2015;05/08/2015;'CINES';-32,40 €;12.664,04 €;7353;-32,40;17.188,13 €;'sin fechas';05/08/2015;'CINES';'Gastos_Ocio y transporte';'Espectáculos';'VARIABLES'
06/08/2015;03/08/2015;'AUTOPISTAS';-4,19 €;12.659,85 €;7354;-4,19;17.183,94 €;'sin fechas';03/08/2015;'AUTOPISTAS';'Gastos_Ocio y transporte';'Parking y peaje';'VARIABLES'
06/08/2015;03/08/2015;'AUTOPISTAS';-3,91 €;12.655,94 €;7355;-3,91;17.180,03 €;'sin fechas';03/08/2015;'AUTOPISTAS';'Gastos_Ocio y transporte';'Parking y peaje';'VARIABLES'
06/08/2015;03/08/2015;'AUTOPISTAS';-6,55 €;12.649,39 €;7356;-6,55;17.173,48 €;'sin fechas';03/08/2015;'AUTOPISTAS';'Gastos_Ocio y transporte';'Parking y peaje';'VARIABLES'
06/08/2015;03/08/2015;'AUTOPISTAS';-4,95 €;12.644,44 €;7357;-4,95;17.168,53 €;'sin fechas';03/08/2015;'AUTOPISTAS';'Gastos_Ocio y transporte';'Parking y peaje';'VARIABLES'
06/08/2015;03/08/2015;'AUTOPISTAS';-7,15 €;12.637,29 €;7358;-7,15;17.161,38 €;'sin fechas';03/08/2015;'AUTOPISTAS';'Gastos_Ocio y transporte';'Parking y peaje';'VARIABLES'
06/08/2015;06/08/2015;'BLITZ';-72,50 €;12.564,79 €;7359;-72,50;17.088,88 €;'sin fechas';06/08/2015;'BLITZ';'Gastos_Vivienda y vehiculo';'Alquiler Parking';'FIJO'
07/08/2015;07/08/2015;'LIDL';-24,46 €;12.540,33 €;7360;-24,46;17.064,42 €;'sin fechas';07/08/2015;'LIDL';'Gastos_Compras';'Supermercado';'VARIABLES'
07/08/2015;07/08/2015;'SABECO';-26,99 €;12.513,34 €;7361;-26,99;17.037,43 €;'sin fechas';07/08/2015;'SABECO';'Gastos_Compras';'Supermercado';'VARIABLES'
10/08/2015;10/08/2015;'NATURA';-6,90 €;12.506,44 €;7362;-6,90;17.030,53 €;'sin fechas';10/08/2015;'NATURA';'Gastos_Salud, saber y deporte';'Estudios';'VARIABLES'
10/08/2015;10/08/2015;'VIENA';-12,05 €;12.494,39 €;7363;-12,05;17.018,48 €;'sin fechas';10/08/2015;'VIENA';'Gastos_Ocio y transporte';'Restaurantes';'VARIABLES'
11/08/2015;11/08/2015;'COMISIONES';-8,00 €;12.486,39 €;7364;-8,00;17.010,48 €;'sin fechas';11/08/2015;'COMISIONES';'Gastos_Banco y organismos';'Cargos banco';'FIJO'
11/08/2015;11/08/2015;'DECATHLON';-48,82 €;12.437,57 €;7365;-48,82;16.961,66 €;'sin fechas';11/08/2015;'DECATHLON';'Gastos_Compras';'Deportivo';'VARIABLES'
11/08/2015;11/08/2015;'REINT.CAJERO';-200,00 €;12.237,57 €;7366;-200,00;16.761,66 €;'sin fechas';11/08/2015;'REINTCAJERO';'Gastos_Gastos varios';'Efectivo';'VARIABLES'
13/08/2015;13/08/2015;'DECATHLON';-19,88 €;12.217,69 €;7367;-19,88;16.741,78 €;'sin fechas';13/08/2015;'DECATHLON';'Gastos_Compras';'Deportivo';'VARIABLES'
13/08/2015;13/08/2015;'VIENA';-11,05 €;12.206,64 €;7368;-11,05;16.730,73 €;'sin fechas';13/08/2015;'VIENA';'Gastos_Ocio y transporte';'Restaurantes';'VARIABLES'
14/08/2015;14/08/2015;'GAS NATURAL';-232,16 €;11.974,48 €;7369;-232,16;16.498,57 €;'sin fechas';14/08/2015;'GAS';'Gastos_Servicios tipicos';'Gas';'FIJO'
14/08/2015;14/08/2015;'GASOLINERA';-33,00 €;11.941,48 €;7370;-33,00;16.465,57 €;'sin fechas';14/08/2015;'GASOLINERA';'Gastos_Ocio y transporte';'Gasolina';'VARIABLES'
17/08/2015;17/08/2015;'COMISIONES';-6,00 €;11.935,48 €;7371;-6,00;16.459,57 €;'sin fechas';17/08/2015;'COMISIONES';'Gastos_Banco y organismos';'Cargos banco';'FIJO'
17/08/2015;17/08/2015;'MERCADONA';-86,03 €;11.849,45 €;7372;-86,03;16.373,54 €;'sin fechas';17/08/2015;'MERCADONA';'Gastos_Compras';'Supermercado';'VARIABLES'
17/08/2015;17/08/2015;'ONO';-149,98 €;11.699,47 €;7373;-149,98;16.223,56 €;'sin fechas';17/08/2015;'ONO';'Gastos_Servicios tipicos';'Telecomunicaciones';'FIJO'
17/08/2015;17/08/2015;'REINT.CAJERO';-150,00 €;11.549,47 €;7374;-150,00;16.073,56 €;'sin fechas';17/08/2015;'REINTCAJERO';'Gastos_Gastos varios';'Efectivo';'VARIABLES'
17/08/2015;17/08/2015;'RESTAURANTES';-75,05 €;11.474,42 €;7375;-75,05;15.998,51 €;'sin fechas';17/08/2015;'RESTAURANTES';'Gastos_Ocio y transporte';'Restaurantes';'VARIABLES'
18/08/2015;18/08/2015;'CCM VIDA Y P SEGURO PRESTAMO';-23,32 €;11.451,10 €;7376;-23,32;15.975,19 €;'sin fechas';18/08/2015;'CCM';'Gastos_Seguros';'Seguro vida';'FIJO'
18/08/2015;18/08/2015;'CCM VIDA Y PENSIO 000000493358';-17,82 €;11.433,28 €;7377;-17,82;15.957,37 €;'sin fechas';18/08/2015;'CCM';'Gastos_Seguros';'Seguro vida';'FIJO'
18/08/2015;18/08/2015;'FARMACIA';-44,00 €;11.389,28 €;7378;-44,00;15.913,37 €;'sin fechas';18/08/2015;'FARMACIA';'Gastos_Salud, saber y deporte';'Farmacia';'VARIABLES'
19/08/2015;19/08/2015;'CINES';-40,50 €;11.348,78 €;7379;-40,50;15.872,87 €;'sin fechas';19/08/2015;'CINES';'Gastos_Ocio y transporte';'Espectáculos';'VARIABLES'
19/08/2015;19/08/2015;'FRAGADIS';-30,18 €;11.318,60 €;7380;-30,18;15.842,69 €;'sin fechas';19/08/2015;'FRAGADIS';'Gastos_Compras';'Supermercado';'VARIABLES'
21/08/2015;21/08/2015;'CINES';-40,50 €;11.278,10 €;7381;-40,50;15.802,19 €;'sin fechas';21/08/2015;'CINES';'Gastos_Ocio y transporte';'Espectáculos';'VARIABLES'
23/08/2015;23/08/2015;'AUTOPISTA MARE NOSTRUM';-7,15 €;11.270,95 €;7382;-7,15;15.795,04 €;'sin fechas';23/08/2015;'AUTOPISTA';'Gastos_Ocio y transporte';'Parking y peaje';'VARIABLES'
23/08/2015;23/08/2015;'AUTOPISTAS';-10,60 €;11.260,35 €;7383;-10,60;15.784,44 €;'sin fechas';23/08/2015;'AUTOPISTAS';'Gastos_Ocio y transporte';'Parking y peaje';'VARIABLES'
23/08/2015;23/08/2015;'AUTOPISTAS';-2,53 €;11.257,82 €;7384;-2,53;15.781,91 €;'sin fechas';23/08/2015;'AUTOPISTAS';'Gastos_Ocio y transporte';'Parking y peaje';'VARIABLES'
24/08/2015;24/08/2015;'MERCADONA';-123,58 €;11.134,24 €;7385;-123,58;15.658,33 €;'sin fechas';24/08/2015;'MERCADONA';'Gastos_Compras';'Supermercado';'VARIABLES'
26/08/2015;26/08/2015;'AUTOPISTAS';-1,39 €;11.132,85 €;7386;-1,39;15.656,94 €;'sin fechas';26/08/2015;'AUTOPISTAS';'Gastos_Ocio y transporte';'Parking y peaje';'VARIABLES'
26/08/2015;26/08/2015;'AUTOPISTAS';-1,39 €;11.131,46 €;7387;-1,39;15.655,55 €;'sin fechas';26/08/2015;'AUTOPISTAS';'Gastos_Ocio y transporte';'Parking y peaje';'VARIABLES'
26/08/2015;26/08/2015;'GASOLINERA';-46,44 €;11.085,02 €;7388;-46,44;15.609,11 €;'sin fechas';26/08/2015;'GASOLINERA';'Gastos_Ocio y transporte';'Gasolina';'VARIABLES'
26/08/2015;26/08/2015;'REDPIZZA';-20,45 €;11.064,57 €;7389;-20,45;15.588,66 €;'sin fechas';26/08/2015;'REDPIZZA';'Gastos_Ocio y transporte';'Restaurantes';'VARIABLES'
26/08/2015;26/08/2015;'REINT.CAJERO';-50,00 €;11.014,57 €;7390;-50,00;15.538,66 €;'sin fechas';26/08/2015;'REINTCAJERO';'Gastos_Gastos varios';'Efectivo';'VARIABLES'
26/08/2015;26/08/2015;'TABASA VALLVI S. C:2T';-4,19 €;11.010,38 €;7391;-4,19;15.534,47 €;'sin fechas';26/08/2015;'TABASA';'Gastos_Ocio y transporte';'Parking y peaje';'VARIABLES'
27/08/2015;24/08/2015;'AUTOPISTAS';-1,39 €;11.008,99 €;7392;-1,39;15.533,08 €;'sin fechas';24/08/2015;'AUTOPISTAS';'Gastos_Ocio y transporte';'Parking y peaje';'VARIABLES'
27/08/2015;24/08/2015;'AUTOPISTAS';-1,39 €;11.007,60 €;7393;-1,39;15.531,69 €;'sin fechas';24/08/2015;'AUTOPISTAS';'Gastos_Ocio y transporte';'Parking y peaje';'VARIABLES'
27/08/2015;25/08/2015;'AUTOPISTAS';-1,39 €;11.006,21 €;7394;-1,39;15.530,30 €;'sin fechas';25/08/2015;'AUTOPISTAS';'Gastos_Ocio y transporte';'Parking y peaje';'VARIABLES'
27/08/2015;25/08/2015;'AUTOPISTAS';-1,39 €;11.004,82 €;7395;-1,39;15.528,91 €;'sin fechas';25/08/2015;'AUTOPISTAS';'Gastos_Ocio y transporte';'Parking y peaje';'VARIABLES'
27/08/2015;27/08/2015;'AUTOPISTAS';-4,19 €;11.000,63 €;7396;-4,19;15.524,72 €;'sin fechas';27/08/2015;'AUTOPISTAS';'Gastos_Ocio y transporte';'Parking y peaje';'VARIABLES'
27/08/2015;27/08/2015;'AUTOPISTAS';-1,39 €;10.999,24 €;7397;-1,39;15.523,33 €;'sin fechas';27/08/2015;'AUTOPISTAS';'Gastos_Ocio y transporte';'Parking y peaje';'VARIABLES'
27/08/2015;27/08/2015;'FARMACIA';-2,83 €;10.996,41 €;7398;-2,83;15.520,50 €;'sin fechas';27/08/2015;'FARMACIA';'Gastos_Salud, saber y deporte';'Farmacia';'VARIABLES'
27/08/2015;27/08/2015;'SEGUROS CATALANA';968,00 €;11.964,41 €;7399;968,00;16.488,50 €;'sin fechas';27/08/2015;'CATALANA';'Gastos_Ocio y transporte';'Parking y peaje';'VARIABLES'
28/08/2015;28/08/2015;'FOMENT DE TERRASSA, SA';2.510,50 €;14.474,91 €;7400;2.510,50;18.999,00 €;'sin fechas';28/08/2015;'FOMENT';'Ingresos';'Nomina';'FIJO'
28/08/2015;28/08/2015;'INFORMACIO I TECNOLOGIA DE CAT';1.599,27 €;16.074,18 €;7401;1.599,27;20.598,27 €;'sin fechas';28/08/2015;'INFORMACIO';'Ingresos';'Nomina';'FIJO'
29/08/2015;27/08/2015;'AUTOPISTAS';-1,39 €;16.072,79 €;7402;-1,39;20.596,88 €;'sin fechas';27/08/2015;'AUTOPISTAS';'Gastos_Ocio y transporte';'Parking y peaje';'VARIABLES'
29/08/2015;29/08/2015;'CAFETERIA';-3,45 €;16.069,34 €;7403;-3,45;20.593,43 €;'sin fechas';29/08/2015;'CAFETERIA';'Gastos_Compras';'Supermercado';'VARIABLES'
29/08/2015;29/08/2015;'MUSEUS';-28,00 €;16.041,34 €;7404;-28,00;20.565,43 €;'sin fechas';29/08/2015;'MUSEUS';'Gastos_Ocio y transporte';'Espectáculos';'VARIABLES'
29/08/2015;29/08/2015;'REDPIZZA';-17,65 €;16.023,69 €;7405;-17,65;20.547,78 €;'sin fechas';29/08/2015;'REDPIZZA';'Gastos_Ocio y transporte';'Restaurantes';'VARIABLES'
30/08/2015;30/08/2015;'PERRUQUERIA';-50,99 €;15.972,70 €;7406;-50,99;20.496,79 €;'sin fechas';30/08/2015;'PERRUQUERIA';'Gastos_Salud, saber y deporte';'Belleza';'VARIABLES'
31/08/2015;31/08/2015;'CAFETERIA';-4,10 €;15.968,60 €;7407;-4,10;20.492,69 €;'sin fechas';31/08/2015;'CAFETERIA';'Gastos_Compras';'Supermercado';'VARIABLES'
31/08/2015;31/08/2015;'CINES';-14,70 €;15.953,90 €;7408;-14,70;20.477,99 €;'sin fechas';31/08/2015;'CINES';'Gastos_Ocio y transporte';'Espectáculos';'VARIABLES'
31/08/2015;31/08/2015;'CINES';-42,50 €;15.911,40 €;7409;-42,50;20.435,49 €;'sin fechas';31/08/2015;'CINES';'Gastos_Ocio y transporte';'Espectáculos';'VARIABLES'
31/08/2015;31/08/2015;'FRANKFURT LES LLETRES';-3,90 €;15.907,50 €;7410;-3,90;20.431,59 €;'sin fechas';31/08/2015;'FRANKFURT';'Gastos_Ocio y transporte';'Restaurantes';'VARIABLES'
31/08/2015;31/08/2015;'REC. 6061.9600001223';-559,26 €;15.348,24 €;7411;-559,26;19.872,33 €;'sin fechas';31/08/2015;'REC';'Gastos_Banco y organismos';'Hipoteca';'FIJO'
31/08/2015;31/08/2015;'VIENA';-11,40 €;15.336,84 €;7412;-11,40;19.860,93 €;'sin fechas';31/08/2015;'VIENA';'Gastos_Ocio y transporte';'Restaurantes';'VARIABLES'
01/09/2015;28/08/2015;'AUTOPISTAS';-1,39 €;15.335,45 €;7413;-1,39;19.859,54 €;'sin fechas';28/08/2015;'AUTOPISTAS';'Gastos_Ocio y transporte';'Parking y peaje';'VARIABLES'
01/09/2015;28/08/2015;'AUTOPISTAS';-1,39 €;15.334,06 €;7414;-1,39;19.858,15 €;'sin fechas';28/08/2015;'AUTOPISTAS';'Gastos_Ocio y transporte';'Parking y peaje';'VARIABLES'
01/09/2015;30/08/2015;'AUTOPISTAS';-2,53 €;15.331,53 €;7415;-2,53;19.855,62 €;'sin fechas';30/08/2015;'AUTOPISTAS';'Gastos_Ocio y transporte';'Parking y peaje';'VARIABLES'
01/09/2015;30/08/2015;'AUTOPISTAS';-2,53 €;15.329,00 €;7416;-2,53;19.853,09 €;'sin fechas';30/08/2015;'AUTOPISTAS';'Gastos_Ocio y transporte';'Parking y peaje';'VARIABLES'
01/09/2015;01/09/2015;'AUTOPISTAS';-1,39 €;15.327,61 €;7417;-1,39;19.851,70 €;'sin fechas';01/09/2015;'AUTOPISTAS';'Gastos_Ocio y transporte';'Parking y peaje';'VARIABLES'
01/09/2015;30/08/2015;'CATALANA DIAG.I CIRUR';-8,05 €;15.319,56 €;7418;-8,05;19.843,65 €;'sin fechas';30/08/2015;'CATALANA';'Gastos_Ocio y transporte';'Parking y peaje';'VARIABLES'
01/09/2015;01/09/2015;'VIRGIN ACTIV';-55,95 €;15.263,61 €;7420;-55,95;19.787,70 €;'sin fechas';01/09/2015;'VIRGIN';'Gastos_Salud, saber y deporte';'Deportes';'VARIABLES'
01/09/2015;01/09/2015;'VIRGIN ACTIV';-55,95 €;15.207,66 €;7421;-55,95;19.731,75 €;'sin fechas';01/09/2015;'VIRGIN';'Gastos_Salud, saber y deporte';'Deportes';'VARIABLES'
02/09/2015;31/08/2015;'AUTOPISTAS';-1,39 €;15.206,27 €;7422;-1,39;19.730,36 €;'sin fechas';31/08/2015;'AUTOPISTAS';'Gastos_Ocio y transporte';'Parking y peaje';'VARIABLES'
02/09/2015;31/08/2015;'AUTOPISTAS';-1,39 €;15.204,88 €;7423;-1,39;19.728,97 €;'sin fechas';31/08/2015;'AUTOPISTAS';'Gastos_Ocio y transporte';'Parking y peaje';'VARIABLES'
02/09/2015;02/09/2015;'AUTOPISTAS';-3,72 €;15.201,16 €;7424;-3,72;19.725,25 €;'sin fechas';02/09/2015;'AUTOPISTAS';'Gastos_Ocio y transporte';'Parking y peaje';'VARIABLES'
02/09/2015;02/09/2015;'AUTOPISTAS';-3,72 €;15.197,44 €;7425;-3,72;19.721,53 €;'sin fechas';02/09/2015;'AUTOPISTAS';'Gastos_Ocio y transporte';'Parking y peaje';'VARIABLES'
02/09/2015;02/09/2015;'AUTOPISTAS';-1,39 €;15.196,05 €;7426;-1,39;19.720,14 €;'sin fechas';02/09/2015;'AUTOPISTAS';'Gastos_Ocio y transporte';'Parking y peaje';'VARIABLES'
02/09/2015;02/09/2015;'MUSEUS';-11,70 €;15.184,35 €;7427;-11,70;19.708,44 €;'sin fechas';02/09/2015;'MUSEUS';'Gastos_Ocio y transporte';'Espectáculos';'VARIABLES'
02/09/2015;02/09/2015;'MUSEUS';-8,10 €;15.176,25 €;7428;-8,10;19.700,34 €;'sin fechas';02/09/2015;'MUSEUS';'Gastos_Ocio y transporte';'Espectáculos';'VARIABLES'
02/09/2015;02/09/2015;'MUSEUS';-8,00 €;15.168,25 €;7429;-8,00;19.692,34 €;'sin fechas';02/09/2015;'MUSEUS';'Gastos_Ocio y transporte';'Espectáculos';'VARIABLES'
02/09/2015;02/09/2015;'MUSEUS';-4,50 €;15.163,75 €;7430;-4,50;19.687,84 €;'sin fechas';02/09/2015;'MUSEUS';'Gastos_Ocio y transporte';'Espectáculos';'VARIABLES'
02/09/2015;02/09/2015;'TABASA VALLVI S. C:2T';-4,19 €;15.159,56 €;7431;-4,19;19.683,65 €;'sin fechas';02/09/2015;'TABASA';'Gastos_Ocio y transporte';'Parking y peaje';'VARIABLES'
03/09/2015;03/09/2015;'CAFETERIA';-2,15 €;15.157,41 €;7432;-2,15;19.681,50 €;'sin fechas';03/09/2015;'CAFETERIA';'Gastos_Compras';'Supermercado';'VARIABLES'
03/09/2015;03/09/2015;'CAFETERIA';-2,70 €;15.154,71 €;7433;-2,70;19.678,80 €;'sin fechas';03/09/2015;'CAFETERIA';'Gastos_Compras';'Supermercado';'VARIABLES'
03/09/2015;03/09/2015;'FRANKFURT LES LLETRES';-4,20 €;15.150,51 €;7434;-4,20;19.674,60 €;'sin fechas';03/09/2015;'FRANKFURT';'Gastos_Ocio y transporte';'Restaurantes';'VARIABLES'
03/09/2015;03/09/2015;'MERCADONA';-17,33 €;15.133,18 €;7435;-17,33;19.657,27 €;'sin fechas';03/09/2015;'MERCADONA';'Gastos_Compras';'Supermercado';'VARIABLES'
04/09/2015;02/09/2015;'AUTOPISTAS';-1,39 €;15.131,79 €;7436;-1,39;19.655,88 €;'sin fechas';02/09/2015;'AUTOPISTAS';'Gastos_Ocio y transporte';'Parking y peaje';'VARIABLES'
04/09/2015;01/09/2015;'AUTOPISTAS';-1,39 €;15.130,40 €;7437;-1,39;19.654,49 €;'sin fechas';01/09/2015;'AUTOPISTAS';'Gastos_Ocio y transporte';'Parking y peaje';'VARIABLES'
04/09/2015;04/09/2015;'CAFETERIA';-4,10 €;15.126,30 €;7438;-4,10;19.650,39 €;'sin fechas';04/09/2015;'CAFETERIA';'Gastos_Compras';'Supermercado';'VARIABLES'
04/09/2015;04/09/2015;'IKEA';-12,60 €;15.113,70 €;7439;-12,60;19.637,79 €;'sin fechas';04/09/2015;'IKEA';'Gastos_Vivienda y vehiculo';'Mnto. hogar';'VARIABLES'
04/09/2015;04/09/2015;'IKEA';-3,10 €;15.110,60 €;7440;-3,10;19.634,69 €;'sin fechas';04/09/2015;'IKEA';'Gastos_Vivienda y vehiculo';'Mnto. hogar';'VARIABLES'
04/09/2015;04/09/2015;'IKEA';-3,95 €;15.106,65 €;7441;-3,95;19.630,74 €;'sin fechas';04/09/2015;'IKEA';'Gastos_Vivienda y vehiculo';'Mnto. hogar';'VARIABLES'
04/09/2015;04/09/2015;'FRANKFURT LES LLETRES';-5,00 €;15.101,65 €;7442;-5,00;19.625,74 €;'sin fechas';04/09/2015;'FRANKFURT';'Gastos_Ocio y transporte';'Restaurantes';'VARIABLES'
05/09/2015;03/09/2015;'AUTOPISTAS';-1,39 €;15.100,26 €;7443;-1,39;19.624,35 €;'sin fechas';03/09/2015;'AUTOPISTAS';'Gastos_Ocio y transporte';'Parking y peaje';'VARIABLES'
05/09/2015;03/09/2015;'AUTOPISTAS';-1,39 €;15.098,87 €;7444;-1,39;19.622,96 €;'sin fechas';03/09/2015;'AUTOPISTAS';'Gastos_Ocio y transporte';'Parking y peaje';'VARIABLES'
05/09/2015;05/09/2015;'CAFETERIA';-2,70 €;15.096,17 €;7445;-2,70;19.620,26 €;'sin fechas';05/09/2015;'CAFETERIA';'Gastos_Compras';'Supermercado';'VARIABLES'
05/09/2015;05/09/2015;'CAFETERIA';-4,50 €;15.091,67 €;7446;-4,50;19.615,76 €;'sin fechas';05/09/2015;'CAFETERIA';'Gastos_Compras';'Supermercado';'VARIABLES'
05/09/2015;05/09/2015;'FRANKFURT LES LLETRES';-2,50 €;15.089,17 €;7447;-2,50;19.613,26 €;'sin fechas';05/09/2015;'FRANKFURT';'Gastos_Ocio y transporte';'Restaurantes';'VARIABLES'
05/09/2015;05/09/2015;'MERCADONA';-16,18 €;15.072,99 €;7448;-16,18;19.597,08 €;'sin fechas';05/09/2015;'MERCADONA';'Gastos_Compras';'Supermercado';'VARIABLES'
05/09/2015;05/09/2015;'REINT.CAJERO';-300,00 €;14.772,99 €;7449;-300,00;19.297,08 €;'sin fechas';05/09/2015;'REINTCAJERO';'Gastos_Gastos varios';'Efectivo';'VARIABLES'
06/09/2015;06/09/2015;'CINES';-12,00 €;14.760,99 €;7450;-12,00;19.285,08 €;'sin fechas';06/09/2015;'CINES';'Gastos_Ocio y transporte';'Espectáculos';'VARIABLES'
06/09/2015;06/09/2015;'CINES';-12,60 €;14.748,39 €;7451;-12,60;19.272,48 €;'sin fechas';06/09/2015;'CINES';'Gastos_Ocio y transporte';'Espectáculos';'VARIABLES'
07/09/2015;07/09/2015;'ADESLAS';-111,00 €;14.637,39 €;7452;-111,00;19.161,48 €;'sin fechas';07/09/2015;'ADESLAS';'Gastos_Salud, saber y deporte';'Medico';'VARIABLES'
07/09/2015;07/09/2015;'BLITZ';-72,50 €;14.564,89 €;7453;-72,50;19.088,98 €;'sin fechas';07/09/2015;'BLITZ';'Gastos_Vivienda y vehiculo';'Alquiler Parking';'FIJO'
07/09/2015;07/09/2015;'CAFETERIA';-3,55 €;14.561,34 €;7454;-3,55;19.085,43 €;'sin fechas';07/09/2015;'CAFETERIA';'Gastos_Compras';'Supermercado';'VARIABLES'
07/09/2015;07/09/2015;'FRANKFURT LES LLETRES';-2,50 €;14.558,84 €;7455;-2,50;19.082,93 €;'sin fechas';07/09/2015;'FRANKFURT';'Gastos_Ocio y transporte';'Restaurantes';'VARIABLES'
08/09/2015;08/09/2015;'ESCOLA DE MUSICA';-97,50 €;14.461,34 €;7456;-97,50;18.985,43 €;'sin fechas';08/09/2015;'ESCOLA';'Gastos_Salud, saber y deporte';'Estudios';'VARIABLES'
09/09/2015;07/09/2015;'AUTOPISTAS';-1,39 €;14.459,95 €;7457;-1,39;18.984,04 €;'sin fechas';07/09/2015;'AUTOPISTAS';'Gastos_Ocio y transporte';'Parking y peaje';'VARIABLES'
09/09/2015;07/09/2015;'AUTOPISTAS';-1,39 €;14.458,56 €;7458;-1,39;18.982,65 €;'sin fechas';07/09/2015;'AUTOPISTAS';'Gastos_Ocio y transporte';'Parking y peaje';'VARIABLES'
09/09/2015;04/09/2015;'AUTOPISTAS';-1,39 €;14.457,17 €;7459;-1,39;18.981,26 €;'sin fechas';04/09/2015;'AUTOPISTAS';'Gastos_Ocio y transporte';'Parking y peaje';'VARIABLES'
09/09/2015;04/09/2015;'AUTOPISTAS';-1,39 €;14.455,78 €;7460;-1,39;18.979,87 €;'sin fechas';04/09/2015;'AUTOPISTAS';'Gastos_Ocio y transporte';'Parking y peaje';'VARIABLES'
10/09/2015;07/09/2015;'AUTOPISTAS';-4,19 €;14.451,59 €;7461;-4,19;18.975,68 €;'sin fechas';07/09/2015;'AUTOPISTAS';'Gastos_Ocio y transporte';'Parking y peaje';'VARIABLES'
10/09/2015;10/09/2015;'AUTOPISTAS';-4,19 €;14.447,40 €;7462;-4,19;18.971,49 €;'sin fechas';10/09/2015;'AUTOPISTAS';'Gastos_Ocio y transporte';'Parking y peaje';'VARIABLES'
10/09/2015;10/09/2015;'AUTOPISTAS';-3,72 €;14.443,68 €;7463;-3,72;18.967,77 €;'sin fechas';10/09/2015;'AUTOPISTAS';'Gastos_Ocio y transporte';'Parking y peaje';'VARIABLES'
10/09/2015;08/09/2015;'AUTOPISTAS';-1,39 €;14.442,29 €;7464;-1,39;18.966,38 €;'sin fechas';08/09/2015;'AUTOPISTAS';'Gastos_Ocio y transporte';'Parking y peaje';'VARIABLES'
10/09/2015;08/09/2015;'AUTOPISTAS';-1,39 €;14.440,90 €;7465;-1,39;18.964,99 €;'sin fechas';08/09/2015;'AUTOPISTAS';'Gastos_Ocio y transporte';'Parking y peaje';'VARIABLES'
10/09/2015;10/09/2015;'CAFETERIA';-4,50 €;14.436,40 €;7466;-4,50;18.960,49 €;'sin fechas';10/09/2015;'CAFETERIA';'Gastos_Compras';'Supermercado';'VARIABLES'
10/09/2015;10/09/2015;'CARREFOUR-[OTROS]';-26,60 €;14.409,80 €;7467;-26,60;18.933,89 €;'sin fechas';10/09/2015;'CARREFOUROTROS';'Gastos_Compras';'Supermercado';'VARIABLES'
10/09/2015;10/09/2015;'GASOLINERA';-45,57 €;14.364,23 €;7468;-45,57;18.888,32 €;'sin fechas';10/09/2015;'GASOLINERA';'Gastos_Ocio y transporte';'Gasolina';'VARIABLES'
11/09/2015;09/09/2015;'AUTOPISTAS';-1,39 €;14.362,84 €;7469;-1,39;18.886,93 €;'sin fechas';09/09/2015;'AUTOPISTAS';'Gastos_Ocio y transporte';'Parking y peaje';'VARIABLES'
11/09/2015;09/09/2015;'AUTOPISTAS';-1,39 €;14.361,45 €;7470;-1,39;18.885,54 €;'sin fechas';09/09/2015;'AUTOPISTAS';'Gastos_Ocio y transporte';'Parking y peaje';'VARIABLES'
11/09/2015;11/09/2015;'BON AREA';-17,31 €;14.344,14 €;7471;-17,31;18.868,23 €;'sin fechas';11/09/2015;'BON';'Gastos_Compras';'Supermercado';'VARIABLES'
11/09/2015;11/09/2015;'CAFETERIA';-3,60 €;14.340,54 €;7472;-3,60;18.864,63 €;'sin fechas';11/09/2015;'CAFETERIA';'Gastos_Compras';'Supermercado';'VARIABLES'
11/09/2015;11/09/2015;'CARREFOUR-[OTROS]';-6,54 €;14.334,00 €;7473;-6,54;18.858,09 €;'sin fechas';11/09/2015;'CARREFOUROTROS';'Gastos_Compras';'Supermercado';'VARIABLES'
11/09/2015;11/09/2015;'FRANKFURT LES LLETRES';-5,90 €;14.328,10 €;7474;-5,90;18.852,19 €;'sin fechas';11/09/2015;'FRANKFURT';'Gastos_Ocio y transporte';'Restaurantes';'VARIABLES'
11/09/2015;11/09/2015;'VIENA';-13,25 €;14.314,85 €;7475;-13,25;18.838,94 €;'sin fechas';11/09/2015;'VIENA';'Gastos_Ocio y transporte';'Restaurantes';'VARIABLES'
12/09/2015;12/09/2015;'AUTOPISTAS';-4,19 €;14.310,66 €;7476;-4,19;18.834,75 €;'sin fechas';12/09/2015;'AUTOPISTAS';'Gastos_Ocio y transporte';'Parking y peaje';'VARIABLES'
12/09/2015;12/09/2015;'CAFETERIA';-4,10 €;14.306,56 €;7477;-4,10;18.830,65 €;'sin fechas';12/09/2015;'CAFETERIA';'Gastos_Compras';'Supermercado';'VARIABLES'
12/09/2015;12/09/2015;'CAFETERIA';-0,90 €;14.305,66 €;7478;-0,90;18.829,75 €;'sin fechas';12/09/2015;'CAFETERIA';'Gastos_Compras';'Supermercado';'VARIABLES'
12/09/2015;12/09/2015;'IKEA';-411,92 €;13.893,74 €;7479;-411,92;18.417,83 €;'sin fechas';12/09/2015;'IKEA';'Gastos_Vivienda y vehiculo';'Mnto. hogar';'VARIABLES'
12/09/2015;12/09/2015;'FRANKFURT LES LLETRES';-2,50 €;13.891,24 €;7480;-2,50;18.415,33 €;'sin fechas';12/09/2015;'FRANKFURT';'Gastos_Ocio y transporte';'Restaurantes';'VARIABLES'
13/09/2015;13/09/2015;'CAFETERIA';-4,50 €;13.886,74 €;7481;-4,50;18.410,83 €;'sin fechas';13/09/2015;'CAFETERIA';'Gastos_Compras';'Supermercado';'VARIABLES'
14/09/2015;14/09/2015;'REINT.CAJERO';-140,00 €;13.746,74 €;7482;-140,00;18.270,83 €;'sin fechas';14/09/2015;'REINTCAJERO';'Gastos_Gastos varios';'Efectivo';'VARIABLES'
14/09/2015;14/09/2015;'RESTAURANTES';-24,15 €;13.722,59 €;7483;-24,15;18.246,68 €;'sin fechas';14/09/2015;'RESTAURANTES';'Gastos_Ocio y transporte';'Restaurantes';'VARIABLES'
15/09/2015;15/09/2015;'BON AREA';-31,81 €;13.690,78 €;7484;-31,81;18.214,87 €;'sin fechas';15/09/2015;'BON';'Gastos_Compras';'Supermercado';'VARIABLES'
15/09/2015;15/09/2015;'CRACK';-6,90 €;13.683,88 €;7485;-6,90;18.207,97 €;'sin fechas';15/09/2015;'CRACK';'Gastos_Compras';'Otras compras';'VARIABLES'
15/09/2015;15/09/2015;'DECATHLON';-48,55 €;13.635,33 €;7486;-48,55;18.159,42 €;'sin fechas';15/09/2015;'DECATHLON';'Gastos_Compras';'Deportivo';'VARIABLES'
15/09/2015;15/09/2015;'IKEA';-6,00 €;13.629,33 €;7487;-6,00;18.153,42 €;'sin fechas';15/09/2015;'IKEA';'Gastos_Vivienda y vehiculo';'Mnto. hogar';'VARIABLES'
15/09/2015;15/09/2015;'IKEA';-29,00 €;13.600,33 €;7488;-29,00;18.124,42 €;'sin fechas';15/09/2015;'IKEA';'Gastos_Vivienda y vehiculo';'Mnto. hogar';'VARIABLES'
15/09/2015;15/09/2015;'IKEA';-18,40 €;13.581,93 €;7489;-18,40;18.106,02 €;'sin fechas';15/09/2015;'IKEA';'Gastos_Vivienda y vehiculo';'Mnto. hogar';'VARIABLES'
15/09/2015;15/09/2015;'IKEA';-3,50 €;13.578,43 €;7490;-3,50;18.102,52 €;'sin fechas';15/09/2015;'IKEA';'Gastos_Vivienda y vehiculo';'Mnto. hogar';'VARIABLES'
15/09/2015;15/09/2015;'IKEA';-38,94 €;13.539,49 €;7491;-38,94;18.063,58 €;'sin fechas';15/09/2015;'IKEA';'Gastos_Vivienda y vehiculo';'Mnto. hogar';'VARIABLES'
15/09/2015;15/09/2015;'IKEA';-20,70 €;13.518,79 €;7492;-20,70;18.042,88 €;'sin fechas';15/09/2015;'IKEA';'Gastos_Vivienda y vehiculo';'Mnto. hogar';'VARIABLES'
15/09/2015;15/09/2015;'IKEA';-29,00 €;13.489,79 €;7493;-29,00;18.013,88 €;'sin fechas';15/09/2015;'IKEA';'Gastos_Vivienda y vehiculo';'Mnto. hogar';'VARIABLES'
15/09/2015;15/09/2015;'IKEA';-307,98 €;13.181,81 €;7494;-307,98;17.705,90 €;'sin fechas';15/09/2015;'IKEA';'Gastos_Vivienda y vehiculo';'Mnto. hogar';'VARIABLES'
15/09/2015;15/09/2015;'MEDIA MARKT';-577,00 €;12.604,81 €;7495;-577,00;17.128,90 €;'sin fechas';15/09/2015;'MEDIA';'Gastos_Compras';'Hobbys';'VARIABLES'
15/09/2015;15/09/2015;'MINA PUBLICA AIGUES T.01A75789';-31,05 €;12.573,76 €;7496;-31,05;17.097,85 €;'sin fechas';15/09/2015;'MINA';'Gastos_Servicios tipicos';'Agua';'FIJO'
15/09/2015;13/09/2015;'PARKING';-6,65 €;12.567,11 €;7497;-6,65;17.091,20 €;'sin fechas';13/09/2015;'PARKING';'Gastos_Ocio y transporte';'Parking y peaje';'VARIABLES'
15/09/2015;15/09/2015;'PARKING';-4,10 €;12.563,01 €;7498;-4,10;17.087,10 €;'sin fechas';15/09/2015;'PARKING';'Gastos_Ocio y transporte';'Parking y peaje';'VARIABLES'
15/09/2015;15/09/2015;'RESTAURANTES';-12,85 €;12.550,16 €;7499;-12,85;17.074,25 €;'sin fechas';15/09/2015;'RESTAURANTES';'Gastos_Ocio y transporte';'Restaurantes';'VARIABLES'
15/09/2015;15/09/2015;'SALA BADRINAS - UNIFORME';-52,60 €;12.497,56 €;7500;-52,60;17.021,65 €;'sin fechas';15/09/2015;'SALA';'Gastos_Salud, saber y deporte';'Estudios';'VARIABLES'
15/09/2015;15/09/2015;'VIRGIN ACTIV';-156,00 €;12.341,56 €;7501;-156,00;16.865,65 €;'sin fechas';15/09/2015;'VIRGIN';'Gastos_Salud, saber y deporte';'Deportes';'VARIABLES'
16/09/2015;13/09/2015;'AUTOPISTAS';-4,19 €;12.337,37 €;7502;-4,19;16.861,46 €;'sin fechas';13/09/2015;'AUTOPISTAS';'Gastos_Ocio y transporte';'Parking y peaje';'VARIABLES'
16/09/2015;14/09/2015;'AUTOPISTAS';-1,39 €;12.335,98 €;7503;-1,39;16.860,07 €;'sin fechas';14/09/2015;'AUTOPISTAS';'Gastos_Ocio y transporte';'Parking y peaje';'VARIABLES'
16/09/2015;14/09/2015;'AUTOPISTAS';-1,39 €;12.334,59 €;7504;-1,39;16.858,68 €;'sin fechas';14/09/2015;'AUTOPISTAS';'Gastos_Ocio y transporte';'Parking y peaje';'VARIABLES'
16/09/2015;10/09/2015;'AUTOPISTAS';-1,39 €;12.333,20 €;7505;-1,39;16.857,29 €;'sin fechas';10/09/2015;'AUTOPISTAS';'Gastos_Ocio y transporte';'Parking y peaje';'VARIABLES'
16/09/2015;16/09/2015;'CCM VIDA Y P SEGURO PRESTAMO';-23,24 €;12.309,96 €;7506;-23,24;16.834,05 €;'sin fechas';16/09/2015;'CCM';'Gastos_Seguros';'Seguro vida';'FIJO'
16/09/2015;16/09/2015;'CCM VIDA Y PENSIO 000000493358';-17,77 €;12.292,19 €;7507;-17,77;16.816,28 €;'sin fechas';16/09/2015;'CCM';'Gastos_Seguros';'Seguro vida';'FIJO'
17/09/2015;17/09/2015;'CAFETERIA';-4,50 €;12.287,69 €;7508;-4,50;16.811,78 €;'sin fechas';17/09/2015;'CAFETERIA';'Gastos_Compras';'Supermercado';'VARIABLES'
17/09/2015;17/09/2015;'ONO';-115,75 €;12.171,94 €;7509;-115,75;16.696,03 €;'sin fechas';17/09/2015;'ONO';'Gastos_Servicios tipicos';'Telecomunicaciones';'FIJO'
17/09/2015;17/09/2015;'PARKING';-5,20 €;12.166,74 €;7510;-5,20;16.690,83 €;'sin fechas';17/09/2015;'PARKING';'Gastos_Ocio y transporte';'Parking y peaje';'VARIABLES'
17/09/2015;17/09/2015;'TOCINERIES VENTURA';-10,26 €;12.156,48 €;7511;-10,26;16.680,57 €;'sin fechas';17/09/2015;'TOCINERIES';'Gastos_Compras';'Supermercado';'VARIABLES'
18/09/2015;17/09/2015;'AUTOPISTAS';-4,19 €;12.152,29 €;7512;-4,19;16.676,38 €;'sin fechas';17/09/2015;'AUTOPISTAS';'Gastos_Ocio y transporte';'Parking y peaje';'VARIABLES'
18/09/2015;18/09/2015;'CAPRABO';-10,00 €;12.142,29 €;7513;-10,00;16.666,38 €;'sin fechas';18/09/2015;'CAPRABO';'Gastos_Compras';'Supermercado';'VARIABLES'
18/09/2015;18/09/2015;'VIENA';-12,90 €;12.129,39 €;7514;-12,90;16.653,48 €;'sin fechas';18/09/2015;'VIENA';'Gastos_Ocio y transporte';'Restaurantes';'VARIABLES'
19/09/2015;17/09/2015;'AUTOPISTAS';-1,39 €;12.128,00 €;7515;-1,39;16.652,09 €;'sin fechas';17/09/2015;'AUTOPISTAS';'Gastos_Ocio y transporte';'Parking y peaje';'VARIABLES'
19/09/2015;17/09/2015;'AUTOPISTAS';-1,39 €;12.126,61 €;7516;-1,39;16.650,70 €;'sin fechas';17/09/2015;'AUTOPISTAS';'Gastos_Ocio y transporte';'Parking y peaje';'VARIABLES'
19/09/2015;19/09/2015;'FRANKFURT LES LLETRES';-3,90 €;12.122,71 €;7517;-3,90;16.646,80 €;'sin fechas';19/09/2015;'FRANKFURT';'Gastos_Ocio y transporte';'Restaurantes';'VARIABLES'
20/09/2015;20/09/2015;'AUTOPISTAS';-3,72 €;12.118,99 €;7518;-3,72;16.643,08 €;'sin fechas';20/09/2015;'AUTOPISTAS';'Gastos_Ocio y transporte';'Parking y peaje';'VARIABLES'
20/09/2015;20/09/2015;'CAFETERIA';-5,00 €;12.113,99 €;7519;-5,00;16.638,08 €;'sin fechas';20/09/2015;'CAFETERIA';'Gastos_Compras';'Supermercado';'VARIABLES'
20/09/2015;20/09/2015;'CAPRABO';-21,22 €;12.092,77 €;7520;-21,22;16.616,86 €;'sin fechas';20/09/2015;'CAPRABO';'Gastos_Compras';'Supermercado';'VARIABLES'
20/09/2015;20/09/2015;'IKEA';-107,00 €;11.985,77 €;7521;-107,00;16.509,86 €;'sin fechas';20/09/2015;'IKEA';'Gastos_Vivienda y vehiculo';'Mnto. hogar';'VARIABLES'
20/09/2015;20/09/2015;'IKEA';-7,45 €;11.978,32 €;7522;-7,45;16.502,41 €;'sin fechas';20/09/2015;'IKEA';'Gastos_Vivienda y vehiculo';'Mnto. hogar';'VARIABLES'
21/09/2015;21/09/2015;'BON AREA';-22,54 €;11.955,78 €;7523;-22,54;16.479,87 €;'sin fechas';21/09/2015;'BON';'Gastos_Compras';'Supermercado';'VARIABLES'
21/09/2015;21/09/2015;'CAFETERIA';-3,65 €;11.952,13 €;7524;-3,65;16.476,22 €;'sin fechas';21/09/2015;'CAFETERIA';'Gastos_Compras';'Supermercado';'VARIABLES'
22/09/2015;22/09/2015;'ABACUS';-23,30 €;11.928,83 €;7525;-23,30;16.452,92 €;'sin fechas';22/09/2015;'ABACUS';'Gastos_Salud, saber y deporte';'Estudios';'VARIABLES'
22/09/2015;18/09/2015;'AUTOPISTAS';-1,39 €;11.927,44 €;7526;-1,39;16.451,53 €;'sin fechas';18/09/2015;'AUTOPISTAS';'Gastos_Ocio y transporte';'Parking y peaje';'VARIABLES'
22/09/2015;18/09/2015;'AUTOPISTAS';-1,39 €;11.926,05 €;7527;-1,39;16.450,14 €;'sin fechas';18/09/2015;'AUTOPISTAS';'Gastos_Ocio y transporte';'Parking y peaje';'VARIABLES'
23/09/2015;21/09/2015;'AUTOPISTAS';-4,19 €;11.921,86 €;7528;-4,19;16.445,95 €;'sin fechas';21/09/2015;'AUTOPISTAS';'Gastos_Ocio y transporte';'Parking y peaje';'VARIABLES'
23/09/2015;21/09/2015;'AUTOPISTAS';-3,72 €;11.918,14 €;7529;-3,72;16.442,23 €;'sin fechas';21/09/2015;'AUTOPISTAS';'Gastos_Ocio y transporte';'Parking y peaje';'VARIABLES'
23/09/2015;21/09/2015;'AUTOPISTAS';-1,39 €;11.916,75 €;7530;-1,39;16.440,84 €;'sin fechas';21/09/2015;'AUTOPISTAS';'Gastos_Ocio y transporte';'Parking y peaje';'VARIABLES'
23/09/2015;21/09/2015;'AUTOPISTAS';-1,39 €;11.915,36 €;7531;-1,39;16.439,45 €;'sin fechas';21/09/2015;'AUTOPISTAS';'Gastos_Ocio y transporte';'Parking y peaje';'VARIABLES'
23/09/2015;23/09/2015;'RESTAURANTES';-13,85 €;11.901,51 €;7532;-13,85;16.425,60 €;'sin fechas';23/09/2015;'RESTAURANTES';'Gastos_Ocio y transporte';'Restaurantes';'VARIABLES'
23/09/2015;23/09/2015;'SALA BADRINAS - QUOTA';-219,00 €;11.682,51 €;7533;-219,00;16.206,60 €;'sin fechas';23/09/2015;'SALA';'Gastos_Salud, saber y deporte';'Estudios';'VARIABLES'
23/09/2015;23/09/2015;'SALA BADRINAS - QUOTA';-286,00 €;11.396,51 €;7534;-286,00;15.920,60 €;'sin fechas';23/09/2015;'SALA';'Gastos_Salud, saber y deporte';'Estudios';'VARIABLES'
24/09/2015;24/09/2015;'CAFETERIA';-4,05 €;11.392,46 €;7535;-4,05;15.916,55 €;'sin fechas';24/09/2015;'CAFETERIA';'Gastos_Compras';'Supermercado';'VARIABLES'
24/09/2015;24/09/2015;'GASOLINERA';-41,76 €;11.350,70 €;7536;-41,76;15.874,79 €;'sin fechas';24/09/2015;'GASOLINERA';'Gastos_Ocio y transporte';'Gasolina';'VARIABLES'
24/09/2015;24/09/2015;'FRANKFURT LES LLETRES';-8,75 €;11.341,95 €;7537;-8,75;15.866,04 €;'sin fechas';24/09/2015;'FRANKFURT';'Gastos_Ocio y transporte';'Restaurantes';'VARIABLES'
24/09/2015;24/09/2015;'FRANKFURT LES LLETRES';-2,50 €;11.339,45 €;7538;-2,50;15.863,54 €;'sin fechas';24/09/2015;'FRANKFURT';'Gastos_Ocio y transporte';'Restaurantes';'VARIABLES'
24/09/2015;24/09/2015;'PARKING';-4,90 €;11.334,55 €;7539;-4,90;15.858,64 €;'sin fechas';24/09/2015;'PARKING';'Gastos_Ocio y transporte';'Parking y peaje';'VARIABLES'
24/09/2015;24/09/2015;'RESTAURANTES';-9,40 €;11.325,15 €;7540;-9,40;15.849,24 €;'sin fechas';24/09/2015;'RESTAURANTES';'Gastos_Ocio y transporte';'Restaurantes';'VARIABLES'
24/09/2015;24/09/2015;'SUSCRIPCIO ARA ANUAL';-36,00 €;11.289,15 €;7541;-36,00;15.813,24 €;'sin fechas';24/09/2015;'SUSCRIPCIO';'Gastos_Compras';'Libreria';'VARIABLES'
24/09/2015;24/09/2015;'TOCINERIES VENTURA';-13,66 €;11.275,49 €;7542;-13,66;15.799,58 €;'sin fechas';24/09/2015;'TOCINERIES';'Gastos_Compras';'Supermercado';'VARIABLES'
25/09/2015;24/09/2015;'AUTOPISTAS';-4,19 €;11.271,30 €;7543;-4,19;15.795,39 €;'sin fechas';24/09/2015;'AUTOPISTAS';'Gastos_Ocio y transporte';'Parking y peaje';'VARIABLES'
25/09/2015;25/09/2015;'AUTOPISTAS';-3,72 €;11.267,58 €;7544;-3,72;15.791,67 €;'sin fechas';25/09/2015;'AUTOPISTAS';'Gastos_Ocio y transporte';'Parking y peaje';'VARIABLES'
25/09/2015;23/09/2015;'AUTOPISTAS';-1,39 €;11.266,19 €;7545;-1,39;15.790,28 €;'sin fechas';23/09/2015;'AUTOPISTAS';'Gastos_Ocio y transporte';'Parking y peaje';'VARIABLES'
25/09/2015;23/09/2015;'AUTOPISTAS';-1,39 €;11.264,80 €;7546;-1,39;15.788,89 €;'sin fechas';23/09/2015;'AUTOPISTAS';'Gastos_Ocio y transporte';'Parking y peaje';'VARIABLES'
25/09/2015;22/09/2015;'AUTOPISTAS';-1,39 €;11.263,41 €;7547;-1,39;15.787,50 €;'sin fechas';22/09/2015;'AUTOPISTAS';'Gastos_Ocio y transporte';'Parking y peaje';'VARIABLES'
25/09/2015;22/09/2015;'AUTOPISTAS';-1,39 €;11.262,02 €;7548;-1,39;15.786,11 €;'sin fechas';22/09/2015;'AUTOPISTAS';'Gastos_Ocio y transporte';'Parking y peaje';'VARIABLES'
25/09/2015;25/09/2015;'BON AREA';-12,70 €;11.249,32 €;7549;-12,70;15.773,41 €;'sin fechas';25/09/2015;'BON';'Gastos_Compras';'Supermercado';'VARIABLES'
25/09/2015;25/09/2015;'CAFETERIA';-2,15 €;11.247,17 €;7550;-2,15;15.771,26 €;'sin fechas';25/09/2015;'CAFETERIA';'Gastos_Compras';'Supermercado';'VARIABLES'
25/09/2015;25/09/2015;'FRANKFURT LES LLETRES';-14,45 €;11.232,72 €;7551;-14,45;15.756,81 €;'sin fechas';25/09/2015;'FRANKFURT';'Gastos_Ocio y transporte';'Restaurantes';'VARIABLES'
25/09/2015;25/09/2015;'FRANKFURT LES LLETRES';-2,50 €;11.230,22 €;7552;-2,50;15.754,31 €;'sin fechas';25/09/2015;'FRANKFURT';'Gastos_Ocio y transporte';'Restaurantes';'VARIABLES'
26/09/2015;26/09/2015;'CAFETERIA';-4,50 €;11.225,72 €;7553;-4,50;15.749,81 €;'sin fechas';26/09/2015;'CAFETERIA';'Gastos_Compras';'Supermercado';'VARIABLES'
26/09/2015;26/09/2015;'OCIO&OTROS';-39,60 €;11.186,12 €;7554;-39,60;15.710,21 €;'sin fechas';26/09/2015;'OCIOOTROS';'Gastos_Ocio y transporte';'Otros ocio';'VARIABLES'
26/09/2015;26/09/2015;'RESTAURANTES';-86,60 €;11.099,52 €;7555;-86,60;15.623,61 €;'sin fechas';26/09/2015;'RESTAURANTES';'Gastos_Ocio y transporte';'Restaurantes';'VARIABLES'
27/09/2015;26/09/2015;'AUTOPISTAS';-4,19 €;11.095,33 €;7556;-4,19;15.619,42 €;'sin fechas';26/09/2015;'AUTOPISTAS';'Gastos_Ocio y transporte';'Parking y peaje';'VARIABLES'
27/09/2015;27/09/2015;'FRANKFURT LES LLETRES';-5,60 €;11.089,73 €;7557;-5,60;15.613,82 €;'sin fechas';27/09/2015;'FRANKFURT';'Gastos_Ocio y transporte';'Restaurantes';'VARIABLES'
27/09/2015;27/09/2015;'FRANKFURT LES LLETRES';-5,00 €;11.084,73 €;7558;-5,00;15.608,82 €;'sin fechas';27/09/2015;'FRANKFURT';'Gastos_Ocio y transporte';'Restaurantes';'VARIABLES'
27/09/2015;27/09/2015;'REDPIZZA';-17,65 €;11.067,08 €;7559;-17,65;15.591,17 €;'sin fechas';27/09/2015;'REDPIZZA';'Gastos_Ocio y transporte';'Restaurantes';'VARIABLES'
28/09/2015;28/09/2015;'BON AREA';-15,18 €;11.051,90 €;7560;-15,18;15.575,99 €;'sin fechas';28/09/2015;'BON';'Gastos_Compras';'Supermercado';'VARIABLES'
28/09/2015;28/09/2015;'CAFETERIA';-3,65 €;11.048,25 €;7561;-3,65;15.572,34 €;'sin fechas';28/09/2015;'CAFETERIA';'Gastos_Compras';'Supermercado';'VARIABLES'
28/09/2015;28/09/2015;'FOMENT DE TERRASSA, SA';1.768,85 €;12.817,10 €;7562;1.768,85;17.341,19 €;'sin fechas';28/09/2015;'FOMENT';'Ingresos';'Nomina';'FIJO'
28/09/2015;28/09/2015;'FRANKFURT LES LLETRES';-4,35 €;12.812,75 €;7563;-4,35;17.336,84 €;'sin fechas';28/09/2015;'FRANKFURT';'Gastos_Ocio y transporte';'Restaurantes';'VARIABLES'
28/09/2015;28/09/2015;'MERCADONA';-153,65 €;12.659,10 €;7564;-153,65;17.183,19 €;'sin fechas';28/09/2015;'MERCADONA';'Gastos_Compras';'Supermercado';'VARIABLES'
29/09/2015;25/09/2015;'AUTOPISTAS';-1,39 €;12.657,71 €;7565;-1,39;17.181,80 €;'sin fechas';25/09/2015;'AUTOPISTAS';'Gastos_Ocio y transporte';'Parking y peaje';'VARIABLES'
29/09/2015;25/09/2015;'AUTOPISTAS';-1,39 €;12.656,32 €;7566;-1,39;17.180,41 €;'sin fechas';25/09/2015;'AUTOPISTAS';'Gastos_Ocio y transporte';'Parking y peaje';'VARIABLES'
29/09/2015;29/09/2015;'CAPRABO';-17,42 €;12.638,90 €;7567;-17,42;17.162,99 €;'sin fechas';29/09/2015;'CAPRABO';'Gastos_Compras';'Supermercado';'VARIABLES'
29/09/2015;29/09/2015;'INFORMACIO I TECNOLOGIA DE CAT';1.599,27 €;14.238,17 €;7568;1.599,27;18.762,26 €;'sin fechas';29/09/2015;'INFORMACIO';'Ingresos';'Nomina';'FIJO'
29/09/2015;29/09/2015;'REINT.CAJERO';-40,00 €;14.198,17 €;7569;-40,00;18.722,26 €;'sin fechas';29/09/2015;'REINTCAJERO';'Gastos_Gastos varios';'Efectivo';'VARIABLES'
30/09/2015;28/09/2015;'AUTOPISTAS';-4,19 €;14.193,98 €;7570;-4,19;18.718,07 €;'sin fechas';28/09/2015;'AUTOPISTAS';'Gastos_Ocio y transporte';'Parking y peaje';'VARIABLES'
30/09/2015;28/09/2015;'AUTOPISTAS';-1,39 €;14.192,59 €;7571;-1,39;18.716,68 €;'sin fechas';28/09/2015;'AUTOPISTAS';'Gastos_Ocio y transporte';'Parking y peaje';'VARIABLES'
30/09/2015;28/09/2015;'AUTOPISTAS';-1,39 €;14.191,20 €;7572;-1,39;18.715,29 €;'sin fechas';28/09/2015;'AUTOPISTAS';'Gastos_Ocio y transporte';'Parking y peaje';'VARIABLES'
30/09/2015;30/09/2015;'IBI';-44,99 €;14.146,21 €;7573;-44,99;18.670,30 €;'sin fechas';30/09/2015;'IBI';'Gastos_Banco y organismos';'Ayuntamiento';'FIJO'
30/09/2015;30/09/2015;'REC. 6061.9600001223';-559,26 €;13.586,95 €;7574;-559,26;18.111,04 €;'sin fechas';30/09/2015;'REC';'Gastos_Banco y organismos';'Hipoteca';'FIJO'
01/10/2015;01/10/2015;'AUTOPISTAS';-4,19 €;13.582,76 €;7575;-4,19;18.106,85 €;'sin fechas';01/10/2015;'AUTOPISTAS';'Gastos_Ocio y transporte';'Parking y peaje';'VARIABLES'
01/10/2015;01/10/2015;'CAFETERIA';-3,60 €;13.579,16 €;7576;-3,60;18.103,25 €;'sin fechas';01/10/2015;'CAFETERIA';'Gastos_Compras';'Supermercado';'VARIABLES'
01/10/2015;01/10/2015;'FARMACIA';-9,87 €;13.569,29 €;7578;-9,87;18.093,38 €;'sin fechas';01/10/2015;'FARMACIA';'Gastos_Salud, saber y deporte';'Farmacia';'VARIABLES'
01/10/2015;01/10/2015;'FRANKFURT LES LLETRES';-2,50 €;13.566,79 €;7579;-2,50;18.090,88 €;'sin fechas';01/10/2015;'FRANKFURT';'Gastos_Ocio y transporte';'Restaurantes';'VARIABLES'
01/10/2015;01/10/2015;'FRANKFURT LES LLETRES';-8,75 €;13.558,04 €;7580;-8,75;18.082,13 €;'sin fechas';01/10/2015;'FRANKFURT';'Gastos_Ocio y transporte';'Restaurantes';'VARIABLES'
01/10/2015;01/10/2015;'PARKING';-4,60 €;13.553,44 €;7581;-4,60;18.077,53 €;'sin fechas';01/10/2015;'PARKING';'Gastos_Ocio y transporte';'Parking y peaje';'VARIABLES'
01/10/2015;01/10/2015;'VIRGIN ACTIV';-55,95 €;13.497,49 €;7582;-55,95;18.021,58 €;'sin fechas';01/10/2015;'VIRGIN';'Gastos_Salud, saber y deporte';'Deportes';'VARIABLES'
01/10/2015;01/10/2015;'VIRGIN ACTIV';-55,95 €;13.441,54 €;7583;-55,95;17.965,63 €;'sin fechas';01/10/2015;'VIRGIN';'Gastos_Salud, saber y deporte';'Deportes';'VARIABLES'
02/10/2015;02/10/2015;'AUTOPISTAS';-4,19 €;13.437,35 €;7584;-4,19;17.961,44 €;'sin fechas';02/10/2015;'AUTOPISTAS';'Gastos_Ocio y transporte';'Parking y peaje';'VARIABLES'
02/10/2015;30/09/2015;'AUTOPISTAS';-1,39 €;13.435,96 €;7585;-1,39;17.960,05 €;'sin fechas';30/09/2015;'AUTOPISTAS';'Gastos_Ocio y transporte';'Parking y peaje';'VARIABLES'
02/10/2015;30/09/2015;'AUTOPISTAS';-1,39 €;13.434,57 €;7586;-1,39;17.958,66 €;'sin fechas';30/09/2015;'AUTOPISTAS';'Gastos_Ocio y transporte';'Parking y peaje';'VARIABLES'
02/10/2015;29/09/2015;'AUTOPISTAS';-1,39 €;13.433,18 €;7587;-1,39;17.957,27 €;'sin fechas';29/09/2015;'AUTOPISTAS';'Gastos_Ocio y transporte';'Parking y peaje';'VARIABLES'
02/10/2015;29/09/2015;'AUTOPISTAS';-1,39 €;13.431,79 €;7588;-1,39;17.955,88 €;'sin fechas';29/09/2015;'AUTOPISTAS';'Gastos_Ocio y transporte';'Parking y peaje';'VARIABLES'
02/10/2015;02/10/2015;'DECATHLON';-12,95 €;13.418,84 €;7589;-12,95;17.942,93 €;'sin fechas';02/10/2015;'DECATHLON';'Gastos_Compras';'Deportivo';'VARIABLES'
02/10/2015;02/10/2015;'FARMACIA';-28,80 €;13.390,04 €;7590;-28,80;17.914,13 €;'sin fechas';02/10/2015;'FARMACIA';'Gastos_Salud, saber y deporte';'Farmacia';'VARIABLES'
02/10/2015;02/10/2015;'MERCADONA';-4,05 €;13.385,99 €;7591;-4,05;17.910,08 €;'sin fechas';02/10/2015;'MERCADONA';'Gastos_Compras';'Supermercado';'VARIABLES'
02/10/2015;02/10/2015;'SALA BADRINAS - MENJADOR';-77,09 €;13.308,90 €;7592;-77,09;17.832,99 €;'sin fechas';02/10/2015;'SALA';'Gastos_Salud, saber y deporte';'Estudios';'VARIABLES'
03/10/2015;03/10/2015;'AUTOPISTAS';-4,19 €;13.304,71 €;7593;-4,19;17.828,80 €;'sin fechas';03/10/2015;'AUTOPISTAS';'Gastos_Ocio y transporte';'Parking y peaje';'VARIABLES'
03/10/2015;03/10/2015;'CAFETERIA';-3,65 €;13.301,06 €;7594;-3,65;17.825,15 €;'sin fechas';03/10/2015;'CAFETERIA';'Gastos_Compras';'Supermercado';'VARIABLES'
03/10/2015;03/10/2015;'FRANKFURT LES LLETRES';-18,65 €;13.282,41 €;7595;-18,65;17.806,50 €;'sin fechas';03/10/2015;'FRANKFURT';'Gastos_Ocio y transporte';'Restaurantes';'VARIABLES'
03/10/2015;03/10/2015;'PARKING';-2,15 €;13.280,26 €;7596;-2,15;17.804,35 €;'sin fechas';03/10/2015;'PARKING';'Gastos_Ocio y transporte';'Parking y peaje';'VARIABLES'
04/10/2015;04/10/2015;'BON AREA';-18,93 €;13.261,33 €;7597;-18,93;17.785,42 €;'sin fechas';04/10/2015;'BON';'Gastos_Compras';'Supermercado';'VARIABLES'
04/10/2015;04/10/2015;'CAFETERIA';-2,70 €;13.258,63 €;7598;-2,70;17.782,72 €;'sin fechas';04/10/2015;'CAFETERIA';'Gastos_Compras';'Supermercado';'VARIABLES'
04/10/2015;04/10/2015;'CARREFOUR-[OTROS]';-13,75 €;13.244,88 €;7599;-13,75;17.768,97 €;'sin fechas';04/10/2015;'CARREFOUROTROS';'Gastos_Compras';'Supermercado';'VARIABLES'
04/10/2015;04/10/2015;'FRANKFURT LES LLETRES';-2,50 €;13.242,38 €;7600;-2,50;17.766,47 €;'sin fechas';04/10/2015;'FRANKFURT';'Gastos_Ocio y transporte';'Restaurantes';'VARIABLES'
04/10/2015;04/10/2015;'FRANKFURT LES LLETRES';-7,45 €;13.234,93 €;7601;-7,45;17.759,02 €;'sin fechas';04/10/2015;'FRANKFURT';'Gastos_Ocio y transporte';'Restaurantes';'VARIABLES'
04/10/2015;04/10/2015;'Regalos JV';-59,95 €;13.174,98 €;7602;-59,95;17.699,07 €;'sin fechas';04/10/2015;'REGALOS';'Gastos_Compras';'Regalos';'VARIABLES'
04/10/2015;04/10/2015;'REINT.CAJERO';-60,00 €;13.114,98 €;7603;-60,00;17.639,07 €;'sin fechas';04/10/2015;'REINTCAJERO';'Gastos_Gastos varios';'Efectivo';'VARIABLES'
05/10/2015;04/10/2015;'AUTOPISTAS';-4,19 €;13.110,79 €;7604;-4,19;17.634,88 €;'sin fechas';04/10/2015;'AUTOPISTAS';'Gastos_Ocio y transporte';'Parking y peaje';'VARIABLES'
05/10/2015;05/10/2015;'CAFETERIA';-3,65 €;13.107,14 €;7605;-3,65;17.631,23 €;'sin fechas';05/10/2015;'CAFETERIA';'Gastos_Compras';'Supermercado';'VARIABLES'
05/10/2015;05/10/2015;'SEGUROS CATALANA';-302,46 €;12.804,68 €;7606;-302,46;17.328,77 €;'sin fechas';05/10/2015;'CATALANA';'Gastos_Ocio y transporte';'Parking y peaje';'VARIABLES'
06/10/2015;06/10/2015;'ESCOLA DE MUSICA';-112,50 €;12.692,18 €;7607;-112,50;17.216,27 €;'sin fechas';06/10/2015;'ESCOLA';'Gastos_Salud, saber y deporte';'Estudios';'VARIABLES'
07/10/2015;05/10/2015;'AUTOPISTAS';-4,19 €;12.687,99 €;7608;-4,19;17.212,08 €;'sin fechas';05/10/2015;'AUTOPISTAS';'Gastos_Ocio y transporte';'Parking y peaje';'VARIABLES'
07/10/2015;05/10/2015;'AUTOPISTAS';-1,39 €;12.686,60 €;7609;-1,39;17.210,69 €;'sin fechas';05/10/2015;'AUTOPISTAS';'Gastos_Ocio y transporte';'Parking y peaje';'VARIABLES'
07/10/2015;05/10/2015;'AUTOPISTAS';-1,39 €;12.685,21 €;7610;-1,39;17.209,30 €;'sin fechas';05/10/2015;'AUTOPISTAS';'Gastos_Ocio y transporte';'Parking y peaje';'VARIABLES'
07/10/2015;02/10/2015;'AUTOPISTAS';-1,39 €;12.683,82 €;7611;-1,39;17.207,91 €;'sin fechas';02/10/2015;'AUTOPISTAS';'Gastos_Ocio y transporte';'Parking y peaje';'VARIABLES'
07/10/2015;02/10/2015;'AUTOPISTAS';-1,39 €;12.682,43 €;7612;-1,39;17.206,52 €;'sin fechas';02/10/2015;'AUTOPISTAS';'Gastos_Ocio y transporte';'Parking y peaje';'VARIABLES'
07/10/2015;01/10/2015;'AUTOPISTAS';-1,39 €;12.681,04 €;7613;-1,39;17.205,13 €;'sin fechas';01/10/2015;'AUTOPISTAS';'Gastos_Ocio y transporte';'Parking y peaje';'VARIABLES'
07/10/2015;01/10/2015;'AUTOPISTAS';-1,39 €;12.679,65 €;7614;-1,39;17.203,74 €;'sin fechas';01/10/2015;'AUTOPISTAS';'Gastos_Ocio y transporte';'Parking y peaje';'VARIABLES'
07/10/2015;07/10/2015;'RESTAURANTES';-10,00 €;12.669,65 €;7615;-10,00;17.193,74 €;'sin fechas';07/10/2015;'RESTAURANTES';'Gastos_Ocio y transporte';'Restaurantes';'VARIABLES'
08/10/2015;08/10/2015;'AUTOPISTAS';-4,19 €;12.665,46 €;7616;-4,19;17.189,55 €;'sin fechas';08/10/2015;'AUTOPISTAS';'Gastos_Ocio y transporte';'Parking y peaje';'VARIABLES'
08/10/2015;06/10/2015;'AUTOPISTAS';-1,39 €;12.664,07 €;7617;-1,39;17.188,16 €;'sin fechas';06/10/2015;'AUTOPISTAS';'Gastos_Ocio y transporte';'Parking y peaje';'VARIABLES'
08/10/2015;06/10/2015;'AUTOPISTAS';-1,39 €;12.662,68 €;7618;-1,39;17.186,77 €;'sin fechas';06/10/2015;'AUTOPISTAS';'Gastos_Ocio y transporte';'Parking y peaje';'VARIABLES'
08/10/2015;08/10/2015;'CAFETERIA';-0,70 €;12.661,98 €;7619;-0,70;17.186,07 €;'sin fechas';08/10/2015;'CAFETERIA';'Gastos_Compras';'Supermercado';'VARIABLES'
08/10/2015;06/10/2015;'DEV.COMPRA TJ 3% DTO REPSOL EURO 6000';2,61 €;12.664,59 €;7620;2,61;17.188,68 €;'sin fechas';06/10/2015;'DEVCOMPRA';'Ingresos';'Devoluciones';'VARIABLES'
08/10/2015;08/10/2015;'GASOLINERA';-44,13 €;12.620,46 €;7621;-44,13;17.144,55 €;'sin fechas';08/10/2015;'GASOLINERA';'Gastos_Ocio y transporte';'Gasolina';'VARIABLES'
08/10/2015;08/10/2015;'H&M';-51,93 €;12.568,53 €;7622;-51,93;17.092,62 €;'sin fechas';08/10/2015;'HM';'Gastos_Compras';'Ropa';'VARIABLES'
08/10/2015;08/10/2015;'HOGAR&MODA';-19,12 €;12.549,41 €;7623;-19,12;17.073,50 €;'sin fechas';08/10/2015;'HOGARMODA';'Gastos_Compras';'Ropa';'VARIABLES'
08/10/2015;08/10/2015;'FRANKFURT LES LLETRES';-18,45 €;12.530,96 €;7624;-18,45;17.055,05 €;'sin fechas';08/10/2015;'FRANKFURT';'Gastos_Ocio y transporte';'Restaurantes';'VARIABLES'
08/10/2015;08/10/2015;'FRANKFURT LES LLETRES';-2,50 €;12.528,46 €;7625;-2,50;17.052,55 €;'sin fechas';08/10/2015;'FRANKFURT';'Gastos_Ocio y transporte';'Restaurantes';'VARIABLES'
08/10/2015;08/10/2015;'PARKING';-2,45 €;12.526,01 €;7626;-2,45;17.050,10 €;'sin fechas';08/10/2015;'PARKING';'Gastos_Ocio y transporte';'Parking y peaje';'VARIABLES'
08/10/2015;08/10/2015;'PARKING';-1,55 €;12.524,46 €;7627;-1,55;17.048,55 €;'sin fechas';08/10/2015;'PARKING';'Gastos_Ocio y transporte';'Parking y peaje';'VARIABLES'
08/10/2015;08/10/2015;'TOCINERIES VENTURA';-7,99 €;12.516,47 €;7628;-7,99;17.040,56 €;'sin fechas';08/10/2015;'TOCINERIES';'Gastos_Compras';'Supermercado';'VARIABLES'
09/10/2015;09/10/2015;'ADESLAS';-111,00 €;12.405,47 €;7629;-111,00;16.929,56 €;'sin fechas';09/10/2015;'ADESLAS';'Gastos_Salud, saber y deporte';'Medico';'VARIABLES'
09/10/2015;07/10/2015;'AUTOPISTAS';-1,39 €;12.404,08 €;7630;-1,39;16.928,17 €;'sin fechas';07/10/2015;'AUTOPISTAS';'Gastos_Ocio y transporte';'Parking y peaje';'VARIABLES'
09/10/2015;07/10/2015;'AUTOPISTAS';-1,39 €;12.402,69 €;7631;-1,39;16.926,78 €;'sin fechas';07/10/2015;'AUTOPISTAS';'Gastos_Ocio y transporte';'Parking y peaje';'VARIABLES'
09/10/2015;09/10/2015;'CAFETERIA';-0,40 €;12.402,29 €;7632;-0,40;16.926,38 €;'sin fechas';09/10/2015;'CAFETERIA';'Gastos_Compras';'Supermercado';'VARIABLES'
09/10/2015;09/10/2015;'FRANKFURT LES LLETRES';-7,40 €;12.394,89 €;7633;-7,40;16.918,98 €;'sin fechas';09/10/2015;'FRANKFURT';'Gastos_Ocio y transporte';'Restaurantes';'VARIABLES'
09/10/2015;09/10/2015;'MERCADONA';-26,15 €;12.368,74 €;7634;-26,15;16.892,83 €;'sin fechas';09/10/2015;'MERCADONA';'Gastos_Compras';'Supermercado';'VARIABLES'
10/10/2015;09/10/2015;'AUTOPISTAS';-4,19 €;12.364,55 €;7635;-4,19;16.888,64 €;'sin fechas';09/10/2015;'AUTOPISTAS';'Gastos_Ocio y transporte';'Parking y peaje';'VARIABLES'
10/10/2015;10/10/2015;'AUTOPISTAS';-4,19 €;12.360,36 €;7636;-4,19;16.884,45 €;'sin fechas';10/10/2015;'AUTOPISTAS';'Gastos_Ocio y transporte';'Parking y peaje';'VARIABLES'
10/10/2015;10/10/2015;'CAFETERIA';-2,15 €;12.358,21 €;7637;-2,15;16.882,30 €;'sin fechas';10/10/2015;'CAFETERIA';'Gastos_Compras';'Supermercado';'VARIABLES'
10/10/2015;10/10/2015;'MERCADONA';-21,70 €;12.336,51 €;7638;-21,70;16.860,60 €;'sin fechas';10/10/2015;'MERCADONA';'Gastos_Compras';'Supermercado';'VARIABLES'
11/10/2015;11/10/2015;'AUTOPISTAS';-4,19 €;12.332,32 €;7639;-4,19;16.856,41 €;'sin fechas';11/10/2015;'AUTOPISTAS';'Gastos_Ocio y transporte';'Parking y peaje';'VARIABLES'
11/10/2015;11/10/2015;'FRANKFURT LES LLETRES';-5,00 €;12.327,32 €;7640;-5,00;16.851,41 €;'sin fechas';11/10/2015;'FRANKFURT';'Gastos_Ocio y transporte';'Restaurantes';'VARIABLES'
11/10/2015;11/10/2015;'PERRUQUERIA';-20,01 €;12.307,31 €;7641;-20,01;16.831,40 €;'sin fechas';11/10/2015;'PERRUQUERIA';'Gastos_Salud, saber y deporte';'Belleza';'VARIABLES'
11/10/2015;11/10/2015;'RESTAURANTES';-47,50 €;12.259,81 €;7642;-47,50;16.783,90 €;'sin fechas';11/10/2015;'RESTAURANTES';'Gastos_Ocio y transporte';'Restaurantes';'VARIABLES'
12/10/2015;12/10/2015;'HOGAR&OTROS';-10,89 €;12.248,92 €;7643;-10,89;16.773,01 €;'sin fechas';12/10/2015;'HOGAROTROS';'Gastos_Vivienda y vehiculo';'Otros vivienda';'VARIABLES'
12/10/2015;12/10/2015;'FRANKFURT LES LLETRES';-2,50 €;12.246,42 €;7644;-2,50;16.770,51 €;'sin fechas';12/10/2015;'FRANKFURT';'Gastos_Ocio y transporte';'Restaurantes';'VARIABLES'
12/10/2015;12/10/2015;'MEDIA MARKT';-27,98 €;12.218,44 €;7645;-27,98;16.742,53 €;'sin fechas';12/10/2015;'MEDIA';'Gastos_Compras';'Hobbys';'VARIABLES'
12/10/2015;12/10/2015;'Regalos JV';-25,81 €;12.192,63 €;7646;-25,81;16.716,72 €;'sin fechas';12/10/2015;'REGALOS';'Gastos_Compras';'Regalos';'VARIABLES'
13/10/2015;13/10/2015;'CARREFOUR-[OTROS]';-32,34 €;12.160,29 €;7647;-32,34;16.684,38 €;'sin fechas';13/10/2015;'CARREFOUROTROS';'Gastos_Compras';'Supermercado';'VARIABLES'
13/10/2015;13/10/2015;'RESTAURANTES';-124,55 €;12.035,74 €;7648;-124,55;16.559,83 €;'sin fechas';13/10/2015;'RESTAURANTES';'Gastos_Ocio y transporte';'Restaurantes';'VARIABLES'
14/10/2015;14/10/2015;'BLITZ';-72,50 €;11.963,24 €;7649;-72,50;16.487,33 €;'sin fechas';14/10/2015;'BLITZ';'Gastos_Vivienda y vehiculo';'Alquiler Parking';'FIJO'
14/10/2015;14/10/2015;'CINES';-28,00 €;11.935,24 €;7650;-28,00;16.459,33 €;'sin fechas';14/10/2015;'CINES';'Gastos_Ocio y transporte';'Espectáculos';'VARIABLES'
15/10/2015;13/10/2015;'AUTOPISTAS';-1,39 €;11.933,85 €;7651;-1,39;16.457,94 €;'sin fechas';13/10/2015;'AUTOPISTAS';'Gastos_Ocio y transporte';'Parking y peaje';'VARIABLES'
15/10/2015;13/10/2015;'AUTOPISTAS';-1,39 €;11.932,46 €;7652;-1,39;16.456,55 €;'sin fechas';13/10/2015;'AUTOPISTAS';'Gastos_Ocio y transporte';'Parking y peaje';'VARIABLES'
15/10/2015;09/10/2015;'AUTOPISTAS';-1,39 €;11.931,07 €;7653;-1,39;16.455,16 €;'sin fechas';09/10/2015;'AUTOPISTAS';'Gastos_Ocio y transporte';'Parking y peaje';'VARIABLES'
15/10/2015;09/10/2015;'AUTOPISTAS';-1,39 €;11.929,68 €;7654;-1,39;16.453,77 €;'sin fechas';09/10/2015;'AUTOPISTAS';'Gastos_Ocio y transporte';'Parking y peaje';'VARIABLES'
15/10/2015;08/10/2015;'AUTOPISTAS';-1,39 €;11.928,29 €;7655;-1,39;16.452,38 €;'sin fechas';08/10/2015;'AUTOPISTAS';'Gastos_Ocio y transporte';'Parking y peaje';'VARIABLES'
15/10/2015;08/10/2015;'AUTOPISTAS';-1,39 €;11.926,90 €;7656;-1,39;16.450,99 €;'sin fechas';08/10/2015;'AUTOPISTAS';'Gastos_Ocio y transporte';'Parking y peaje';'VARIABLES'
15/10/2015;15/10/2015;'GAS NATURAL';-148,85 €;11.778,05 €;7657;-148,85;16.302,14 €;'sin fechas';15/10/2015;'GAS';'Gastos_Servicios tipicos';'Gas';'FIJO'
15/10/2015;15/10/2015;'REDPIZZA';-17,65 €;11.760,40 €;7658;-17,65;16.284,49 €;'sin fechas';15/10/2015;'REDPIZZA';'Gastos_Ocio y transporte';'Restaurantes';'VARIABLES'
15/10/2015;15/10/2015;'REINT.CAJERO';-100,00 €;11.660,40 €;7659;-100,00;16.184,49 €;'sin fechas';15/10/2015;'REINTCAJERO';'Gastos_Gastos varios';'Efectivo';'VARIABLES'
15/10/2015;15/10/2015;'REINT.CAJERO';-150,00 €;11.510,40 €;7660;-150,00;16.034,49 €;'sin fechas';15/10/2015;'REINTCAJERO';'Gastos_Gastos varios';'Efectivo';'VARIABLES'
16/10/2015;14/10/2015;'AUTOPISTAS';-1,39 €;11.509,01 €;7661;-1,39;16.033,10 €;'sin fechas';14/10/2015;'AUTOPISTAS';'Gastos_Ocio y transporte';'Parking y peaje';'VARIABLES'
16/10/2015;14/10/2015;'AUTOPISTAS';-1,39 €;11.507,62 €;7662;-1,39;16.031,71 €;'sin fechas';14/10/2015;'AUTOPISTAS';'Gastos_Ocio y transporte';'Parking y peaje';'VARIABLES'
16/10/2015;16/10/2015;'CAPRABO';-12,26 €;11.495,36 €;7663;-12,26;16.019,45 €;'sin fechas';16/10/2015;'CAPRABO';'Gastos_Compras';'Supermercado';'VARIABLES'
16/10/2015;16/10/2015;'CCM VIDA Y P SEGURO PRESTAMO';-23,17 €;11.472,19 €;7664;-23,17;15.996,28 €;'sin fechas';16/10/2015;'CCM';'Gastos_Seguros';'Seguro vida';'FIJO'
16/10/2015;16/10/2015;'CCM VIDA Y PENSIO 000000493358';-17,71 €;11.454,48 €;7665;-17,71;15.978,57 €;'sin fechas';16/10/2015;'CCM';'Gastos_Seguros';'Seguro vida';'FIJO'
16/10/2015;16/10/2015;'RESTAURANTES';-7,60 €;11.446,88 €;7666;-7,60;15.970,97 €;'sin fechas';16/10/2015;'RESTAURANTES';'Gastos_Ocio y transporte';'Restaurantes';'VARIABLES'
16/10/2015;16/10/2015;'RESTAURANTES';-7,45 €;11.439,43 €;7667;-7,45;15.963,52 €;'sin fechas';16/10/2015;'RESTAURANTES';'Gastos_Ocio y transporte';'Restaurantes';'VARIABLES'
17/10/2015;17/10/2015;'CAFETERIA';-3,60 €;11.435,83 €;7668;-3,60;15.959,92 €;'sin fechas';17/10/2015;'CAFETERIA';'Gastos_Compras';'Supermercado';'VARIABLES'
17/10/2015;17/10/2015;'HOGAR&OTROS';-18,49 €;11.417,34 €;7669;-18,49;15.941,43 €;'sin fechas';17/10/2015;'HOGAROTROS';'Gastos_Vivienda y vehiculo';'Otros vivienda';'VARIABLES'
17/10/2015;17/10/2015;'RESTAURANTES';-2,50 €;11.414,84 €;7670;-2,50;15.938,93 €;'sin fechas';17/10/2015;'RESTAURANTES';'Gastos_Ocio y transporte';'Restaurantes';'VARIABLES'
17/10/2015;12/10/2015;'TABASA VALLVI S. C:2T';-4,19 €;11.410,65 €;7671;-4,19;15.934,74 €;'sin fechas';12/10/2015;'TABASA';'Gastos_Ocio y transporte';'Parking y peaje';'VARIABLES'
17/10/2015;16/10/2015;'TABASA VALLVI S. C:2T';-4,19 €;11.406,46 €;7672;-4,19;15.930,55 €;'sin fechas';16/10/2015;'TABASA';'Gastos_Ocio y transporte';'Parking y peaje';'VARIABLES'
17/10/2015;17/10/2015;'TABASA VALLVI S. C:2T';-4,19 €;11.402,27 €;7673;-4,19;15.926,36 €;'sin fechas';17/10/2015;'TABASA';'Gastos_Ocio y transporte';'Parking y peaje';'VARIABLES'
17/10/2015;17/10/2015;'TACISA';-34,62 €;11.367,65 €;7674;-34,62;15.891,74 €;'sin fechas';17/10/2015;'TACISA';'Gastos_Compras';'Supermercado';'VARIABLES'
18/10/2015;15/10/2015;'AUTOPISTAS';-1,39 €;11.366,26 €;7675;-1,39;15.890,35 €;'sin fechas';15/10/2015;'AUTOPISTAS';'Gastos_Ocio y transporte';'Parking y peaje';'VARIABLES'
18/10/2015;15/10/2015;'AUTOPISTAS';-1,39 €;11.364,87 €;7676;-1,39;15.888,96 €;'sin fechas';15/10/2015;'AUTOPISTAS';'Gastos_Ocio y transporte';'Parking y peaje';'VARIABLES'
18/10/2015;18/10/2015;'CAFETERIA';-5,75 €;11.359,12 €;7677;-5,75;15.883,21 €;'sin fechas';18/10/2015;'CAFETERIA';'Gastos_Compras';'Supermercado';'VARIABLES'
18/10/2015;18/10/2015;'CAFETERIA';-3,60 €;11.355,52 €;7678;-3,60;15.879,61 €;'sin fechas';18/10/2015;'CAFETERIA';'Gastos_Compras';'Supermercado';'VARIABLES'
18/10/2015;18/10/2015;'FARMACIA';-2,93 €;11.352,59 €;7679;-2,93;15.876,68 €;'sin fechas';18/10/2015;'FARMACIA';'Gastos_Salud, saber y deporte';'Farmacia';'VARIABLES'
18/10/2015;18/10/2015;'RESTAURANTES';-2,50 €;11.350,09 €;7680;-2,50;15.874,18 €;'sin fechas';18/10/2015;'RESTAURANTES';'Gastos_Ocio y transporte';'Restaurantes';'VARIABLES'
18/10/2015;18/10/2015;'RESTAURANTES';-5,60 €;11.344,49 €;7681;-5,60;15.868,58 €;'sin fechas';18/10/2015;'RESTAURANTES';'Gastos_Ocio y transporte';'Restaurantes';'VARIABLES'
19/10/2015;19/10/2015;'AUTOPISTAS';-1,39 €;11.343,10 €;7682;-1,39;15.867,19 €;'sin fechas';19/10/2015;'AUTOPISTAS';'Gastos_Ocio y transporte';'Parking y peaje';'VARIABLES'
19/10/2015;19/10/2015;'AUTOPISTAS';-1,39 €;11.341,71 €;7683;-1,39;15.865,80 €;'sin fechas';19/10/2015;'AUTOPISTAS';'Gastos_Ocio y transporte';'Parking y peaje';'VARIABLES'
19/10/2015;19/10/2015;'CAFETERIA';-3,65 €;11.338,06 €;7684;-3,65;15.862,15 €;'sin fechas';19/10/2015;'CAFETERIA';'Gastos_Compras';'Supermercado';'VARIABLES'
19/10/2015;19/10/2015;'CARREFOUR-[OTROS]';-6,30 €;11.331,76 €;7685;-6,30;15.855,85 €;'sin fechas';19/10/2015;'CARREFOUROTROS';'Gastos_Compras';'Supermercado';'VARIABLES'
19/10/2015;19/10/2015;'LIDL';-21,31 €;11.310,45 €;7686;-21,31;15.834,54 €;'sin fechas';19/10/2015;'LIDL';'Gastos_Compras';'Supermercado';'VARIABLES'
19/10/2015;19/10/2015;'ONO';-121,23 €;11.189,22 €;7687;-121,23;15.713,31 €;'sin fechas';19/10/2015;'ONO';'Gastos_Servicios tipicos';'Telecomunicaciones';'FIJO'
19/10/2015;19/10/2015;'PARKING';-5,25 €;11.183,97 €;7688;-5,25;15.708,06 €;'sin fechas';19/10/2015;'PARKING';'Gastos_Ocio y transporte';'Parking y peaje';'VARIABLES'
20/10/2015;18/10/2015;'AUTOPISTAS';-2,53 €;11.181,44 €;7689;-2,53;15.705,53 €;'sin fechas';18/10/2015;'AUTOPISTAS';'Gastos_Ocio y transporte';'Parking y peaje';'VARIABLES'
20/10/2015;18/10/2015;'AUTOPISTAS';-2,53 €;11.178,91 €;7690;-2,53;15.703,00 €;'sin fechas';18/10/2015;'AUTOPISTAS';'Gastos_Ocio y transporte';'Parking y peaje';'VARIABLES'
20/10/2015;17/10/2015;'AUTOPISTAS';-2,53 €;11.176,38 €;7691;-2,53;15.700,47 €;'sin fechas';17/10/2015;'AUTOPISTAS';'Gastos_Ocio y transporte';'Parking y peaje';'VARIABLES'
20/10/2015;17/10/2015;'AUTOPISTAS';-2,53 €;11.173,85 €;7692;-2,53;15.697,94 €;'sin fechas';17/10/2015;'AUTOPISTAS';'Gastos_Ocio y transporte';'Parking y peaje';'VARIABLES'
20/10/2015;16/10/2015;'AUTOPISTAS';-1,39 €;11.172,46 €;7693;-1,39;15.696,55 €;'sin fechas';16/10/2015;'AUTOPISTAS';'Gastos_Ocio y transporte';'Parking y peaje';'VARIABLES'
20/10/2015;16/10/2015;'AUTOPISTAS';-1,39 €;11.171,07 €;7694;-1,39;15.695,16 €;'sin fechas';16/10/2015;'AUTOPISTAS';'Gastos_Ocio y transporte';'Parking y peaje';'VARIABLES'
20/10/2015;20/10/2015;'AUTOPISTAS';-1,39 €;11.169,68 €;7695;-1,39;15.693,77 €;'sin fechas';20/10/2015;'AUTOPISTAS';'Gastos_Ocio y transporte';'Parking y peaje';'VARIABLES'
20/10/2015;20/10/2015;'TABASA VALLVI S. C:2T';-4,19 €;11.165,49 €;7696;-4,19;15.689,58 €;'sin fechas';20/10/2015;'TABASA';'Gastos_Ocio y transporte';'Parking y peaje';'VARIABLES'
21/10/2015;21/10/2015;'AUTOPISTAS';-2,40 €;11.163,09 €;7697;-2,40;15.687,18 €;'sin fechas';21/10/2015;'AUTOPISTAS';'Gastos_Ocio y transporte';'Parking y peaje';'VARIABLES'
21/10/2015;21/10/2015;'AUTOPISTAS';-2,40 €;11.160,69 €;7698;-2,40;15.684,78 €;'sin fechas';21/10/2015;'AUTOPISTAS';'Gastos_Ocio y transporte';'Parking y peaje';'VARIABLES'
21/10/2015;21/10/2015;'CAFETERIA';-3,65 €;11.157,04 €;7699;-3,65;15.681,13 €;'sin fechas';21/10/2015;'CAFETERIA';'Gastos_Compras';'Supermercado';'VARIABLES'
21/10/2015;21/10/2015;'GASOLINERA';-40,42 €;11.116,62 €;7700;-40,42;15.640,71 €;'sin fechas';21/10/2015;'GASOLINERA';'Gastos_Ocio y transporte';'Gasolina';'VARIABLES'
21/10/2015;21/10/2015;'SATSA PL. VELLA TERRASSA';-1,20 €;11.115,42 €;7701;-1,20;15.639,51 €;'sin fechas';21/10/2015;'SATSA';'Gastos_Ocio y transporte';'Parking y peaje';'VARIABLES'
21/10/2015;19/10/2015;'TABASA VALLVI S. C:2T';-4,19 €;11.111,23 €;7702;-4,19;15.635,32 €;'sin fechas';19/10/2015;'TABASA';'Gastos_Ocio y transporte';'Parking y peaje';'VARIABLES'
22/10/2015;22/10/2015;'AUTOPISTAS';-1,39 €;11.109,84 €;7703;-1,39;15.633,93 €;'sin fechas';22/10/2015;'AUTOPISTAS';'Gastos_Ocio y transporte';'Parking y peaje';'VARIABLES'
22/10/2015;22/10/2015;'AUTOPISTAS';-1,39 €;11.108,45 €;7704;-1,39;15.632,54 €;'sin fechas';22/10/2015;'AUTOPISTAS';'Gastos_Ocio y transporte';'Parking y peaje';'VARIABLES'
22/10/2015;22/10/2015;'CAFETERIA';-3,60 €;11.104,85 €;7705;-3,60;15.628,94 €;'sin fechas';22/10/2015;'CAFETERIA';'Gastos_Compras';'Supermercado';'VARIABLES'
22/10/2015;22/10/2015;'IKEA';-80,87 €;11.023,98 €;7706;-80,87;15.548,07 €;'sin fechas';22/10/2015;'IKEA';'Gastos_Vivienda y vehiculo';'Mnto. hogar';'VARIABLES'
22/10/2015;22/10/2015;'IKEA';-12,35 €;11.011,63 €;7707;-12,35;15.535,72 €;'sin fechas';22/10/2015;'IKEA';'Gastos_Vivienda y vehiculo';'Mnto. hogar';'VARIABLES'
22/10/2015;22/10/2015;'TABASA VALLVI S. C:2T';-4,19 €;11.007,44 €;7708;-4,19;15.531,53 €;'sin fechas';22/10/2015;'TABASA';'Gastos_Ocio y transporte';'Parking y peaje';'VARIABLES'
23/10/2015;21/10/2015;'AUTOPISTAS';-1,39 €;11.006,05 €;7709;-1,39;15.530,14 €;'sin fechas';21/10/2015;'AUTOPISTAS';'Gastos_Ocio y transporte';'Parking y peaje';'VARIABLES'
23/10/2015;23/10/2015;'AUTOPISTAS';-1,39 €;11.004,66 €;7710;-1,39;15.528,75 €;'sin fechas';23/10/2015;'AUTOPISTAS';'Gastos_Ocio y transporte';'Parking y peaje';'VARIABLES'
23/10/2015;23/10/2015;'AUTOPISTAS';-1,39 €;11.003,27 €;7711;-1,39;15.527,36 €;'sin fechas';23/10/2015;'AUTOPISTAS';'Gastos_Ocio y transporte';'Parking y peaje';'VARIABLES'
23/10/2015;23/10/2015;'CAFETERIA';-3,05 €;11.000,22 €;7712;-3,05;15.524,31 €;'sin fechas';23/10/2015;'CAFETERIA';'Gastos_Compras';'Supermercado';'VARIABLES'
23/10/2015;23/10/2015;'CAFETERIA';-0,90 €;10.999,32 €;7713;-0,90;15.523,41 €;'sin fechas';23/10/2015;'CAFETERIA';'Gastos_Compras';'Supermercado';'VARIABLES'
23/10/2015;23/10/2015;'CAFETERIA';-3,65 €;10.995,67 €;7714;-3,65;15.519,76 €;'sin fechas';23/10/2015;'CAFETERIA';'Gastos_Compras';'Supermercado';'VARIABLES'
23/10/2015;23/10/2015;'MERCADONA';-5,14 €;10.990,53 €;7715;-5,14;15.514,62 €;'sin fechas';23/10/2015;'MERCADONA';'Gastos_Compras';'Supermercado';'VARIABLES'
23/10/2015;23/10/2015;'SALA BADRINAS - MENJADOR';-118,60 €;10.871,93 €;7716;-118,60;15.396,02 €;'sin fechas';23/10/2015;'SALA';'Gastos_Salud, saber y deporte';'Estudios';'VARIABLES'
23/10/2015;23/10/2015;'TABASA VALLVI S. C:2T';-4,19 €;10.867,74 €;7717;-4,19;15.391,83 €;'sin fechas';23/10/2015;'TABASA';'Gastos_Ocio y transporte';'Parking y peaje';'VARIABLES'
24/10/2015;24/10/2015;'BON AREA';-10,49 €;10.857,25 €;7718;-10,49;15.381,34 €;'sin fechas';24/10/2015;'BON';'Gastos_Compras';'Supermercado';'VARIABLES'
24/10/2015;24/10/2015;'GLT STORE HOME';-13,58 €;10.843,67 €;7719;-13,58;15.367,76 €;'sin fechas';24/10/2015;'GLT';'Gastos_Compras';'Otras compras';'VARIABLES'
24/10/2015;24/10/2015;'HOGAR&COMIDA';-7,48 €;10.836,19 €;7720;-7,48;15.360,28 €;'sin fechas';24/10/2015;'HOGARCOMIDA';'Gastos_Compras';'Supermercado';'VARIABLES'
24/10/2015;24/10/2015;'LIDL';-30,92 €;10.805,27 €;7721;-30,92;15.329,36 €;'sin fechas';24/10/2015;'LIDL';'Gastos_Compras';'Supermercado';'VARIABLES'
24/10/2015;24/10/2015;'MERCADONA';-129,38 €;10.675,89 €;7722;-129,38;15.199,98 €;'sin fechas';24/10/2015;'MERCADONA';'Gastos_Compras';'Supermercado';'VARIABLES'
24/10/2015;24/10/2015;'PERRUQUERIA';-42,00 €;10.633,89 €;7723;-42,00;15.157,98 €;'sin fechas';24/10/2015;'PERRUQUERIA';'Gastos_Salud, saber y deporte';'Belleza';'VARIABLES'
24/10/2015;24/10/2015;'TABASA VALLVI S. C:2T';-4,19 €;10.629,70 €;7724;-4,19;15.153,79 €;'sin fechas';24/10/2015;'TABASA';'Gastos_Ocio y transporte';'Parking y peaje';'VARIABLES'
25/10/2015;25/10/2015;'AUTOPISTAS';-2,53 €;10.627,17 €;7725;-2,53;15.151,26 €;'sin fechas';25/10/2015;'AUTOPISTAS';'Gastos_Ocio y transporte';'Parking y peaje';'VARIABLES'
25/10/2015;25/10/2015;'AUTOPISTAS';-2,53 €;10.624,64 €;7726;-2,53;15.148,73 €;'sin fechas';25/10/2015;'AUTOPISTAS';'Gastos_Ocio y transporte';'Parking y peaje';'VARIABLES'
25/10/2015;25/10/2015;'CINES';-6,60 €;10.618,04 €;7727;-6,60;15.142,13 €;'sin fechas';25/10/2015;'CINES';'Gastos_Ocio y transporte';'Espectáculos';'VARIABLES'
25/10/2015;25/10/2015;'CINES';-23,60 €;10.594,44 €;7728;-23,60;15.118,53 €;'sin fechas';25/10/2015;'CINES';'Gastos_Ocio y transporte';'Espectáculos';'VARIABLES'
25/10/2015;25/10/2015;'FARMACIA';-6,24 €;10.588,20 €;7729;-6,24;15.112,29 €;'sin fechas';25/10/2015;'FARMACIA';'Gastos_Salud, saber y deporte';'Farmacia';'VARIABLES'
25/10/2015;25/10/2015;'IKEA';-15,16 €;10.573,04 €;7730;-15,16;15.097,13 €;'sin fechas';25/10/2015;'IKEA';'Gastos_Vivienda y vehiculo';'Mnto. hogar';'VARIABLES'
25/10/2015;25/10/2015;'REDPIZZA';-17,65 €;10.555,39 €;7731;-17,65;15.079,48 €;'sin fechas';25/10/2015;'REDPIZZA';'Gastos_Ocio y transporte';'Restaurantes';'VARIABLES'
25/10/2015;25/10/2015;'RESTAURANTES';-46,90 €;10.508,49 €;7732;-46,90;15.032,58 €;'sin fechas';25/10/2015;'RESTAURANTES';'Gastos_Ocio y transporte';'Restaurantes';'VARIABLES'
26/10/2015;26/10/2015;'AUTOPISTAS';-1,39 €;10.507,10 €;7733;-1,39;15.031,19 €;'sin fechas';26/10/2015;'AUTOPISTAS';'Gastos_Ocio y transporte';'Parking y peaje';'VARIABLES'
26/10/2015;26/10/2015;'AUTOPISTAS';-1,39 €;10.505,71 €;7734;-1,39;15.029,80 €;'sin fechas';26/10/2015;'AUTOPISTAS';'Gastos_Ocio y transporte';'Parking y peaje';'VARIABLES'
26/10/2015;26/10/2015;'PARKING';-4,60 €;10.501,11 €;7735;-4,60;15.025,20 €;'sin fechas';26/10/2015;'PARKING';'Gastos_Ocio y transporte';'Parking y peaje';'VARIABLES'
26/10/2015;26/10/2015;'RESTAURANTES';-15,60 €;10.485,51 €;7736;-15,60;15.009,60 €;'sin fechas';26/10/2015;'RESTAURANTES';'Gastos_Ocio y transporte';'Restaurantes';'VARIABLES'
26/10/2015;26/10/2015;'RESTAURANTES';-4,40 €;10.481,11 €;7737;-4,40;15.005,20 €;'sin fechas';26/10/2015;'RESTAURANTES';'Gastos_Ocio y transporte';'Restaurantes';'VARIABLES'
26/10/2015;26/10/2015;'TABASA VALLVI S. C:2T';-4,19 €;10.476,92 €;7738;-4,19;15.001,01 €;'sin fechas';26/10/2015;'TABASA';'Gastos_Ocio y transporte';'Parking y peaje';'VARIABLES'
27/10/2015;27/10/2015;'AUTOPISTAS';-1,39 €;10.475,53 €;7739;-1,39;14.999,62 €;'sin fechas';27/10/2015;'AUTOPISTAS';'Gastos_Ocio y transporte';'Parking y peaje';'VARIABLES'
27/10/2015;27/10/2015;'AUTOPISTAS';-1,39 €;10.474,14 €;7740;-1,39;14.998,23 €;'sin fechas';27/10/2015;'AUTOPISTAS';'Gastos_Ocio y transporte';'Parking y peaje';'VARIABLES'
27/10/2015;27/10/2015;'CAFETERIA';-3,60 €;10.470,54 €;7741;-3,60;14.994,63 €;'sin fechas';27/10/2015;'CAFETERIA';'Gastos_Compras';'Supermercado';'VARIABLES'
27/10/2015;27/10/2015;'CAFETERIA';-5,75 €;10.464,79 €;7742;-5,75;14.988,88 €;'sin fechas';27/10/2015;'CAFETERIA';'Gastos_Compras';'Supermercado';'VARIABLES'
27/10/2015;27/10/2015;'COMISIONES';-18,00 €;10.446,79 €;7743;-18,00;14.970,88 €;'sin fechas';27/10/2015;'COMISIONES';'Gastos_Banco y organismos';'Cargos banco';'FIJO'
27/10/2015;27/10/2015;'COMISIONES';-18,00 €;10.428,79 €;7744;-18,00;14.952,88 €;'sin fechas';27/10/2015;'COMISIONES';'Gastos_Banco y organismos';'Cargos banco';'FIJO'
27/10/2015;27/10/2015;'TABASA VALLVI S. C:2T';-4,19 €;10.424,60 €;7745;-4,19;14.948,69 €;'sin fechas';27/10/2015;'TABASA';'Gastos_Ocio y transporte';'Parking y peaje';'VARIABLES'
28/10/2015;28/10/2015;'AUTOPISTAS';-1,39 €;10.423,21 €;7746;-1,39;14.947,30 €;'sin fechas';28/10/2015;'AUTOPISTAS';'Gastos_Ocio y transporte';'Parking y peaje';'VARIABLES'
28/10/2015;28/10/2015;'FOMENT DE TERRASSA, SA';1.768,85 €;12.192,06 €;7747;1.768,85;16.716,15 €;'sin fechas';28/10/2015;'FOMENT';'Ingresos';'Nomina';'FIJO'
28/10/2015;28/10/2015;'GASOLINERA';-40,81 €;12.151,25 €;7748;-40,81;16.675,34 €;'sin fechas';28/10/2015;'GASOLINERA';'Gastos_Ocio y transporte';'Gasolina';'VARIABLES'
28/10/2015;28/10/2015;'VIENA';-19,30 €;12.131,95 €;7749;-19,30;16.656,04 €;'sin fechas';28/10/2015;'VIENA';'Gastos_Ocio y transporte';'Restaurantes';'VARIABLES'
29/10/2015;29/10/2015;'AUTOPISTAS';-1,39 €;12.130,56 €;7750;-1,39;16.654,65 €;'sin fechas';29/10/2015;'AUTOPISTAS';'Gastos_Ocio y transporte';'Parking y peaje';'VARIABLES'
29/10/2015;29/10/2015;'AUTOPISTAS';-4,19 €;12.126,37 €;7751;-4,19;16.650,46 €;'sin fechas';29/10/2015;'AUTOPISTAS';'Gastos_Ocio y transporte';'Parking y peaje';'VARIABLES'
29/10/2015;29/10/2015;'BON AREA';-11,36 €;12.115,01 €;7752;-11,36;16.639,10 €;'sin fechas';29/10/2015;'BON';'Gastos_Compras';'Supermercado';'VARIABLES'
29/10/2015;29/10/2015;'CAFETERIA';-2,15 €;12.112,86 €;7753;-2,15;16.636,95 €;'sin fechas';29/10/2015;'CAFETERIA';'Gastos_Compras';'Supermercado';'VARIABLES'
29/10/2015;29/10/2015;'INFORMACIO I TECNOLOGIA DE CAT';1.599,27 €;13.712,13 €;7754;1.599,27;18.236,22 €;'sin fechas';29/10/2015;'INFORMACIO';'Ingresos';'Nomina';'FIJO'
29/10/2015;29/10/2015;'REINT.CAJERO';-30,00 €;13.682,13 €;7755;-30,00;18.206,22 €;'sin fechas';29/10/2015;'REINTCAJERO';'Gastos_Gastos varios';'Efectivo';'VARIABLES'
29/10/2015;29/10/2015;'RESTAURANTES';-2,50 €;13.679,63 €;7756;-2,50;18.203,72 €;'sin fechas';29/10/2015;'RESTAURANTES';'Gastos_Ocio y transporte';'Restaurantes';'VARIABLES'
29/10/2015;29/10/2015;'TABASA VALLVI S. C:2T';-4,19 €;13.675,44 €;7757;-4,19;18.199,53 €;'sin fechas';29/10/2015;'TABASA';'Gastos_Ocio y transporte';'Parking y peaje';'VARIABLES'
30/10/2015;28/10/2015;'AUTOPISTAS';-1,39 €;13.674,05 €;7758;-1,39;18.198,14 €;'sin fechas';28/10/2015;'AUTOPISTAS';'Gastos_Ocio y transporte';'Parking y peaje';'VARIABLES'
30/10/2015;30/10/2015;'CAFETERIA';-17,10 €;13.656,95 €;7759;-17,10;18.181,04 €;'sin fechas';30/10/2015;'CAFETERIA';'Gastos_Compras';'Supermercado';'VARIABLES'
30/10/2015;30/10/2015;'MERKALZADOS';-121,98 €;13.534,97 €;7760;-121,98;18.059,06 €;'sin fechas';30/10/2015;'MERKALZADOS';'Gastos_Compras';'Ropa';'VARIABLES'
31/10/2015;29/10/2015;'AUTOPISTAS';-1,39 €;13.533,58 €;7761;-1,39;18.057,67 €;'sin fechas';29/10/2015;'AUTOPISTAS';'Gastos_Ocio y transporte';'Parking y peaje';'VARIABLES'
31/10/2015;31/10/2015;'CAFETERIA';-3,50 €;13.530,08 €;7762;-3,50;18.054,17 €;'sin fechas';31/10/2015;'CAFETERIA';'Gastos_Compras';'Supermercado';'VARIABLES'
31/10/2015;31/10/2015;'CONSUM';-16,42 €;13.513,66 €;7763;-16,42;18.037,75 €;'sin fechas';31/10/2015;'CONSUM';'Gastos_Compras';'Supermercado';'VARIABLES'
31/10/2015;31/10/2015;'REC. 6061.9600001223';-559,26 €;12.954,40 €;7764;-559,26;17.478,49 €;'sin fechas';31/10/2015;'REC';'Gastos_Banco y organismos';'Hipoteca';'FIJO'
31/10/2015;31/10/2015;'RESTAURANTES';-4,90 €;12.949,50 €;7765;-4,90;17.473,59 €;'sin fechas';31/10/2015;'RESTAURANTES';'Gastos_Ocio y transporte';'Restaurantes';'VARIABLES'
01/11/2015;01/11/2015;'AUTOPISTAS';-2,53 €;12.946,97 €;7766;-2,53;17.471,06 €;'sin fechas';01/11/2015;'AUTOPISTAS';'Gastos_Ocio y transporte';'Parking y peaje';'VARIABLES'
01/11/2015;01/11/2015;'AUTOPISTAS';-2,53 €;12.944,44 €;7767;-2,53;17.468,53 €;'sin fechas';01/11/2015;'AUTOPISTAS';'Gastos_Ocio y transporte';'Parking y peaje';'VARIABLES'
01/11/2015;01/11/2015;'AUTOPISTAS';-2,53 €;12.941,91 €;7768;-2,53;17.466,00 €;'sin fechas';01/11/2015;'AUTOPISTAS';'Gastos_Ocio y transporte';'Parking y peaje';'VARIABLES'
01/11/2015;01/11/2015;'AUTOPISTAS';-2,53 €;12.939,38 €;7769;-2,53;17.463,47 €;'sin fechas';01/11/2015;'AUTOPISTAS';'Gastos_Ocio y transporte';'Parking y peaje';'VARIABLES'
01/11/2015;01/11/2015;'CAFETERIA';-2,70 €;12.936,68 €;7770;-2,70;17.460,77 €;'sin fechas';01/11/2015;'CAFETERIA';'Gastos_Compras';'Supermercado';'VARIABLES'
01/11/2015;01/11/2015;'CAFETERIA';-7,50 €;12.929,18 €;7771;-7,50;17.453,27 €;'sin fechas';01/11/2015;'CAFETERIA';'Gastos_Compras';'Supermercado';'VARIABLES'
01/11/2015;01/11/2015;'LA BRASA';-29,79 €;12.899,39 €;7773;-29,79;17.423,48 €;'sin fechas';01/11/2015;'BRASA';'Gastos_Ocio y transporte';'Restaurantes';'VARIABLES'
01/11/2015;01/11/2015;'LA BRASA';-29,79 €;12.869,60 €;7774;-29,79;17.393,69 €;'sin fechas';01/11/2015;'BRASA';'Gastos_Ocio y transporte';'Restaurantes';'VARIABLES'
01/11/2015;01/11/2015;'RESTAURANTES';-7,50 €;12.862,10 €;7775;-7,50;17.386,19 €;'sin fechas';01/11/2015;'RESTAURANTES';'Gastos_Ocio y transporte';'Restaurantes';'VARIABLES'
02/11/2015;02/11/2015;'AUTOPISTAS';-1,39 €;12.860,71 €;7776;-1,39;17.384,80 €;'sin fechas';02/11/2015;'AUTOPISTAS';'Gastos_Ocio y transporte';'Parking y peaje';'VARIABLES'
02/11/2015;02/11/2015;'AUTOPISTAS';-1,39 €;12.859,32 €;7777;-1,39;17.383,41 €;'sin fechas';02/11/2015;'AUTOPISTAS';'Gastos_Ocio y transporte';'Parking y peaje';'VARIABLES'
02/11/2015;02/11/2015;'AUTOPISTAS';-1,39 €;12.857,93 €;7778;-1,39;17.382,02 €;'sin fechas';02/11/2015;'AUTOPISTAS';'Gastos_Ocio y transporte';'Parking y peaje';'VARIABLES'
02/11/2015;02/11/2015;'AUTOPISTAS';-1,39 €;12.856,54 €;7779;-1,39;17.380,63 €;'sin fechas';02/11/2015;'AUTOPISTAS';'Gastos_Ocio y transporte';'Parking y peaje';'VARIABLES'
02/11/2015;02/11/2015;'AUTOPISTAS';-4,19 €;12.852,35 €;7780;-4,19;17.376,44 €;'sin fechas';02/11/2015;'AUTOPISTAS';'Gastos_Ocio y transporte';'Parking y peaje';'VARIABLES'
02/11/2015;02/11/2015;'CAFETERIA';-3,65 €;12.848,70 €;7781;-3,65;17.372,79 €;'sin fechas';02/11/2015;'CAFETERIA';'Gastos_Compras';'Supermercado';'VARIABLES'
02/11/2015;02/11/2015;'CAFETERIA';-3,65 €;12.845,05 €;7782;-3,65;17.369,14 €;'sin fechas';02/11/2015;'CAFETERIA';'Gastos_Compras';'Supermercado';'VARIABLES'
02/11/2015;02/11/2015;'FARMACIA';-16,58 €;12.828,47 €;7783;-16,58;17.352,56 €;'sin fechas';02/11/2015;'FARMACIA';'Gastos_Salud, saber y deporte';'Farmacia';'VARIABLES'
02/11/2015;02/11/2015;'FARMACIA';-16,58 €;12.811,89 €;7784;-16,58;17.335,98 €;'sin fechas';02/11/2015;'FARMACIA';'Gastos_Salud, saber y deporte';'Farmacia';'VARIABLES'
02/11/2015;02/11/2015;'FRANKFURT LES LLETRES';-9,30 €;12.802,59 €;7785;-9,30;17.326,68 €;'sin fechas';02/11/2015;'FRANKFURT';'Gastos_Ocio y transporte';'Restaurantes';'VARIABLES'
02/11/2015;02/11/2015;'PARKING';-4,90 €;12.797,69 €;7786;-4,90;17.321,78 €;'sin fechas';02/11/2015;'PARKING';'Gastos_Ocio y transporte';'Parking y peaje';'VARIABLES'
02/11/2015;02/11/2015;'PARKING';-4,90 €;12.792,79 €;7787;-4,90;17.316,88 €;'sin fechas';02/11/2015;'PARKING';'Gastos_Ocio y transporte';'Parking y peaje';'VARIABLES'
02/11/2015;02/11/2015;'RESTAURANTES';-9,30 €;12.783,49 €;7788;-9,30;17.307,58 €;'sin fechas';02/11/2015;'RESTAURANTES';'Gastos_Ocio y transporte';'Restaurantes';'VARIABLES'
02/11/2015;02/11/2015;'VIRGIN ACTIV';-37,00 €;12.746,49 €;7789;-37,00;17.270,58 €;'sin fechas';02/11/2015;'VIRGIN';'Gastos_Salud, saber y deporte';'Deportes';'VARIABLES'
02/11/2015;02/11/2015;'VIRGIN ACTIV';-37,00 €;12.709,49 €;7790;-37,00;17.233,58 €;'sin fechas';02/11/2015;'VIRGIN';'Gastos_Salud, saber y deporte';'Deportes';'VARIABLES'
03/11/2015;03/11/2015;'AUTOPISTAS';-1,39 €;12.708,10 €;7791;-1,39;17.232,19 €;'sin fechas';03/11/2015;'AUTOPISTAS';'Gastos_Ocio y transporte';'Parking y peaje';'VARIABLES'
03/11/2015;03/11/2015;'AUTOPISTAS';-1,39 €;12.706,71 €;7792;-1,39;17.230,80 €;'sin fechas';03/11/2015;'AUTOPISTAS';'Gastos_Ocio y transporte';'Parking y peaje';'VARIABLES'
03/11/2015;03/11/2015;'AUTOPISTAS';-1,39 €;12.705,32 €;7793;-1,39;17.229,41 €;'sin fechas';03/11/2015;'AUTOPISTAS';'Gastos_Ocio y transporte';'Parking y peaje';'VARIABLES'
03/11/2015;03/11/2015;'AUTOPISTAS';-4,19 €;12.701,13 €;7794;-4,19;17.225,22 €;'sin fechas';03/11/2015;'AUTOPISTAS';'Gastos_Ocio y transporte';'Parking y peaje';'VARIABLES'
03/11/2015;03/11/2015;'CAFETERIA';-3,60 €;12.697,53 €;7795;-3,60;17.221,62 €;'sin fechas';03/11/2015;'CAFETERIA';'Gastos_Compras';'Supermercado';'VARIABLES'
03/11/2015;03/11/2015;'HOGAR&OTROS';-68,00 €;12.629,53 €;7796;-68,00;17.153,62 €;'sin fechas';03/11/2015;'HOGAROTROS';'Gastos_Vivienda y vehiculo';'Otros vivienda';'VARIABLES'
03/11/2015;03/11/2015;'KIABI';-60,00 €;12.569,53 €;7797;-60,00;17.093,62 €;'sin fechas';03/11/2015;'KIABI';'Gastos_Compras';'Ropa';'VARIABLES'
03/11/2015;03/11/2015;'RESTAURANTES';-9,35 €;12.560,18 €;7798;-9,35;17.084,27 €;'sin fechas';03/11/2015;'RESTAURANTES';'Gastos_Ocio y transporte';'Restaurantes';'VARIABLES'
04/11/2015;04/11/2015;'AUTOPISTAS';-1,39 €;12.558,79 €;7799;-1,39;17.082,88 €;'sin fechas';04/11/2015;'AUTOPISTAS';'Gastos_Ocio y transporte';'Parking y peaje';'VARIABLES'
04/11/2015;04/11/2015;'AUTOPISTAS';-1,39 €;12.557,40 €;7800;-1,39;17.081,49 €;'sin fechas';04/11/2015;'AUTOPISTAS';'Gastos_Ocio y transporte';'Parking y peaje';'VARIABLES'
04/11/2015;04/11/2015;'CARREFOUR-[OTROS]';-7,80 €;12.549,60 €;7801;-7,80;17.073,69 €;'sin fechas';04/11/2015;'CARREFOUROTROS';'Gastos_Compras';'Supermercado';'VARIABLES'
04/11/2015;04/11/2015;'LIDL';-29,90 €;12.519,70 €;7802;-29,90;17.043,79 €;'sin fechas';04/11/2015;'LIDL';'Gastos_Compras';'Supermercado';'VARIABLES'
04/11/2015;04/11/2015;'TABASA VALLVI S. C:2T';-4,19 €;12.515,51 €;7803;-4,19;17.039,60 €;'sin fechas';04/11/2015;'TABASA';'Gastos_Ocio y transporte';'Parking y peaje';'VARIABLES'
05/11/2015;05/11/2015;'ADESLAS';-111,00 €;12.404,51 €;7804;-111,00;16.928,60 €;'sin fechas';05/11/2015;'ADESLAS';'Gastos_Salud, saber y deporte';'Medico';'VARIABLES'
05/11/2015;05/11/2015;'AUTOPISTAS';-1,39 €;12.403,12 €;7805;-1,39;16.927,21 €;'sin fechas';05/11/2015;'AUTOPISTAS';'Gastos_Ocio y transporte';'Parking y peaje';'VARIABLES'
05/11/2015;05/11/2015;'AUTOPISTAS';-1,39 €;12.401,73 €;7806;-1,39;16.925,82 €;'sin fechas';05/11/2015;'AUTOPISTAS';'Gastos_Ocio y transporte';'Parking y peaje';'VARIABLES'
05/11/2015;05/11/2015;'AUTOPISTAS';-1,39 €;12.400,34 €;7807;-1,39;16.924,43 €;'sin fechas';05/11/2015;'AUTOPISTAS';'Gastos_Ocio y transporte';'Parking y peaje';'VARIABLES'
05/11/2015;05/11/2015;'AUTOPISTAS';-1,39 €;12.398,95 €;7808;-1,39;16.923,04 €;'sin fechas';05/11/2015;'AUTOPISTAS';'Gastos_Ocio y transporte';'Parking y peaje';'VARIABLES'
05/11/2015;05/11/2015;'CAFETERIA';-4,50 €;12.394,45 €;7809;-4,50;16.918,54 €;'sin fechas';05/11/2015;'CAFETERIA';'Gastos_Compras';'Supermercado';'VARIABLES'
05/11/2015;05/11/2015;'CATALANA DIAG.I CIRUR';-3,60 €;12.390,85 €;7810;-3,60;16.914,94 €;'sin fechas';05/11/2015;'CATALANA';'Gastos_Ocio y transporte';'Parking y peaje';'VARIABLES'
05/11/2015;05/11/2015;'FRANKFURT LES LLETRES';-5,60 €;12.385,25 €;7811;-5,60;16.909,34 €;'sin fechas';05/11/2015;'FRANKFURT';'Gastos_Ocio y transporte';'Restaurantes';'VARIABLES'
05/11/2015;05/11/2015;'RESTAURANTES';-8,45 €;12.376,80 €;7812;-8,45;16.900,89 €;'sin fechas';05/11/2015;'RESTAURANTES';'Gastos_Ocio y transporte';'Restaurantes';'VARIABLES'
06/11/2015;06/11/2015;'AUTOPISTAS';-1,39 €;12.375,41 €;7813;-1,39;16.899,50 €;'sin fechas';06/11/2015;'AUTOPISTAS';'Gastos_Ocio y transporte';'Parking y peaje';'VARIABLES'
06/11/2015;06/11/2015;'AUTOPISTAS';-1,39 €;12.374,02 €;7814;-1,39;16.898,11 €;'sin fechas';06/11/2015;'AUTOPISTAS';'Gastos_Ocio y transporte';'Parking y peaje';'VARIABLES'
06/11/2015;06/11/2015;'AUTOPISTAS';-4,19 €;12.369,83 €;7815;-4,19;16.893,92 €;'sin fechas';06/11/2015;'AUTOPISTAS';'Gastos_Ocio y transporte';'Parking y peaje';'VARIABLES'
06/11/2015;06/11/2015;'BURGUER KING PARC';-12,25 €;12.357,58 €;7816;-12,25;16.881,67 €;'sin fechas';06/11/2015;'BURGUER';'Gastos_Ocio y transporte';'Restaurantes';'VARIABLES'
06/11/2015;31/10/2015;'KIABI';-193,77 €;12.163,81 €;7817;-193,77;16.687,90 €;'sin fechas';31/10/2015;'KIABI';'Gastos_Compras';'Ropa';'VARIABLES'
06/11/2015;06/11/2015;'FRANKFURT LES LLETRES';-4,70 €;12.159,11 €;7818;-4,70;16.683,20 €;'sin fechas';06/11/2015;'FRANKFURT';'Gastos_Ocio y transporte';'Restaurantes';'VARIABLES'
06/11/2015;06/11/2015;'RESTAURANTES';-4,05 €;12.155,06 €;7819;-4,05;16.679,15 €;'sin fechas';06/11/2015;'RESTAURANTES';'Gastos_Ocio y transporte';'Restaurantes';'VARIABLES'
07/11/2015;07/11/2015;'CAFETERIA';-4,50 €;12.150,56 €;7820;-4,50;16.674,65 €;'sin fechas';07/11/2015;'CAFETERIA';'Gastos_Compras';'Supermercado';'VARIABLES'
07/11/2015;07/11/2015;'DECATHLON';-112,95 €;12.037,61 €;7821;-112,95;16.561,70 €;'sin fechas';07/11/2015;'DECATHLON';'Gastos_Compras';'Deportivo';'VARIABLES'
07/11/2015;07/11/2015;'MEDIA MARKT';-99,85 €;11.937,76 €;7822;-99,85;16.461,85 €;'sin fechas';07/11/2015;'MEDIA';'Gastos_Compras';'Hobbys';'VARIABLES'
07/11/2015;07/11/2015;'RESTAURANTES';-58,20 €;11.879,56 €;7823;-58,20;16.403,65 €;'sin fechas';07/11/2015;'RESTAURANTES';'Gastos_Ocio y transporte';'Restaurantes';'VARIABLES'
08/11/2015;08/11/2015;'GASOLINERA';-20,00 €;11.859,56 €;7824;-20,00;16.383,65 €;'sin fechas';08/11/2015;'GASOLINERA';'Gastos_Ocio y transporte';'Gasolina';'VARIABLES'
08/11/2015;08/11/2015;'LA BRASA';-16,98 €;11.842,58 €;7825;-16,98;16.366,67 €;'sin fechas';08/11/2015;'BRASA';'Gastos_Ocio y transporte';'Restaurantes';'VARIABLES'
08/11/2015;08/11/2015;'RESTAURANTES';-9,70 €;11.832,88 €;7826;-9,70;16.356,97 €;'sin fechas';08/11/2015;'RESTAURANTES';'Gastos_Ocio y transporte';'Restaurantes';'VARIABLES'
08/11/2015;08/11/2015;'RESTAURANTES';-4,50 €;11.828,38 €;7827;-4,50;16.352,47 €;'sin fechas';08/11/2015;'RESTAURANTES';'Gastos_Ocio y transporte';'Restaurantes';'VARIABLES'
08/11/2015;08/11/2015;'TRANSCARGO';-968,00 €;10.860,38 €;7828;-968,00;15.384,47 €;'sin fechas';08/11/2015;'TRANSCARGO';'Gastos_Gastos varios';'Transferencias';'VARIABLES'
09/11/2015;09/11/2015;'AUTOPISTAS';-4,19 €;10.856,19 €;7829;-4,19;15.380,28 €;'sin fechas';09/11/2015;'AUTOPISTAS';'Gastos_Ocio y transporte';'Parking y peaje';'VARIABLES'
09/11/2015;09/11/2015;'AUTOPISTAS';-1,39 €;10.854,80 €;7830;-1,39;15.378,89 €;'sin fechas';09/11/2015;'AUTOPISTAS';'Gastos_Ocio y transporte';'Parking y peaje';'VARIABLES'
09/11/2015;09/11/2015;'AUTOPISTAS';-1,39 €;10.853,41 €;7831;-1,39;15.377,50 €;'sin fechas';09/11/2015;'AUTOPISTAS';'Gastos_Ocio y transporte';'Parking y peaje';'VARIABLES'
09/11/2015;09/11/2015;'BLITZ';-72,50 €;10.780,91 €;7832;-72,50;15.305,00 €;'sin fechas';09/11/2015;'BLITZ';'Gastos_Vivienda y vehiculo';'Alquiler Parking';'FIJO'
09/11/2015;09/11/2015;'CAFETERIA';-3,50 €;10.777,41 €;7833;-3,50;15.301,50 €;'sin fechas';09/11/2015;'CAFETERIA';'Gastos_Compras';'Supermercado';'VARIABLES'
09/11/2015;09/11/2015;'CAFETERIA';-3,65 €;10.773,76 €;7834;-3,65;15.297,85 €;'sin fechas';09/11/2015;'CAFETERIA';'Gastos_Compras';'Supermercado';'VARIABLES'
09/11/2015;09/11/2015;'ESCOLA DE MUSICA';-97,50 €;10.676,26 €;7835;-97,50;15.200,35 €;'sin fechas';09/11/2015;'ESCOLA';'Gastos_Salud, saber y deporte';'Estudios';'VARIABLES'
09/11/2015;09/11/2015;'FRANKFURT LES LLETRES';-12,50 €;10.663,76 €;7836;-12,50;15.187,85 €;'sin fechas';09/11/2015;'FRANKFURT';'Gastos_Ocio y transporte';'Restaurantes';'VARIABLES'
09/11/2015;09/11/2015;'PARKING';-4,85 €;10.658,91 €;7837;-4,85;15.183,00 €;'sin fechas';09/11/2015;'PARKING';'Gastos_Ocio y transporte';'Parking y peaje';'VARIABLES'
09/11/2015;09/11/2015;'RESTAURANTES';-3,85 €;10.655,06 €;7838;-3,85;15.179,15 €;'sin fechas';09/11/2015;'RESTAURANTES';'Gastos_Ocio y transporte';'Restaurantes';'VARIABLES'
10/11/2015;10/11/2015;'AUTOPISTAS';-3,72 €;10.651,34 €;7839;-3,72;15.175,43 €;'sin fechas';10/11/2015;'AUTOPISTAS';'Gastos_Ocio y transporte';'Parking y peaje';'VARIABLES'
10/11/2015;10/11/2015;'AUTOPISTAS';-1,39 €;10.649,95 €;7840;-1,39;15.174,04 €;'sin fechas';10/11/2015;'AUTOPISTAS';'Gastos_Ocio y transporte';'Parking y peaje';'VARIABLES'
10/11/2015;10/11/2015;'AUTOPISTAS';-1,39 €;10.648,56 €;7841;-1,39;15.172,65 €;'sin fechas';10/11/2015;'AUTOPISTAS';'Gastos_Ocio y transporte';'Parking y peaje';'VARIABLES'
10/11/2015;10/11/2015;'AUTOPISTAS';-1,39 €;10.647,17 €;7842;-1,39;15.171,26 €;'sin fechas';10/11/2015;'AUTOPISTAS';'Gastos_Ocio y transporte';'Parking y peaje';'VARIABLES'
10/11/2015;10/11/2015;'CAFETERIA';-3,60 €;10.643,57 €;7843;-3,60;15.167,66 €;'sin fechas';10/11/2015;'CAFETERIA';'Gastos_Compras';'Supermercado';'VARIABLES'
10/11/2015;10/11/2015;'CATALANA DIAG.I CIRUR';-2,40 €;10.641,17 €;7844;-2,40;15.165,26 €;'sin fechas';10/11/2015;'CATALANA';'Gastos_Ocio y transporte';'Parking y peaje';'VARIABLES'
11/11/2015;11/11/2015;'AUTOPISTAS';-3,72 €;10.637,45 €;7845;-3,72;15.161,54 €;'sin fechas';11/11/2015;'AUTOPISTAS';'Gastos_Ocio y transporte';'Parking y peaje';'VARIABLES'
11/11/2015;11/11/2015;'AUTOPISTAS';-1,39 €;10.636,06 €;7846;-1,39;15.160,15 €;'sin fechas';11/11/2015;'AUTOPISTAS';'Gastos_Ocio y transporte';'Parking y peaje';'VARIABLES'
11/11/2015;11/11/2015;'REINT.CAJERO';-50,00 €;10.586,06 €;7847;-50,00;15.110,15 €;'sin fechas';11/11/2015;'REINTCAJERO';'Gastos_Gastos varios';'Efectivo';'VARIABLES'
12/11/2015;12/11/2015;'FRANKFURT LES LLETRES';-4,70 €;10.581,36 €;7848;-4,70;15.105,45 €;'sin fechas';12/11/2015;'FRANKFURT';'Gastos_Ocio y transporte';'Restaurantes';'VARIABLES'
12/11/2015;12/11/2015;'FRANKFURT LES LLETRES';-2,50 €;10.578,86 €;7849;-2,50;15.102,95 €;'sin fechas';12/11/2015;'FRANKFURT';'Gastos_Ocio y transporte';'Restaurantes';'VARIABLES'
13/11/2015;11/11/2015;'AUTOPISTAS';-1,39 €;10.577,47 €;7850;-1,39;15.101,56 €;'sin fechas';11/11/2015;'AUTOPISTAS';'Gastos_Ocio y transporte';'Parking y peaje';'VARIABLES'
13/11/2015;10/11/2015;'AUTOPISTAS';-1,39 €;10.576,08 €;7851;-1,39;15.100,17 €;'sin fechas';10/11/2015;'AUTOPISTAS';'Gastos_Ocio y transporte';'Parking y peaje';'VARIABLES'
13/11/2015;13/11/2015;'FRANKFURT LES LLETRES';-2,50 €;10.573,58 €;7852;-2,50;15.097,67 €;'sin fechas';13/11/2015;'FRANKFURT';'Gastos_Ocio y transporte';'Restaurantes';'VARIABLES'
13/11/2015;13/11/2015;'REINT.CAJERO';-40,00 €;10.533,58 €;7853;-40,00;15.057,67 €;'sin fechas';13/11/2015;'REINTCAJERO';'Gastos_Gastos varios';'Efectivo';'VARIABLES'
13/11/2015;13/11/2015;'RESTAURANTES';-5,60 €;10.527,98 €;7854;-5,60;15.052,07 €;'sin fechas';13/11/2015;'RESTAURANTES';'Gastos_Ocio y transporte';'Restaurantes';'VARIABLES'
13/11/2015;13/11/2015;'RESTAURANTES';-16,00 €;10.511,98 €;7855;-16,00;15.036,07 €;'sin fechas';13/11/2015;'RESTAURANTES';'Gastos_Ocio y transporte';'Restaurantes';'VARIABLES'
14/11/2015;14/11/2015;'BON AREA';-14,86 €;10.497,12 €;7856;-14,86;15.021,21 €;'sin fechas';14/11/2015;'BON';'Gastos_Compras';'Supermercado';'VARIABLES'
14/11/2015;14/11/2015;'CAFETERIA';-3,65 €;10.493,47 €;7857;-3,65;15.017,56 €;'sin fechas';14/11/2015;'CAFETERIA';'Gastos_Compras';'Supermercado';'VARIABLES'
14/11/2015;14/11/2015;'FRANKFURT LES LLETRES';-2,50 €;10.490,97 €;7858;-2,50;15.015,06 €;'sin fechas';14/11/2015;'FRANKFURT';'Gastos_Ocio y transporte';'Restaurantes';'VARIABLES'
14/11/2015;14/11/2015;'LIDL';-24,39 €;10.466,58 €;7859;-24,39;14.990,67 €;'sin fechas';14/11/2015;'LIDL';'Gastos_Compras';'Supermercado';'VARIABLES'
14/11/2015;14/11/2015;'RESTAURANTES';-11,35 €;10.455,23 €;7860;-11,35;14.979,32 €;'sin fechas';14/11/2015;'RESTAURANTES';'Gastos_Ocio y transporte';'Restaurantes';'VARIABLES'
14/11/2015;14/11/2015;'RESTAURANTES';-22,10 €;10.433,13 €;7861;-22,10;14.957,22 €;'sin fechas';14/11/2015;'RESTAURANTES';'Gastos_Ocio y transporte';'Restaurantes';'VARIABLES'
14/11/2015;14/11/2015;'SATSA PL. VELLA TERRASSA';-6,75 €;10.426,38 €;7862;-6,75;14.950,47 €;'sin fechas';14/11/2015;'SATSA';'Gastos_Ocio y transporte';'Parking y peaje';'VARIABLES'
15/11/2015;15/11/2015;'FRANKFURT LES LLETRES';-5,00 €;10.421,38 €;7863;-5,00;14.945,47 €;'sin fechas';15/11/2015;'FRANKFURT';'Gastos_Ocio y transporte';'Restaurantes';'VARIABLES'
15/11/2015;15/11/2015;'FRANKFURT LES LLETRES';-6,05 €;10.415,33 €;7864;-6,05;14.939,42 €;'sin fechas';15/11/2015;'FRANKFURT';'Gastos_Ocio y transporte';'Restaurantes';'VARIABLES'
15/11/2015;15/11/2015;'VIENA';-5,20 €;10.410,13 €;7865;-5,20;14.934,22 €;'sin fechas';15/11/2015;'VIENA';'Gastos_Ocio y transporte';'Restaurantes';'VARIABLES'
16/11/2015;16/11/2015;'CAFETERIA';-3,65 €;10.406,48 €;7866;-3,65;14.930,57 €;'sin fechas';16/11/2015;'CAFETERIA';'Gastos_Compras';'Supermercado';'VARIABLES'
16/11/2015;16/11/2015;'CAFETERIA';-4,50 €;10.401,98 €;7867;-4,50;14.926,07 €;'sin fechas';16/11/2015;'CAFETERIA';'Gastos_Compras';'Supermercado';'VARIABLES'
16/11/2015;16/11/2015;'FRANKFURT LES LLETRES';-2,50 €;10.399,48 €;7868;-2,50;14.923,57 €;'sin fechas';16/11/2015;'FRANKFURT';'Gastos_Ocio y transporte';'Restaurantes';'VARIABLES'
16/11/2015;16/11/2015;'RESTAURANTES';-14,10 €;10.385,38 €;7869;-14,10;14.909,47 €;'sin fechas';16/11/2015;'RESTAURANTES';'Gastos_Ocio y transporte';'Restaurantes';'VARIABLES'
17/11/2015;17/11/2015;'CAFETERIA';-3,05 €;10.382,33 €;7870;-3,05;14.906,42 €;'sin fechas';17/11/2015;'CAFETERIA';'Gastos_Compras';'Supermercado';'VARIABLES'
17/11/2015;17/11/2015;'CCM VIDA Y P SEGURO PRESTAMO';-23,10 €;10.359,23 €;7871;-23,10;14.883,32 €;'sin fechas';17/11/2015;'CCM';'Gastos_Seguros';'Seguro vida';'FIJO'
17/11/2015;17/11/2015;'CCM VIDA Y PENSIO 000000493358';-17,65 €;10.341,58 €;7872;-17,65;14.865,67 €;'sin fechas';17/11/2015;'CCM';'Gastos_Seguros';'Seguro vida';'FIJO'
17/11/2015;17/11/2015;'LIDL';-47,45 €;10.294,13 €;7873;-47,45;14.818,22 €;'sin fechas';17/11/2015;'LIDL';'Gastos_Compras';'Supermercado';'VARIABLES'
17/11/2015;17/11/2015;'ONO';-115,23 €;10.178,90 €;7874;-115,23;14.702,99 €;'sin fechas';17/11/2015;'ONO';'Gastos_Servicios tipicos';'Telecomunicaciones';'FIJO'
17/11/2015;17/11/2015;'SALA BADRINAS - MENJADOR';-124,53 €;10.054,37 €;7875;-124,53;14.578,46 €;'sin fechas';17/11/2015;'SALA';'Gastos_Salud, saber y deporte';'Estudios';'VARIABLES'
18/11/2015;16/11/2015;'AUTOPISTAS';-3,72 €;10.050,65 €;7876;-3,72;14.574,74 €;'sin fechas';16/11/2015;'AUTOPISTAS';'Gastos_Ocio y transporte';'Parking y peaje';'VARIABLES'
18/11/2015;16/11/2015;'AUTOPISTAS';-1,39 €;10.049,26 €;7877;-1,39;14.573,35 €;'sin fechas';16/11/2015;'AUTOPISTAS';'Gastos_Ocio y transporte';'Parking y peaje';'VARIABLES'
18/11/2015;16/11/2015;'AUTOPISTAS';-1,39 €;10.047,87 €;7878;-1,39;14.571,96 €;'sin fechas';16/11/2015;'AUTOPISTAS';'Gastos_Ocio y transporte';'Parking y peaje';'VARIABLES'
18/11/2015;13/11/2015;'AUTOPISTAS';-1,39 €;10.046,48 €;7879;-1,39;14.570,57 €;'sin fechas';13/11/2015;'AUTOPISTAS';'Gastos_Ocio y transporte';'Parking y peaje';'VARIABLES'
18/11/2015;13/11/2015;'AUTOPISTAS';-1,39 €;10.045,09 €;7880;-1,39;14.569,18 €;'sin fechas';13/11/2015;'AUTOPISTAS';'Gastos_Ocio y transporte';'Parking y peaje';'VARIABLES'
18/11/2015;18/11/2015;'REINT.CAJERO';-80,00 €;9.965,09 €;7881;-80,00;14.489,18 €;'sin fechas';18/11/2015;'REINTCAJERO';'Gastos_Gastos varios';'Efectivo';'VARIABLES'
19/11/2015;19/11/2015;'AUTOPISTAS';-4,19 €;9.960,90 €;7882;-4,19;14.484,99 €;'sin fechas';19/11/2015;'AUTOPISTAS';'Gastos_Ocio y transporte';'Parking y peaje';'VARIABLES'
19/11/2015;17/11/2015;'AUTOPISTAS';-1,39 €;9.959,51 €;7883;-1,39;14.483,60 €;'sin fechas';17/11/2015;'AUTOPISTAS';'Gastos_Ocio y transporte';'Parking y peaje';'VARIABLES'
19/11/2015;17/11/2015;'AUTOPISTAS';-1,39 €;9.958,12 €;7884;-1,39;14.482,21 €;'sin fechas';17/11/2015;'AUTOPISTAS';'Gastos_Ocio y transporte';'Parking y peaje';'VARIABLES'
19/11/2015;19/11/2015;'CAFETERIA';-4,05 €;9.954,07 €;7885;-4,05;14.478,16 €;'sin fechas';19/11/2015;'CAFETERIA';'Gastos_Compras';'Supermercado';'VARIABLES'
19/11/2015;19/11/2015;'GASOLINERA';-40,69 €;9.913,38 €;7886;-40,69;14.437,47 €;'sin fechas';19/11/2015;'GASOLINERA';'Gastos_Ocio y transporte';'Gasolina';'VARIABLES'
19/11/2015;19/11/2015;'FRANKFURT LES LLETRES';-8,55 €;9.904,83 €;7887;-8,55;14.428,92 €;'sin fechas';19/11/2015;'FRANKFURT';'Gastos_Ocio y transporte';'Restaurantes';'VARIABLES'
19/11/2015;19/11/2015;'FRANKFURT LES LLETRES';-2,50 €;9.902,33 €;7888;-2,50;14.426,42 €;'sin fechas';19/11/2015;'FRANKFURT';'Gastos_Ocio y transporte';'Restaurantes';'VARIABLES'
19/11/2015;19/11/2015;'PARKING';-4,15 €;9.898,18 €;7889;-4,15;14.422,27 €;'sin fechas';19/11/2015;'PARKING';'Gastos_Ocio y transporte';'Parking y peaje';'VARIABLES'
20/11/2015;18/11/2015;'AUTOPISTAS';-1,39 €;9.896,79 €;7890;-1,39;14.420,88 €;'sin fechas';18/11/2015;'AUTOPISTAS';'Gastos_Ocio y transporte';'Parking y peaje';'VARIABLES'
20/11/2015;18/11/2015;'AUTOPISTAS';-1,39 €;9.895,40 €;7891;-1,39;14.419,49 €;'sin fechas';18/11/2015;'AUTOPISTAS';'Gastos_Ocio y transporte';'Parking y peaje';'VARIABLES'
20/11/2015;20/11/2015;'CAFETERIA';-3,65 €;9.891,75 €;7892;-3,65;14.415,84 €;'sin fechas';20/11/2015;'CAFETERIA';'Gastos_Compras';'Supermercado';'VARIABLES'
20/11/2015;20/11/2015;'FRANKFURT LES LLETRES';-4,35 €;9.887,40 €;7893;-4,35;14.411,49 €;'sin fechas';20/11/2015;'FRANKFURT';'Gastos_Ocio y transporte';'Restaurantes';'VARIABLES'
20/11/2015;20/11/2015;'FRANKFURT LES LLETRES';-5,05 €;9.882,35 €;7894;-5,05;14.406,44 €;'sin fechas';20/11/2015;'FRANKFURT';'Gastos_Ocio y transporte';'Restaurantes';'VARIABLES'
20/11/2015;20/11/2015;'REINT.CAJERO';-20,00 €;9.862,35 €;7895;-20,00;14.386,44 €;'sin fechas';20/11/2015;'REINTCAJERO';'Gastos_Gastos varios';'Efectivo';'VARIABLES'
21/11/2015;20/11/2015;'AUTOPISTAS';-4,19 €;9.858,16 €;7896;-4,19;14.382,25 €;'sin fechas';20/11/2015;'AUTOPISTAS';'Gastos_Ocio y transporte';'Parking y peaje';'VARIABLES'
21/11/2015;21/11/2015;'AUTOPISTAS';-4,19 €;9.853,97 €;7897;-4,19;14.378,06 €;'sin fechas';21/11/2015;'AUTOPISTAS';'Gastos_Ocio y transporte';'Parking y peaje';'VARIABLES'
21/11/2015;19/11/2015;'AUTOPISTAS';-1,39 €;9.852,58 €;7898;-1,39;14.376,67 €;'sin fechas';19/11/2015;'AUTOPISTAS';'Gastos_Ocio y transporte';'Parking y peaje';'VARIABLES'
21/11/2015;19/11/2015;'AUTOPISTAS';-1,39 €;9.851,19 €;7899;-1,39;14.375,28 €;'sin fechas';19/11/2015;'AUTOPISTAS';'Gastos_Ocio y transporte';'Parking y peaje';'VARIABLES'
21/11/2015;21/11/2015;'CAFETERIA';-4,50 €;9.846,69 €;7900;-4,50;14.370,78 €;'sin fechas';21/11/2015;'CAFETERIA';'Gastos_Compras';'Supermercado';'VARIABLES'
21/11/2015;21/11/2015;'FRANKFURT LES LLETRES';-2,50 €;9.844,19 €;7901;-2,50;14.368,28 €;'sin fechas';21/11/2015;'FRANKFURT';'Gastos_Ocio y transporte';'Restaurantes';'VARIABLES'
21/11/2015;21/11/2015;'RESTAURANTES';-19,55 €;9.824,64 €;7902;-19,55;14.348,73 €;'sin fechas';21/11/2015;'RESTAURANTES';'Gastos_Ocio y transporte';'Restaurantes';'VARIABLES'
22/11/2015;22/11/2015;'AUTOPISTAS';-4,19 €;9.820,45 €;7903;-4,19;14.344,54 €;'sin fechas';22/11/2015;'AUTOPISTAS';'Gastos_Ocio y transporte';'Parking y peaje';'VARIABLES'
22/11/2015;22/11/2015;'FRANKFURT LES LLETRES';-2,50 €;9.817,95 €;7904;-2,50;14.342,04 €;'sin fechas';22/11/2015;'FRANKFURT';'Gastos_Ocio y transporte';'Restaurantes';'VARIABLES'
22/11/2015;22/11/2015;'FRANKFURT LES LLETRES';-6,95 €;9.811,00 €;7905;-6,95;14.335,09 €;'sin fechas';22/11/2015;'FRANKFURT';'Gastos_Ocio y transporte';'Restaurantes';'VARIABLES'
22/11/2015;22/11/2015;'MERCADONA';-18,24 €;9.792,76 €;7906;-18,24;14.316,85 €;'sin fechas';22/11/2015;'MERCADONA';'Gastos_Compras';'Supermercado';'VARIABLES'
23/11/2015;23/11/2015;'FRANKFURT LES LLETRES';-2,50 €;9.790,26 €;7907;-2,50;14.314,35 €;'sin fechas';23/11/2015;'FRANKFURT';'Gastos_Ocio y transporte';'Restaurantes';'VARIABLES'
23/11/2015;23/11/2015;'MERCADONA';-8,65 €;9.781,61 €;7908;-8,65;14.305,70 €;'sin fechas';23/11/2015;'MERCADONA';'Gastos_Compras';'Supermercado';'VARIABLES'
24/11/2015;20/11/2015;'AUTOPISTAS';-1,39 €;9.780,22 €;7909;-1,39;14.304,31 €;'sin fechas';20/11/2015;'AUTOPISTAS';'Gastos_Ocio y transporte';'Parking y peaje';'VARIABLES'
24/11/2015;20/11/2015;'AUTOPISTAS';-1,39 €;9.778,83 €;7910;-1,39;14.302,92 €;'sin fechas';20/11/2015;'AUTOPISTAS';'Gastos_Ocio y transporte';'Parking y peaje';'VARIABLES'
24/11/2015;24/11/2015;'CAFETERIA';-4,50 €;9.774,33 €;7911;-4,50;14.298,42 €;'sin fechas';24/11/2015;'CAFETERIA';'Gastos_Compras';'Supermercado';'VARIABLES'
24/11/2015;24/11/2015;'HOGAR&OTROS';-7,20 €;9.767,13 €;7912;-7,20;14.291,22 €;'sin fechas';24/11/2015;'HOGAROTROS';'Gastos_Vivienda y vehiculo';'Otros vivienda';'VARIABLES'
25/11/2015;23/11/2015;'AUTOPISTAS';-3,72 €;9.763,41 €;7913;-3,72;14.287,50 €;'sin fechas';23/11/2015;'AUTOPISTAS';'Gastos_Ocio y transporte';'Parking y peaje';'VARIABLES'
25/11/2015;23/11/2015;'AUTOPISTAS';-1,39 €;9.762,02 €;7914;-1,39;14.286,11 €;'sin fechas';23/11/2015;'AUTOPISTAS';'Gastos_Ocio y transporte';'Parking y peaje';'VARIABLES'
25/11/2015;23/11/2015;'AUTOPISTAS';-1,39 €;9.760,63 €;7915;-1,39;14.284,72 €;'sin fechas';23/11/2015;'AUTOPISTAS';'Gastos_Ocio y transporte';'Parking y peaje';'VARIABLES'
25/11/2015;25/11/2015;'AUTOPISTAS';-4,19 €;9.756,44 €;7916;-4,19;14.280,53 €;'sin fechas';25/11/2015;'AUTOPISTAS';'Gastos_Ocio y transporte';'Parking y peaje';'VARIABLES'
25/11/2015;25/11/2015;'AUTOPISTAS';-1,39 €;9.755,05 €;7917;-1,39;14.279,14 €;'sin fechas';25/11/2015;'AUTOPISTAS';'Gastos_Ocio y transporte';'Parking y peaje';'VARIABLES'
25/11/2015;25/11/2015;'AUTOPISTAS';-1,39 €;9.753,66 €;7918;-1,39;14.277,75 €;'sin fechas';25/11/2015;'AUTOPISTAS';'Gastos_Ocio y transporte';'Parking y peaje';'VARIABLES'
25/11/2015;25/11/2015;'LIDL';-22,80 €;9.730,86 €;7919;-22,80;14.254,95 €;'sin fechas';25/11/2015;'LIDL';'Gastos_Compras';'Supermercado';'VARIABLES'
25/11/2015;25/11/2015;'RESTAURANTES';-17,65 €;9.713,21 €;7920;-17,65;14.237,30 €;'sin fechas';25/11/2015;'RESTAURANTES';'Gastos_Ocio y transporte';'Restaurantes';'VARIABLES'
26/11/2015;26/11/2015;'AUTOPISTAS';-4,19 €;9.709,02 €;7921;-4,19;14.233,11 €;'sin fechas';26/11/2015;'AUTOPISTAS';'Gastos_Ocio y transporte';'Parking y peaje';'VARIABLES'
26/11/2015;26/11/2015;'AUTOPISTAS';-4,19 €;9.704,83 €;7922;-4,19;14.228,92 €;'sin fechas';26/11/2015;'AUTOPISTAS';'Gastos_Ocio y transporte';'Parking y peaje';'VARIABLES'
26/11/2015;26/11/2015;'AUTOPISTAS';-1,39 €;9.703,44 €;7923;-1,39;14.227,53 €;'sin fechas';26/11/2015;'AUTOPISTAS';'Gastos_Ocio y transporte';'Parking y peaje';'VARIABLES'
26/11/2015;26/11/2015;'CAFETERIA';-3,65 €;9.699,79 €;7924;-3,65;14.223,88 €;'sin fechas';26/11/2015;'CAFETERIA';'Gastos_Compras';'Supermercado';'VARIABLES'
26/11/2015;26/11/2015;'CARREFOUR-[OTROS]';-20,03 €;9.679,76 €;7925;-20,03;14.203,85 €;'sin fechas';26/11/2015;'CARREFOUROTROS';'Gastos_Compras';'Supermercado';'VARIABLES'
26/11/2015;26/11/2015;'FRANKFURT LES LLETRES';-2,50 €;9.677,26 €;7926;-2,50;14.201,35 €;'sin fechas';26/11/2015;'FRANKFURT';'Gastos_Ocio y transporte';'Restaurantes';'VARIABLES'
26/11/2015;26/11/2015;'FRANKFURT LES LLETRES';-9,25 €;9.668,01 €;7927;-9,25;14.192,10 €;'sin fechas';26/11/2015;'FRANKFURT';'Gastos_Ocio y transporte';'Restaurantes';'VARIABLES'
26/11/2015;26/11/2015;'MERCADONA';-9,95 €;9.658,06 €;7928;-9,95;14.182,15 €;'sin fechas';26/11/2015;'MERCADONA';'Gastos_Compras';'Supermercado';'VARIABLES'
26/11/2015;26/11/2015;'PARKING';-4,90 €;9.653,16 €;7929;-4,90;14.177,25 €;'sin fechas';26/11/2015;'PARKING';'Gastos_Ocio y transporte';'Parking y peaje';'VARIABLES'
26/11/2015;26/11/2015;'REINT.CAJERO';-30,00 €;9.623,16 €;7930;-30,00;14.147,25 €;'sin fechas';26/11/2015;'REINTCAJERO';'Gastos_Gastos varios';'Efectivo';'VARIABLES'
27/11/2015;27/11/2015;'AUTOPISTAS';-4,19 €;9.618,97 €;7931;-4,19;14.143,06 €;'sin fechas';27/11/2015;'AUTOPISTAS';'Gastos_Ocio y transporte';'Parking y peaje';'VARIABLES'
27/11/2015;24/11/2015;'AUTOPISTAS';-1,39 €;9.617,58 €;7932;-1,39;14.141,67 €;'sin fechas';24/11/2015;'AUTOPISTAS';'Gastos_Ocio y transporte';'Parking y peaje';'VARIABLES'
27/11/2015;24/11/2015;'AUTOPISTAS';-1,39 €;9.616,19 €;7933;-1,39;14.140,28 €;'sin fechas';24/11/2015;'AUTOPISTAS';'Gastos_Ocio y transporte';'Parking y peaje';'VARIABLES'
27/11/2015;27/11/2015;'BON AREA';-17,80 €;9.598,39 €;7934;-17,80;14.122,48 €;'sin fechas';27/11/2015;'BON';'Gastos_Compras';'Supermercado';'VARIABLES'
27/11/2015;27/11/2015;'FOMENT DE TERRASSA, SA';1.778,20 €;11.376,59 €;7935;1.778,20;15.900,68 €;'sin fechas';27/11/2015;'FOMENT';'Ingresos';'Nomina';'FIJO'
27/11/2015;27/11/2015;'INFORMACIO I TECNOLOGIA DE CAT';1.599,39 €;12.975,98 €;7936;1.599,39;17.500,07 €;'sin fechas';27/11/2015;'INFORMACIO';'Ingresos';'Nomina';'FIJO'
27/11/2015;27/11/2015;'FRANKFURT LES LLETRES';-4,20 €;12.971,78 €;7937;-4,20;17.495,87 €;'sin fechas';27/11/2015;'FRANKFURT';'Gastos_Ocio y transporte';'Restaurantes';'VARIABLES'
27/11/2015;27/11/2015;'FRANKFURT LES LLETRES';-2,50 €;12.969,28 €;7938;-2,50;17.493,37 €;'sin fechas';27/11/2015;'FRANKFURT';'Gastos_Ocio y transporte';'Restaurantes';'VARIABLES'
27/11/2015;27/11/2015;'RESTAURANTES';-5,30 €;12.963,98 €;7939;-5,30;17.488,07 €;'sin fechas';27/11/2015;'RESTAURANTES';'Gastos_Ocio y transporte';'Restaurantes';'VARIABLES'
28/11/2015;26/11/2015;'AUTOPISTAS';-1,39 €;12.962,59 €;7940;-1,39;17.486,68 €;'sin fechas';26/11/2015;'AUTOPISTAS';'Gastos_Ocio y transporte';'Parking y peaje';'VARIABLES'
28/11/2015;28/11/2015;'CAFETERIA';-4,50 €;12.958,09 €;7941;-4,50;17.482,18 €;'sin fechas';28/11/2015;'CAFETERIA';'Gastos_Compras';'Supermercado';'VARIABLES'
28/11/2015;28/11/2015;'FRANKFURT LES LLETRES';-2,50 €;12.955,59 €;7942;-2,50;17.479,68 €;'sin fechas';28/11/2015;'FRANKFURT';'Gastos_Ocio y transporte';'Restaurantes';'VARIABLES'
28/11/2015;28/11/2015;'REINT.CAJERO';-40,00 €;12.915,59 €;7943;-40,00;17.439,68 €;'sin fechas';28/11/2015;'REINTCAJERO';'Gastos_Gastos varios';'Efectivo';'VARIABLES'
29/11/2015;29/11/2015;'CAFETERIA';-4,35 €;12.911,24 €;7944;-4,35;17.435,33 €;'sin fechas';29/11/2015;'CAFETERIA';'Gastos_Compras';'Supermercado';'VARIABLES'
29/11/2015;29/11/2015;'GLT STORE HOME';-18,50 €;12.892,74 €;7945;-18,50;17.416,83 €;'sin fechas';29/11/2015;'GLT';'Gastos_Compras';'Otras compras';'VARIABLES'
29/11/2015;29/11/2015;'HOGAR&OTROS';-309,20 €;12.583,54 €;7946;-309,20;17.107,63 €;'sin fechas';29/11/2015;'HOGAROTROS';'Gastos_Vivienda y vehiculo';'Otros vivienda';'VARIABLES'
29/11/2015;29/11/2015;'FRANKFURT LES LLETRES';-4,20 €;12.579,34 €;7947;-4,20;17.103,43 €;'sin fechas';29/11/2015;'FRANKFURT';'Gastos_Ocio y transporte';'Restaurantes';'VARIABLES'
29/11/2015;29/11/2015;'RESTAURANTES';-3,80 €;12.575,54 €;7948;-3,80;17.099,63 €;'sin fechas';29/11/2015;'RESTAURANTES';'Gastos_Ocio y transporte';'Restaurantes';'VARIABLES'
30/11/2015;30/11/2015;'CAFETERIA';-3,65 €;12.571,89 €;7949;-3,65;17.095,98 €;'sin fechas';30/11/2015;'CAFETERIA';'Gastos_Compras';'Supermercado';'VARIABLES'
30/11/2015;30/11/2015;'GASOLINERA';-36,02 €;12.535,87 €;7950;-36,02;17.059,96 €;'sin fechas';30/11/2015;'GASOLINERA';'Gastos_Ocio y transporte';'Gasolina';'VARIABLES'
30/11/2015;30/11/2015;'IBI';-44,99 €;12.490,88 €;7951;-44,99;17.014,97 €;'sin fechas';30/11/2015;'IBI';'Gastos_Banco y organismos';'Ayuntamiento';'FIJO'
30/11/2015;30/11/2015;'FRANKFURT';-3,70 €;12.487,18 €;7952;-3,70;17.011,27 €;'sin fechas';30/11/2015;'FRANKFURT';'Gastos_Ocio y transporte';'Restaurantes';'VARIABLES'
30/11/2015;30/11/2015;'REC. 6061.9600001223';-559,26 €;11.927,92 €;7953;-559,26;16.452,01 €;'sin fechas';30/11/2015;'REC';'Gastos_Banco y organismos';'Hipoteca';'FIJO'
01/12/2015;27/11/2015;'AUTOPISTAS';-1,39 €;11.926,53 €;7954;-1,39;16.450,62 €;'sin fechas';27/11/2015;'AUTOPISTAS';'Gastos_Ocio y transporte';'Parking y peaje';'VARIABLES'
01/12/2015;27/11/2015;'AUTOPISTAS';-1,39 €;11.925,14 €;7955;-1,39;16.449,23 €;'sin fechas';27/11/2015;'AUTOPISTAS';'Gastos_Ocio y transporte';'Parking y peaje';'VARIABLES'
01/12/2015;01/12/2015;'CREDITO';-33,00 €;11.892,14 €;7957;-33,00;16.416,23 €;'sin fechas';01/12/2015;'CREDITO';'No computable';'Recibo Tarjeta';
01/12/2015;01/12/2015;'HOGAR&OTROS';-6,00 €;11.886,14 €;7958;-6,00;16.410,23 €;'sin fechas';01/12/2015;'HOGAROTROS';'Gastos_Vivienda y vehiculo';'Otros vivienda';'VARIABLES'
01/12/2015;01/12/2015;'RESTAURANTES';-29,00 €;11.857,14 €;7959;-29,00;16.381,23 €;'sin fechas';01/12/2015;'RESTAURANTES';'Gastos_Ocio y transporte';'Restaurantes';'VARIABLES'
02/12/2015;30/11/2015;'AUTOPISTAS';-1,39 €;11.855,75 €;7960;-1,39;16.379,84 €;'sin fechas';30/11/2015;'AUTOPISTAS';'Gastos_Ocio y transporte';'Parking y peaje';'VARIABLES'
02/12/2015;02/12/2015;'REINT.CAJERO';-80,00 €;11.775,75 €;7961;-80,00;16.299,84 €;'sin fechas';02/12/2015;'REINTCAJERO';'Gastos_Gastos varios';'Efectivo';'VARIABLES'
03/12/2015;30/11/2015;'AUTOPISTAS';-4,19 €;11.771,56 €;7962;-4,19;16.295,65 €;'sin fechas';30/11/2015;'AUTOPISTAS';'Gastos_Ocio y transporte';'Parking y peaje';'VARIABLES'
03/12/2015;03/12/2015;'CAFETERIA';-4,50 €;11.767,06 €;7963;-4,50;16.291,15 €;'sin fechas';03/12/2015;'CAFETERIA';'Gastos_Compras';'Supermercado';'VARIABLES'
03/12/2015;03/12/2015;'FRANKFURT LES LLETRES';-9,25 €;11.757,81 €;7964;-9,25;16.281,90 €;'sin fechas';03/12/2015;'FRANKFURT';'Gastos_Ocio y transporte';'Restaurantes';'VARIABLES'
03/12/2015;03/12/2015;'MERCADONA';-111,56 €;11.646,25 €;7965;-111,56;16.170,34 €;'sin fechas';03/12/2015;'MERCADONA';'Gastos_Compras';'Supermercado';'VARIABLES'
03/12/2015;03/12/2015;'MERCADONA';-8,21 €;11.638,04 €;7966;-8,21;16.162,13 €;'sin fechas';03/12/2015;'MERCADONA';'Gastos_Compras';'Supermercado';'VARIABLES'
03/12/2015;03/12/2015;'MERCADONA';-11,54 €;11.626,50 €;7967;-11,54;16.150,59 €;'sin fechas';03/12/2015;'MERCADONA';'Gastos_Compras';'Supermercado';'VARIABLES'
03/12/2015;03/12/2015;'PARKING';-4,65 €;11.621,85 €;7968;-4,65;16.145,94 €;'sin fechas';03/12/2015;'PARKING';'Gastos_Ocio y transporte';'Parking y peaje';'VARIABLES'
03/12/2015;03/12/2015;'SALA BADRINAS - MENJADOR';-290,57 €;11.331,28 €;7969;-290,57;15.855,37 €;'sin fechas';03/12/2015;'SALA';'Gastos_Salud, saber y deporte';'Estudios';'VARIABLES'
04/12/2015;04/12/2015;'BON AREA';-21,77 €;11.309,51 €;7970;-21,77;15.833,60 €;'sin fechas';04/12/2015;'BON';'Gastos_Compras';'Supermercado';'VARIABLES'
04/12/2015;04/12/2015;'CAJA DE SEGUROS R G00031940935';-398,17 €;10.911,34 €;7971;-398,17;15.435,43 €;'sin fechas';04/12/2015;'CAJA';'Gastos_Seguros';'Seguro hogar';'FIJO'
04/12/2015;04/12/2015;'ESCOLA DE MUSICA';-97,50 €;10.813,84 €;7972;-97,50;15.337,93 €;'sin fechas';04/12/2015;'ESCOLA';'Gastos_Salud, saber y deporte';'Estudios';'VARIABLES'
04/12/2015;04/12/2015;'FRANKFURT LES LLETRES';-2,50 €;10.811,34 €;7973;-2,50;15.335,43 €;'sin fechas';04/12/2015;'FRANKFURT';'Gastos_Ocio y transporte';'Restaurantes';'VARIABLES'
05/12/2015;02/12/2015;'AUTOPISTAS';-1,39 €;10.809,95 €;7974;-1,39;15.334,04 €;'sin fechas';02/12/2015;'AUTOPISTAS';'Gastos_Ocio y transporte';'Parking y peaje';'VARIABLES'
05/12/2015;05/12/2015;'FRANKFURT LES LLETRES';-11,15 €;10.798,80 €;7975;-11,15;15.322,89 €;'sin fechas';05/12/2015;'FRANKFURT';'Gastos_Ocio y transporte';'Restaurantes';'VARIABLES'
05/12/2015;05/12/2015;'FRANKFURT LES LLETRES';-4,70 €;10.794,10 €;7976;-4,70;15.318,19 €;'sin fechas';05/12/2015;'FRANKFURT';'Gastos_Ocio y transporte';'Restaurantes';'VARIABLES'
05/12/2015;05/12/2015;'REINT.CAJERO';-120,00 €;10.674,10 €;7977;-120,00;15.198,19 €;'sin fechas';05/12/2015;'REINTCAJERO';'Gastos_Gastos varios';'Efectivo';'VARIABLES'
06/12/2015;06/12/2015;'AKI 104 - TERRASSA';-12,95 €;10.661,15 €;7978;-12,95;15.185,24 €;'sin fechas';06/12/2015;'AKI';'Gastos_Vivienda y vehiculo';'Mnto. hogar';'VARIABLES'
06/12/2015;03/12/2015;'AUTOPISTAS';-1,39 €;10.659,76 €;7979;-1,39;15.183,85 €;'sin fechas';03/12/2015;'AUTOPISTAS';'Gastos_Ocio y transporte';'Parking y peaje';'VARIABLES'
06/12/2015;03/12/2015;'AUTOPISTAS';-1,39 €;10.658,37 €;7980;-1,39;15.182,46 €;'sin fechas';03/12/2015;'AUTOPISTAS';'Gastos_Ocio y transporte';'Parking y peaje';'VARIABLES'
06/12/2015;06/12/2015;'CAFETERIA';-3,30 €;10.655,07 €;7981;-3,30;15.179,16 €;'sin fechas';06/12/2015;'CAFETERIA';'Gastos_Compras';'Supermercado';'VARIABLES'
06/12/2015;06/12/2015;'FRANKFURT LES LLETRES';-5,65 €;10.649,42 €;7982;-5,65;15.173,51 €;'sin fechas';06/12/2015;'FRANKFURT';'Gastos_Ocio y transporte';'Restaurantes';'VARIABLES'
06/12/2015;06/12/2015;'FRANKFURT LES LLETRES';-2,50 €;10.646,92 €;7983;-2,50;15.171,01 €;'sin fechas';06/12/2015;'FRANKFURT';'Gastos_Ocio y transporte';'Restaurantes';'VARIABLES'
07/12/2015;07/12/2015;'CAFETERIA';-3,95 €;10.642,97 €;7984;-3,95;15.167,06 €;'sin fechas';07/12/2015;'CAFETERIA';'Gastos_Compras';'Supermercado';'VARIABLES'
07/12/2015;07/12/2015;'FRANKFURT LES LLETRES';-3,55 €;10.639,42 €;7985;-3,55;15.163,51 €;'sin fechas';07/12/2015;'FRANKFURT';'Gastos_Ocio y transporte';'Restaurantes';'VARIABLES'
08/12/2015;06/12/2015;'AUTOPISTAS';-2,53 €;10.636,89 €;7986;-2,53;15.160,98 €;'sin fechas';06/12/2015;'AUTOPISTAS';'Gastos_Ocio y transporte';'Parking y peaje';'VARIABLES'
08/12/2015;04/12/2015;'AUTOPISTAS';-1,39 €;10.635,50 €;7987;-1,39;15.159,59 €;'sin fechas';04/12/2015;'AUTOPISTAS';'Gastos_Ocio y transporte';'Parking y peaje';'VARIABLES'
08/12/2015;04/12/2015;'AUTOPISTAS';-1,39 €;10.634,11 €;7988;-1,39;15.158,20 €;'sin fechas';04/12/2015;'AUTOPISTAS';'Gastos_Ocio y transporte';'Parking y peaje';'VARIABLES'
08/12/2015;08/12/2015;'MERCADONA';-46,96 €;10.587,15 €;7989;-46,96;15.111,24 €;'sin fechas';08/12/2015;'MERCADONA';'Gastos_Compras';'Supermercado';'VARIABLES'
09/12/2015;09/12/2015;'VIENA';-21,20 €;10.565,95 €;7990;-21,20;15.090,04 €;'sin fechas';09/12/2015;'VIENA';'Gastos_Ocio y transporte';'Restaurantes';'VARIABLES'
10/12/2015;08/12/2015;'AUTOPISTAS';-2,53 €;10.563,42 €;7991;-2,53;15.087,51 €;'sin fechas';08/12/2015;'AUTOPISTAS';'Gastos_Ocio y transporte';'Parking y peaje';'VARIABLES'
10/12/2015;07/12/2015;'AUTOPISTAS';-1,39 €;10.562,03 €;7992;-1,39;15.086,12 €;'sin fechas';07/12/2015;'AUTOPISTAS';'Gastos_Ocio y transporte';'Parking y peaje';'VARIABLES'
10/12/2015;10/12/2015;'CAFETERIA';-3,60 €;10.558,43 €;7993;-3,60;15.082,52 €;'sin fechas';10/12/2015;'CAFETERIA';'Gastos_Compras';'Supermercado';'VARIABLES'
10/12/2015;10/12/2015;'CAFETERIA';-4,15 €;10.554,28 €;7994;-4,15;15.078,37 €;'sin fechas';10/12/2015;'CAFETERIA';'Gastos_Compras';'Supermercado';'VARIABLES'
10/12/2015;10/12/2015;'REDPIZZA';-17,65 €;10.536,63 €;7995;-17,65;15.060,72 €;'sin fechas';10/12/2015;'REDPIZZA';'Gastos_Ocio y transporte';'Restaurantes';'VARIABLES'
11/12/2015;09/12/2015;'AUTOPISTAS';-1,39 €;10.535,24 €;7996;-1,39;15.059,33 €;'sin fechas';09/12/2015;'AUTOPISTAS';'Gastos_Ocio y transporte';'Parking y peaje';'VARIABLES'
11/12/2015;11/12/2015;'CINES';-12,40 €;10.522,84 €;7997;-12,40;15.046,93 €;'sin fechas';11/12/2015;'CINES';'Gastos_Ocio y transporte';'Espectáculos';'VARIABLES'
11/12/2015;11/12/2015;'GASOLINERA';-37,48 €;10.485,36 €;7998;-37,48;15.009,45 €;'sin fechas';11/12/2015;'GASOLINERA';'Gastos_Ocio y transporte';'Gasolina';'VARIABLES'
11/12/2015;11/12/2015;'HOGAR&OTROS';-119,34 €;10.366,02 €;7999;-119,34;14.890,11 €;'sin fechas';11/12/2015;'HOGAROTROS';'Gastos_Vivienda y vehiculo';'Otros vivienda';'VARIABLES'
11/12/2015;11/12/2015;'RESTAURANTES';-15,10 €;10.350,92 €;8000;-15,10;14.875,01 €;'sin fechas';11/12/2015;'RESTAURANTES';'Gastos_Ocio y transporte';'Restaurantes';'VARIABLES'
11/12/2015;11/12/2015;'SALA BADRINAS - MENJADOR';-83,02 €;10.267,90 €;8001;-83,02;14.791,99 €;'sin fechas';11/12/2015;'SALA';'Gastos_Salud, saber y deporte';'Estudios';'VARIABLES'
11/12/2015;11/12/2015;'SALA BADRINAS - MENJADOR';-83,02 €;10.184,88 €;8002;-83,02;14.708,97 €;'sin fechas';11/12/2015;'SALA';'Gastos_Salud, saber y deporte';'Estudios';'VARIABLES'
11/12/2015;06/12/2015;'TABASA VALLVI S. C:2T';-4,19 €;10.180,69 €;8003;-4,19;14.704,78 €;'sin fechas';06/12/2015;'TABASA';'Gastos_Ocio y transporte';'Parking y peaje';'VARIABLES'
11/12/2015;07/12/2015;'TABASA VALLVI S. C:2T';-4,19 €;10.176,50 €;8004;-4,19;14.700,59 €;'sin fechas';07/12/2015;'TABASA';'Gastos_Ocio y transporte';'Parking y peaje';'VARIABLES'
11/12/2015;11/12/2015;'VIENA';-21,20 €;10.155,30 €;8005;-21,20;14.679,39 €;'sin fechas';11/12/2015;'VIENA';'Gastos_Ocio y transporte';'Restaurantes';'VARIABLES'
12/12/2015;10/12/2015;'AUTOPISTAS';-1,39 €;10.153,91 €;8006;-1,39;14.678,00 €;'sin fechas';10/12/2015;'AUTOPISTAS';'Gastos_Ocio y transporte';'Parking y peaje';'VARIABLES'
12/12/2015;10/12/2015;'AUTOPISTAS';-1,39 €;10.152,52 €;8007;-1,39;14.676,61 €;'sin fechas';10/12/2015;'AUTOPISTAS';'Gastos_Ocio y transporte';'Parking y peaje';'VARIABLES'
12/12/2015;12/12/2015;'CAFETERIA';-2,20 €;10.150,32 €;8008;-2,20;14.674,41 €;'sin fechas';12/12/2015;'CAFETERIA';'Gastos_Compras';'Supermercado';'VARIABLES'
12/12/2015;12/12/2015;'LIDL';-15,41 €;10.134,91 €;8009;-15,41;14.659,00 €;'sin fechas';12/12/2015;'LIDL';'Gastos_Compras';'Supermercado';'VARIABLES'
13/12/2015;13/12/2015;'CAFETERIA';-3,65 €;10.131,26 €;8010;-3,65;14.655,35 €;'sin fechas';13/12/2015;'CAFETERIA';'Gastos_Compras';'Supermercado';'VARIABLES'
13/12/2015;13/12/2015;'FARMACIA';-12,68 €;10.118,58 €;8011;-12,68;14.642,67 €;'sin fechas';13/12/2015;'FARMACIA';'Gastos_Salud, saber y deporte';'Farmacia';'VARIABLES'
13/12/2015;13/12/2015;'FRANKFURT LES LLETRES';-5,60 €;10.112,98 €;8012;-5,60;14.637,07 €;'sin fechas';13/12/2015;'FRANKFURT';'Gastos_Ocio y transporte';'Restaurantes';'VARIABLES'
13/12/2015;13/12/2015;'PARKING';-50,00 €;10.062,98 €;8013;-50,00;14.587,07 €;'sin fechas';13/12/2015;'PARKING';'Gastos_Ocio y transporte';'Parking y peaje';'VARIABLES'
13/12/2015;13/12/2015;'TABASA VALLVI S. C:2T';-4,19 €;10.058,79 €;8014;-4,19;14.582,88 €;'sin fechas';13/12/2015;'TABASA';'Gastos_Ocio y transporte';'Parking y peaje';'VARIABLES'
14/12/2015;14/12/2015;'BLITZ';-72,50 €;9.986,29 €;8015;-72,50;14.510,38 €;'sin fechas';14/12/2015;'BLITZ';'Gastos_Vivienda y vehiculo';'Alquiler Parking';'FIJO'
14/12/2015;14/12/2015;'Néstor López Royo: REGALO ESPE HOGAR&OTROS';-14,99 €;9.971,30 €;8016;-14,99;14.495,39 €;'sin fechas';14/12/2015;'NSTOR';'Gastos_Compras';'Regalos';'VARIABLES'
15/12/2015;15/12/2015;'GAS NATURAL';-176,87 €;9.794,43 €;8017;-176,87;14.318,52 €;'sin fechas';15/12/2015;'GAS';'Gastos_Servicios tipicos';'Gas';'FIJO'
15/12/2015;15/12/2015;'H&M';-19,98 €;9.774,45 €;8018;-19,98;14.298,54 €;'sin fechas';15/12/2015;'HM';'Gastos_Compras';'Ropa';'VARIABLES'
15/12/2015;15/12/2015;'MINA PUBLICA AIGUES T.01A75789';-38,67 €;9.735,78 €;8019;-38,67;14.259,87 €;'sin fechas';15/12/2015;'MINA';'Gastos_Servicios tipicos';'Agua';'FIJO'
15/12/2015;15/12/2015;'PERRUQUERIA';-48,20 €;9.687,58 €;8020;-48,20;14.211,67 €;'sin fechas';15/12/2015;'PERRUQUERIA';'Gastos_Salud, saber y deporte';'Belleza';'VARIABLES'
15/12/2015;15/12/2015;'REINT.CAJERO';-40,00 €;9.647,58 €;8021;-40,00;14.171,67 €;'sin fechas';15/12/2015;'REINTCAJERO';'Gastos_Gastos varios';'Efectivo';'VARIABLES'
16/12/2015;16/12/2015;'ADESLAS';-111,00 €;9.536,58 €;8022;-111,00;14.060,67 €;'sin fechas';16/12/2015;'ADESLAS';'Gastos_Salud, saber y deporte';'Medico';'VARIABLES'
16/12/2015;14/12/2015;'AUTOPISTAS';-1,39 €;9.535,19 €;8023;-1,39;14.059,28 €;'sin fechas';14/12/2015;'AUTOPISTAS';'Gastos_Ocio y transporte';'Parking y peaje';'VARIABLES'
16/12/2015;14/12/2015;'AUTOPISTAS';-1,39 €;9.533,80 €;8024;-1,39;14.057,89 €;'sin fechas';14/12/2015;'AUTOPISTAS';'Gastos_Ocio y transporte';'Parking y peaje';'VARIABLES'
16/12/2015;11/12/2015;'AUTOPISTAS';-1,39 €;9.532,41 €;8025;-1,39;14.056,50 €;'sin fechas';11/12/2015;'AUTOPISTAS';'Gastos_Ocio y transporte';'Parking y peaje';'VARIABLES'
16/12/2015;16/12/2015;'CAPRABO';-15,66 €;9.516,75 €;8026;-15,66;14.040,84 €;'sin fechas';16/12/2015;'CAPRABO';'Gastos_Compras';'Supermercado';'VARIABLES'
16/12/2015;16/12/2015;'CCM VIDA Y P SEGURO PRESTAMO';-23,03 €;9.493,72 €;8027;-23,03;14.017,81 €;'sin fechas';16/12/2015;'CCM';'Gastos_Seguros';'Seguro vida';'FIJO'
16/12/2015;16/12/2015;'CCM VIDA Y PENSIO 000000493358';-18,42 €;9.475,30 €;8028;-18,42;13.999,39 €;'sin fechas';16/12/2015;'CCM';'Gastos_Seguros';'Seguro vida';'FIJO'
16/12/2015;16/12/2015;'RESTAURANTES';-56,00 €;9.419,30 €;8029;-56,00;13.943,39 €;'sin fechas';16/12/2015;'RESTAURANTES';'Gastos_Ocio y transporte';'Restaurantes';'VARIABLES'
16/12/2015;16/12/2015;'VIENA';-16,00 €;9.403,30 €;8030;-16,00;13.927,39 €;'sin fechas';16/12/2015;'VIENA';'Gastos_Ocio y transporte';'Restaurantes';'VARIABLES'
17/12/2015;17/12/2015;'FRANKFURT LES LLETRES';-13,10 €;9.390,20 €;8031;-13,10;13.914,29 €;'sin fechas';17/12/2015;'FRANKFURT';'Gastos_Ocio y transporte';'Restaurantes';'VARIABLES'
17/12/2015;17/12/2015;'FRANKFURT LES LLETRES';-2,50 €;9.387,70 €;8032;-2,50;13.911,79 €;'sin fechas';17/12/2015;'FRANKFURT';'Gastos_Ocio y transporte';'Restaurantes';'VARIABLES'
17/12/2015;17/12/2015;'ONO';-115,78 €;9.271,92 €;8033;-115,78;13.796,01 €;'sin fechas';17/12/2015;'ONO';'Gastos_Servicios tipicos';'Telecomunicaciones';'FIJO'
17/12/2015;17/12/2015;'REGALOS NAV';-19,90 €;9.252,02 €;8034;-19,90;13.776,11 €;'sin fechas';17/12/2015;'REGALOS';'Gastos_Compras';'Regalos';'VARIABLES'
17/12/2015;17/12/2015;'REGALOS NAV';-100,95 €;9.151,07 €;8035;-100,95;13.675,16 €;'sin fechas';17/12/2015;'REGALOS';'Gastos_Compras';'Regalos';'VARIABLES'
17/12/2015;17/12/2015;'REINT.CAJERO';-40,00 €;9.111,07 €;8036;-40,00;13.635,16 €;'sin fechas';17/12/2015;'REINTCAJERO';'Gastos_Gastos varios';'Efectivo';'VARIABLES'
18/12/2015;17/12/2015;'AUTOPISTAS';-4,19 €;9.106,88 €;8037;-4,19;13.630,97 €;'sin fechas';17/12/2015;'AUTOPISTAS';'Gastos_Ocio y transporte';'Parking y peaje';'VARIABLES'
18/12/2015;16/12/2015;'AUTOPISTAS';-1,39 €;9.105,49 €;8038;-1,39;13.629,58 €;'sin fechas';16/12/2015;'AUTOPISTAS';'Gastos_Ocio y transporte';'Parking y peaje';'VARIABLES'
18/12/2015;18/12/2015;'CAFETERIA';-3,65 €;9.101,84 €;8039;-3,65;13.625,93 €;'sin fechas';18/12/2015;'CAFETERIA';'Gastos_Compras';'Supermercado';'VARIABLES'
18/12/2015;18/12/2015;'INFORMACIO I TECNOLOGIA DE CAT';1.768,51 €;10.870,35 €;8040;1.768,51;15.394,44 €;'sin fechas';18/12/2015;'INFORMACIO';'Ingresos';'Nomina';'FIJO'
18/12/2015;18/12/2015;'FRANKFURT LES LLETRES';-2,50 €;10.867,85 €;8041;-2,50;15.391,94 €;'sin fechas';18/12/2015;'FRANKFURT';'Gastos_Ocio y transporte';'Restaurantes';'VARIABLES'
18/12/2015;18/12/2015;'MERCADONA';-15,46 €;10.852,39 €;8042;-15,46;15.376,48 €;'sin fechas';18/12/2015;'MERCADONA';'Gastos_Compras';'Supermercado';'VARIABLES'
19/12/2015;17/12/2015;'AUTOPISTAS';-1,39 €;10.851,00 €;8043;-1,39;15.375,09 €;'sin fechas';17/12/2015;'AUTOPISTAS';'Gastos_Ocio y transporte';'Parking y peaje';'VARIABLES'
19/12/2015;19/12/2015;'CAFETERIA';-3,60 €;10.847,40 €;8044;-3,60;15.371,49 €;'sin fechas';19/12/2015;'CAFETERIA';'Gastos_Compras';'Supermercado';'VARIABLES'
19/12/2015;19/12/2015;'VIENA';-25,75 €;10.821,65 €;8045;-25,75;15.345,74 €;'sin fechas';19/12/2015;'VIENA';'Gastos_Ocio y transporte';'Restaurantes';'VARIABLES'
20/12/2015;20/12/2015;'CAFETERIA';-3,65 €;10.818,00 €;8046;-3,65;15.342,09 €;'sin fechas';20/12/2015;'CAFETERIA';'Gastos_Compras';'Supermercado';'VARIABLES'
20/12/2015;20/12/2015;'CARREFOUR-[OTROS]';-173,75 €;10.644,25 €;8047;-173,75;15.168,34 €;'sin fechas';20/12/2015;'CARREFOUROTROS';'Gastos_Compras';'Supermercado';'VARIABLES'
20/12/2015;20/12/2015;'REDPIZZA';-17,65 €;10.626,60 €;8048;-17,65;15.150,69 €;'sin fechas';20/12/2015;'REDPIZZA';'Gastos_Ocio y transporte';'Restaurantes';'VARIABLES'
21/12/2015;21/12/2015;'LUDINFANT, S.L. \ 18-12-2015';-15,00 €;10.611,60 €;8049;-15,00;15.135,69 €;'18-12-2015';'Err:502';'LUDINFANT';'Gastos_Compras';'Niños';'VARIABLES'
21/12/2015;21/12/2015;'REGALOS NAV';-32,81 €;10.578,79 €;8050;-32,81;15.102,88 €;'sin fechas';21/12/2015;'REGALOS';'Gastos_Compras';'Regalos';'VARIABLES'
21/12/2015;21/12/2015;'REGALOS NAV';-68,97 €;10.509,82 €;8051;-68,97;15.033,91 €;'sin fechas';21/12/2015;'REGALOS';'Gastos_Compras';'Regalos';'VARIABLES'
21/12/2015;21/12/2015;'REGALOS NAV';-18,95 €;10.490,87 €;8052;-18,95;15.014,96 €;'sin fechas';21/12/2015;'REGALOS';'Gastos_Compras';'Regalos';'VARIABLES'
21/12/2015;21/12/2015;'RESTAURANTES';-32,60 €;10.458,27 €;8053;-32,60;14.982,36 €;'sin fechas';21/12/2015;'RESTAURANTES';'Gastos_Ocio y transporte';'Restaurantes';'VARIABLES'
21/12/2015;21/12/2015;'RESTAURANTES';-6,40 €;10.451,87 €;8054;-6,40;14.975,96 €;'sin fechas';21/12/2015;'RESTAURANTES';'Gastos_Ocio y transporte';'Restaurantes';'VARIABLES'
21/12/2015;21/12/2015;'TOCINERIES VENTURA';-7,67 €;10.444,20 €;8055;-7,67;14.968,29 €;'sin fechas';21/12/2015;'TOCINERIES';'Gastos_Compras';'Supermercado';'VARIABLES'
21/12/2015;21/12/2015;'VIENA';-12,15 €;10.432,05 €;8056;-12,15;14.956,14 €;'sin fechas';21/12/2015;'VIENA';'Gastos_Ocio y transporte';'Restaurantes';'VARIABLES'
22/12/2015;22/12/2015;'ENTREGA PTMO. 3061-0960001518';-5.000,00 €;5.432,05 €;8057;-5.000,00;9.956,14 €;'sin fechas';22/12/2015;'ENTREGA';'Gastos_Banco y organismos';'Hipoteca';'FIJO'
22/12/2015;22/12/2015;'FOMENT DE TERRASSA, SA';3.675,75 €;9.107,80 €;8058;3.675,75;13.631,89 €;'sin fechas';22/12/2015;'FOMENT';'Ingresos';'Nomina';'FIJO'
22/12/2015;22/12/2015;'IKEA';-37,43 €;9.070,37 €;8059;-37,43;13.594,46 €;'sin fechas';22/12/2015;'IKEA';'Gastos_Vivienda y vehiculo';'Mnto. hogar';'VARIABLES'
22/12/2015;22/12/2015;'REDPIZZA';-17,65 €;9.052,72 €;8060;-17,65;13.576,81 €;'sin fechas';22/12/2015;'REDPIZZA';'Gastos_Ocio y transporte';'Restaurantes';'VARIABLES'
22/12/2015;22/12/2015;'ENTRADA DESDE LIBRETA MAX';5.000,00 €;14.052,72 €;8061;5.000,00;18.576,81 €;'sin fechas';22/12/2015;'ENTRADA';'Ingresos';'Transferencias';'VARIABLES'
23/12/2015;21/12/2015;'AUTOPISTAS';-1,39 €;14.051,33 €;8062;-1,39;18.575,42 €;'sin fechas';21/12/2015;'AUTOPISTAS';'Gastos_Ocio y transporte';'Parking y peaje';'VARIABLES'
23/12/2015;23/12/2015;'LIDL';-19,32 €;14.032,01 €;8063;-19,32;18.556,10 €;'sin fechas';23/12/2015;'LIDL';'Gastos_Compras';'Supermercado';'VARIABLES'
23/12/2015;21/12/2015;'PARKING';-6,40 €;14.025,61 €;8064;-6,40;18.549,70 €;'sin fechas';21/12/2015;'PARKING';'Gastos_Ocio y transporte';'Parking y peaje';'VARIABLES'
23/12/2015;23/12/2015;'REINT.CAJERO';-40,00 €;13.985,61 €;8065;-40,00;18.509,70 €;'sin fechas';23/12/2015;'REINTCAJERO';'Gastos_Gastos varios';'Efectivo';'VARIABLES'
24/12/2015;22/12/2015;'AUTOPISTAS';-1,39 €;13.984,22 €;8066;-1,39;18.508,31 €;'sin fechas';22/12/2015;'AUTOPISTAS';'Gastos_Ocio y transporte';'Parking y peaje';'VARIABLES'
24/12/2015;24/12/2015;'HOGAR&OTROS';-97,34 €;13.886,88 €;8067;-97,34;18.410,97 €;'sin fechas';24/12/2015;'HOGAROTROS';'Gastos_Vivienda y vehiculo';'Otros vivienda';'VARIABLES'
24/12/2015;24/12/2015;'LIDL';-23,09 €;13.863,79 €;8068;-23,09;18.387,88 €;'sin fechas';24/12/2015;'LIDL';'Gastos_Compras';'Supermercado';'VARIABLES'
24/12/2015;24/12/2015;'MERCADONA';-11,31 €;13.852,48 €;8069;-11,31;18.376,57 €;'sin fechas';24/12/2015;'MERCADONA';'Gastos_Compras';'Supermercado';'VARIABLES'
25/12/2015;25/12/2015;'ALCAMPO';-23,87 €;13.828,61 €;8070;-23,87;18.352,70 €;'sin fechas';25/12/2015;'ALCAMPO';'Gastos_Compras';'Supermercado';'VARIABLES'
25/12/2015;25/12/2015;'AUTOPISTAS';-4,19 €;13.824,42 €;8071;-4,19;18.348,51 €;'sin fechas';25/12/2015;'AUTOPISTAS';'Gastos_Ocio y transporte';'Parking y peaje';'VARIABLES'
25/12/2015;23/12/2015;'AUTOPISTAS';-1,39 €;13.823,03 €;8072;-1,39;18.347,12 €;'sin fechas';23/12/2015;'AUTOPISTAS';'Gastos_Ocio y transporte';'Parking y peaje';'VARIABLES'
25/12/2015;25/12/2015;'FF.CC.GENERALITAT';-8,00 €;13.815,03 €;8073;-8,00;18.339,12 €;'sin fechas';25/12/2015;'FFCCGENERALITAT';'Gastos_Ocio y transporte';'Transporte';'VARIABLES'
25/12/2015;25/12/2015;'GASOLINERA';-38,44 €;13.776,59 €;8074;-38,44;18.300,68 €;'sin fechas';25/12/2015;'GASOLINERA';'Gastos_Ocio y transporte';'Gasolina';'VARIABLES'
25/12/2015;25/12/2015;'HOGAR&OTROS';-13,60 €;13.762,99 €;8075;-13,60;18.287,08 €;'sin fechas';25/12/2015;'HOGAROTROS';'Gastos_Vivienda y vehiculo';'Otros vivienda';'VARIABLES'
25/12/2015;25/12/2015;'HOGAR&OTROS';-3,50 €;13.759,49 €;8076;-3,50;18.283,58 €;'sin fechas';25/12/2015;'HOGAROTROS';'Gastos_Vivienda y vehiculo';'Otros vivienda';'VARIABLES'
26/12/2015;26/12/2015;'AUTOPISTAS';-4,19 €;13.755,30 €;8077;-4,19;18.279,39 €;'sin fechas';26/12/2015;'AUTOPISTAS';'Gastos_Ocio y transporte';'Parking y peaje';'VARIABLES'
26/12/2015;26/12/2015;'HOGAR&OTROS';-24,87 €;13.730,43 €;8078;-24,87;18.254,52 €;'sin fechas';26/12/2015;'HOGAROTROS';'Gastos_Vivienda y vehiculo';'Otros vivienda';'VARIABLES'
27/12/2015;27/12/2015;'HOGAR&COMIDA';-10,93 €;13.719,50 €;8079;-10,93;18.243,59 €;'sin fechas';27/12/2015;'HOGARCOMIDA';'Gastos_Compras';'Supermercado';'VARIABLES'
27/12/2015;27/12/2015;'HOGAR&COMIDA';-12,41 €;13.707,09 €;8080;-12,41;18.231,18 €;'sin fechas';27/12/2015;'HOGARCOMIDA';'Gastos_Compras';'Supermercado';'VARIABLES'
27/12/2015;27/12/2015;'HOGAR&COMIDA';-20,66 €;13.686,43 €;8081;-20,66;18.210,52 €;'sin fechas';27/12/2015;'HOGARCOMIDA';'Gastos_Compras';'Supermercado';'VARIABLES'
27/12/2015;27/12/2015;'OTROS';-9,40 €;13.677,03 €;8082;-9,40;18.201,12 €;'sin fechas';27/12/2015;'OTROS';'Gastos_Gastos varios';'Otros gastos';'VARIABLES'
27/12/2015;27/12/2015;'RESTAURANTES';-20,75 €;13.656,28 €;8083;-20,75;18.180,37 €;'sin fechas';27/12/2015;'RESTAURANTES';'Gastos_Ocio y transporte';'Restaurantes';'VARIABLES'
27/12/2015;27/12/2015;'TRANSPORTS MUNICIP';-18,00 €;13.638,28 €;8084;-18,00;18.162,37 €;'sin fechas';27/12/2015;'TRANSPORTS';'Gastos_Ocio y transporte';'Transporte';'VARIABLES'
28/12/2015;28/12/2015;'AJUNTAMENT D TAXA RESIDUS CA';-51,23 €;13.587,05 €;8085;-51,23;18.111,14 €;'sin fechas';28/12/2015;'AJUNTAMENT';'Gastos_Banco y organismos';'Ayuntamiento';'FIJO'
28/12/2015;28/12/2015;'COMISIONES';-0,57 €;13.586,48 €;8086;-0,57;18.110,57 €;'sin fechas';28/12/2015;'COMISIONES';'Gastos_Banco y organismos';'Cargos banco';'FIJO'
28/12/2015;28/12/2015;'REINT.CAJERO';-60,00 €;13.526,48 €;8087;-60,00;18.050,57 €;'sin fechas';28/12/2015;'REINTCAJERO';'Gastos_Gastos varios';'Efectivo';'VARIABLES'
29/12/2015;27/12/2015;'AUTOPISTAS';-2,53 €;13.523,95 €;8088;-2,53;18.048,04 €;'sin fechas';27/12/2015;'AUTOPISTAS';'Gastos_Ocio y transporte';'Parking y peaje';'VARIABLES'
29/12/2015;27/12/2015;'AUTOPISTAS';-2,53 €;13.521,42 €;8089;-2,53;18.045,51 €;'sin fechas';27/12/2015;'AUTOPISTAS';'Gastos_Ocio y transporte';'Parking y peaje';'VARIABLES'
29/12/2015;29/12/2015;'INFORMACIO I TECNOLOGIA DE CAT';1.616,08 €;15.137,50 €;8090;1.616,08;19.661,59 €;'sin fechas';29/12/2015;'INFORMACIO';'Ingresos';'Nomina';'FIJO'
31/12/2015;31/12/2015;'CAFETERIA';-3,65 €;15.133,85 €;8091;-3,65;19.657,94 €;'sin fechas';31/12/2015;'CAFETERIA';'Gastos_Compras';'Supermercado';'VARIABLES'
31/12/2015;31/12/2015;'REC. 6061.9600001223';-539,84 €;14.594,01 €;8092;-539,84;19.118,10 €;'sin fechas';31/12/2015;'REC';'Gastos_Banco y organismos';'Hipoteca';'FIJO'
30/12/2015;30/12/2015;'AUTOPISTAS';-2,40 €;14.591,61 €;8093;-2,40;19.115,70 €;'sin fechas';30/12/2015;'AUTOPISTAS';'Gastos_Ocio y transporte';'Parking y peaje';'VARIABLES'
30/12/2015;30/12/2015;'AUTOPISTAS';-2,40 €;14.589,21 €;8094;-2,40;19.113,30 €;'sin fechas';30/12/2015;'AUTOPISTAS';'Gastos_Ocio y transporte';'Parking y peaje';'VARIABLES'
30/12/2015;28/12/2015;'AUTOPISTAS';-1,39 €;14.587,82 €;8095;-1,39;19.111,91 €;'sin fechas';28/12/2015;'AUTOPISTAS';'Gastos_Ocio y transporte';'Parking y peaje';'VARIABLES'
02/11/2015;02/11/2015;'PARKING';-4,19 €;14.583,63 €;8096;-4,19;19.107,72 €;'sin fechas';02/11/2015;'PARKING';'Gastos_Ocio y transporte';'Parking y peaje';'VARIABLES'
27/11/2015;27/11/2015;'AUTOPISTAS';-1,39 €;14.582,24 €;8097;-1,39;19.106,33 €;'sin fechas';27/11/2015;'AUTOPISTAS';'Gastos_Ocio y transporte';'Parking y peaje';'VARIABLES'
30/11/2015;30/11/2015;'AUTOPISTAS';-1,39 €;14.580,85 €;8098;-1,39;19.104,94 €;'sin fechas';30/11/2015;'AUTOPISTAS';'Gastos_Ocio y transporte';'Parking y peaje';'VARIABLES'
01/12/2015;01/12/2015;'AUTOPISTAS';-1,39 €;14.579,46 €;8099;-1,39;19.103,55 €;'sin fechas';01/12/2015;'AUTOPISTAS';'Gastos_Ocio y transporte';'Parking y peaje';'VARIABLES'
01/12/2015;01/12/2015;'TABASA VALLVI S. C:2T';-4,19 €;14.575,27 €;8100;-4,19;19.099,36 €;'sin fechas';01/12/2015;'TABASA';'Gastos_Ocio y transporte';'Parking y peaje';'VARIABLES'
01/12/2015;01/12/2015;'AUTOPISTAS';-1,39 €;14.573,88 €;8101;-1,39;19.097,97 €;'sin fechas';01/12/2015;'AUTOPISTAS';'Gastos_Ocio y transporte';'Parking y peaje';'VARIABLES'
01/12/2015;01/12/2015;'PERRUQUERIA';-20,00 €;14.553,88 €;8102;-20,00;19.077,97 €;'sin fechas';01/12/2015;'PERRUQUERIA';'Gastos_Salud, saber y deporte';'Belleza';'VARIABLES'
02/12/2015;02/12/2015;'TABASA VALLVI S. C:2T';-3,72 €;14.550,16 €;8103;-3,72;19.074,25 €;'sin fechas';02/12/2015;'TABASA';'Gastos_Ocio y transporte';'Parking y peaje';'VARIABLES'
02/12/2015;02/12/2015;'AUTOPISTAS';-1,39 €;14.548,77 €;8104;-1,39;19.072,86 €;'sin fechas';02/12/2015;'AUTOPISTAS';'Gastos_Ocio y transporte';'Parking y peaje';'VARIABLES'
02/12/2015;02/12/2015;'CAFETERIA';-3,65 €;14.545,12 €;8105;-3,65;19.069,21 €;'sin fechas';02/12/2015;'CAFETERIA';'Gastos_Compras';'Supermercado';'VARIABLES'
02/12/2015;02/12/2015;'CAFETERIA';-5,40 €;14.539,72 €;8106;-5,40;19.063,81 €;'sin fechas';02/12/2015;'CAFETERIA';'Gastos_Compras';'Supermercado';'VARIABLES'
04/12/2015;04/12/2015;'PERRUQUERIA';-29,65 €;14.510,07 €;8107;-29,65;19.034,16 €;'sin fechas';04/12/2015;'PERRUQUERIA';'Gastos_Salud, saber y deporte';'Belleza';'VARIABLES'
07/12/2015;07/12/2015;'AUTOPISTAS';-1,39 €;14.508,68 €;8108;-1,39;19.032,77 €;'sin fechas';07/12/2015;'AUTOPISTAS';'Gastos_Ocio y transporte';'Parking y peaje';'VARIABLES'
08/12/2015;08/12/2015;'FNAC';-31,46 €;14.477,22 €;8109;-31,46;19.001,31 €;'sin fechas';08/12/2015;'FNAC';'Gastos_Compras';'Supermercado';'VARIABLES'
08/12/2015;08/12/2015;'PRIMARK';-60,00 €;14.417,22 €;8110;-60,00;18.941,31 €;'sin fechas';08/12/2015;'PRIMARK';'Gastos_Compras';'Ropa';'VARIABLES'
09/12/2015;09/12/2015;'TABASA VALLVI S. C:2T';-4,19 €;14.413,03 €;8111;-4,19;18.937,12 €;'sin fechas';09/12/2015;'TABASA';'Gastos_Ocio y transporte';'Parking y peaje';'VARIABLES'
09/12/2015;09/12/2015;'AUTOPISTAS';-1,39 €;14.411,64 €;8112;-1,39;18.935,73 €;'sin fechas';09/12/2015;'AUTOPISTAS';'Gastos_Ocio y transporte';'Parking y peaje';'VARIABLES'
10/12/2015;10/12/2015;'FRANKFURT LES LLETRES';-18,15 €;14.393,49 €;8113;-18,15;18.917,58 €;'sin fechas';10/12/2015;'FRANKFURT';'Gastos_Ocio y transporte';'Restaurantes';'VARIABLES'
11/12/2015;11/12/2015;'AUTOPISTAS';-1,39 €;14.392,10 €;8114;-1,39;18.916,19 €;'sin fechas';11/12/2015;'AUTOPISTAS';'Gastos_Ocio y transporte';'Parking y peaje';'VARIABLES'
12/12/2015;12/12/2015;'CARREFOUR-[OTROS]';-70,27 €;14.321,83 €;8115;-70,27;18.845,92 €;'sin fechas';12/12/2015;'CARREFOUROTROS';'Gastos_Compras';'Supermercado';'VARIABLES'
12/12/2015;12/12/2015;'RESTAURANTES';-5,00 €;14.316,83 €;8116;-5,00;18.840,92 €;'sin fechas';12/12/2015;'RESTAURANTES';'Gastos_Ocio y transporte';'Restaurantes';'VARIABLES'
12/12/2015;12/12/2015;'RESTAURANTES';-15,40 €;14.301,43 €;8117;-15,40;18.825,52 €;'sin fechas';12/12/2015;'RESTAURANTES';'Gastos_Ocio y transporte';'Restaurantes';'VARIABLES'
14/12/2015;14/12/2015;'CAFETERIA';-3,05 €;14.298,38 €;8118;-3,05;18.822,47 €;'sin fechas';14/12/2015;'CAFETERIA';'Gastos_Compras';'Supermercado';'VARIABLES'
15/12/2015;15/12/2015;'TABASA VALLVI S. C:2T';-4,19 €;14.294,19 €;8119;-4,19;18.818,28 €;'sin fechas';15/12/2015;'TABASA';'Gastos_Ocio y transporte';'Parking y peaje';'VARIABLES'
15/12/2015;15/12/2015;'AUTOPISTAS';-1,39 €;14.292,80 €;8120;-1,39;18.816,89 €;'sin fechas';15/12/2015;'AUTOPISTAS';'Gastos_Ocio y transporte';'Parking y peaje';'VARIABLES'
15/12/2015;15/12/2015;'AUTOPISTAS';-1,39 €;14.291,41 €;8121;-1,39;18.815,50 €;'sin fechas';15/12/2015;'AUTOPISTAS';'Gastos_Ocio y transporte';'Parking y peaje';'VARIABLES'
15/12/2015;15/12/2015;'TOYOTA ORIENT CARS';-366,09 €;13.925,32 €;8122;-366,09;18.449,41 €;'sin fechas';15/12/2015;'TOYOTA';'Gastos_Vivienda y vehiculo';'Mnto. vehiculo';'VARIABLE'
16/12/2015;16/12/2015;'TABASA VALLVI S. C:2T';-4,19 €;13.921,13 €;8123;-4,19;18.445,22 €;'sin fechas';16/12/2015;'TABASA';'Gastos_Ocio y transporte';'Parking y peaje';'VARIABLES'
16/12/2015;16/12/2015;'AUTOPISTAS';-1,39 €;13.919,74 €;8124;-1,39;18.443,83 €;'sin fechas';16/12/2015;'AUTOPISTAS';'Gastos_Ocio y transporte';'Parking y peaje';'VARIABLES'
17/12/2015;17/12/2015;'AUTOPISTAS';-1,39 €;13.918,35 €;8125;-1,39;18.442,44 €;'sin fechas';17/12/2015;'AUTOPISTAS';'Gastos_Ocio y transporte';'Parking y peaje';'VARIABLES'
17/12/2015;17/12/2015;'DECATHLON';-9,98 €;13.908,37 €;8126;-9,98;18.432,46 €;'sin fechas';17/12/2015;'DECATHLON';'Gastos_Compras';'Deportivo';'VARIABLES'
20/12/2015;20/12/2015;'BURGUER KING PARC';-24,33 €;13.884,04 €;8127;-24,33;18.408,13 €;'sin fechas';20/12/2015;'BURGUER';'Gastos_Ocio y transporte';'Restaurantes';'VARIABLES'
21/12/2015;21/12/2015;'TABASA VALLVI S. C:2T';-4,19 €;13.879,85 €;8128;-4,19;18.403,94 €;'sin fechas';21/12/2015;'TABASA';'Gastos_Ocio y transporte';'Parking y peaje';'VARIABLES'
21/12/2015;21/12/2015;'AUTOPISTAS';-1,39 €;13.878,46 €;8129;-1,39;18.402,55 €;'sin fechas';21/12/2015;'AUTOPISTAS';'Gastos_Ocio y transporte';'Parking y peaje';'VARIABLES'
21/12/2015;21/12/2015;'CAFETERIA';-3,65 €;13.874,81 €;8130;-3,65;18.398,90 €;'sin fechas';21/12/2015;'CAFETERIA';'Gastos_Compras';'Supermercado';'VARIABLES'
22/12/2015;22/12/2015;'AUTOPISTAS';-1,39 €;13.873,42 €;8131;-1,39;18.397,51 €;'sin fechas';22/12/2015;'AUTOPISTAS';'Gastos_Ocio y transporte';'Parking y peaje';'VARIABLES'
22/12/2015;22/12/2015;'CAFETERIA';-3,60 €;13.869,82 €;8132;-3,60;18.393,91 €;'sin fechas';22/12/2015;'CAFETERIA';'Gastos_Compras';'Supermercado';'VARIABLES'
23/12/2015;23/12/2015;'AUTOPISTAS';-1,39 €;13.868,43 €;8133;-1,39;18.392,52 €;'sin fechas';23/12/2015;'AUTOPISTAS';'Gastos_Ocio y transporte';'Parking y peaje';'VARIABLES'
23/12/2015;23/12/2015;'CAFETERIA';-3,65 €;13.864,78 €;8134;-3,65;18.388,87 €;'sin fechas';23/12/2015;'CAFETERIA';'Gastos_Compras';'Supermercado';'VARIABLES'
24/12/2015;24/12/2015;'AUTOPISTAS';-1,39 €;13.863,39 €;8135;-1,39;18.387,48 €;'sin fechas';24/12/2015;'AUTOPISTAS';'Gastos_Ocio y transporte';'Parking y peaje';'VARIABLES'
24/12/2015;24/12/2015;'CAFETERIA';-3,50 €;13.859,89 €;8136;-3,50;18.383,98 €;'sin fechas';24/12/2015;'CAFETERIA';'Gastos_Compras';'Supermercado';'VARIABLES'
30/12/2015;30/12/2015;'CAFETERIA';-3,65 €;13.856,24 €;8137;-3,65;18.380,33 €;'sin fechas';30/12/2015;'CAFETERIA';'Gastos_Compras';'Supermercado';'VARIABLES'
