F. contable;F. valor;Concepto;Importe;Saldo anterior;Saldo;Seq;Import_num;Saldo anterior;Tiene fecha;Fecha Valor Concepto;Clave_Concepto;Categoria;Subcategoria;Mes_Valor_Concepto;Fijo_Variable
31/12/2015;31/12/2015;SALDO AÑO ANTERIOR;0,00;18380,33;18380,33;0;0,00;18380,33;2015-12-31;31/12/2015;SALDO;No computable;Inicializacion;12;
01/01/2016;29/12/2015;T/ AUTOPISTAS TERR;-1,39;18380,33;18378,94;8138;-1,39;18378,94;2015-12-29;29/12/2015;AUTOPISTAS;Gastos_Ocio y transporte;Parking y peaje;12;VARIABLES
01/01/2016;30/12/2015;T/ AUTOPISTAS TERR;-1,39;18378,94;18377,55;8139;-1,39;18377,55;2015-12-30;30/12/2015;AUTOPISTAS;Gastos_Ocio y transporte;Parking y peaje;12;VARIABLES
01/01/2016;30/12/2015;T/ AUTOPISTAS TERR;-1,39;18377,55;18376,16;8140;-1,39;18376,16;2015-12-30;30/12/2015;AUTOPISTAS;Gastos_Ocio y transporte;Parking y peaje;12;VARIABLES
01/01/2016;01/01/2016;T/ VIENA PARC VALLES \ 29-12-2015;-21,25;18376,16;18354,91;8141;-21,25;18354,91;2015-12-29;29/12/2015;VIENA;Gastos_Ocio y transporte;Restaurantes;12;VARIABLES
01/01/2016;01/01/2016;T/ MERCADONA PARC VAL\ 29-12-2015;-61,16;18354,91;18293,75;8142;-61,16;18293,75;2015-12-29;29/12/2015;MERCADONA;Gastos_Compras;Supermercado;12;VARIABLES
01/01/2016;01/01/2016;INT. 210560613010013266;0,90;18293,75;18294,65;8143;0,90;18294,65;2016-01-01;01/01/2016;INT;Ingresos;Rendimientos;1;
01/01/2016;01/01/2016;RET.REND.CAP.M;-0,18;18294,65;18294,47;8144;-0,18;18294,47;2016-01-01;01/01/2016;RETRENDCAPM;Gastos_Banco y organismos;Impuestos;1;FIJO
01/01/2016;01/01/2016;LIMPIEZA;-130,00;18294,47;18164,47;8145;-130,00;18164,47;2016-01-01;01/01/2016;LIMPIEZA;Gastos_Vivienda y vehiculo;Serv. domestico;1;FIJO
02/01/2016;02/01/2016;T/ LIDL TERRASSA LES \ 30-12-2015;-51,56;18164,47;18112,91;8146;-51,56;18112,91;2015-12-30;30/12/2015;LIDL;Gastos_Compras;Supermercado;12;VARIABLES
02/01/2016;02/01/2016;T/ SUPER.REYPA \TARRA 30-12-2015;-7,76;18112,91;18105,15;8147;-7,76;18105,15;2015-12-30;30/12/2015;SUPERREYPA;Gastos_Compras;Supermercado;12;VARIABLES
03/01/2016;03/01/2016;'T/ JOHN''S ITALIAN CAF\ 31-12-2015';-19,30;18105,15;18085,85;8148;-19,30;18085,85;2015-12-31;31/12/2015;JOHNS;Gastos_Ocio y transporte;Restaurantes;12;VARIABLES
03/01/2016;03/01/2016;T/ SR. FROS \ 31-12-2015;-15,10;18085,85;18070,75;8149;-15,10;18070,75;2015-12-31;31/12/2015;FROS;Gastos_Ocio y transporte;Restaurantes;12;VARIABLES
03/01/2016;03/01/2016;T/ MERCADONA - CUATRE\ 31-12-2015;-42,40;18070,75;18028,35;8150;-42,40;18028,35;2015-12-31;31/12/2015;MERCADONA;Gastos_Compras;Supermercado;12;VARIABLES
05/01/2016;31/12/2015;T/ AUTOPISTAS TERR;-1,39;18028,35;18026,96;8151;-1,39;18026,96;2015-12-31;31/12/2015;AUTOPISTAS;Gastos_Ocio y transporte;Parking y peaje;12;VARIABLES
06/01/2016;06/01/2016;R/ CEM - CENTRE DESCRIPCION;-97,50;18026,96;17929,46;8152;-97,50;17929,46;2016-01-06;06/01/2016;CEM;Gastos_Salud, saber y deporte;Estudios;1;VARIABLES
06/01/2016;06/01/2016;T/ ALABINA PIZZERIA \B 03-01-2016;-44,00;17929,46;17885,46;8153;-44,00;17885,46;2016-01-03;03/01/2016;ALABINA;Gastos_Ocio y transporte;Restaurantes;1;VARIABLES
07/01/2016;07/01/2016;R/ Serunion SA /FOR/ESCOLA SALA;-88,95;17885,46;17796,51;8154;-88,95;17796,51;2016-01-07;07/01/2016;SERUNION;Gastos_Salud, saber y deporte;Menjador;1;FIJO
07/01/2016;07/01/2016;R/ Serunion SA /FOR/ESCOLA SALA;-88,95;17796,51;17707,56;8155;-88,95;17707,56;2016-01-07;07/01/2016;SERUNION;Gastos_Salud, saber y deporte;Menjador;1;FIJO
07/01/2016;06/01/2016;T/ TABASA VALLVI N. 03-01-2016;-3,70;17707,56;17703,86;8156;-3,70;17703,86;2016-01-03;03/01/2016;TABASA;Gastos_Ocio y transporte;Parking y peaje;1;VARIABLES
07/01/2016;06/01/2016;T/ TABASA VALLVI S. 03-01-2016;-3,70;17703,86;17700,16;8157;-3,70;17700,16;2016-01-03;03/01/2016;TABASA;Gastos_Ocio y transporte;Parking y peaje;1;VARIABLES
08/01/2016;03/01/2016;T/ AUTOPISTAS TERR;-2,51;17700,16;17697,65;8158;-2,51;17697,65;2016-01-03;03/01/2016;AUTOPISTAS;Gastos_Ocio y transporte;Parking y peaje;1;VARIABLES
08/01/2016;03/01/2016;T/ AUTOPISTAS TERR;-2,51;17697,65;17695,14;8159;-2,51;17695,14;2016-01-03;03/01/2016;AUTOPISTAS;Gastos_Ocio y transporte;Parking y peaje;1;VARIABLES
08/01/2016;08/01/2016;T/ WWW.JUST-EAT.ES 05-01-2016;-25,55;17695,14;17669,59;8160;-25,55;17669,59;2016-01-05;05/01/2016;WWWJUSTEATES;Gastos_Ocio y transporte;Restaurantes;1;VARIABLES
08/01/2016;08/01/2016;T/ SATURN E515 EL\PRAT 05-01-2016;-99,95;17669,59;17569,64;8161;-99,95;17569,64;2016-01-05;05/01/2016;SATURN;Gastos_Compras;Hobbys;1;VARIABLES
08/01/2016;08/01/2016;T/ CINESA PARC VALLES\ 05-01-2016;-37,00;17569,64;17532,64;8162;-37,00;17532,64;2016-01-05;05/01/2016;CINESA;Gastos_Ocio y transporte;Espectáculos;1;VARIABLES
10/01/2016;10/01/2016;T/ CINESA PARC VALLES\ 07-01-2016;-15,40;17532,64;17517,24;8163;-15,40;17517,24;2016-01-07;07/01/2016;CINESA;Gastos_Ocio y transporte;Espectáculos;1;VARIABLES
10/01/2016;10/01/2016;T/ MERCADONA PARC VAL\ 07-01-2016;-12,65;17517,24;17504,59;8164;-12,65;17504,59;2016-01-07;07/01/2016;MERCADONA;Gastos_Compras;Supermercado;1;VARIABLES
10/01/2016;10/01/2016;T/ CINESA PARC VALLES\ 07-01-2016;-7,60;17504,59;17496,99;8165;-7,60;17496,99;2016-01-07;07/01/2016;CINESA;Gastos_Ocio y transporte;Espectáculos;1;VARIABLES
10/01/2016;10/01/2016;T/ CAFET.C T PRAT\PRAT 07-01-2016;-2,15;17496,99;17494,84;8166;-2,15;17494,84;2016-01-07;07/01/2016;CAFETC;Gastos_Ocio y transporte;Restaurantes;1;VARIABLES
10/01/2016;10/01/2016;T/ CAFET.C T PRAT\PRAT 07-01-2016;-4,50;17494,84;17490,34;8167;-4,50;17490,34;2016-01-07;07/01/2016;CAFETC;Gastos_Ocio y transporte;Restaurantes;1;VARIABLES
10/01/2016;10/01/2016;T/ FRANKFURT LES LLET\ 07-01-2016;-4,00;17490,34;17486,34;8168;-4,00;17486,34;2016-01-07;07/01/2016;FRANKFURT;Gastos_Ocio y transporte;Restaurantes;1;VARIABLES
10/01/2016;10/01/2016;T/ CEDIPSA 13497-1 C\B 07-01-2016;-30,00;17486,34;17456,34;8169;-30,00;17456,34;2016-01-07;07/01/2016;CEDIPSA;Gastos_Ocio y transporte;Gasolina;1;VARIABLES
11/01/2016;11/01/2016;T/ FRANKFURT LES LLET\ 08-01-2016;-2,50;17456,34;17453,84;8170;-2,50;17453,84;2016-01-08;08/01/2016;FRANKFURT;Gastos_Ocio y transporte;Restaurantes;1;VARIABLES
12/01/2016;12/01/2016;R/ BLITZ 40, S. Alquiler mes en c;-72,50;17453,84;17381,34;8171;-72,50;17381,34;2016-01-12;12/01/2016;BLITZ;Gastos_Vivienda y vehiculo;Alquiler Parking;1;FIJO
12/01/2016;07/01/2016;T/ AUTOPISTAS TERR;-1,38;17381,34;17379,96;8172;-1,38;17379,96;2016-01-07;07/01/2016;AUTOPISTAS;Gastos_Ocio y transporte;Parking y peaje;1;VARIABLES
12/01/2016;08/01/2016;T/ AUTOPISTAS TERR;-1,38;17379,96;17378,58;8173;-1,38;17378,58;2016-01-08;08/01/2016;AUTOPISTAS;Gastos_Ocio y transporte;Parking y peaje;1;VARIABLES
12/01/2016;08/01/2016;T/ AUTOPISTAS TERR;-1,38;17378,58;17377,20;8174;-1,38;17377,20;2016-01-08;08/01/2016;AUTOPISTAS;Gastos_Ocio y transporte;Parking y peaje;1;VARIABLES
12/01/2016;12/01/2016;T/ FOTOPRIX SA \B 09-01-2016;-5,25;17377,20;17371,95;8175;-5,25;17371,95;2016-01-09;09/01/2016;FOTOPRIX;Gastos_Compras;Niños;1;VARIABLES
12/01/2016;12/01/2016;T/ MERCADONA PARC VAL\ 09-01-2016;-27,13;17371,95;17344,82;8176;-27,13;17344,82;2016-01-09;09/01/2016;MERCADONA;Gastos_Compras;Supermercado;1;VARIABLES
12/01/2016;12/01/2016;T/ PRODUCTOS NATURAL\B 09-01-2016;-23,90;17344,82;17320,92;8177;-23,90;17320,92;2016-01-09;09/01/2016;PRODUCTOS;Gastos_Salud, saber y deporte;Otros Salud;1;VARIABLES
12/01/2016;12/01/2016;T/ PRODUCTOS NATURAL\B 09-01-2016;-111,49;17320,92;17209,43;8178;-111,49;17209,43;2016-01-09;09/01/2016;PRODUCTOS;Gastos_Salud, saber y deporte;Otros Salud;1;VARIABLES
13/01/2016;13/01/2016;O/ GENERALITAT DE CATALUNYA-BENES;372,17;17209,43;17581,60;8179;372,17;17581,60;2016-01-13;13/01/2016;GENERALITAT;Ingresos;Subvenciones;1;
13/01/2016;11/01/2016;T/ AUTOPISTAS TERR;-1,38;17581,60;17580,22;8180;-1,38;17580,22;2016-01-11;11/01/2016;AUTOPISTAS;Gastos_Ocio y transporte;Parking y peaje;1;VARIABLES
13/01/2016;11/01/2016;T/ AUTOPISTAS TERR;-1,38;17580,22;17578,84;8181;-1,38;17578,84;2016-01-11;11/01/2016;AUTOPISTAS;Gastos_Ocio y transporte;Parking y peaje;1;VARIABLES
13/01/2016;11/01/2016;T/ TABASA VALLVI S. 08-01-2016;-4,16;17578,84;17574,68;8182;-4,16;17574,68;2016-01-08;08/01/2016;TABASA;Gastos_Ocio y transporte;Parking y peaje;1;VARIABLES
14/01/2016;12/01/2016;T/ AUTOPISTAS TERR;-1,38;17574,68;17573,30;8183;-1,38;17573,30;2016-01-12;12/01/2016;AUTOPISTAS;Gastos_Ocio y transporte;Parking y peaje;1;VARIABLES
14/01/2016;14/01/2016;T/ FRANKFURT LES LLET\ 11-01-2016;-6,90;17573,30;17566,40;8184;-6,90;17566,40;2016-01-11;11/01/2016;FRANKFURT;Gastos_Ocio y transporte;Restaurantes;1;VARIABLES
14/01/2016;14/01/2016;T/ FRANKFURT LES LLET\ 11-01-2016;-1,40;17566,40;17565,00;8185;-1,40;17565,00;2016-01-11;11/01/2016;FRANKFURT;Gastos_Ocio y transporte;Restaurantes;1;VARIABLES
14/01/2016;14/01/2016;T/ TABASA VALLVI S. 11-01-2016;-4,16;17565,00;17560,84;8186;-4,16;17560,84;2016-01-11;11/01/2016;TABASA;Gastos_Ocio y transporte;Parking y peaje;1;VARIABLES
14/01/2016;14/01/2016;T/ MERCADONA - CUATRE\ 11-01-2016;-31,84;17560,84;17529,00;8187;-31,84;17529,00;2016-01-11;11/01/2016;MERCADONA;Gastos_Compras;Supermercado;1;VARIABLES
15/01/2016;15/01/2016;R/ SEGUROS ADESLAS CENT MODULAR CO;-113,89;17529,00;17415,11;8188;-113,89;17415,11;2016-01-15;15/01/2016;ADESLAS;Gastos_Salud, saber y deporte;Medico;1;VARIABLES
15/01/2016;13/01/2016;T/ AUTOPISTAS TERR;-1,38;17415,11;17413,73;8189;-1,38;17413,73;2016-01-13;13/01/2016;AUTOPISTAS;Gastos_Ocio y transporte;Parking y peaje;1;VARIABLES
16/01/2016;16/01/2016;T/ MERCADONA - CUATRE\ 13-01-2016;-8,85;17413,73;17404,88;8190;-8,85;17404,88;2016-01-13;13/01/2016;MERCADONA;Gastos_Compras;Supermercado;1;VARIABLES
16/01/2016;16/01/2016;T/ MERCADONA - CUATRE\ 13-01-2016;-126,56;17404,88;17278,32;8191;-126,56;17278,32;2016-01-13;13/01/2016;MERCADONA;Gastos_Compras;Supermercado;1;VARIABLES
18/01/2016;18/01/2016;R/ TELEFONO Vodafone Ono ONOAU16-0;-115,23;17278,32;17163,09;8192;-115,23;17163,09;2016-01-18;18/01/2016;TELEFONO;Gastos_Servicios tipicos;Telecomunicaciones;1;FIJO
18/01/2016;18/01/2016;R/ SEGUROS CCM VIDA Y P Recibo:133;-21,76;17163,09;17141,33;8193;-21,76;17141,33;2016-01-18;18/01/2016;CCM;Gastos_Seguros;Seguro vida;1;FIJO
18/01/2016;18/01/2016;R/ SEGUROS CCM VIDA Y P Recibo:133;-17,40;17141,33;17123,93;8194;-17,40;17123,93;2016-01-18;18/01/2016;CCM;Gastos_Seguros;Seguro vida;1;FIJO
18/01/2016;18/01/2016;T/ EL RACO \ 15-01-2016;-14,45;17123,93;17109,48;8195;-14,45;17109,48;2016-01-15;15/01/2016;RACO;Gastos_Ocio y transporte;Restaurantes;1;VARIABLES
18/01/2016;18/01/2016;T/ FRANKFURT LES LLET\ 15-01-2016;-1,40;17109,48;17108,08;8196;-1,40;17108,08;2016-01-15;15/01/2016;FRANKFURT;Gastos_Ocio y transporte;Restaurantes;1;VARIABLES
19/01/2016;19/01/2016;T/ VIENA XALET SABADE\ 16-01-2016;-10,50;17108,08;17097,58;8197;-10,50;17097,58;2016-01-16;16/01/2016;VIENA;Gastos_Ocio y transporte;Restaurantes;1;VARIABLES
20/01/2016;18/01/2016;T/ AUTOPISTAS TERR;-1,38;17097,58;17096,20;8198;-1,38;17096,20;2016-01-18;18/01/2016;AUTOPISTAS;Gastos_Ocio y transporte;Parking y peaje;1;VARIABLES
20/01/2016;20/01/2016;T/ LA BRASA \ 17-01-2016;-15,00;17096,20;17081,20;8199;-15,00;17081,20;2016-01-17;17/01/2016;BRASA;Gastos_Ocio y transporte;Restaurantes;1;VARIABLES
21/01/2016;21/01/2016;T/ CEDIPSA 15838-1 EG\ 18-01-2016;-41,20;17081,20;17040,00;8200;-41,20;17040,00;2016-01-18;18/01/2016;CEDIPSA;Gastos_Ocio y transporte;Gasolina;1;VARIABLES
22/01/2016;19/01/2016;T/ AUTOPISTAS TERR;-1,38;17040,00;17038,62;8201;-1,38;17038,62;2016-01-19;19/01/2016;AUTOPISTAS;Gastos_Ocio y transporte;Parking y peaje;1;VARIABLES
22/01/2016;20/01/2016;T/ AUTOPISTAS TERR;-1,38;17038,62;17037,24;8202;-1,38;17037,24;2016-01-20;20/01/2016;AUTOPISTAS;Gastos_Ocio y transporte;Parking y peaje;1;VARIABLES
22/01/2016;22/01/2016;CAJ. AJENO SERVIRED \TERRASSA;-20,00;17037,24;17017,24;8203;-20,00;17017,24;2016-01-22;22/01/2016;CAJ;Gastos_Gastos varios;Efectivo;1;VARIABLES
22/01/2016;22/01/2016;COM. 64970028 SVRED CAJ OFI;-1,87;17017,24;17015,37;8204;-1,87;17015,37;2016-01-22;22/01/2016;COM;Gastos_Banco y organismos;Cargos banco;1;FIJO
22/01/2016;22/01/2016;T/ LIDL TERRASSA LES \ 19-01-2016;-41,59;17015,37;16973,78;8205;-41,59;16973,78;2016-01-19;19/01/2016;LIDL;Gastos_Compras;Supermercado;1;VARIABLES
24/01/2016;24/01/2016;T/ CAPRABO \ 21-01-2016;-14,92;16973,78;16958,86;8206;-14,92;16958,86;2016-01-21;21/01/2016;CAPRABO;Gastos_Compras;Supermercado;1;VARIABLES
24/01/2016;24/01/2016;T/ FRANKFURT LES LLET\ 21-01-2016;-4,00;16958,86;16954,86;8207;-4,00;16954,86;2016-01-21;21/01/2016;FRANKFURT;Gastos_Ocio y transporte;Restaurantes;1;VARIABLES
24/01/2016;23/01/2016;T/ TABASA VALLVI S. 20-01-2016;-4,16;16954,86;16950,70;8208;-4,16;16950,70;2016-01-20;20/01/2016;TABASA;Gastos_Ocio y transporte;Parking y peaje;1;VARIABLES
25/01/2016;25/01/2016;T/ CAFET.C T PRAT\PRAT 22-01-2016;-0,90;16950,70;16949,80;8209;-0,90;16949,80;2016-01-22;22/01/2016;CAFETC;Gastos_Ocio y transporte;Restaurantes;1;VARIABLES
25/01/2016;25/01/2016;T/ MERCADONA PARC VAL\ 22-01-2016;-13,88;16949,80;16935,92;8210;-13,88;16935,92;2016-01-22;22/01/2016;MERCADONA;Gastos_Compras;Supermercado;1;VARIABLES
25/01/2016;25/01/2016;T/ LA TERRASSETA \ 22-01-2016;-13,20;16935,92;16922,72;8211;-13,20;16922,72;2016-01-22;22/01/2016;TERRASSETA;Gastos_Ocio y transporte;Restaurantes;1;VARIABLES
26/01/2016;26/01/2016;T/ CAPRABO - 427 TERR\ 23-01-2016;-25,07;16922,72;16897,65;8212;-25,07;16897,65;2016-01-23;23/01/2016;CAPRABO;Gastos_Compras;Supermercado;1;VARIABLES
26/01/2016;26/01/2016;T/ LEFTIES \B 23-01-2016;-21,97;16897,65;16875,68;8213;-21,97;16875,68;2016-01-23;23/01/2016;LEFTIES;Gastos_Compras;Ropa;1;VARIABLES
26/01/2016;26/01/2016;T/ PRODUCTOS NATURAL\B 23-01-2016;-60,90;16875,68;16814,78;8214;-60,90;16814,78;2016-01-23;23/01/2016;PRODUCTOS;Gastos_Salud, saber y deporte;Otros Salud;1;VARIABLES
26/01/2016;26/01/2016;T/ SATURN E515 EL\PRAT 23-01-2016;-49,79;16814,78;16764,99;8215;-49,79;16764,99;2016-01-23;23/01/2016;SATURN;Gastos_Compras;Hobbys;1;VARIABLES
28/01/2016;28/01/2016;HAB. FOMENT DE TERRASSA, SA;1789,37;16764,99;18554,36;8216;1789,37;18554,36;2016-01-28;28/01/2016;HAB;Ingresos;Nomina;1;FIJO
29/01/2016;29/01/2016;HAB. INFORMACIO I TECNOLOGIA DE CAT;1615,32;18554,36;20169,68;8217;1615,32;20169,68;2016-01-29;29/01/2016;HAB;Ingresos;Nomina;1;FIJO
29/01/2016;29/01/2016;T/ FRANKFURT LES LLET\ 26-01-2016;-3,80;20169,68;20165,88;8218;-3,80;20165,88;2016-01-26;26/01/2016;FRANKFURT;Gastos_Ocio y transporte;Restaurantes;1;VARIABLES
29/01/2016;29/01/2016;T/ CAFET.C T PRAT\PRAT 26-01-2016;-4,80;20165,88;20161,08;8219;-4,80;20161,08;2016-01-26;26/01/2016;CAFETC;Gastos_Ocio y transporte;Restaurantes;1;VARIABLES
29/01/2016;01/02/2016;INT. 210560613010013266;0,61;20161,08;20161,69;8220;0,61;20161,69;2016-02-01;01/02/2016;INT;Ingresos;Rendimientos;2;
29/01/2016;01/02/2016;RET.REND.CAP.M;-0,12;20161,69;20161,57;8221;-0,12;20161,57;2016-02-01;01/02/2016;RETRENDCAPM;Gastos_Banco y organismos;Impuestos;2;FIJO
30/01/2016;30/01/2016;T/ LA TERRASSETA \ 27-01-2016;-4,30;20161,57;20157,27;8222;-4,30;20157,27;2016-01-27;27/01/2016;TERRASSETA;Gastos_Ocio y transporte;Restaurantes;1;VARIABLES
30/01/2016;30/01/2016;T/ FRANKFURT LES LLET\ 27-01-2016;-3,15;20157,27;20154,12;8223;-3,15;20154,12;2016-01-27;27/01/2016;FRANKFURT;Gastos_Ocio y transporte;Restaurantes;1;VARIABLES
31/01/2016;31/01/2016;REC. 6061.9600001223;-530,06;20154,12;19624,06;8224;-530,06;19624,06;2016-01-31;31/01/2016;REC;Gastos_Banco y organismos;Hipoteca;1;FIJO
31/01/2016;31/01/2016;T/ CAFET.C T PRAT\PRAT 28-01-2016;-1,80;19624,06;19622,26;8225;-1,80;19622,26;2016-01-28;28/01/2016;CAFETC;Gastos_Ocio y transporte;Restaurantes;1;VARIABLES
31/01/2016;31/01/2016;T/ GAME CC CARREFOUR \ 28-01-2016;-19,95;19622,26;19602,31;8226;-19,95;19602,31;2016-01-28;28/01/2016;GAME;Gastos_Compras;Hobbys;1;VARIABLES
31/01/2016;31/01/2016;T/ LA BRASA \ 28-01-2016;-46,00;19602,31;19556,31;8227;-46,00;19556,31;2016-01-28;28/01/2016;BRASA;Gastos_Ocio y transporte;Restaurantes;1;VARIABLES
31/01/2016;31/01/2016;FACT TARJETAS TARJ.CREDITO 42689013 16-02-01;-340,31;19556,31;19216,00;8228;-340,31;19216,00;2016-02-01;31/01/2016;FACT;No computable;Recibo Tarjeta;1;
01/02/2016;01/02/2016;R/ AJUNTAMENT D I.B.I. CA D.ALBI;-45,65;19216,00;19170,35;8229;-45,65;19170,35;2016-02-01;01/02/2016;AJUNTAMENT;Gastos_Banco y organismos;Ayuntamiento;2;FIJO
01/02/2016;01/02/2016;T/ CAFET.C T PRAT\PRAT 29-01-2016;-1,30;19170,35;19169,05;8230;-1,30;19169,05;2016-01-29;29/01/2016;CAFETC;Gastos_Ocio y transporte;Restaurantes;1;VARIABLES
01/02/2016;01/02/2016;T/ LIDL TERRASSA LES \ 29-01-2016;-85,06;19169,05;19083,99;8231;-85,06;19083,99;2016-01-29;29/01/2016;LIDL;Gastos_Compras;Supermercado;1;VARIABLES
01/02/2016;01/02/2016;LIMPIEZA;-130,00;19083,99;18953,99;8232;-130,00;18953,99;2016-02-01;01/02/2016;LIMPIEZA;Gastos_Vivienda y vehiculo;Serv. domestico;2;FIJO
02/02/2016;02/02/2016;R/ GAS GAS NATURAL GNS27630480116;-230,69;18953,99;18723,30;8233;-230,69;18723,30;2016-02-02;02/02/2016;GAS;Gastos_Servicios tipicos;Gas;2;FIJO
02/02/2016;02/02/2016;CAJ. AJENO SISTEMA 4B \TERRASSA;-40,00;18723,30;18683,30;8234;-40,00;18683,30;2016-02-02;02/02/2016;CAJ;Gastos_Gastos varios;Efectivo;2;VARIABLES
02/02/2016;02/02/2016;COM. 76985025 4b CAJ4 OFI9376;-1,85;18683,30;18681,45;8235;-1,85;18681,45;2016-02-02;02/02/2016;COM;Gastos_Banco y organismos;Cargos banco;2;FIJO
02/02/2016;02/02/2016;T/ SUPER.REYPA \TARRA 30-01-2016;-8,16;18681,45;18673,29;8236;-8,16;18673,29;2016-01-30;30/01/2016;SUPERREYPA;Gastos_Compras;Supermercado;1;VARIABLES
03/02/2016;03/02/2016;R/ CEM - CENTRE DESCRIPCION;-97,50;18673,29;18575,79;8237;-97,50;18575,79;2016-02-03;03/02/2016;CEM;Gastos_Salud, saber y deporte;Estudios;2;VARIABLES
04/02/2016;04/02/2016;T/ CAPRABO \ 01-02-2016;-4,88;18575,79;18570,91;8238;-4,88;18570,91;2016-02-01;01/02/2016;CAPRABO;Gastos_Compras;Supermercado;2;VARIABLES
06/02/2016;06/02/2016;CAJ. AJENO CAIXABANK \BARCELONA;-50,00;18570,91;18520,91;8239;-50,00;18520,91;2016-02-06;06/02/2016;CAJ;Gastos_Gastos varios;Efectivo;2;VARIABLES
06/02/2016;06/02/2016;COM. 76985025 SVRED CAJ OFI;-2,00;18520,91;18518,91;8240;-2,00;18518,91;2016-02-06;06/02/2016;COM;Gastos_Banco y organismos;Cargos banco;2;FIJO
06/02/2016;06/02/2016;T/ CAFET.C T PRAT\PRAT 03-02-2016;-3,15;18518,91;18515,76;8241;-3,15;18515,76;2016-02-03;03/02/2016;CAFETC;Gastos_Ocio y transporte;Restaurantes;2;VARIABLES
08/02/2016;08/02/2016;T/ LA TERRASSETA \ 05-02-2016;-2,70;18515,76;18513,06;8242;-2,70;18513,06;2016-02-05;05/02/2016;TERRASSETA;Gastos_Ocio y transporte;Restaurantes;2;VARIABLES
08/02/2016;08/02/2016;T/ FRANKFURT LES LLET\ 05-02-2016;-2,70;18513,06;18510,36;8243;-2,70;18510,36;2016-02-05;05/02/2016;FRANKFURT;Gastos_Ocio y transporte;Restaurantes;2;VARIABLES
09/02/2016;09/02/2016;R/ GAS GAS NATURAL GNS27630480216;-45,56;18510,36;18464,80;8244;-45,56;18464,80;2016-02-09;09/02/2016;GAS;Gastos_Servicios tipicos;Gas;2;FIJO
09/02/2016;09/02/2016;R/ BLITZ 40, S. Alquiler mes en c;-72,50;18464,80;18392,30;8245;-72,50;18392,30;2016-02-09;09/02/2016;BLITZ;Gastos_Vivienda y vehiculo;Alquiler Parking;2;FIJO
09/02/2016;09/02/2016;T/ SABA PL. CAT 06-02-2016;-5,85;18392,30;18386,45;8246;-5,85;18386,45;2016-02-06;06/02/2016;SABA;Gastos_Ocio y transporte;Parking y peaje;2;VARIABLES
09/02/2016;09/02/2016;T/ PRODUCTOS NATURAL\B 06-02-2016;-39,54;18386,45;18346,91;8247;-39,54;18346,91;2016-02-06;06/02/2016;PRODUCTOS;Gastos_Salud, saber y deporte;Otros Salud;2;VARIABLES
09/02/2016;09/02/2016;T/ DULCINEA \B 06-02-2016;-22,90;18346,91;18324,01;8248;-22,90;18324,01;2016-02-06;06/02/2016;DULCINEA;Gastos_Ocio y transporte;Restaurantes;2;VARIABLES
10/02/2016;10/02/2016;R/ Serunion SA /FOR/ESCOLA SALA;-118,60;18324,01;18205,41;8249;-118,60;18205,41;2016-02-10;10/02/2016;SERUNION;Gastos_Salud, saber y deporte;Menjador;2;FIJO
10/02/2016;10/02/2016;R/ Serunion SA /FOR/ESCOLA SALA;-118,60;18205,41;18086,81;8250;-118,60;18086,81;2016-02-10;10/02/2016;SERUNION;Gastos_Salud, saber y deporte;Menjador;2;FIJO
10/02/2016;05/02/2016;T/ AUTOPISTAS TERR;-1,38;18086,81;18085,43;8251;-1,38;18085,43;2016-02-05;05/02/2016;AUTOPISTAS;Gastos_Ocio y transporte;Parking y peaje;2;VARIABLES
10/02/2016;10/02/2016;T/ BURGUER KING PARC \ 07-02-2016;-10,60;18085,43;18074,83;8252;-10,60;18074,83;2016-02-07;07/02/2016;BURGUER;Gastos_Ocio y transporte;Restaurantes;2;VARIABLES
11/02/2016;11/02/2016;COM. 64970028 SVRED CAJ OFI;-1,87;18074,83;18072,96;8253;-1,87;18072,96;2016-02-11;11/02/2016;COM;Gastos_Banco y organismos;Cargos banco;2;FIJO
11/02/2016;11/02/2016;COM. 64970028 SVRED CAJ OFI;-1,87;18072,96;18071,09;8254;-1,87;18071,09;2016-02-11;11/02/2016;COM;Gastos_Banco y organismos;Cargos banco;2;FIJO
11/02/2016;11/02/2016;ABO.COMIS. 64970028 SVRED CAJ1033 OFI1113;1,87;18071,09;18072,96;8255;1,87;18072,96;2016-02-11;11/02/2016;ABOCOMIS;Ingresos;Devoluciones;2;VARIABLES
11/02/2016;09/02/2016;T/ AUTOPISTAS TERR;-1,38;18072,96;18071,58;8256;-1,38;18071,58;2016-02-09;09/02/2016;AUTOPISTAS;Gastos_Ocio y transporte;Parking y peaje;2;VARIABLES
11/02/2016;11/02/2016;T/ CAPRABO \ 08-02-2016;-7,92;18071,58;18063,66;8257;-7,92;18063,66;2016-02-08;08/02/2016;CAPRABO;Gastos_Compras;Supermercado;2;VARIABLES
11/02/2016;11/02/2016;T/ CAPRABO \ 08-02-2016;-24,04;18063,66;18039,62;8258;-24,04;18039,62;2016-02-08;08/02/2016;CAPRABO;Gastos_Compras;Supermercado;2;VARIABLES
11/02/2016;11/02/2016;CAJ. AJENO SERVIRED \PRAT DE LLOBR;-40,00;18039,62;17999,62;8259;-40,00;17999,62;2016-02-11;11/02/2016;CAJ;Gastos_Gastos varios;Efectivo;2;VARIABLES
12/02/2016;12/02/2016;R/ SEGUROS ADESLAS CENT MODULAR CO;-113,89;17999,62;17885,73;8260;-113,89;17885,73;2016-02-12;12/02/2016;ADESLAS;Gastos_Salud, saber y deporte;Medico;2;VARIABLES
12/02/2016;12/02/2016;T/ VIENA TERRASSA CEN\ 09-02-2016;-1,35;17885,73;17884,38;8261;-1,35;17884,38;2016-02-09;09/02/2016;VIENA;Gastos_Ocio y transporte;Restaurantes;2;VARIABLES
12/02/2016;12/02/2016;T/ VIENA TERRASSA CEN\ 09-02-2016;-5,75;17884,38;17878,63;8262;-5,75;17878,63;2016-02-09;09/02/2016;VIENA;Gastos_Ocio y transporte;Restaurantes;2;VARIABLES
12/02/2016;12/02/2016;T/ CAFET.C T PRAT\PRAT 09-02-2016;-3,00;17878,63;17875,63;8263;-3,00;17875,63;2016-02-09;09/02/2016;CAFETC;Gastos_Ocio y transporte;Restaurantes;2;VARIABLES
12/02/2016;12/02/2016;T/ TABASA VALLVI S. 09-02-2016;-4,16;17875,63;17871,47;8264;-4,16;17871,47;2016-02-09;09/02/2016;TABASA;Gastos_Ocio y transporte;Parking y peaje;2;VARIABLES
12/02/2016;12/02/2016;T/ FORN CARNE \ 09-02-2016;-6,05;17871,47;17865,42;8265;-6,05;17865,42;2016-02-09;09/02/2016;FORN;Gastos_Compras;Supermercado;2;VARIABLES
12/02/2016;12/02/2016;T/ MERCADONA QUATRE C\ 09-02-2016;-50,36;17865,42;17815,06;8266;-50,36;17815,06;2016-02-09;09/02/2016;MERCADONA;Gastos_Compras;Supermercado;2;VARIABLES
12/02/2016;12/02/2016;T/ CAFET.C T PRAT\PRAT 09-02-2016;-3,45;17815,06;17811,61;8267;-3,45;17811,61;2016-02-09;09/02/2016;CAFETC;Gastos_Ocio y transporte;Restaurantes;2;VARIABLES
15/02/2016;15/02/2016;T/ LIBRERIAS CASA DEL\ 12-02-2016;-23,85;17811,61;17787,76;8268;-23,85;17787,76;2016-02-12;12/02/2016;LIBRERIAS;Gastos_Salud, saber y deporte;Estudios;2;VARIABLES
15/02/2016;15/02/2016;T/ EL RACO \ 12-02-2016;-29,70;17787,76;17758,06;8269;-29,70;17758,06;2016-02-12;12/02/2016;RACO;Gastos_Ocio y transporte;Restaurantes;2;VARIABLES
15/02/2016;15/02/2016;T/ FRANKFURT LES LLET\ 12-02-2016;-2,70;17758,06;17755,36;8270;-2,70;17755,36;2016-02-12;12/02/2016;FRANKFURT;Gastos_Ocio y transporte;Restaurantes;2;VARIABLES
16/02/2016;16/02/2016;T/ AKI 101 - BARI\BARB 13-02-2016;-6,95;17755,36;17748,41;8271;-6,95;17748,41;2016-02-13;13/02/2016;AKI;Gastos_Vivienda y vehiculo;Mnto. hogar;2;VARIABLES
16/02/2016;16/02/2016;T/ ABACUS BARICEN\BARB 13-02-2016;-21,45;17748,41;17726,96;8272;-21,45;17726,96;2016-02-13;13/02/2016;ABACUS;Gastos_Salud, saber y deporte;Estudios;2;VARIABLES
17/02/2016;17/02/2016;R/ TELEFONO Vodafone Ono ONOAU16-0;-115,23;17726,96;17611,73;8273;-115,23;17611,73;2016-02-17;17/02/2016;TELEFONO;Gastos_Servicios tipicos;Telecomunicaciones;2;FIJO
17/02/2016;17/02/2016;R/ SEGUROS CCM VIDA Y P Recibo:134;-17,34;17611,73;17594,39;8274;-17,34;17594,39;2016-02-17;17/02/2016;CCM;Gastos_Seguros;Seguro vida;2;FIJO
17/02/2016;17/02/2016;R/ SEGUROS CCM VIDA Y P Recibo:134;-21,69;17594,39;17572,70;8275;-21,69;17572,70;2016-02-17;17/02/2016;CCM;Gastos_Seguros;Seguro vida;2;FIJO
18/02/2016;18/02/2016;T/ CAFET.C T PRAT\PRAT 15-02-2016;-3,00;17572,70;17569,70;8276;-3,00;17569,70;2016-02-15;15/02/2016;CAFETC;Gastos_Ocio y transporte;Restaurantes;2;VARIABLES
18/02/2016;18/02/2016;T/ RODELAS ZONA OLIMP\ 15-02-2016;-7,50;17569,70;17562,20;8277;-7,50;17562,20;2016-02-15;15/02/2016;RODELAS;Gastos_Salud, saber y deporte;Belleza;2;VARIABLES
18/02/2016;18/02/2016;T/ FRANKFURT LES LLET\ 15-02-2016;-5,85;17562,20;17556,35;8278;-5,85;17556,35;2016-02-15;15/02/2016;FRANKFURT;Gastos_Ocio y transporte;Restaurantes;2;VARIABLES
18/02/2016;18/02/2016;T/ BON AREA 15-02-2016;-15,55;17556,35;17540,80;8279;-15,55;17540,80;2016-02-15;15/02/2016;BON;Gastos_Compras;Supermercado;2;VARIABLES
19/02/2016;01/02/2016;C-CGO 6061.9600001223 U;530,06;17540,80;18070,86;8280;530,06;18070,86;2016-02-01;01/02/2016;CCGO;Gastos_Banco y organismos;Hipoteca;2;FIJO
19/02/2016;19/02/2016;T/ FRANKFURT LES LLET\ 16-02-2016;-14,85;18070,86;18056,01;8281;-14,85;18056,01;2016-02-16;16/02/2016;FRANKFURT;Gastos_Ocio y transporte;Restaurantes;2;VARIABLES
20/02/2016;20/02/2016;REC. 6061.9600001223;-514,31;18056,01;17541,70;8282;-514,31;17541,70;2016-02-20;20/02/2016;REC;Gastos_Banco y organismos;Hipoteca;2;FIJO
21/02/2016;21/02/2016;T/ FRANKFURT LES LLET\ 18-02-2016;-7,40;17541,70;17534,30;8283;-7,40;17534,30;2016-02-18;18/02/2016;FRANKFURT;Gastos_Ocio y transporte;Restaurantes;2;VARIABLES
21/02/2016;21/02/2016;T/ FRANKFURT LES LLET\ 18-02-2016;-2,70;17534,30;17531,60;8284;-2,70;17531,60;2016-02-18;18/02/2016;FRANKFURT;Gastos_Ocio y transporte;Restaurantes;2;VARIABLES
21/02/2016;21/02/2016;T/ BON AREA 18-02-2016;-23,73;17531,60;17507,87;8285;-23,73;17507,87;2016-02-18;18/02/2016;BON;Gastos_Compras;Supermercado;2;VARIABLES
22/02/2016;22/02/2016;R/ GAS GAS NATURAL GNS27630480216;-173,54;17507,87;17334,33;8286;-173,54;17334,33;2016-02-22;22/02/2016;GAS;Gastos_Servicios tipicos;Gas;2;FIJO
22/02/2016;22/02/2016;T/ FRANKFURT LES LLET\ 19-02-2016;-2,70;17334,33;17331,63;8287;-2,70;17331,63;2016-02-19;19/02/2016;FRANKFURT;Gastos_Ocio y transporte;Restaurantes;2;VARIABLES
22/02/2016;22/02/2016;T/ MIL COSES \ 19-02-2016;-9,15;17331,63;17322,48;8288;-9,15;17322,48;2016-02-19;19/02/2016;MIL;Gastos_Vivienda y vehiculo;Mnto. hogar;2;VARIABLES
23/02/2016;21/02/2016;T/ AUTOPISTAS TERR;-2,51;17322,48;17319,97;8289;-2,51;17319,97;2016-02-21;21/02/2016;AUTOPISTAS;Gastos_Ocio y transporte;Parking y peaje;2;VARIABLES
24/02/2016;24/02/2016;T/ TABASA VALLVI N. 21-02-2016;-3,70;17319,97;17316,27;8290;-3,70;17316,27;2016-02-21;21/02/2016;TABASA;Gastos_Ocio y transporte;Parking y peaje;2;VARIABLES
25/02/2016;25/02/2016;T/ MERCADONA QUATRE C\ 22-02-2016;-13,49;17316,27;17302,78;8291;-13,49;17302,78;2016-02-22;22/02/2016;MERCADONA;Gastos_Compras;Supermercado;2;VARIABLES
26/02/2016;26/02/2016;HAB. INFORMACIO I TECNOLOGIA DE CAT;1615,32;17302,78;18918,10;8292;1615,32;18918,10;2016-02-26;26/02/2016;HAB;Ingresos;Nomina;2;FIJO
26/02/2016;26/02/2016;HAB. FOMENT DE TERRASSA, SA Transfe;1991,50;18918,10;20909,60;8293;1991,50;20909,60;2016-02-26;26/02/2016;HAB;Ingresos;Nomina;2;FIJO
26/02/2016;26/02/2016;T/ FRANKFURT LES LLET\ 23-02-2016;-5,15;20909,60;20904,45;8294;-5,15;20904,45;2016-02-23;23/02/2016;FRANKFURT;Gastos_Ocio y transporte;Restaurantes;2;VARIABLES
26/02/2016;26/02/2016;T/ FRANKFURT LES LLET\ 23-02-2016;-2,70;20904,45;20901,75;8295;-2,70;20901,75;2016-02-23;23/02/2016;FRANKFURT;Gastos_Ocio y transporte;Restaurantes;2;VARIABLES
27/02/2016;27/02/2016;T/ FRANKFURT LES LLET\ 24-02-2016;-7,40;20901,75;20894,35;8296;-7,40;20894,35;2016-02-24;24/02/2016;FRANKFURT;Gastos_Ocio y transporte;Restaurantes;2;VARIABLES
27/02/2016;27/02/2016;T/ CAFET.C T PRAT\PRAT 24-02-2016;-0,90;20894,35;20893,45;8297;-0,90;20893,45;2016-02-24;24/02/2016;CAFETC;Gastos_Ocio y transporte;Restaurantes;2;VARIABLES
27/02/2016;27/02/2016;T/ FRANKFURT LES LLET\ 24-02-2016;-2,70;20893,45;20890,75;8298;-2,70;20890,75;2016-02-24;24/02/2016;FRANKFURT;Gastos_Ocio y transporte;Restaurantes;2;VARIABLES
28/02/2016;28/02/2016;T/ CAFET.C T PRAT\PRAT 25-02-2016;-0,90;20890,75;20889,85;8299;-0,90;20889,85;2016-02-25;25/02/2016;CAFETC;Gastos_Ocio y transporte;Restaurantes;2;VARIABLES
28/02/2016;28/02/2016;T/ CAFET.C T PRAT\PRAT 25-02-2016;-4,00;20889,85;20885,85;8300;-4,00;20885,85;2016-02-25;25/02/2016;CAFETC;Gastos_Ocio y transporte;Restaurantes;2;VARIABLES
28/02/2016;28/02/2016;T/ CAPRABO \ 25-02-2016;-2,89;20885,85;20882,96;8301;-2,89;20882,96;2016-02-25;25/02/2016;CAPRABO;Gastos_Compras;Supermercado;2;VARIABLES
29/02/2016;29/02/2016;REC. 6061.9600001223;-514,31;20882,96;20368,65;8302;-514,31;20368,65;2016-02-29;29/02/2016;REC;Gastos_Banco y organismos;Hipoteca;2;FIJO
29/02/2016;29/02/2016;T/ FRANKFURT LES LLET\ 26-02-2016;-4,10;20368,65;20364,55;8303;-4,10;20364,55;2016-02-26;26/02/2016;FRANKFURT;Gastos_Ocio y transporte;Restaurantes;2;VARIABLES
29/02/2016;29/02/2016;T/ FRANKFURT LES LLET\ 26-02-2016;-6,45;20364,55;20358,10;8304;-6,45;20358,10;2016-02-26;26/02/2016;FRANKFURT;Gastos_Ocio y transporte;Restaurantes;2;VARIABLES
29/02/2016;01/03/2016;INT. 210560613010013266;0,57;20358,10;20358,67;8305;0,57;20358,67;2016-03-01;01/03/2016;INT;Ingresos;Rendimientos;3;
29/02/2016;01/03/2016;RET.REND.CAP.M;-0,11;20358,67;20358,56;8306;-0,11;20358,56;2016-03-01;01/03/2016;RETRENDCAPM;Gastos_Banco y organismos;Impuestos;3;FIJO
29/02/2016;29/02/2016;FACT TARJETAS TARJ.CREDITO 07126017 16-03-01;-313,52;20358,56;20045,04;8307;-313,52;20045,04;2016-03-01;29/02/2016;FACT 07126017;Gastos_Banco y organismos;Credito Bea;2;VARIABLE
29/02/2016;29/02/2016;FACT TARJETAS TARJ.CREDITO 42689013 16-03-01;-609,74;20045,04;19435,30;8308;-609,74;19435,30;2016-03-01;29/02/2016;FACT;No computable;Recibo Tarjeta;2;
01/03/2016;26/02/2016;T/ AUTOPISTAS TERR;-1,38;19435,30;19433,92;8309;-1,38;19433,92;2016-02-26;26/02/2016;AUTOPISTAS;Gastos_Ocio y transporte;Parking y peaje;2;VARIABLES
01/03/2016;01/03/2016;T/ RODELAS ZONA OLIMP\ 27-02-2016;-99,44;19433,92;19334,48;8310;-99,44;19334,48;2016-02-27;27/02/2016;RODELAS;Gastos_Salud, saber y deporte;Belleza;2;VARIABLES
01/03/2016;01/03/2016;LIMPIEZA;-130,00;19334,48;19204,48;8311;-130,00;19204,48;2016-03-01;01/03/2016;LIMPIEZA;Gastos_Vivienda y vehiculo;Serv. domestico;3;FIJO
02/03/2016;02/03/2016;T/ LA BRASA \ 28-02-2016;-59,98;19204,48;19144,50;8312;-59,98;19144,50;2016-02-28;28/02/2016;BRASA;Gastos_Ocio y transporte;Restaurantes;2;VARIABLES
03/03/2016;29/02/2016;T/ AUTOPISTAS TERR;-1,38;19144,50;19143,12;8313;-1,38;19143,12;2016-02-29;29/02/2016;AUTOPISTAS;Gastos_Ocio y transporte;Parking y peaje;2;VARIABLES
03/03/2016;03/03/2016;T/ CAFET.C T PRAT\PRAT 29-02-2016;-3,15;19143,12;19139,97;8314;-3,15;19139,97;2016-02-29;29/02/2016;CAFETC;Gastos_Ocio y transporte;Restaurantes;2;VARIABLES
04/03/2016;04/03/2016;'R/ CEM - CENTRE D''ED LOPEZGARCIA,';-97,50;19139,97;19042,47;8315;-97,50;19042,47;2016-03-04;04/03/2016;CEM;Gastos_Salud, saber y deporte;Estudios;3;VARIABLES
04/03/2016;04/03/2016;T/ BON AREA 01-03-2016;-19,75;19042,47;19022,72;8316;-19,75;19022,72;2016-03-01;01/03/2016;BON;Gastos_Compras;Supermercado;3;VARIABLES
04/03/2016;04/03/2016;T/ CAFET.C T PRAT\PRAT 01-03-2016;-3,45;19022,72;19019,27;8317;-3,45;19019,27;2016-03-01;01/03/2016;CAFETC;Gastos_Ocio y transporte;Restaurantes;3;VARIABLES
05/03/2016;02/03/2016;T/ AUTOPISTAS TERR;-1,38;19019,27;19017,89;8318;-1,38;19017,89;2016-03-02;02/03/2016;AUTOPISTAS;Gastos_Ocio y transporte;Parking y peaje;3;VARIABLES
05/03/2016;05/03/2016;T/ FORNERIA ARTESANA\B 02-03-2016;-3,55;19017,89;19014,34;8319;-3,55;19014,34;2016-03-02;02/03/2016;FORNERIA;Gastos_Compras;Supermercado;3;VARIABLES
05/03/2016;05/03/2016;T/ METRO BARCELONA \B 02-03-2016;-4,30;19014,34;19010,04;8320;-4,30;19010,04;2016-03-02;02/03/2016;METRO;Gastos_Ocio y transporte;Transporte;3;VARIABLES
07/03/2016;07/03/2016;T/ LA TERRASSETA \ 04-03-2016;-8,40;19010,04;19001,64;8321;-8,40;19001,64;2016-03-04;04/03/2016;TERRASSETA;Gastos_Ocio y transporte;Restaurantes;3;VARIABLES
07/03/2016;07/03/2016;T/ FRANKFURT LES LLET\ 04-03-2016;-2,70;19001,64;18998,94;8322;-2,70;18998,94;2016-03-04;04/03/2016;FRANKFURT;Gastos_Ocio y transporte;Restaurantes;3;VARIABLES
08/03/2016;08/03/2016;R/ BLITZ 40, S. Alquiler mes en c;-72,50;18998,94;18926,44;8323;-72,50;18926,44;2016-03-08;08/03/2016;BLITZ;Gastos_Vivienda y vehiculo;Alquiler Parking;3;FIJO
08/03/2016;04/03/2016;T/ AUTOPISTAS TERR;-1,38;18926,44;18925,06;8324;-1,38;18925,06;2016-03-04;04/03/2016;AUTOPISTAS;Gastos_Ocio y transporte;Parking y peaje;3;VARIABLES
08/03/2016;08/03/2016;T/ VIENA PARC VALLES \ 05-03-2016;-13,45;18925,06;18911,61;8325;-13,45;18911,61;2016-03-05;05/03/2016;VIENA;Gastos_Ocio y transporte;Restaurantes;3;VARIABLES
08/03/2016;08/03/2016;T/ FARMACIA BALCELLS\B 05-03-2016;-7,96;18911,61;18903,65;8326;-7,96;18903,65;2016-03-05;05/03/2016;FARMACIA;Gastos_Salud, saber y deporte;Farmacia;3;VARIABLES
09/03/2016;09/03/2016;R/ Serunion SA Ntra.KRL1703505,;-99,63;18903,65;18804,02;8327;-99,63;18804,02;2016-03-09;09/03/2016;SERUNION;Gastos_Salud, saber y deporte;Menjador;3;FIJO
09/03/2016;09/03/2016;R/ Serunion SA Ntra.KRL1703420,;-99,63;18804,02;18704,39;8328;-99,63;18704,39;2016-03-09;09/03/2016;SERUNION;Gastos_Salud, saber y deporte;Menjador;3;FIJO
09/03/2016;08/03/2016;T/ ZONA BLAVA-ESTACION 05-03-2016;-0,85;18704,39;18703,54;8329;-0,85;18703,54;2016-03-05;05/03/2016;ZONA;Gastos_Ocio y transporte;Parking y peaje;3;VARIABLES
10/03/2016;10/03/2016;T/ VIENA TERRASSA CEN\ 07-03-2016;-5,40;18703,54;18698,14;8330;-5,40;18698,14;2016-03-07;07/03/2016;VIENA;Gastos_Ocio y transporte;Restaurantes;3;VARIABLES
10/03/2016;10/03/2016;T/ FRANKFURT LES LLET\ 07-03-2016;-7,50;18698,14;18690,64;8331;-7,50;18690,64;2016-03-07;07/03/2016;FRANKFURT;Gastos_Ocio y transporte;Restaurantes;3;VARIABLES
10/03/2016;10/03/2016;T/ CAFET.C T PRAT\PRAT 07-03-2016;-2,10;18690,64;18688,54;8332;-2,10;18688,54;2016-03-07;07/03/2016;CAFETC;Gastos_Ocio y transporte;Restaurantes;3;VARIABLES
11/03/2016;11/03/2016;R/ LUZ IBERDROLA CL IBERDROLA ELEC;-58,41;18688,54;18630,13;8333;-58,41;18630,13;2016-03-11;11/03/2016;LUZ;Gastos_Servicios tipicos;Electricidad;3;FIJO
11/03/2016;11/03/2016;T/ CAFET.C T PRAT\PRAT 08-03-2016;-0,90;18630,13;18629,23;8334;-0,90;18629,23;2016-03-08;08/03/2016;CAFETC;Gastos_Ocio y transporte;Restaurantes;3;VARIABLES
11/03/2016;11/03/2016;T/ BON AREA 08-03-2016;-15,38;18629,23;18613,85;8335;-15,38;18613,85;2016-03-08;08/03/2016;BON;Gastos_Compras;Supermercado;3;VARIABLES
11/03/2016;11/03/2016;T/ CAFET.C T PRAT\PRAT 08-03-2016;-3,15;18613,85;18610,70;8336;-3,15;18610,70;2016-03-08;08/03/2016;CAFETC;Gastos_Ocio y transporte;Restaurantes;3;VARIABLES
12/03/2016;12/03/2016;T/ CAFET.C T PRAT\PRAT 09-03-2016;-3,00;18610,70;18607,70;8337;-3,00;18607,70;2016-03-09;09/03/2016;CAFETC;Gastos_Ocio y transporte;Restaurantes;3;VARIABLES
12/03/2016;12/03/2016;T/ CAFET.C T PRAT\PRAT 09-03-2016;-0,90;18607,70;18606,80;8338;-0,90;18606,80;2016-03-09;09/03/2016;CAFETC;Gastos_Ocio y transporte;Restaurantes;3;VARIABLES
14/03/2016;14/03/2016;T/ PARC VALLES \ 11-03-2016;-33,53;18606,80;18573,27;8339;-33,53;18573,27;2016-03-11;11/03/2016;PARC;Gastos_Compras;Supermercado;3;VARIABLES
14/03/2016;14/03/2016;T/ CAFET.C T PRAT\PRAT 11-03-2016;-3,00;18573,27;18570,27;8340;-3,00;18570,27;2016-03-11;11/03/2016;CAFETC;Gastos_Ocio y transporte;Restaurantes;3;VARIABLES
16/03/2016;16/03/2016;R/ MINA PUBLICA AIGUES T.01A75789;-40,17;18570,27;18530,10;8341;-40,17;18530,10;2016-03-16;16/03/2016;MINA;Gastos_Servicios tipicos;Agua;3;FIJO
16/03/2016;16/03/2016;R/ SEGUROS CCM VIDA Y P Recibo:135;-17,27;18530,10;18512,83;8342;-17,27;18512,83;2016-03-16;16/03/2016;CCM;Gastos_Seguros;Seguro vida;3;FIJO
16/03/2016;16/03/2016;R/ SEGUROS CCM VIDA Y P Recibo:135;-21,61;18512,83;18491,22;8343;-21,61;18491,22;2016-03-16;16/03/2016;CCM;Gastos_Seguros;Seguro vida;3;FIJO
16/03/2016;16/03/2016;R/ SEGUROS ADESLAS CENT MODULAR CO;-113,89;18491,22;18377,33;8344;-113,89;18377,33;2016-03-16;16/03/2016;ADESLAS;Gastos_Salud, saber y deporte;Medico;3;VARIABLES
16/03/2016;16/03/2016;COM. 64970028 SVRED CAJ OFI;-1,87;18377,33;18375,46;8345;-1,87;18375,46;2016-03-16;16/03/2016;COM;Gastos_Banco y organismos;Cargos banco;3;FIJO
16/03/2016;16/03/2016;ABO.COMIS. 64970028 SVRED CAJ0605 OFI1619;1,87;18375,46;18377,33;8346;1,87;18377,33;2016-03-16;16/03/2016;ABOCOMIS;Ingresos;Devoluciones;3;VARIABLES
16/03/2016;16/03/2016;CAJ. AJENO SERVIRED \PRAT DE LLOBR;-20,00;18377,33;18357,33;8347;-20,00;18357,33;2016-03-16;16/03/2016;CAJ;Gastos_Gastos varios;Efectivo;3;VARIABLES
17/03/2016;17/03/2016;R/ TELEFONO Vodafone Ono ONOAU16-0;-118,04;18357,33;18239,29;8348;-118,04;18239,29;2016-03-17;17/03/2016;TELEFONO;Gastos_Servicios tipicos;Telecomunicaciones;3;FIJO
17/03/2016;17/03/2016;T/ CAPRABO \ 14-03-2016;-6,49;18239,29;18232,80;8349;-6,49;18232,80;2016-03-14;14/03/2016;CAPRABO;Gastos_Compras;Supermercado;3;VARIABLES
17/03/2016;17/03/2016;T/ CAFET.C T PRAT\PRAT 14-03-2016;-3,00;18232,80;18229,80;8350;-3,00;18229,80;2016-03-14;14/03/2016;CAFETC;Gastos_Ocio y transporte;Restaurantes;3;VARIABLES
19/03/2016;19/03/2016;T/ BON AREA 16-03-2016;-19,29;18229,80;18210,51;8351;-19,29;18210,51;2016-03-16;16/03/2016;BON;Gastos_Compras;Supermercado;3;VARIABLES
20/03/2016;20/03/2016;T/ FF.CC.GENERALITAT\B 17-03-2016;-3,00;18210,51;18207,51;8352;-3,00;18207,51;2016-03-17;17/03/2016;FFCCGENERALITATB;Gastos_Ocio y transporte;Transporte;3;VARIABLES
20/03/2016;20/03/2016;T/ ES LA RIERA \EL PR 17-03-2016;-30,00;18207,51;18177,51;8353;-30,00;18177,51;2016-03-17;17/03/2016;RIERA;Gastos_Ocio y transporte;Gasolina;3;VARIABLES
20/03/2016;20/03/2016;T/ CAFET.C T PRAT\PRAT 17-03-2016;-3,65;18177,51;18173,86;8354;-3,65;18173,86;2016-03-17;17/03/2016;CAFETC;Gastos_Ocio y transporte;Restaurantes;3;VARIABLES
20/03/2016;20/03/2016;T/ FRANKFURT LES LLET\ 17-03-2016;-4,70;18173,86;18169,16;8355;-4,70;18169,16;2016-03-17;17/03/2016;FRANKFURT;Gastos_Ocio y transporte;Restaurantes;3;VARIABLES
21/03/2016;21/03/2016;R/ LUZ IBERDROLA CL IBERDROLA ELEC;-7,93;18169,16;18161,23;8356;-7,93;18161,23;2016-03-21;21/03/2016;LUZ;Gastos_Servicios tipicos;Electricidad;3;FIJO
21/03/2016;21/03/2016;T/ CAFET.H.G.C. \SANT 18-03-2016;-9,35;18161,23;18151,88;8357;-9,35;18151,88;2016-03-18;18/03/2016;CAFETHGC;Gastos_Ocio y transporte;Restaurantes;3;VARIABLES
22/03/2016;22/03/2016;T/ FF.CC.GENERALITAT\B 19-03-2016;-3,00;18151,88;18148,88;8358;-3,00;18148,88;2016-03-19;19/03/2016;FFCCGENERALITATB;Gastos_Ocio y transporte;Transporte;3;VARIABLES
22/03/2016;22/03/2016;T/ CAFET.H.G.C. \SANT 19-03-2016;-7,45;18148,88;18141,43;8359;-7,45;18141,43;2016-03-19;19/03/2016;CAFETHGC;Gastos_Ocio y transporte;Restaurantes;3;VARIABLES
22/03/2016;22/03/2016;T/ FF.CC.GENERALITAT\B 19-03-2016;-3,00;18141,43;18138,43;8360;-3,00;18138,43;2016-03-19;19/03/2016;FFCCGENERALITATB;Gastos_Ocio y transporte;Transporte;3;VARIABLES
22/03/2016;22/03/2016;T/ CAFET.H.G.C. \SANT 19-03-2016;-8,00;18138,43;18130,43;8361;-8,00;18130,43;2016-03-19;19/03/2016;CAFETHGC;Gastos_Ocio y transporte;Restaurantes;3;VARIABLES
22/03/2016;21/03/2016;T/ CATALANA DIAG.I CIR 18-03-2016;-19,25;18130,43;18111,18;8362;-19,25;18111,18;2016-03-18;18/03/2016;CATALANA;Gastos_Ocio y transporte;Parking y peaje;3;VARIABLES
23/03/2016;23/03/2016;HAB. FOMENT DE TERRASSA S.A. Transf;1784,69;18111,18;19895,87;8363;1784,69;19895,87;2016-03-23;23/03/2016;HAB;Ingresos;Nomina;3;FIJO
23/03/2016;23/03/2016;T/ CAFET.H.G.C. \SANT 20-03-2016;-13,30;19895,87;19882,57;8364;-13,30;19882,57;2016-03-20;20/03/2016;CAFETHGC;Gastos_Ocio y transporte;Restaurantes;3;VARIABLES
24/03/2016;18/03/2016;T/ AUTOPISTAS TERR;-1,38;19882,57;19881,19;8365;-1,38;19881,19;2016-03-18;18/03/2016;AUTOPISTAS;Gastos_Ocio y transporte;Parking y peaje;3;VARIABLES
24/03/2016;18/03/2016;T/ AUTOPISTAS TERR;-1,38;19881,19;19879,81;8366;-1,38;19879,81;2016-03-18;18/03/2016;AUTOPISTAS;Gastos_Ocio y transporte;Parking y peaje;3;VARIABLES
24/03/2016;18/03/2016;T/ AUTOPISTAS TERR;-1,38;19879,81;19878,43;8367;-1,38;19878,43;2016-03-18;18/03/2016;AUTOPISTAS;Gastos_Ocio y transporte;Parking y peaje;3;VARIABLES
24/03/2016;18/03/2016;T/ AUTOPISTAS TERR;-1,38;19878,43;19877,05;8368;-1,38;19877,05;2016-03-18;18/03/2016;AUTOPISTAS;Gastos_Ocio y transporte;Parking y peaje;3;VARIABLES
24/03/2016;19/03/2016;T/ AUTOPISTAS TERR;-2,51;19877,05;19874,54;8369;-2,51;19874,54;2016-03-19;19/03/2016;AUTOPISTAS;Gastos_Ocio y transporte;Parking y peaje;3;VARIABLES
24/03/2016;19/03/2016;T/ AUTOPISTAS TERR;-2,51;19874,54;19872,03;8370;-2,51;19872,03;2016-03-19;19/03/2016;AUTOPISTAS;Gastos_Ocio y transporte;Parking y peaje;3;VARIABLES
24/03/2016;24/03/2016;T/ FF.CC.GENERALITAT\B 21-03-2016;-19,60;19872,03;19852,43;8371;-19,60;19852,43;2016-03-21;21/03/2016;FFCCGENERALITATB;Gastos_Ocio y transporte;Transporte;3;VARIABLES
25/03/2016;25/03/2016;T/ CAFET.H.G.C. \SANT 22-03-2016;-11,60;19852,43;19840,83;8372;-11,60;19840,83;2016-03-22;22/03/2016;CAFETHGC;Gastos_Ocio y transporte;Restaurantes;3;VARIABLES
25/03/2016;25/03/2016;T/ CAFET.H.G.C. \SANT 22-03-2016;-7,50;19840,83;19833,33;8373;-7,50;19833,33;2016-03-22;22/03/2016;CAFETHGC;Gastos_Ocio y transporte;Restaurantes;3;VARIABLES
25/03/2016;25/03/2016;T/ CAFET.H.G.C. \SANT 22-03-2016;-6,95;19833,33;19826,38;8374;-6,95;19826,38;2016-03-22;22/03/2016;CAFETHGC;Gastos_Ocio y transporte;Restaurantes;3;VARIABLES
26/03/2016;26/03/2016;T/ CAFET.H.G.C. \SANT 23-03-2016;-13,40;19826,38;19812,98;8375;-13,40;19812,98;2016-03-23;23/03/2016;CAFETHGC;Gastos_Ocio y transporte;Restaurantes;3;VARIABLES
27/03/2016;27/03/2016;T/ CAFET.H.G.C. \SANT 24-03-2016;-7,45;19812,98;19805,53;8376;-7,45;19805,53;2016-03-24;24/03/2016;CAFETHGC;Gastos_Ocio y transporte;Restaurantes;3;VARIABLES
29/03/2016;29/03/2016;HAB. INFORMACIO I TECNOLOGIA DE CAT;1615,93;19805,53;21421,46;8377;1615,93;21421,46;2016-03-29;29/03/2016;HAB;Ingresos;Nomina;3;FIJO
29/03/2016;29/03/2016;R/ LUZ IBERDROLA CL IBERDROLA GAS;-109,23;21421,46;21312,23;8378;-109,23;21312,23;2016-03-29;29/03/2016;LUZ;Gastos_Servicios tipicos;Electricidad;3;FIJO
29/03/2016;29/03/2016;T/ CAFET.H.G.C. \SANT 26-03-2016;-5,65;21312,23;21306,58;8379;-5,65;21306,58;2016-03-26;26/03/2016;CAFETHGC;Gastos_Ocio y transporte;Restaurantes;3;VARIABLES
29/03/2016;29/03/2016;T/ CAFET.H.G.C. \SANT 26-03-2016;-7,45;21306,58;21299,13;8380;-7,45;21299,13;2016-03-26;26/03/2016;CAFETHGC;Gastos_Ocio y transporte;Restaurantes;3;VARIABLES
30/03/2016;24/03/2016;T/ AUTOPISTAS TERR;-1,38;21299,13;21297,75;8381;-1,38;21297,75;2016-03-24;24/03/2016;AUTOPISTAS;Gastos_Ocio y transporte;Parking y peaje;3;VARIABLES
30/03/2016;30/03/2016;T/ CAFET.H.G.C. \SANT 27-03-2016;-12,00;21297,75;21285,75;8382;-12,00;21285,75;2016-03-27;27/03/2016;CAFETHGC;Gastos_Ocio y transporte;Restaurantes;3;VARIABLES
31/03/2016;31/03/2016;REC. 6061.9600001223;-514,31;21285,75;20771,44;8383;-514,31;20771,44;2016-03-31;31/03/2016;REC;Gastos_Banco y organismos;Hipoteca;3;FIJO
31/03/2016;31/03/2016;R/ AJUNTAMENT D I.B.I. CA D.ALBI;-45,65;20771,44;20725,79;8384;-45,65;20725,79;2016-03-31;31/03/2016;AJUNTAMENT;Gastos_Banco y organismos;Ayuntamiento;3;FIJO
31/03/2016;31/03/2016;T/ CAFET.H.G.C. \SANT 28-03-2016;-5,25;20725,79;20720,54;8385;-5,25;20720,54;2016-03-28;28/03/2016;CAFETHGC;Gastos_Ocio y transporte;Restaurantes;3;VARIABLES
31/03/2016;31/03/2016;T/ CAFET.H.G.C. \SANT 28-03-2016;-4,45;20720,54;20716,09;8386;-4,45;20716,09;2016-03-28;28/03/2016;CAFETHGC;Gastos_Ocio y transporte;Restaurantes;3;VARIABLES
31/03/2016;31/03/2016;T/ LA BRASA \ 28-03-2016;-14,74;20716,09;20701,35;8387;-14,74;20701,35;2016-03-28;28/03/2016;BRASA;Gastos_Ocio y transporte;Restaurantes;3;VARIABLES
31/03/2016;31/03/2016;T/ CAFET.H.G.C. \SANT 28-03-2016;-4,25;20701,35;20697,10;8388;-4,25;20697,10;2016-03-28;28/03/2016;CAFETHGC;Gastos_Ocio y transporte;Restaurantes;3;VARIABLES
31/03/2016;31/03/2016;CAJ. AJENO SISTEMA 4B \SANT CUGAT DE;-110,00;20697,10;20587,10;8389;-110,00;20587,10;2016-03-31;31/03/2016;CAJ;Gastos_Gastos varios;Efectivo;3;VARIABLES
31/03/2016;01/04/2016;INT. 210560613010013266;0,31;20587,10;20587,41;8390;0,31;20587,41;2016-04-01;01/04/2016;INT;Ingresos;Rendimientos;4;
31/03/2016;01/04/2016;RET.REND.CAP.M;-0,06;20587,41;20587,35;8391;-0,06;20587,35;2016-04-01;01/04/2016;RETRENDCAPM;Gastos_Banco y organismos;Impuestos;4;FIJO
31/03/2016;31/03/2016;FACT TARJETAS TARJ.CREDITO 07126017 16-04-01;-44,72;20587,35;20542,63;8392;-44,72;20542,63;2016-04-01;31/03/2016;FACT 07126017;Gastos_Banco y organismos;Credito Bea;3;VARIABLE
31/03/2016;31/03/2016;FACT TARJETAS TARJ.CREDITO 42689013 16-04-01;-615,26;20542,63;19927,37;8393;-615,26;19927,37;2016-04-01;31/03/2016;FACT;No computable;Recibo Tarjeta;3;
01/04/2016;01/04/2016;T/ CAFET.C T PRAT\PRAT 29-03-2016;-3,60;19927,37;19923,77;8394;-3,60;19923,77;2016-03-29;29/03/2016;CAFETC;Gastos_Ocio y transporte;Restaurantes;3;VARIABLES
01/04/2016;01/04/2016;T/ CAFET.H.G.C. \SANT 29-03-2016;-7,15;19923,77;19916,62;8395;-7,15;19916,62;2016-03-29;29/03/2016;CAFETHGC;Gastos_Ocio y transporte;Restaurantes;3;VARIABLES
01/04/2016;01/04/2016;T/ CAFET.H.G.C. \SANT 29-03-2016;-7,50;19916,62;19909,12;8396;-7,50;19909,12;2016-03-29;29/03/2016;CAFETHGC;Gastos_Ocio y transporte;Restaurantes;3;VARIABLES
01/04/2016;01/04/2016;LIMPIEZA;-130,00;19909,12;19779,12;8397;-130,00;19779,12;2016-04-01;01/04/2016;LIMPIEZA;Gastos_Vivienda y vehiculo;Serv. domestico;4;FIJO
02/04/2016;31/03/2016;T/ AUTOPISTAS TERR;-1,38;19779,12;19777,74;8398;-1,38;19777,74;2016-03-31;31/03/2016;AUTOPISTAS;Gastos_Ocio y transporte;Parking y peaje;3;VARIABLES
02/04/2016;02/04/2016;T/ CAFET.H.G.C. \SANT 30-03-2016;-4,00;19777,74;19773,74;8399;-4,00;19773,74;2016-03-30;30/03/2016;CAFETHGC;Gastos_Ocio y transporte;Restaurantes;3;VARIABLES
02/04/2016;02/04/2016;T/ CAFET.H.G.C. \SANT 30-03-2016;-6,30;19773,74;19767,44;8400;-6,30;19767,44;2016-03-30;30/03/2016;CAFETHGC;Gastos_Ocio y transporte;Restaurantes;3;VARIABLES
03/04/2016;03/04/2016;T/ CAFET.H.G.C. \SANT 31-03-2016;-7,55;19767,44;19759,89;8401;-7,55;19759,89;2016-03-31;31/03/2016;CAFETHGC;Gastos_Ocio y transporte;Restaurantes;3;VARIABLES
03/04/2016;03/04/2016;T/ CAFET.H.G.C. \SANT 31-03-2016;-3,60;19759,89;19756,29;8402;-3,60;19756,29;2016-03-31;31/03/2016;CAFETHGC;Gastos_Ocio y transporte;Restaurantes;3;VARIABLES
04/04/2016;04/04/2016;T/ CAFET.H.G.C. \SANT 01-04-2016;-7,85;19756,29;19748,44;8403;-7,85;19748,44;2016-04-01;01/04/2016;CAFETHGC;Gastos_Ocio y transporte;Restaurantes;4;VARIABLES
05/04/2016;05/04/2016;R/ SEGUROS SEGUROS CATA SEGURO OBL;-319,02;19748,44;19429,42;8404;-319,02;19429,42;2016-04-05;05/04/2016;CATA;Gastos_Seguros;Seguro auto;4;FIJO
05/04/2016;05/04/2016;T/ FARMA.ANGEL MORENO\ 02-04-2016;-9,49;19429,42;19419,93;8405;-9,49;19419,93;2016-04-02;02/04/2016;FARMAANGEL;Gastos_Salud, saber y deporte;Farmacia;4;VARIABLES
05/04/2016;05/04/2016;T/ CAFET.H.G.C. \SANT 02-04-2016;-11,25;19419,93;19408,68;8406;-11,25;19408,68;2016-04-02;02/04/2016;CAFETHGC;Gastos_Ocio y transporte;Restaurantes;4;VARIABLES
06/04/2016;06/04/2016;'R/ CEM - CENTRE D''EDU LOPEZGARCIA';-97,50;19408,68;19311,18;8407;-97,50;19311,18;2016-04-06;06/04/2016;CEM;Gastos_Salud, saber y deporte;Estudios;4;VARIABLES
06/04/2016;06/04/2016;T/ CAFET.H.G.C. \SANT 03-04-2016;-5,30;19311,18;19305,88;8408;-5,30;19305,88;2016-04-03;03/04/2016;CAFETHGC;Gastos_Ocio y transporte;Restaurantes;4;VARIABLES
06/04/2016;06/04/2016;T/ FF.CC.GENERALITAT\B 03-04-2016;-19,60;19305,88;19286,28;8409;-19,60;19286,28;2016-04-03;03/04/2016;FFCCGENERALITATB;Gastos_Ocio y transporte;Transporte;4;VARIABLES
07/04/2016;07/04/2016;T/ FRANKFURT LES LLET\ 04-04-2016;-2,70;19286,28;19283,58;8410;-2,70;19283,58;2016-04-04;04/04/2016;FRANKFURT;Gastos_Ocio y transporte;Restaurantes;4;VARIABLES
07/04/2016;07/04/2016;T/ NOSTRUM \ 04-04-2016;-12,00;19283,58;19271,58;8411;-12,00;19271,58;2016-04-04;04/04/2016;NOSTRUM;Gastos_Ocio y transporte;Restaurantes;4;VARIABLES
07/04/2016;07/04/2016;T/ CAFET.H.G.C. \SANT 04-04-2016;-7,40;19271,58;19264,18;8412;-7,40;19264,18;2016-04-04;04/04/2016;CAFETHGC;Gastos_Ocio y transporte;Restaurantes;4;VARIABLES
08/04/2016;08/04/2016;R/ SEGUROS ADESLAS CENT MODULAR CO;-113,89;19264,18;19150,29;8413;-113,89;19150,29;2016-04-08;08/04/2016;ADESLAS;Gastos_Salud, saber y deporte;Medico;4;VARIABLES
08/04/2016;08/04/2016;CAJ. AJENO SISTEMA 4B \SANT CUGAT DE;-140,00;19150,29;19010,29;8414;-140,00;19010,29;2016-04-08;08/04/2016;CAJ;Gastos_Gastos varios;Efectivo;4;VARIABLES
08/04/2016;08/04/2016;T/ FLECA CARNE 05-04-2016;-7,95;19010,29;19002,34;8415;-7,95;19002,34;2016-04-05;05/04/2016;FLECA;Gastos_Compras;Supermercado;4;VARIABLES
08/04/2016;08/04/2016;T/ FRANKFURT LES LLET\ 05-04-2016;-2,70;19002,34;18999,64;8416;-2,70;18999,64;2016-04-05;05/04/2016;FRANKFURT;Gastos_Ocio y transporte;Restaurantes;4;VARIABLES
08/04/2016;08/04/2016;T/ TOCINERIES VENTURA\ 05-04-2016;-10,36;18999,64;18989,28;8417;-10,36;18989,28;2016-04-05;05/04/2016;TOCINERIES;Gastos_Compras;Supermercado;4;VARIABLES
08/04/2016;08/04/2016;T/ FARMA.ANGEL MORENO\ 05-04-2016;-10,21;18989,28;18979,07;8418;-10,21;18979,07;2016-04-05;05/04/2016;FARMAANGEL;Gastos_Salud, saber y deporte;Farmacia;4;VARIABLES
09/04/2016;09/04/2016;T/ FRANKFURT LES LLET\ 06-04-2016;-2,70;18979,07;18976,37;8419;-2,70;18976,37;2016-04-06;06/04/2016;FRANKFURT;Gastos_Ocio y transporte;Restaurantes;4;VARIABLES
09/04/2016;09/04/2016;T/ NOSTRUM \ 06-04-2016;-5,00;18976,37;18971,37;8420;-5,00;18971,37;2016-04-06;06/04/2016;NOSTRUM;Gastos_Ocio y transporte;Restaurantes;4;VARIABLES
09/04/2016;09/04/2016;T/ CAFET.H.G.C. \SANT 06-04-2016;-7,20;18971,37;18964,17;8421;-7,20;18964,17;2016-04-06;06/04/2016;CAFETHGC;Gastos_Ocio y transporte;Restaurantes;4;VARIABLES
10/04/2016;10/04/2016;T/ FRANKFURT LES LLET\ 07-04-2016;-2,70;18964,17;18961,47;8422;-2,70;18961,47;2016-04-07;07/04/2016;FRANKFURT;Gastos_Ocio y transporte;Restaurantes;4;VARIABLES
11/04/2016;11/04/2016;R/ BLITZ 40, S. Alquiler mes en c;-72,50;18961,47;18888,97;8423;-72,50;18888,97;2016-04-11;11/04/2016;BLITZ;Gastos_Vivienda y vehiculo;Alquiler Parking;4;FIJO
11/04/2016;11/04/2016;R/ Serunion SA Ntra.KRL1703627,;-105,62;18888,97;18783,35;8424;-105,62;18783,35;2016-04-11;11/04/2016;SERUNION;Gastos_Salud, saber y deporte;Menjador;4;FIJO
11/04/2016;11/04/2016;R/ Serunion SA Ntra.KRL1703545,;-118,60;18783,35;18664,75;8425;-118,60;18664,75;2016-04-11;11/04/2016;SERUNION;Gastos_Salud, saber y deporte;Menjador;4;FIJO
11/04/2016;11/04/2016;CAJ. AJENO SISTEMA 4B \TERRASSA;-110,00;18664,75;18554,75;8426;-110,00;18554,75;2016-04-11;11/04/2016;CAJ;Gastos_Gastos varios;Efectivo;4;VARIABLES
11/04/2016;11/04/2016;T/ FRANKFURT LES LLET\ 08-04-2016;-2,70;18554,75;18552,05;8427;-2,70;18552,05;2016-04-08;08/04/2016;FRANKFURT;Gastos_Ocio y transporte;Restaurantes;4;VARIABLES
13/04/2016;13/04/2016;R/ LUZ IBERDROLA CL IBERDROLA OTRO;-10,79;18552,05;18541,26;8428;-10,79;18541,26;2016-04-13;13/04/2016;LUZ;Gastos_Servicios tipicos;Electricidad;4;FIJO
14/04/2016;14/04/2016;R/ LUZ IBERDROLA CL IBERDROLA ELEC;-7,18;18541,26;18534,08;8429;-7,18;18534,08;2016-04-14;14/04/2016;LUZ;Gastos_Servicios tipicos;Electricidad;4;FIJO
14/04/2016;14/04/2016;R/ ENDESA ENERG 0FACTURA DE GAS P;-15,85;18534,08;18518,23;8430;-15,85;18518,23;2016-04-14;14/04/2016;ENDESA;Gastos_Servicios tipicos;Electricidad;4;FIJO
14/04/2016;14/04/2016;T/ LIDL EL PRAT D\PRAT 11-04-2016;-30,07;18518,23;18488,16;8431;-30,07;18488,16;2016-04-11;11/04/2016;LIDL;Gastos_Compras;Supermercado;4;VARIABLES
14/04/2016;14/04/2016;T/ CAFET.C T PRAT\PRAT 11-04-2016;-3,60;18488,16;18484,56;8432;-3,60;18484,56;2016-04-11;11/04/2016;CAFETC;Gastos_Ocio y transporte;Restaurantes;4;VARIABLES
14/04/2016;14/04/2016;T/ FF.CC.GENERALITAT\B 11-04-2016;-19,60;18484,56;18464,96;8433;-19,60;18464,96;2016-04-11;11/04/2016;FFCCGENERALITATB;Gastos_Ocio y transporte;Transporte;4;VARIABLES
15/04/2016;15/04/2016;DEV. RECIBOS Serunion SA Ntra.KRL1703627,;105,62;18464,96;18570,58;8434;105,62;18570,58;2016-04-15;15/04/2016;DEV;Ingresos;Devoluciones;4;VARIABLES
15/04/2016;15/04/2016;T/ NOSTRUM \ 12-04-2016;-6,50;18570,58;18564,08;8435;-6,50;18564,08;2016-04-12;12/04/2016;NOSTRUM;Gastos_Ocio y transporte;Restaurantes;4;VARIABLES
17/04/2016;17/04/2016;T/ CAFET.C T PRAT\PRAT 14-04-2016;-8,10;18564,08;18555,98;8436;-8,10;18555,98;2016-04-14;14/04/2016;CAFETC;Gastos_Ocio y transporte;Restaurantes;4;VARIABLES
17/04/2016;17/04/2016;T/ CAFET.C T PRAT\PRAT 14-04-2016;-3,65;18555,98;18552,33;8437;-3,65;18552,33;2016-04-14;14/04/2016;CAFETC;Gastos_Ocio y transporte;Restaurantes;4;VARIABLES
18/04/2016;18/04/2016;R/ TELEFONO Vodafone Ono ONOAU16-0;-153,91;18552,33;18398,42;8438;-153,91;18398,42;2016-04-18;18/04/2016;TELEFONO;Gastos_Servicios tipicos;Telecomunicaciones;4;FIJO
18/04/2016;18/04/2016;R/ SEGUROS CCM VIDA Y P Recibo:135;-17,22;18398,42;18381,20;8439;-17,22;18381,20;2016-04-18;18/04/2016;CCM;Gastos_Seguros;Seguro vida;4;FIJO
18/04/2016;18/04/2016;R/ SEGUROS CCM VIDA Y P Recibo:135;-21,54;18381,20;18359,66;8440;-21,54;18359,66;2016-04-18;18/04/2016;CCM;Gastos_Seguros;Seguro vida;4;FIJO
18/04/2016;18/04/2016;T/ BON AREA 15-04-2016;-15,26;18359,66;18344,40;8441;-15,26;18344,40;2016-04-15;15/04/2016;BON;Gastos_Compras;Supermercado;4;VARIABLES
19/04/2016;19/04/2016;T/ CAFET.H.G.C. \SANT 16-04-2016;-7,35;18344,40;18337,05;8442;-7,35;18337,05;2016-04-16;16/04/2016;CAFETHGC;Gastos_Ocio y transporte;Restaurantes;4;VARIABLES
20/04/2016;20/04/2016;CAJ. AJENO SISTEMA 4B \TERRASSA;-40,00;18337,05;18297,05;8443;-40,00;18297,05;2016-04-20;20/04/2016;CAJ;Gastos_Gastos varios;Efectivo;4;VARIABLES
20/04/2016;20/04/2016;COM. 76985025 4b CAJ4 OFI9376;-1,85;18297,05;18295,20;8444;-1,85;18295,20;2016-04-20;20/04/2016;COM;Gastos_Banco y organismos;Cargos banco;4;FIJO
20/04/2016;18/04/2016;T/ AUTOPISTAS TERR;-1,38;18295,20;18293,82;8445;-1,38;18293,82;2016-04-18;18/04/2016;AUTOPISTAS;Gastos_Ocio y transporte;Parking y peaje;4;VARIABLES
21/04/2016;21/04/2016;T/ FRANKFURT LES LLET\ 18-04-2016;-2,70;18293,82;18291,12;8446;-2,70;18291,12;2016-04-18;18/04/2016;FRANKFURT;Gastos_Ocio y transporte;Restaurantes;4;VARIABLES
21/04/2016;21/04/2016;T/ CAPRABO \ 18-04-2016;-7,83;18291,12;18283,29;8447;-7,83;18283,29;2016-04-18;18/04/2016;CAPRABO;Gastos_Compras;Supermercado;4;VARIABLES
21/04/2016;20/04/2016;T/ CATALANA DIAG.I CIR 17-04-2016;-6,40;18283,29;18276,89;8448;-6,40;18276,89;2016-04-17;17/04/2016;CATALANA;Gastos_Ocio y transporte;Parking y peaje;4;VARIABLES
22/04/2016;22/04/2016;T/ FRANKFURT LES LLET\ 19-04-2016;-2,70;18276,89;18274,19;8449;-2,70;18274,19;2016-04-19;19/04/2016;FRANKFURT;Gastos_Ocio y transporte;Restaurantes;4;VARIABLES
22/04/2016;22/04/2016;T/ CAFET.H.G.C. \SANT 19-04-2016;-14,95;18274,19;18259,24;8450;-14,95;18259,24;2016-04-19;19/04/2016;CAFETHGC;Gastos_Ocio y transporte;Restaurantes;4;VARIABLES
23/04/2016;23/04/2016;T/ FRANKFURT LES LLET\ 20-04-2016;-2,70;18259,24;18256,54;8451;-2,70;18256,54;2016-04-20;20/04/2016;FRANKFURT;Gastos_Ocio y transporte;Restaurantes;4;VARIABLES
24/04/2016;24/04/2016;T/ LIDL TERRASSA LES \ 21-04-2016;-18,10;18256,54;18238,44;8452;-18,10;18238,44;2016-04-21;21/04/2016;LIDL;Gastos_Compras;Supermercado;4;VARIABLES
25/04/2016;25/04/2016;T/ FORN PASTISSERIA M\ 22-04-2016;-13,75;18238,44;18224,69;8453;-13,75;18224,69;2016-04-22;22/04/2016;FORN;Gastos_Compras;Supermercado;4;VARIABLES
25/04/2016;25/04/2016;DEV.COMPRA TJ VIENA PARC VALLES \TERRASSA;12,05;18224,69;18236,74;8454;12,05;18236,74;2016-04-25;25/04/2016;DEVCOMPRA;Ingresos;Devoluciones;4;VARIABLES
26/04/2016;24/04/2016;T/ AUTOPISTAS TERR;-2,51;18236,74;18234,23;8455;-2,51;18234,23;2016-04-24;24/04/2016;AUTOPISTAS;Gastos_Ocio y transporte;Parking y peaje;4;VARIABLES
27/04/2016;25/04/2016;T/ AUTOPISTAS TERR;-1,38;18234,23;18232,85;8456;-1,38;18232,85;2016-04-25;25/04/2016;AUTOPISTAS;Gastos_Ocio y transporte;Parking y peaje;4;VARIABLES
27/04/2016;27/04/2016;T/ CAFET.H.G.C. \SANT 24-04-2016;-7,30;18232,85;18225,55;8457;-7,30;18225,55;2016-04-24;24/04/2016;CAFETHGC;Gastos_Ocio y transporte;Restaurantes;4;VARIABLES
27/04/2016;27/04/2016;T/ CAFET.H.G.C. \SANT 24-04-2016;-5,20;18225,55;18220,35;8458;-5,20;18220,35;2016-04-24;24/04/2016;CAFETHGC;Gastos_Ocio y transporte;Restaurantes;4;VARIABLES
28/04/2016;28/04/2016;HAB. INFORMACIO I TECNOLOGIA DE CAT;1615,93;18220,35;19836,28;8459;1615,93;19836,28;2016-04-28;28/04/2016;HAB;Ingresos;Nomina;4;FIJO
28/04/2016;28/04/2016;HAB. FOMENT DE TERRASSA S.A. Transf;1784,93;19836,28;21621,21;8460;1784,93;21621,21;2016-04-28;28/04/2016;HAB;Ingresos;Nomina;4;FIJO
28/04/2016;28/04/2016;COM. 64970028 SVRED CAJ OFI;-1,87;21621,21;21619,34;8461;-1,87;21619,34;2016-04-28;28/04/2016;COM;Gastos_Banco y organismos;Cargos banco;4;FIJO
28/04/2016;28/04/2016;T/ VIENA PARC VALLES \ 25-04-2016;-12,05;21619,34;21607,29;8462;-12,05;21607,29;2016-04-25;25/04/2016;VIENA;Gastos_Ocio y transporte;Restaurantes;4;VARIABLES
28/04/2016;28/04/2016;T/ VIENA PARC VALLES \ 25-04-2016;-10,95;21607,29;21596,34;8463;-10,95;21596,34;2016-04-25;25/04/2016;VIENA;Gastos_Ocio y transporte;Restaurantes;4;VARIABLES
28/04/2016;28/04/2016;T/ CAFET.H.G.C. \SANT 25-04-2016;-9,05;21596,34;21587,29;8464;-9,05;21587,29;2016-04-25;25/04/2016;CAFETHGC;Gastos_Ocio y transporte;Restaurantes;4;VARIABLES
28/04/2016;28/04/2016;CAJ. AJENO SERVIRED \PRAT DE LLOBR;-20,00;21587,29;21567,29;8465;-20,00;21567,29;2016-04-28;28/04/2016;CAJ;Gastos_Gastos varios;Efectivo;4;VARIABLES
29/04/2016;29/04/2016;R/ AJUNTAMENT D I.B.I. CA D.ALBI;-45,65;21567,29;21521,64;8466;-45,65;21521,64;2016-04-29;29/04/2016;AJUNTAMENT;Gastos_Banco y organismos;Ayuntamiento;4;FIJO
29/04/2016;29/04/2016;T/ FRANKFURT LES LLET\ 26-04-2016;-2,70;21521,64;21518,94;8467;-2,70;21518,94;2016-04-26;26/04/2016;FRANKFURT;Gastos_Ocio y transporte;Restaurantes;4;VARIABLES
29/04/2016;29/04/2016;T/ CAPRABO \ 26-04-2016;-7,69;21518,94;21511,25;8468;-7,69;21511,25;2016-04-26;26/04/2016;CAPRABO;Gastos_Compras;Supermercado;4;VARIABLES
29/04/2016;01/05/2016;INT. 210560613010013266;0,30;21511,25;21511,55;8469;0,30;21511,55;2016-05-01;01/05/2016;INT;Ingresos;Rendimientos;5;
29/04/2016;01/05/2016;RET.REND.CAP.M;-0,06;21511,55;21511,49;8470;-0,06;21511,49;2016-05-01;01/05/2016;RETRENDCAPM;Gastos_Banco y organismos;Impuestos;5;FIJO
30/04/2016;30/04/2016;REC. 6061.9600001223;-514,31;21511,49;20997,18;8471;-514,31;20997,18;2016-04-30;30/04/2016;REC;Gastos_Banco y organismos;Hipoteca;4;FIJO
30/04/2016;28/04/2016;T/ AUTOPISTAS TERR;-1,38;20997,18;20995,80;8472;-1,38;20995,80;2016-04-28;28/04/2016;AUTOPISTAS;Gastos_Ocio y transporte;Parking y peaje;4;VARIABLES
30/04/2016;30/04/2016;T/ CAFET.H.G.C. \SANT 27-04-2016;-10,85;20995,80;20984,95;8473;-10,85;20984,95;2016-04-27;27/04/2016;CAFETHGC;Gastos_Ocio y transporte;Restaurantes;4;VARIABLES
30/04/2016;30/04/2016;T/ FF.CC.GENERALITAT\B 27-04-2016;-19,60;20984,95;20965,35;8474;-19,60;20965,35;2016-04-27;27/04/2016;FFCCGENERALITATB;Gastos_Ocio y transporte;Transporte;4;VARIABLES
30/04/2016;30/04/2016;T/ RODELAS PERRUQUERS\ 27-04-2016;-6,00;20965,35;20959,35;8475;-6,00;20959,35;2016-04-27;27/04/2016;RODELAS;Gastos_Salud, saber y deporte;Belleza;4;VARIABLES
30/04/2016;30/04/2016;FACT TARJETAS TARJ.CREDITO 07126017 16-05-01;-58,12;20959,35;20901,23;8476;-58,12;20901,23;2016-05-01;30/04/2016;FACT 07126017;Gastos_Banco y organismos;Credito Bea;4;VARIABLE
30/04/2016;30/04/2016;FACT TARJETAS TARJ.CREDITO 42689013 16-05-01;-605,39;20901,23;20295,84;8477;-605,39;20295,84;2016-05-01;30/04/2016;FACT;No computable;Recibo Tarjeta;4;
01/05/2016;01/05/2016;T/ FRANKFURT LES LLET\ 28-04-2016;-2,70;20295,84;20293,14;8478;-2,70;20293,14;2016-04-28;28/04/2016;FRANKFURT;Gastos_Ocio y transporte;Restaurantes;4;VARIABLES
01/05/2016;01/05/2016;T/ TABASA VALLVI S. 28-04-2016;-4,16;20293,14;20288,98;8479;-4,16;20288,98;2016-04-28;28/04/2016;TABASA;Gastos_Ocio y transporte;Parking y peaje;4;VARIABLES
01/05/2016;01/05/2016;T/ CAFET.C T PRAT\PRAT 28-04-2016;-0,90;20288,98;20288,08;8480;-0,90;20288,08;2016-04-28;28/04/2016;CAFETC;Gastos_Ocio y transporte;Restaurantes;4;VARIABLES
01/05/2016;01/05/2016;T/ CAFET.H.G.C. \SANT 28-04-2016;-17,35;20288,08;20270,73;8481;-17,35;20270,73;2016-04-28;28/04/2016;CAFETHGC;Gastos_Ocio y transporte;Restaurantes;4;VARIABLES
01/05/2016;01/05/2016;T/ CAFET.H.G.C. \SANT 28-04-2016;-10,90;20270,73;20259,83;8482;-10,90;20259,83;2016-04-28;28/04/2016;CAFETHGC;Gastos_Ocio y transporte;Restaurantes;4;VARIABLES
01/05/2016;01/05/2016;T/ CAFET.C T PRAT\PRAT 28-04-2016;-3,05;20259,83;20256,78;8483;-3,05;20256,78;2016-04-28;28/04/2016;CAFETC;Gastos_Ocio y transporte;Restaurantes;4;VARIABLES
01/05/2016;01/05/2016;LIMPIEZA;-130,00;20256,78;20126,78;8484;-130,00;20126,78;2016-05-01;01/05/2016;LIMPIEZA;Gastos_Vivienda y vehiculo;Serv. domestico;5;FIJO
03/05/2016;03/05/2016;CAJ. AJENO SISTEMA 4B \TERRASSA;-70,00;20126,78;20056,78;8485;-70,00;20056,78;2016-05-03;03/05/2016;CAJ;Gastos_Gastos varios;Efectivo;5;VARIABLES
03/05/2016;03/05/2016;COM. 76985025 4b CAJ4 OFI9376;-1,85;20056,78;20054,93;8486;-1,85;20054,93;2016-05-03;03/05/2016;COM;Gastos_Banco y organismos;Cargos banco;5;FIJO
03/05/2016;29/04/2016;T/ AUTOPISTAS TERR;-1,38;20054,93;20053,55;8487;-1,38;20053,55;2016-04-29;29/04/2016;AUTOPISTAS;Gastos_Ocio y transporte;Parking y peaje;4;VARIABLES
03/05/2016;03/05/2016;T/ MERCADONA AV.JACQU\ 30-04-2016;-23,61;20053,55;20029,94;8488;-23,61;20029,94;2016-04-30;30/04/2016;MERCADONA;Gastos_Compras;Supermercado;4;VARIABLES
04/05/2016;04/05/2016;R/ LUZ IBERDROLA CL IBERDROLA GAS;-131,20;20029,94;19898,74;8489;-131,20;19898,74;2016-05-04;04/05/2016;LUZ;Gastos_Servicios tipicos;Electricidad;5;FIJO
04/05/2016;04/05/2016;R/ CEM - CENTRE DESCRIPCION;-97,50;19898,74;19801,24;8490;-97,50;19801,24;2016-05-04;04/05/2016;CEM;Gastos_Salud, saber y deporte;Estudios;5;VARIABLES
04/05/2016;04/05/2016;T/ CAFET.H.G.C. \SANT 01-05-2016;-3,90;19801,24;19797,34;8491;-3,90;19797,34;2016-05-01;01/05/2016;CAFETHGC;Gastos_Ocio y transporte;Restaurantes;5;VARIABLES
04/05/2016;02/05/2016;T/ TABASA VALLVI S. 29-04-2016;-4,16;19797,34;19793,18;8492;-4,16;19793,18;2016-04-29;29/04/2016;TABASA;Gastos_Ocio y transporte;Parking y peaje;4;VARIABLES
05/05/2016;05/05/2016;T/ FRANKFURT LES LLET\ 02-05-2016;-2,70;19793,18;19790,48;8493;-2,70;19790,48;2016-05-02;02/05/2016;FRANKFURT;Gastos_Ocio y transporte;Restaurantes;5;VARIABLES
05/05/2016;05/05/2016;T/ GRANJA ARMENGOL TE\ 02-05-2016;-12,10;19790,48;19778,38;8494;-12,10;19778,38;2016-05-02;02/05/2016;GRANJA;Gastos_Ocio y transporte;Restaurantes;5;VARIABLES
05/05/2016;05/05/2016;T/ CAFET.C T PRAT\PRAT 02-05-2016;-8,10;19778,38;19770,28;8495;-8,10;19770,28;2016-05-02;02/05/2016;CAFETC;Gastos_Ocio y transporte;Restaurantes;5;VARIABLES
05/05/2016;05/05/2016;T/ CRACK \ 02-05-2016;-7,63;19770,28;19762,65;8496;-7,63;19762,65;2016-05-02;02/05/2016;CRACK;Gastos_Compras;Otras compras;5;VARIABLES
06/05/2016;06/05/2016;T/ FRANKFURT LES LLET\ 03-05-2016;-2,70;19762,65;19759,95;8497;-2,70;19759,95;2016-05-03;03/05/2016;FRANKFURT;Gastos_Ocio y transporte;Restaurantes;5;VARIABLES
06/05/2016;06/05/2016;T/ CAPRABO \ 03-05-2016;-8,54;19759,95;19751,41;8498;-8,54;19751,41;2016-05-03;03/05/2016;CAPRABO;Gastos_Compras;Supermercado;5;VARIABLES
07/05/2016;07/05/2016;T/ LA TERRASSETA \ 04-05-2016;-15,10;19751,41;19736,31;8499;-15,10;19736,31;2016-05-04;04/05/2016;TERRASSETA;Gastos_Ocio y transporte;Restaurantes;5;VARIABLES
08/05/2016;08/05/2016;T/ BON AREA 05-05-2016;-15,64;19736,31;19720,67;8500;-15,64;19720,67;2016-05-05;05/05/2016;BON;Gastos_Compras;Supermercado;5;VARIABLES
10/05/2016;10/05/2016;R/ BLITZ 40, S. Alquiler mes en c;-72,50;19720,67;19648,17;8501;-72,50;19648,17;2016-05-10;10/05/2016;BLITZ;Gastos_Vivienda y vehiculo;Alquiler Parking;5;FIJO
11/05/2016;11/05/2016;R/ LUZ ENDESA ENERG 0FACTURA DE EL;-93,85;19648,17;19554,32;8502;-93,85;19554,32;2016-05-11;11/05/2016;LUZ;Gastos_Servicios tipicos;Electricidad;5;FIJO
12/05/2016;12/05/2016;R/ LUZ IBERDROLA CL IBERDROLA ELEC;-7,18;19554,32;19547,14;8503;-7,18;19547,14;2016-05-12;12/05/2016;LUZ;Gastos_Servicios tipicos;Electricidad;5;FIJO
12/05/2016;12/05/2016;R/ SEGUROS ADESLAS CENT MODULAR CO;-113,89;19547,14;19433,25;8504;-113,89;19433,25;2016-05-12;12/05/2016;ADESLAS;Gastos_Salud, saber y deporte;Medico;5;VARIABLES
12/05/2016;12/05/2016;ABO. A.E.A.T. DEVOLUCIONES TRIBUTAR;358,10;19433,25;19791,35;8505;358,10;19791,35;2016-05-12;12/05/2016;ABO;Ingresos;Devoluciones;5;VARIABLES
12/05/2016;12/05/2016;R/ Serunion SA Ntra.KRL1703672,;-118,60;19791,35;19672,75;8506;-118,60;19672,75;2016-05-12;12/05/2016;SERUNION;Gastos_Salud, saber y deporte;Menjador;5;FIJO
12/05/2016;12/05/2016;R/ LUZ IBERDROLA CL IBERDROLA OTRO;-10,79;19672,75;19661,96;8507;-10,79;19661,96;2016-05-12;12/05/2016;LUZ;Gastos_Servicios tipicos;Electricidad;5;FIJO
12/05/2016;12/05/2016;T/ FRANKFURT LES LLET\ 09-05-2016;-6,15;19661,96;19655,81;8508;-6,15;19655,81;2016-05-09;09/05/2016;FRANKFURT;Gastos_Ocio y transporte;Restaurantes;5;VARIABLES
13/05/2016;11/05/2016;T/ AUTOPISTAS TERR;-1,38;19655,81;19654,43;8509;-1,38;19654,43;2016-05-11;11/05/2016;AUTOPISTAS;Gastos_Ocio y transporte;Parking y peaje;5;VARIABLES
13/05/2016;11/05/2016;T/ AUTOPISTAS TERR;-1,38;19654,43;19653,05;8510;-1,38;19653,05;2016-05-11;11/05/2016;AUTOPISTAS;Gastos_Ocio y transporte;Parking y peaje;5;VARIABLES
13/05/2016;13/05/2016;T/ CAFET.C T PRAT\PRAT 10-05-2016;-3,00;19653,05;19650,05;8511;-3,00;19650,05;2016-05-10;10/05/2016;CAFETC;Gastos_Ocio y transporte;Restaurantes;5;VARIABLES
14/05/2016;14/05/2016;T/ CAFET.C T PRAT\PRAT 11-05-2016;-3,65;19650,05;19646,40;8512;-3,65;19646,40;2016-05-11;11/05/2016;CAFETC;Gastos_Ocio y transporte;Restaurantes;5;VARIABLES
14/05/2016;14/05/2016;T/ TABASA VALLVI S. 11-05-2016;-4,16;19646,40;19642,24;8513;-4,16;19642,24;2016-05-11;11/05/2016;TABASA;Gastos_Ocio y transporte;Parking y peaje;5;VARIABLES
14/05/2016;14/05/2016;T/ CAFET.C T PRAT\PRAT 11-05-2016;-0,90;19642,24;19641,34;8514;-0,90;19641,34;2016-05-11;11/05/2016;CAFETC;Gastos_Ocio y transporte;Restaurantes;5;VARIABLES
14/05/2016;14/05/2016;T/ VIENA PARC VALLES \ 11-05-2016;-15,90;19641,34;19625,44;8515;-15,90;19625,44;2016-05-11;11/05/2016;VIENA;Gastos_Ocio y transporte;Restaurantes;5;VARIABLES
15/05/2016;15/05/2016;T/ FRANKFURT LES LLET\ 12-05-2016;-29,50;19625,44;19595,94;8516;-29,50;19595,94;2016-05-12;12/05/2016;FRANKFURT;Gastos_Ocio y transporte;Restaurantes;5;VARIABLES
16/05/2016;16/05/2016;T/ FRANKFURT LES LLET\ 13-05-2016;-12,35;19595,94;19583,59;8517;-12,35;19583,59;2016-05-13;13/05/2016;FRANKFURT;Gastos_Ocio y transporte;Restaurantes;5;VARIABLES
17/05/2016;17/05/2016;R/ TELEFONO Vodafone Ono ONOAU16-0;-146,40;19583,59;19437,19;8518;-146,40;19437,19;2016-05-17;17/05/2016;TELEFONO;Gastos_Servicios tipicos;Telecomunicaciones;5;FIJO
17/05/2016;17/05/2016;R/ SEGUROS CCM VIDA Y P Recibo:136;-17,22;19437,19;19419,97;8519;-17,22;19419,97;2016-05-17;17/05/2016;CCM;Gastos_Seguros;Seguro vida;5;FIJO
17/05/2016;17/05/2016;R/ SEGUROS CCM VIDA Y P Recibo:136;-21,54;19419,97;19398,43;8520;-21,54;19398,43;2016-05-17;17/05/2016;CCM;Gastos_Seguros;Seguro vida;5;FIJO
20/05/2016;18/05/2016;T/ AUTOPISTAS TERR;-1,38;19398,43;19397,05;8521;-1,38;19397,05;2016-05-18;18/05/2016;AUTOPISTAS;Gastos_Ocio y transporte;Parking y peaje;5;VARIABLES
20/05/2016;20/05/2016;T/ LA TERRASSETA \ 17-05-2016;-5,20;19397,05;19391,85;8522;-5,20;19391,85;2016-05-17;17/05/2016;TERRASSETA;Gastos_Ocio y transporte;Restaurantes;5;VARIABLES
21/05/2016;21/05/2016;T/ FRANKFURT LES LLET\ 18-05-2016;-4,25;19391,85;19387,60;8523;-4,25;19387,60;2016-05-18;18/05/2016;FRANKFURT;Gastos_Ocio y transporte;Restaurantes;5;VARIABLES
21/05/2016;21/05/2016;T/ CAFET.C T PRAT\PRAT 18-05-2016;-3,60;19387,60;19384,00;8524;-3,60;19384,00;2016-05-18;18/05/2016;CAFETC;Gastos_Ocio y transporte;Restaurantes;5;VARIABLES
23/05/2016;23/05/2016;T/ FRANKFURT LES LLET\ 20-05-2016;-4,85;19384,00;19379,15;8525;-4,85;19379,15;2016-05-20;20/05/2016;FRANKFURT;Gastos_Ocio y transporte;Restaurantes;5;VARIABLES
23/05/2016;23/05/2016;T/ FRANKFURT LES LLET\ 20-05-2016;-6,52;19379,15;19372,63;8526;-6,52;19372,63;2016-05-20;20/05/2016;FRANKFURT;Gastos_Ocio y transporte;Restaurantes;5;VARIABLES
24/05/2016;24/05/2016;ABO. A.E.A.T. DEVOLUCIONES TRIBUTAR;1268,94;19372,63;20641,57;8527;1268,94;20641,57;2016-05-24;24/05/2016;ABO;Ingresos;Devoluciones;5;VARIABLES
26/05/2016;26/05/2016;O/ SERUNION S.A. ARL1700429;50,89;20641,57;20692,46;8528;50,89;20692,46;2016-05-26;26/05/2016;SERUNION;Gastos_Salud, saber y deporte;Menjador;5;FIJO
26/05/2016;26/05/2016;T/ TOCINERIES VENTURA\ 23-05-2016;-13,36;20692,46;20679,10;8529;-13,36;20679,10;2016-05-23;23/05/2016;TOCINERIES;Gastos_Compras;Supermercado;5;VARIABLES
26/05/2016;26/05/2016;T/ FRANKFURT LES LLET\ 23-05-2016;-4,55;20679,10;20674,55;8530;-4,55;20674,55;2016-05-23;23/05/2016;FRANKFURT;Gastos_Ocio y transporte;Restaurantes;5;VARIABLES
26/05/2016;26/05/2016;T/ FRANKFURT LES LLET\ 23-05-2016;-8,05;20674,55;20666,50;8531;-8,05;20666,50;2016-05-23;23/05/2016;FRANKFURT;Gastos_Ocio y transporte;Restaurantes;5;VARIABLES
27/05/2016;27/05/2016;HAB. FOMENT DE TERRASSA S.A. Transf;1784,93;20666,50;22451,43;8532;1784,93;22451,43;2016-05-27;27/05/2016;HAB;Ingresos;Nomina;5;FIJO
27/05/2016;27/05/2016;COM. 64970028 SVRED CAJ OFI;-1,87;22451,43;22449,56;8533;-1,87;22449,56;2016-05-27;27/05/2016;COM;Gastos_Banco y organismos;Cargos banco;5;FIJO
27/05/2016;27/05/2016;T/ FRANKFURT LES LLET\ 24-05-2016;-2,70;22449,56;22446,86;8534;-2,70;22446,86;2016-05-24;24/05/2016;FRANKFURT;Gastos_Ocio y transporte;Restaurantes;5;VARIABLES
27/05/2016;27/05/2016;CAJ. AJENO SERVIRED \PRAT DE LLOBR;-20,00;22446,86;22426,86;8535;-20,00;22426,86;2016-05-27;27/05/2016;CAJ;Gastos_Gastos varios;Efectivo;5;VARIABLES
28/05/2016;26/05/2016;T/ AMAZON.ES COMPRA;-201,99;22426,86;22224,87;8536;-201,99;22224,87;2016-05-26;26/05/2016;AMAZONES;Gastos_Compras;Hobbys;5;VARIABLES
28/05/2016;26/05/2016;T/ AUTOPISTAS TERR;-1,38;22224,87;22223,49;8537;-1,38;22223,49;2016-05-26;26/05/2016;AUTOPISTAS;Gastos_Ocio y transporte;Parking y peaje;5;VARIABLES
28/05/2016;26/05/2016;T/ AUTOPISTAS TERR;-1,38;22223,49;22222,11;8538;-1,38;22222,11;2016-05-26;26/05/2016;AUTOPISTAS;Gastos_Ocio y transporte;Parking y peaje;5;VARIABLES
28/05/2016;28/05/2016;T/ CAPIO SANIDAD \SANT 25-05-2016;-21,00;22222,11;22201,11;8539;-21,00;22201,11;2016-05-25;25/05/2016;CAPIO;Gastos_Salud, saber y deporte;Medico;5;VARIABLES
28/05/2016;28/05/2016;T/ DECATHLON SA TERRA\ 25-05-2016;-38,30;22201,11;22162,81;8540;-38,30;22162,81;2016-05-25;25/05/2016;DECATHLON;Gastos_Compras;Deportivo;5;VARIABLES
28/05/2016;28/05/2016;T/ BOLIN SHIJIA, SCP \ 25-05-2016;-22,25;22162,81;22140,56;8541;-22,25;22140,56;2016-05-25;25/05/2016;BOLIN;Gastos_Ocio y transporte;Restaurantes;5;VARIABLES
28/05/2016;28/05/2016;T/ VIENA PARC VALLES \ 25-05-2016;-12,35;22140,56;22128,21;8542;-12,35;22128,21;2016-05-25;25/05/2016;VIENA;Gastos_Ocio y transporte;Restaurantes;5;VARIABLES
28/05/2016;28/05/2016;T/ MERKALZADOS TARRAS\ 25-05-2016;-71,98;22128,21;22056,23;8543;-71,98;22056,23;2016-05-25;25/05/2016;MERKALZADOS;Gastos_Compras;Ropa;5;VARIABLES
28/05/2016;28/05/2016;T/ CINESA PARC VALLES\ 25-05-2016;-12,20;22056,23;22044,03;8544;-12,20;22044,03;2016-05-25;25/05/2016;CINESA;Gastos_Ocio y transporte;Espectáculos;5;VARIABLES
29/05/2016;29/05/2016;T/ FARMA.ANGEL MORENO\ 26-05-2016;-6,03;22044,03;22038,00;8545;-6,03;22038,00;2016-05-26;26/05/2016;FARMAANGEL;Gastos_Salud, saber y deporte;Farmacia;5;VARIABLES
29/05/2016;29/05/2016;T/ TABASA VALLVI S. 26-05-2016;-3,70;22038,00;22034,30;8546;-3,70;22034,30;2016-05-26;26/05/2016;TABASA;Gastos_Ocio y transporte;Parking y peaje;5;VARIABLES
29/05/2016;29/05/2016;T/ CAFET.C T PRAT\PRAT 26-05-2016;-3,50;22034,30;22030,80;8547;-3,50;22030,80;2016-05-26;26/05/2016;CAFETC;Gastos_Ocio y transporte;Restaurantes;5;VARIABLES
30/05/2016;30/05/2016;HAB. INFORMACIO I TECNOLOGIA DE CAT;1615,93;22030,80;23646,73;8548;1615,93;23646,73;2016-05-30;30/05/2016;HAB;Ingresos;Nomina;5;FIJO
30/05/2016;30/05/2016;T/ CAFET.C T PRAT\PRAT 27-05-2016;-3,65;23646,73;23643,08;8549;-3,65;23643,08;2016-05-27;27/05/2016;CAFETC;Gastos_Ocio y transporte;Restaurantes;5;VARIABLES
31/05/2016;31/05/2016;REC. 6061.9600001223;-514,31;23643,08;23128,77;8550;-514,31;23128,77;2016-05-31;31/05/2016;REC;Gastos_Banco y organismos;Hipoteca;5;FIJO
31/05/2016;27/05/2016;T/ AUTOPISTAS TERR;-1,38;23128,77;23127,39;8551;-1,38;23127,39;2016-05-27;27/05/2016;AUTOPISTAS;Gastos_Ocio y transporte;Parking y peaje;5;VARIABLES
31/05/2016;27/05/2016;T/ AUTOPISTAS TERR;-1,38;23127,39;23126,01;8552;-1,38;23126,01;2016-05-27;27/05/2016;AUTOPISTAS;Gastos_Ocio y transporte;Parking y peaje;5;VARIABLES
31/05/2016;31/05/2016;T/ DECATHLON SA TERRA\ 28-05-2016;-25,43;23126,01;23100,58;8553;-25,43;23100,58;2016-05-28;28/05/2016;DECATHLON;Gastos_Compras;Deportivo;5;VARIABLES
31/05/2016;31/05/2016;T/ SATURN E515 EL\PRAT 28-05-2016;-26,89;23100,58;23073,69;8554;-26,89;23073,69;2016-05-28;28/05/2016;SATURN;Gastos_Compras;Hobbys;5;VARIABLES
31/05/2016;31/05/2016;T/ VIENA PARC VALLES \ 28-05-2016;-10,60;23073,69;23063,09;8555;-10,60;23063,09;2016-05-28;28/05/2016;VIENA;Gastos_Ocio y transporte;Restaurantes;5;VARIABLES
31/05/2016;31/05/2016;T/ REDPIZZA \ 28-05-2016;-17,65;23063,09;23045,44;8556;-17,65;23045,44;2016-05-28;28/05/2016;REDPIZZA;Gastos_Ocio y transporte;Restaurantes;5;VARIABLES
31/05/2016;28/05/2016;T/ CATALANA DIAG.I CIR 25-05-2016;-8,85;23045,44;23036,59;8557;-8,85;23036,59;2016-05-25;25/05/2016;CATALANA;Gastos_Ocio y transporte;Parking y peaje;5;VARIABLES
31/05/2016;01/06/2016;INT. 210560613010013266;0,31;23036,59;23036,90;8558;0,31;23036,90;2016-06-01;01/06/2016;INT;Ingresos;Rendimientos;6;
31/05/2016;01/06/2016;RET.REND.CAP.M;-0,06;23036,90;23036,84;8559;-0,06;23036,84;2016-06-01;01/06/2016;RETRENDCAPM;Gastos_Banco y organismos;Impuestos;6;FIJO
31/05/2016;31/05/2016;FACT TARJETAS TARJ.CREDITO 07126017 16-06-01;-555,33;23036,84;22481,51;8560;-555,33;22481,51;2016-06-01;31/05/2016;FACT 07126017;Gastos_Banco y organismos;Credito Bea;5;VARIABLE
31/05/2016;31/05/2016;FACT TARJETAS TARJ.CREDITO 42689013 16-06-01;-995,91;22481,51;21485,60;8561;-995,91;21485,60;2016-06-01;31/05/2016;FACT;No computable;Recibo Tarjeta;5;
01/06/2016;30/05/2016;T/ TABASA VALLVI S. 27-05-2016;-3,70;21485,60;21481,90;8562;-3,70;21481,90;2016-05-27;27/05/2016;TABASA;Gastos_Ocio y transporte;Parking y peaje;5;VARIABLES
01/06/2016;01/06/2016;LIMPIEZA;-130,00;21481,90;21351,90;8563;-130,00;21351,90;2016-06-01;01/06/2016;LIMPIEZA;Gastos_Vivienda y vehiculo;Serv. domestico;6;FIJO
02/06/2016;31/05/2016;T/ AUTOPISTAS TERR;-1,38;21351,90;21350,52;8564;-1,38;21350,52;2016-05-31;31/05/2016;AUTOPISTAS;Gastos_Ocio y transporte;Parking y peaje;5;VARIABLES
02/06/2016;02/06/2016;T/ CAPRABO \ 30-05-2016;-6,00;21350,52;21344,52;8565;-6,00;21344,52;2016-05-30;30/05/2016;CAPRABO;Gastos_Compras;Supermercado;5;VARIABLES
02/06/2016;02/06/2016;T/ HENNES & MAURITZ S\ 30-05-2016;-45,89;21344,52;21298,63;8566;-45,89;21298,63;2016-05-30;30/05/2016;HENNES;Gastos_Compras;Ropa;5;VARIABLES
03/06/2016;03/06/2016;R/ AJUNTAMENT D IMPOST VEHICLES T;-62,78;21298,63;21235,85;8567;-62,78;21235,85;2016-06-03;03/06/2016;AJUNTAMENT;Gastos_Banco y organismos;Ayuntamiento;6;FIJO
03/06/2016;03/06/2016;T/ FRANKFURT LES LLET\ 31-05-2016;-2,70;21235,85;21233,15;8568;-2,70;21233,15;2016-05-31;31/05/2016;FRANKFURT;Gastos_Ocio y transporte;Restaurantes;5;VARIABLES
04/06/2016;01/06/2016;T/ AUTOPISTAS TERR;-1,38;21233,15;21231,77;8569;-1,38;21231,77;2016-06-01;01/06/2016;AUTOPISTAS;Gastos_Ocio y transporte;Parking y peaje;6;VARIABLES
04/06/2016;01/06/2016;T/ AUTOPISTAS TERR;-1,38;21231,77;21230,39;8570;-1,38;21230,39;2016-06-01;01/06/2016;AUTOPISTAS;Gastos_Ocio y transporte;Parking y peaje;6;VARIABLES
04/06/2016;02/06/2016;T/ AUTOPISTAS TERR;-1,38;21230,39;21229,01;8571;-1,38;21229,01;2016-06-02;02/06/2016;AUTOPISTAS;Gastos_Ocio y transporte;Parking y peaje;6;VARIABLES
04/06/2016;04/06/2016;T/ HONG KONG 2 \EL PR 01-06-2016;-9,95;21229,01;21219,06;8572;-9,95;21219,06;2016-06-01;01/06/2016;HONG;Gastos_Ocio y transporte;Restaurantes;6;VARIABLES
04/06/2016;04/06/2016;T/ E.S. RUBI II 01-06-2016;-43,19;21219,06;21175,87;8573;-43,19;21175,87;2016-06-01;01/06/2016;RUBI;Gastos_Ocio y transporte;Gasolina;6;VARIABLES
04/06/2016;04/06/2016;T/ CAPRABO \ 01-06-2016;-7,77;21175,87;21168,10;8574;-7,77;21168,10;2016-06-01;01/06/2016;CAPRABO;Gastos_Compras;Supermercado;6;VARIABLES
04/06/2016;04/06/2016;T/ CAFET.C T PRAT\PRAT 01-06-2016;-2,10;21168,10;21166,00;8575;-2,10;21166,00;2016-06-01;01/06/2016;CAFETC;Gastos_Ocio y transporte;Restaurantes;6;VARIABLES
04/06/2016;04/06/2016;T/ LIDL TERRASSA LES \ 01-06-2016;-28,16;21166,00;21137,84;8576;-28,16;21137,84;2016-06-01;01/06/2016;LIDL;Gastos_Compras;Supermercado;6;VARIABLES
05/06/2016;05/06/2016;T/ CAFET.C T PRAT\PRAT 02-06-2016;-4,50;21137,84;21133,34;8577;-4,50;21133,34;2016-06-02;02/06/2016;CAFETC;Gastos_Ocio y transporte;Restaurantes;6;VARIABLES
06/06/2016;06/06/2016;'R/ CEM - CENTRE D''EDU LOPEZGARCIA';-187,50;21133,34;20945,84;8578;-187,50;20945,84;2016-06-06;06/06/2016;CEM;Gastos_Salud, saber y deporte;Estudios;6;VARIABLES
06/06/2016;06/06/2016;S/OR. CASAL CAN PALET;-252,00;20945,84;20693,84;8579;-252,00;20693,84;2016-06-06;06/06/2016;CASAL;Gastos_Salud, saber y deporte;Estudios;6;VARIABLES
07/06/2016;31/05/2016;T/ KIABI.ES;-63,75;20693,84;20630,09;8580;-63,75;20630,09;2016-05-31;31/05/2016;KIABIES;Gastos_Compras;Ropa;5;VARIABLES
09/06/2016;09/06/2016;R/ Serunion SA Ntra.KRL1703797,;-16,61;20630,09;20613,48;8581;-16,61;20613,48;2016-06-09;09/06/2016;SERUNION;Gastos_Salud, saber y deporte;Menjador;6;FIJO
09/06/2016;09/06/2016;R/ BLITZ 40, S. Alquiler mes en c;-72,50;20613,48;20540,98;8582;-72,50;20540,98;2016-06-09;09/06/2016;BLITZ;Gastos_Vivienda y vehiculo;Alquiler Parking;6;FIJO
09/06/2016;09/06/2016;CAJ. AJENO SISTEMA 4B \TERRASSA;-60,00;20540,98;20480,98;8583;-60,00;20480,98;2016-06-09;09/06/2016;CAJ;Gastos_Gastos varios;Efectivo;6;VARIABLES
09/06/2016;09/06/2016;COM. 76985025 4b CAJ4 OFI9376;-1,85;20480,98;20479,13;8584;-1,85;20479,13;2016-06-09;09/06/2016;COM;Gastos_Banco y organismos;Cargos banco;6;FIJO
10/06/2016;10/06/2016;T/ FRANKFURT LES LLET\ 07-06-2016;-2,70;20479,13;20476,43;8585;-2,70;20476,43;2016-06-07;07/06/2016;FRANKFURT;Gastos_Ocio y transporte;Restaurantes;6;VARIABLES
11/06/2016;11/06/2016;T/ FRANKFURT LES LLET\ 08-06-2016;-2,70;20476,43;20473,73;8586;-2,70;20473,73;2016-06-08;08/06/2016;FRANKFURT;Gastos_Ocio y transporte;Restaurantes;6;VARIABLES
12/06/2016;12/06/2016;T/ FRANKFURT LES LLET\ 09-06-2016;-2,70;20473,73;20471,03;8587;-2,70;20471,03;2016-06-09;09/06/2016;FRANKFURT;Gastos_Ocio y transporte;Restaurantes;6;VARIABLES
12/06/2016;12/06/2016;T/ FRANKFURT LES LLET\ 09-06-2016;-11,35;20471,03;20459,68;8588;-11,35;20459,68;2016-06-09;09/06/2016;FRANKFURT;Gastos_Ocio y transporte;Restaurantes;6;VARIABLES
13/06/2016;13/06/2016;R/ SEGUROS ADESLAS CENT MODULAR CO;-113,89;20459,68;20345,79;8589;-113,89;20345,79;2016-06-13;13/06/2016;ADESLAS;Gastos_Salud, saber y deporte;Medico;6;VARIABLES
13/06/2016;13/06/2016;R/ LUZ ENDESA ENERG FACTURA DE GAS;-133,37;20345,79;20212,42;8590;-133,37;20212,42;2016-06-13;13/06/2016;GAS;Gastos_Servicios tipicos;Gas;6;FIJO
13/06/2016;13/06/2016;T/ PARKING VAPOR GRAN\ 10-06-2016;-7,55;20212,42;20204,87;8591;-7,55;20204,87;2016-06-10;10/06/2016;PARKING;Gastos_Ocio y transporte;Parking y peaje;6;VARIABLES
13/06/2016;13/06/2016;T/ MERCADONA QUATRE C\ 10-06-2016;-98,06;20204,87;20106,81;8592;-98,06;20106,81;2016-06-10;10/06/2016;MERCADONA;Gastos_Compras;Supermercado;6;VARIABLES
14/06/2016;14/06/2016;R/ LUZ IBERDROLA CL IBERDROLA OTRO;-10,79;20106,81;20096,02;8593;-10,79;20096,02;2016-06-14;14/06/2016;LUZ;Gastos_Servicios tipicos;Electricidad;6;FIJO
14/06/2016;14/06/2016;T/ LIDL TERRASSA LES \ 11-06-2016;-50,30;20096,02;20045,72;8594;-50,30;20045,72;2016-06-11;11/06/2016;LIDL;Gastos_Compras;Supermercado;6;VARIABLES
14/06/2016;14/06/2016;T/ VIENA SPLAU \EL PR 11-06-2016;-26,40;20045,72;20019,32;8595;-26,40;20019,32;2016-06-11;11/06/2016;VIENA;Gastos_Ocio y transporte;Restaurantes;6;VARIABLES
15/06/2016;15/06/2016;R/ MINA PUBLICA AIGUES T.01A75789;-40,17;20019,32;19979,15;8596;-40,17;19979,15;2016-06-15;15/06/2016;MINA;Gastos_Servicios tipicos;Agua;6;FIJO
16/06/2016;16/06/2016;R/ SEGUROS CCM VIDA Y P Recibo:136;-21,39;19979,15;19957,76;8597;-21,39;19957,76;2016-06-16;16/06/2016;CCM;Gastos_Seguros;Seguro vida;6;FIJO
16/06/2016;16/06/2016;R/ SEGUROS CCM VIDA Y P Recibo:136;-17,10;19957,76;19940,66;8598;-17,10;19940,66;2016-06-16;16/06/2016;CCM;Gastos_Seguros;Seguro vida;6;FIJO
16/06/2016;16/06/2016;T/ Jogaplamon S.L. \ 13-06-2016;-10,60;19940,66;19930,06;8599;-10,60;19930,06;2016-06-13;13/06/2016;JOGAPLAMON;Gastos_Compras;Niños;6;VARIABLES
17/06/2016;17/06/2016;R/ TELEFONO Vodafone Ono ONOAU16-0;-118,34;19930,06;19811,72;8600;-118,34;19811,72;2016-06-17;17/06/2016;TELEFONO;Gastos_Servicios tipicos;Telecomunicaciones;6;FIJO
17/06/2016;17/06/2016;T/ FRANKFURT LES LLET\ 14-06-2016;-2,70;19811,72;19809,02;8601;-2,70;19809,02;2016-06-14;14/06/2016;FRANKFURT;Gastos_Ocio y transporte;Restaurantes;6;VARIABLES
18/06/2016;18/06/2016;T/ FRANKFURT LES LLET\ 15-06-2016;-2,60;19809,02;19806,42;8602;-2,60;19806,42;2016-06-15;15/06/2016;FRANKFURT;Gastos_Ocio y transporte;Restaurantes;6;VARIABLES
18/06/2016;18/06/2016;T/ FRANKFURT LES LLET\ 15-06-2016;-4,85;19806,42;19801,57;8603;-4,85;19801,57;2016-06-15;15/06/2016;FRANKFURT;Gastos_Ocio y transporte;Restaurantes;6;VARIABLES
19/06/2016;19/06/2016;COM. 64970028 SVRED CAJ OFI;-1,87;19801,57;19799,70;8604;-1,87;19799,70;2016-06-19;19/06/2016;COM;Gastos_Banco y organismos;Cargos banco;6;FIJO
19/06/2016;19/06/2016;T/ CAPRABO \ 16-06-2016;-11,55;19799,70;19788,15;8605;-11,55;19788,15;2016-06-16;16/06/2016;CAPRABO;Gastos_Compras;Supermercado;6;VARIABLES
19/06/2016;19/06/2016;T/ FRANKFURT LES LLET\ 16-06-2016;-2,70;19788,15;19785,45;8606;-2,70;19785,45;2016-06-16;16/06/2016;FRANKFURT;Gastos_Ocio y transporte;Restaurantes;6;VARIABLES
19/06/2016;19/06/2016;CAJ. AJENO SERVIRED \TERRASSA;-70,00;19785,45;19715,45;8607;-70,00;19715,45;2016-06-19;19/06/2016;CAJ;Gastos_Gastos varios;Efectivo;6;VARIABLES
20/06/2016;20/06/2016;R/ LUZ IBERDROLA CL IBERDROLA ELEC;-7,18;19715,45;19708,27;8608;-7,18;19708,27;2016-06-20;20/06/2016;LUZ;Gastos_Servicios tipicos;Electricidad;6;FIJO
20/06/2016;20/06/2016;T/ FRANKFURT LES LLET\ 17-06-2016;-2,70;19708,27;19705,57;8609;-2,70;19705,57;2016-06-17;17/06/2016;FRANKFURT;Gastos_Ocio y transporte;Restaurantes;6;VARIABLES
21/06/2016;21/06/2016;HAB. FOMENT DE TERRASSA S.A. Transf;3735,73;19705,57;23441,30;8610;3735,73;23441,30;2016-06-21;21/06/2016;HAB;Ingresos;Nomina;6;FIJO
24/06/2016;24/06/2016;T/ FRANKFURT LES LLET\ 21-06-2016;-4,00;23441,30;23437,30;8611;-4,00;23437,30;2016-06-21;21/06/2016;FRANKFURT;Gastos_Ocio y transporte;Restaurantes;6;VARIABLES
24/06/2016;24/06/2016;T/ FRANKFURT LES LLET\ 21-06-2016;-2,70;23437,30;23434,60;8612;-2,70;23434,60;2016-06-21;21/06/2016;FRANKFURT;Gastos_Ocio y transporte;Restaurantes;6;VARIABLES
25/06/2016;25/06/2016;T/ FRANKFURT LES LLET\ 22-06-2016;-11,25;23434,60;23423,35;8613;-11,25;23423,35;2016-06-22;22/06/2016;FRANKFURT;Gastos_Ocio y transporte;Restaurantes;6;VARIABLES
25/06/2016;25/06/2016;T/ FRANKFURT LES LLET\ 22-06-2016;-2,70;23423,35;23420,65;8614;-2,70;23420,65;2016-06-22;22/06/2016;FRANKFURT;Gastos_Ocio y transporte;Restaurantes;6;VARIABLES
26/06/2016;26/06/2016;T/ FRANKFURT LES LLET\ 23-06-2016;-2,70;23420,65;23417,95;8615;-2,70;23417,95;2016-06-23;23/06/2016;FRANKFURT;Gastos_Ocio y transporte;Restaurantes;6;VARIABLES
28/06/2016;28/06/2016;HAB. INFORMACIO I TECNOLOGIA DE CAT;1615,93;23417,95;25033,88;8616;1615,93;25033,88;2016-06-28;28/06/2016;HAB;Ingresos;Nomina;6;FIJO
30/06/2016;30/06/2016;REC. 6061.9600001223;-514,31;25033,88;24519,57;8617;-514,31;24519,57;2016-06-30;30/06/2016;REC;Gastos_Banco y organismos;Hipoteca;6;FIJO
30/06/2016;01/07/2016;INT. 210560613010013266;0,30;24519,57;24519,87;8618;0,30;24519,87;2016-07-01;01/07/2016;INT;Ingresos;Rendimientos;7;
30/06/2016;01/07/2016;RET.REND.CAP.M;-0,06;24519,87;24519,81;8619;-0,06;24519,81;2016-07-01;01/07/2016;RETRENDCAPM;Gastos_Banco y organismos;Impuestos;7;FIJO
30/06/2016;30/06/2016;FACT TARJETAS TARJ.CREDITO 07126017 16-07-01;-256,37;24519,81;24263,44;8620;-256,37;24263,44;2016-07-01;30/06/2016;FACT 07126017;Gastos_Banco y organismos;Credito Bea;6;VARIABLE
30/06/2016;30/06/2016;FACT TARJETAS TARJ.CREDITO 42689013 16-07-01;-835,73;24263,44;23427,71;8621;-835,73;23427,71;2016-07-01;30/06/2016;FACT;No computable;Recibo Tarjeta;6;
01/07/2016;01/07/2016;T/ FRANKFURT LES LLET\ 28-06-2016;-2,70;23427,71;23425,01;8622;-2,70;23425,01;2016-06-28;28/06/2016;FRANKFURT;Gastos_Ocio y transporte;Restaurantes;6;VARIABLES
01/07/2016;01/07/2016;LIMPIEZA;-130,00;23425,01;23295,01;8623;-130,00;23295,01;2016-07-01;01/07/2016;LIMPIEZA;Gastos_Vivienda y vehiculo;Serv. domestico;7;FIJO
04/07/2016;04/07/2016;R/ AJUNTAMENT D I.B.I. CA D.ALBI;-45,65;23295,01;23249,36;8624;-45,65;23249,36;2016-07-04;04/07/2016;AJUNTAMENT;Gastos_Banco y organismos;Ayuntamiento;7;FIJO
04/07/2016;04/07/2016;T/ PARC VALLES \ 01-07-2016;-106,93;23249,36;23142,43;8625;-106,93;23142,43;2016-07-01;01/07/2016;PARC;Gastos_Compras;Supermercado;7;VARIABLES
05/07/2016;28/06/2016;T/ KIABI.ES;-66,75;23142,43;23075,68;8626;-66,75;23075,68;2016-06-28;28/06/2016;KIABIES;Gastos_Compras;Ropa;6;VARIABLES
06/07/2016;06/07/2016;O/ INFOM. I TECNOLOGIA DE CATALUN;7,10;23075,68;23082,78;8627;7,10;23082,78;2016-07-06;06/07/2016;INFOM;Ingresos;Nomina;7;FIJO
06/07/2016;06/07/2016;R/ BLITZ 40, S. Alquiler mes en c;-72,50;23082,78;23010,28;8628;-72,50;23010,28;2016-07-06;06/07/2016;BLITZ;Gastos_Vivienda y vehiculo;Alquiler Parking;7;FIJO
06/07/2016;02/07/2016;T/ AUTOPISTAS TERR;-2,51;23010,28;23007,77;8629;-2,51;23007,77;2016-07-02;02/07/2016;AUTOPISTAS;Gastos_Ocio y transporte;Parking y peaje;7;VARIABLES
07/07/2016;07/07/2016;R/ SEGUROS ADESLAS CENT MODULAR CO;-113,89;23007,77;22893,88;8630;-113,89;22893,88;2016-07-07;07/07/2016;ADESLAS;Gastos_Salud, saber y deporte;Medico;7;VARIABLES
07/07/2016;07/07/2016;R/ CEM - CENTRE DESCRIPCION;-90,00;22893,88;22803,88;8631;-90,00;22803,88;2016-07-07;07/07/2016;CEM;Gastos_Salud, saber y deporte;Estudios;7;VARIABLES
07/07/2016;07/07/2016;CAJ. AJENO SISTEMA 4B \TERRASSA;-70,00;22803,88;22733,88;8632;-70,00;22733,88;2016-07-07;07/07/2016;CAJ;Gastos_Gastos varios;Efectivo;7;VARIABLES
07/07/2016;07/07/2016;COM. 64970028 4b CAJ0 OFI5364;-1,50;22733,88;22732,38;8633;-1,50;22732,38;2016-07-07;07/07/2016;COM;Gastos_Banco y organismos;Cargos banco;7;FIJO
08/07/2016;08/07/2016;T/ VIENA PARC VALLES \ 05-07-2016;-8,75;22732,38;22723,63;8634;-8,75;22723,63;2016-07-05;05/07/2016;VIENA;Gastos_Ocio y transporte;Restaurantes;7;VARIABLES
08/07/2016;08/07/2016;T/ DECATHLON SA TERRA\ 05-07-2016;-16,98;22723,63;22706,65;8635;-16,98;22706,65;2016-07-05;05/07/2016;DECATHLON;Gastos_Compras;Deportivo;7;VARIABLES
09/07/2016;07/07/2016;T/ AUTOPISTAS TERR;-1,38;22706,65;22705,27;8636;-1,38;22705,27;2016-07-07;07/07/2016;AUTOPISTAS;Gastos_Ocio y transporte;Parking y peaje;7;VARIABLES
09/07/2016;09/07/2016;T/ FRANKFURT LES LLET\ 06-07-2016;-2,70;22705,27;22702,57;8637;-2,70;22702,57;2016-07-06;06/07/2016;FRANKFURT;Gastos_Ocio y transporte;Restaurantes;7;VARIABLES
10/07/2016;10/07/2016;T/ FRANKFURT LES LLET\ 07-07-2016;-2,70;22702,57;22699,87;8638;-2,70;22699,87;2016-07-07;07/07/2016;FRANKFURT;Gastos_Ocio y transporte;Restaurantes;7;VARIABLES
10/07/2016;10/07/2016;T/ NORDEN \ 07-07-2016;-13,20;22699,87;22686,67;8639;-13,20;22686,67;2016-07-07;07/07/2016;NORDEN;Gastos_Ocio y transporte;Restaurantes;7;VARIABLES
11/07/2016;11/07/2016;T/ FRANKFURT LES LLET\ 08-07-2016;-2,70;22686,67;22683,97;8640;-2,70;22683,97;2016-07-08;08/07/2016;FRANKFURT;Gastos_Ocio y transporte;Restaurantes;7;VARIABLES
11/07/2016;11/07/2016;T/ BON AREA 08-07-2016;-21,47;22683,97;22662,50;8641;-21,47;22662,50;2016-07-08;08/07/2016;BON;Gastos_Compras;Supermercado;7;VARIABLES
12/07/2016;08/07/2016;T/ AUTOPISTAS TERR;-1,38;22662,50;22661,12;8642;-1,38;22661,12;2016-07-08;08/07/2016;AUTOPISTAS;Gastos_Ocio y transporte;Parking y peaje;7;VARIABLES
13/07/2016;13/07/2016;R/ LUZ IBERDROLA CL IBERDROLA OTRO;-10,79;22661,12;22650,33;8643;-10,79;22650,33;2016-07-13;13/07/2016;LUZ;Gastos_Servicios tipicos;Electricidad;7;FIJO
13/07/2016;13/07/2016;T/ WWW.JUST-EAT.ES 10-07-2016;-18,00;22650,33;22632,33;8644;-18,00;22632,33;2016-07-10;10/07/2016;WWWJUSTEATES;Gastos_Ocio y transporte;Restaurantes;7;VARIABLES
14/07/2016;14/07/2016;R/ LUZ IBERDROLA CL IBERDROLA ELEC;-7,18;22632,33;22625,15;8645;-7,18;22625,15;2016-07-14;14/07/2016;LUZ;Gastos_Servicios tipicos;Electricidad;7;FIJO
14/07/2016;14/07/2016;R/ LUZ ENDESA ENERG FACTURA DE ELE;-130,46;22625,15;22494,69;8646;-130,46;22494,69;2016-07-14;14/07/2016;ELE;Gastos_Servicios tipicos;Electricidad;7;FIJO
14/07/2016;12/07/2016;T/ AUTOPISTAS TERR;-1,38;22494,69;22493,31;8647;-1,38;22493,31;2016-07-12;12/07/2016;AUTOPISTAS;Gastos_Ocio y transporte;Parking y peaje;7;VARIABLES
14/07/2016;12/07/2016;T/ AMAZON.ES COMPRA;-339,99;22493,31;22153,32;8648;-339,99;22153,32;2016-07-12;12/07/2016;AMAZONES;Gastos_Compras;Hobbys;7;VARIABLES
14/07/2016;14/07/2016;T/ FRANKFURT LES LLET\ 11-07-2016;-5,80;22153,32;22147,52;8649;-5,80;22147,52;2016-07-11;11/07/2016;FRANKFURT;Gastos_Ocio y transporte;Restaurantes;7;VARIABLES
15/07/2016;13/07/2016;T/ Amazon *Mktplce EU-ES;-6,99;22147,52;22140,53;8650;-6,99;22140,53;2016-07-13;13/07/2016;AMAZON;Gastos_Compras;Hobbys;7;VARIABLES
15/07/2016;13/07/2016;T/ AMAZON SPAIN RETAIL AM;-225,00;22140,53;21915,53;8651;-225,00;21915,53;2016-07-13;13/07/2016;AMAZON;Gastos_Compras;Hobbys;7;VARIABLES
15/07/2016;15/07/2016;T/ JOHN S ITALIAN \ 12-07-2016;-8,00;21915,53;21907,53;8652;-8,00;21907,53;2016-07-12;12/07/2016;JOHN;Gastos_Ocio y transporte;Restaurantes;7;VARIABLES
15/07/2016;15/07/2016;T/ FRANKFURT LES LLET\ 12-07-2016;-2,70;21907,53;21904,83;8653;-2,70;21904,83;2016-07-12;12/07/2016;FRANKFURT;Gastos_Ocio y transporte;Restaurantes;7;VARIABLES
15/07/2016;15/07/2016;T/ MERCADONA QUATRE C\ 12-07-2016;-27,23;21904,83;21877,60;8654;-27,23;21877,60;2016-07-12;12/07/2016;MERCADONA;Gastos_Compras;Supermercado;7;VARIABLES
16/07/2016;16/07/2016;CAJ. AJENO SERVIRED \TERRASSA;-50,00;21877,60;21827,60;8655;-50,00;21827,60;2016-07-16;16/07/2016;CAJ;Gastos_Gastos varios;Efectivo;7;VARIABLES
16/07/2016;16/07/2016;COM. 64970028 SVRED CAJ OFI;-1,87;21827,60;21825,73;8656;-1,87;21825,73;2016-07-16;16/07/2016;COM;Gastos_Banco y organismos;Cargos banco;7;FIJO
16/07/2016;14/07/2016;T/ Amazon *Mktplce EU-ES;-10,99;21825,73;21814,74;8657;-10,99;21814,74;2016-07-14;14/07/2016;AMAZON;Gastos_Compras;Hobbys;7;VARIABLES
16/07/2016;14/07/2016;T/ C&A Online GmbH;-68,53;21814,74;21746,21;8658;-68,53;21746,21;2016-07-14;14/07/2016;ONLINE;Gastos_Compras;Ropa;7;VARIABLES
16/07/2016;16/07/2016;T/ CAPRABO \ 13-07-2016;-4,25;21746,21;21741,96;8659;-4,25;21741,96;2016-07-13;13/07/2016;CAPRABO;Gastos_Compras;Supermercado;7;VARIABLES
16/07/2016;16/07/2016;T/ BUSCOUNCHOLLO.COM\TARRAGONA;-662,00;21741,96;21079,96;8660;-662,00;21079,96;2016-07-16;16/07/2016;BUSCOUNCHOLLOCOMTARRAGONA;Gastos_Ocio y transporte;Vacaciones;7;VARIABLES
17/07/2016;17/07/2016;T/ RODELAS PERRUQUERS\ 14-07-2016;-21,40;21079,96;21058,56;8661;-21,40;21058,56;2016-07-14;14/07/2016;RODELAS;Gastos_Salud, saber y deporte;Belleza;7;VARIABLES
17/07/2016;17/07/2016;T/ FRANKFURT LES LLET\ 14-07-2016;-2,70;21058,56;21055,86;8662;-2,70;21055,86;2016-07-14;14/07/2016;FRANKFURT;Gastos_Ocio y transporte;Restaurantes;7;VARIABLES
17/07/2016;17/07/2016;T/ FRANKFURT LES LLET\ 14-07-2016;-5,80;21055,86;21050,06;8663;-5,80;21050,06;2016-07-14;14/07/2016;FRANKFURT;Gastos_Ocio y transporte;Restaurantes;7;VARIABLES
17/07/2016;17/07/2016;T/ CAFET.C T PRAT\PRAT 14-07-2016;-3,45;21050,06;21046,61;8664;-3,45;21046,61;2016-07-14;14/07/2016;CAFETC;Gastos_Ocio y transporte;Restaurantes;7;VARIABLES
17/07/2016;14/07/2016;T/ AUTOPISTAS TERR;-1,38;21046,61;21045,23;8665;-1,38;21045,23;2016-07-14;14/07/2016;AUTOPISTAS;Gastos_Ocio y transporte;Parking y peaje;7;VARIABLES
18/07/2016;18/07/2016;HAB. INFORMACIO I TECNOLOGIA DE CAT;1767,10;21045,23;22812,33;8666;1767,10;22812,33;2016-07-18;18/07/2016;HAB;Ingresos;Nomina;7;FIJO
18/07/2016;18/07/2016;R/ TELEFONO Vodafone Ono ONOAU16-0;-123,21;22812,33;22689,12;8667;-123,21;22689,12;2016-07-18;18/07/2016;TELEFONO;Gastos_Servicios tipicos;Telecomunicaciones;7;FIJO
18/07/2016;18/07/2016;R/ SEGUROS CCM VIDA Y P Recibo:137;-22,05;22689,12;22667,07;8668;-22,05;22667,07;2016-07-18;18/07/2016;CCM;Gastos_Seguros;Seguro vida;7;FIJO
18/07/2016;18/07/2016;R/ SEGUROS CCM VIDA Y P Recibo:137;-17,05;22667,07;22650,02;8669;-17,05;22650,02;2016-07-18;18/07/2016;CCM;Gastos_Seguros;Seguro vida;7;FIJO
18/07/2016;18/07/2016;T/ CAFET.C T PRAT\PRAT 15-07-2016;-3,65;22650,02;22646,37;8670;-3,65;22646,37;2016-07-15;15/07/2016;CAFETC;Gastos_Ocio y transporte;Restaurantes;7;VARIABLES
18/07/2016;18/07/2016;T/ RODELAS PERRUQUERS\ 15-07-2016;-10,00;22646,37;22636,37;8671;-10,00;22636,37;2016-07-15;15/07/2016;RODELAS;Gastos_Salud, saber y deporte;Belleza;7;VARIABLES
18/07/2016;18/07/2016;T/ FRANKFURT LES LLET\ 15-07-2016;-4,85;22636,37;22631,52;8672;-4,85;22631,52;2016-07-15;15/07/2016;FRANKFURT;Gastos_Ocio y transporte;Restaurantes;7;VARIABLES
18/07/2016;18/07/2016;T/ PARKING VAPOR GRAN\ 15-07-2016;-0,80;22631,52;22630,72;8673;-0,80;22630,72;2016-07-15;15/07/2016;PARKING;Gastos_Ocio y transporte;Parking y peaje;7;VARIABLES
18/07/2016;18/07/2016;T/ DECATHLON SA TERRA\ 15-07-2016;-8,99;22630,72;22621,73;8674;-8,99;22621,73;2016-07-15;15/07/2016;DECATHLON;Gastos_Compras;Deportivo;7;VARIABLES
18/07/2016;18/07/2016;T/ MONALISA \ 15-07-2016;-82,40;22621,73;22539,33;8675;-82,40;22539,33;2016-07-15;15/07/2016;MONALISA;Gastos_Salud, saber y deporte;Belleza;7;VARIABLES
18/07/2016;18/07/2016;T/ TOCINERIES VENTURA\TERRASSA;-19,04;22539,33;22520,29;8676;-19,04;22520,29;2016-07-18;18/07/2016;TOCINERIES;Gastos_Compras;Supermercado;7;VARIABLES
19/07/2016;19/07/2016;'DEV. RECIBOS CEM - CENTRE D''EDU LOPEZGARCIA';187,50;22520,29;22707,79;8677;187,50;22707,79;2016-07-19;19/07/2016;DEV;Ingresos;Devoluciones;7;VARIABLES
19/07/2016;19/07/2016;'DEV. RECIBOS CEM - CENTRE D''EDU LOPEZGARCIA';90,00;22707,79;22797,79;8678;90,00;22797,79;2016-07-19;19/07/2016;DEV;Ingresos;Devoluciones;7;VARIABLES
19/07/2016;15/07/2016;T/ AUTOPISTAS TERR;-1,38;22797,79;22796,41;8679;-1,38;22796,41;2016-07-15;15/07/2016;AUTOPISTAS;Gastos_Ocio y transporte;Parking y peaje;7;VARIABLES
19/07/2016;19/07/2016;T/ REDPIZZA \ 16-07-2016;-24,15;22796,41;22772,26;8680;-24,15;22772,26;2016-07-16;16/07/2016;REDPIZZA;Gastos_Ocio y transporte;Restaurantes;7;VARIABLES
20/07/2016;18/07/2016;T/ AUTOPISTAS TERR;-1,38;22772,26;22770,88;8681;-1,38;22770,88;2016-07-18;18/07/2016;AUTOPISTAS;Gastos_Ocio y transporte;Parking y peaje;7;VARIABLES
20/07/2016;18/07/2016;T/ AUTOPISTAS TERR;-1,38;22770,88;22769,50;8682;-1,38;22769,50;2016-07-18;18/07/2016;AUTOPISTAS;Gastos_Ocio y transporte;Parking y peaje;7;VARIABLES
20/07/2016;20/07/2016;T/ WWW.JUST-EAT.ES 17-07-2016;-27,65;22769,50;22741,85;8683;-27,65;22741,85;2016-07-17;17/07/2016;WWWJUSTEATES;Gastos_Ocio y transporte;Restaurantes;7;VARIABLES
20/07/2016;18/07/2016;T/ TABASA VALLVI S. 15-07-2016;-4,16;22741,85;22737,69;8684;-4,16;22737,69;2016-07-15;15/07/2016;TABASA;Gastos_Ocio y transporte;Parking y peaje;7;VARIABLES
20/07/2016;20/07/2016;T/ TOMATIS TERRASSA \TERRASSA;-100,00;22737,69;22637,69;8685;-100,00;22637,69;2016-07-20;20/07/2016;TOMATIS;Gastos_Salud, saber y deporte;Estudios;7;VARIABLES
21/07/2016;19/07/2016;T/ AUTOPISTAS TERR;-1,38;22637,69;22636,31;8686;-1,38;22636,31;2016-07-19;19/07/2016;AUTOPISTAS;Gastos_Ocio y transporte;Parking y peaje;7;VARIABLES
21/07/2016;21/07/2016;T/ DECATHLON SA TERRA\ 18-07-2016;-79,85;22636,31;22556,46;8687;-79,85;22556,46;2016-07-18;18/07/2016;DECATHLON;Gastos_Compras;Deportivo;7;VARIABLES
21/07/2016;21/07/2016;T/ FRANKFURT LES LLET\ 18-07-2016;-2,70;22556,46;22553,76;8688;-2,70;22553,76;2016-07-18;18/07/2016;FRANKFURT;Gastos_Ocio y transporte;Restaurantes;7;VARIABLES
21/07/2016;21/07/2016;T/ CAPRABO \ 18-07-2016;-5,35;22553,76;22548,41;8689;-5,35;22548,41;2016-07-18;18/07/2016;CAPRABO;Gastos_Compras;Supermercado;7;VARIABLES
21/07/2016;21/07/2016;T/ E.S. RUBI II 18-07-2016;-40,33;22548,41;22508,08;8690;-40,33;22508,08;2016-07-18;18/07/2016;RUBI;Gastos_Ocio y transporte;Gasolina;7;VARIABLES
21/07/2016;21/07/2016;T/ BURGUER KING PARC \ 18-07-2016;-20,48;22508,08;22487,60;8691;-20,48;22487,60;2016-07-18;18/07/2016;BURGUER;Gastos_Ocio y transporte;Restaurantes;7;VARIABLES
21/07/2016;21/07/2016;T/ CAFET.C T PRAT\PRAT 18-07-2016;-4,05;22487,60;22483,55;8692;-4,05;22483,55;2016-07-18;18/07/2016;CAFETC;Gastos_Ocio y transporte;Restaurantes;7;VARIABLES
21/07/2016;21/07/2016;T/ MERCACHINA TERRASS\ 18-07-2016;-14,45;22483,55;22469,10;8693;-14,45;22469,10;2016-07-18;18/07/2016;MERCACHINA;Gastos_Compras;Otras compras;7;VARIABLES
21/07/2016;21/07/2016;S/OR. ESCOLA DE NATURA;-120,00;22469,10;22349,10;8694;-120,00;22349,10;2016-07-21;21/07/2016;ESCOLA;Gastos_Salud, saber y deporte;Estudios;7;VARIABLES
21/07/2016;21/07/2016;S/OR. AMPA Escola Sala i Badrinas;-30,00;22349,10;22319,10;8695;-30,00;22319,10;2016-07-21;21/07/2016;AMPA;Gastos_Salud, saber y deporte;Estudios;7;VARIABLES
22/07/2016;22/07/2016;T/ CAFET.C T PRAT\PRAT 19-07-2016;-3,05;22319,10;22316,05;8696;-3,05;22316,05;2016-07-19;19/07/2016;CAFETC;Gastos_Ocio y transporte;Restaurantes;7;VARIABLES
22/07/2016;22/07/2016;T/ MERCADONA QUATRE C\ 19-07-2016;-16,61;22316,05;22299,44;8697;-16,61;22299,44;2016-07-19;19/07/2016;MERCADONA;Gastos_Compras;Supermercado;7;VARIABLES
22/07/2016;22/07/2016;T/ FRANKFURT LES LLET\ 19-07-2016;-2,70;22299,44;22296,74;8698;-2,70;22296,74;2016-07-19;19/07/2016;FRANKFURT;Gastos_Ocio y transporte;Restaurantes;7;VARIABLES
22/07/2016;22/07/2016;T/ ORIENT CARS - RECA\TERRASSA;-226,06;22296,74;22070,68;8699;-226,06;22070,68;2016-07-22;22/07/2016;ORIENT;Gastos_Vivienda y vehiculo;Mnto. vehiculo;7;VARIABLE
23/07/2016;23/07/2016;COM. 64970028 SVRED CAJ OFI;-1,87;22070,68;22068,81;8700;-1,87;22068,81;2016-07-23;23/07/2016;COM;Gastos_Banco y organismos;Cargos banco;7;FIJO
23/07/2016;21/07/2016;T/ AUTOPISTAS TERR;-1,38;22068,81;22067,43;8701;-1,38;22067,43;2016-07-21;21/07/2016;AUTOPISTAS;Gastos_Ocio y transporte;Parking y peaje;7;VARIABLES
23/07/2016;21/07/2016;T/ AUTOPISTAS TERR;-1,38;22067,43;22066,05;8702;-1,38;22066,05;2016-07-21;21/07/2016;AUTOPISTAS;Gastos_Ocio y transporte;Parking y peaje;7;VARIABLES
23/07/2016;23/07/2016;T/ CAFET.C T PRAT\PRAT 20-07-2016;-3,65;22066,05;22062,40;8703;-3,65;22062,40;2016-07-20;20/07/2016;CAFETC;Gastos_Ocio y transporte;Restaurantes;7;VARIABLES
23/07/2016;23/07/2016;T/ FRANKFURT LES LLET\ 20-07-2016;-2,70;22062,40;22059,70;8704;-2,70;22059,70;2016-07-20;20/07/2016;FRANKFURT;Gastos_Ocio y transporte;Restaurantes;7;VARIABLES
23/07/2016;23/07/2016;T/ FRANKFURT LES LLET\ 20-07-2016;-7,40;22059,70;22052,30;8705;-7,40;22052,30;2016-07-20;20/07/2016;FRANKFURT;Gastos_Ocio y transporte;Restaurantes;7;VARIABLES
23/07/2016;23/07/2016;T/ PARKING VAPOR GRAN\ 20-07-2016;-2,75;22052,30;22049,55;8706;-2,75;22049,55;2016-07-20;20/07/2016;PARKING;Gastos_Ocio y transporte;Parking y peaje;7;VARIABLES
23/07/2016;23/07/2016;CAJ. AJENO SERVIRED \TERRASSA;-70,00;22049,55;21979,55;8707;-70,00;21979,55;2016-07-23;23/07/2016;CAJ;Gastos_Gastos varios;Efectivo;7;VARIABLES
24/07/2016;24/07/2016;T/ PARC VALLES \ 21-07-2016;-13,72;21979,55;21965,83;8708;-13,72;21965,83;2016-07-21;21/07/2016;PARC;Gastos_Compras;Supermercado;7;VARIABLES
24/07/2016;24/07/2016;T/ CAFET.C T PRAT\PRAT 21-07-2016;-4,05;21965,83;21961,78;8709;-4,05;21961,78;2016-07-21;21/07/2016;CAFETC;Gastos_Ocio y transporte;Restaurantes;7;VARIABLES
24/07/2016;24/07/2016;T/ FRANKFURT LES LLET\ 21-07-2016;-3,90;21961,78;21957,88;8710;-3,90;21957,88;2016-07-21;21/07/2016;FRANKFURT;Gastos_Ocio y transporte;Restaurantes;7;VARIABLES
25/07/2016;25/07/2016;T/ REDPIZZA \ 22-07-2016;-17,65;21957,88;21940,23;8711;-17,65;21940,23;2016-07-22;22/07/2016;REDPIZZA;Gastos_Ocio y transporte;Restaurantes;7;VARIABLES
25/07/2016;25/07/2016;T/ CAFET.C T PRAT\PRAT 22-07-2016;-3,65;21940,23;21936,58;8712;-3,65;21936,58;2016-07-22;22/07/2016;CAFETC;Gastos_Ocio y transporte;Restaurantes;7;VARIABLES
26/07/2016;26/07/2016;BONIF.COM. 5540556264970028;18,00;21936,58;21954,58;8713;18,00;21954,58;2016-07-26;26/07/2016;BONIFCOM;Ingresos;Devoluciones;7;VARIABLES
26/07/2016;26/07/2016;COMIS.TARJETAS 5540556264970028;-18,00;21954,58;21936,58;8714;-18,00;21936,58;2016-07-26;26/07/2016;COMISTARJETAS;Gastos_Banco y organismos;Cargos banco;7;FIJO
26/07/2016;26/07/2016;DEV.COMPRA TJ BUSCOUNCHOLLO.COM\TARRAGONA;74,00;21936,58;22010,58;8715;74,00;22010,58;2016-07-26;26/07/2016;DEVCOMPRA;Ingresos;Devoluciones;7;VARIABLES
26/07/2016;22/07/2016;T/ AUTOPISTAS TERR;-1,38;22010,58;22009,20;8716;-1,38;22009,20;2016-07-22;22/07/2016;AUTOPISTAS;Gastos_Ocio y transporte;Parking y peaje;7;VARIABLES
26/07/2016;22/07/2016;T/ AUTOPISTAS TERR;-1,38;22009,20;22007,82;8717;-1,38;22007,82;2016-07-22;22/07/2016;AUTOPISTAS;Gastos_Ocio y transporte;Parking y peaje;7;VARIABLES
26/07/2016;23/07/2016;T/ AUTOPISTAS TERR;-7,67;22007,82;22000,15;8718;-7,67;22000,15;2016-07-23;23/07/2016;AUTOPISTAS;Gastos_Ocio y transporte;Parking y peaje;7;VARIABLES
26/07/2016;23/07/2016;T/ LA CASA DEL FORMATGE;-88,40;22000,15;21911,75;8719;-88,40;21911,75;2016-07-23;23/07/2016;CASA;Gastos_Ocio y transporte;Restaurantes;7;VARIABLES
26/07/2016;24/07/2016;T/ GE CANILLO;-26,00;21911,75;21885,75;8720;-26,00;21885,75;2016-07-24;24/07/2016;CANILLO;Gastos_Ocio y transporte;Vacaciones;7;VARIABLES
26/07/2016;24/07/2016;T/ RESTAURANT EL FORN;-39,40;21885,75;21846,35;8721;-39,40;21846,35;2016-07-24;24/07/2016;RESTAURANT;Gastos_Ocio y transporte;Restaurantes;7;VARIABLES
26/07/2016;24/07/2016;T/ BOT RIBA;-30,00;21846,35;21816,35;8722;-30,00;21816,35;2016-07-24;24/07/2016;BOT;Gastos_Ocio y transporte;Vacaciones;7;VARIABLES
26/07/2016;24/07/2016;T/ RESTAURANT EL FORN;-5,60;21816,35;21810,75;8723;-5,60;21810,75;2016-07-24;24/07/2016;RESTAURANT;Gastos_Ocio y transporte;Restaurantes;7;VARIABLES
26/07/2016;24/07/2016;T/ APARC.ESCALDES CENTRE,;-33,50;21810,75;21777,25;8724;-33,50;21777,25;2016-07-24;24/07/2016;APARCESCALDES;Gastos_Ocio y transporte;Parking y peaje;7;VARIABLES
26/07/2016;26/07/2016;T/ 4007 TERRASSA \ 23-07-2016;-20,77;21777,25;21756,48;8725;-20,77;21756,48;2016-07-23;23/07/2016;TERRASSA;Gastos_Ocio y transporte;Gasolina;7;VARIABLES
26/07/2016;26/07/2016;T/ VIENA PARC VALLES \ 23-07-2016;-15,10;21756,48;21741,38;8726;-15,10;21741,38;2016-07-23;23/07/2016;VIENA;Gastos_Ocio y transporte;Restaurantes;7;VARIABLES
26/07/2016;26/07/2016;T/ DECATHLON SA TERRA\ 23-07-2016;-69,33;21741,38;21672,05;8727;-69,33;21672,05;2016-07-23;23/07/2016;DECATHLON;Gastos_Compras;Deportivo;7;VARIABLES
27/07/2016;25/07/2016;T/ VIENA CARLEMANY;-9,80;21672,05;21662,25;8728;-9,80;21662,25;2016-07-25;25/07/2016;VIENA;Gastos_Ocio y transporte;Restaurantes;7;VARIABLES
27/07/2016;25/07/2016;T/ REST. PIZZERIA PRIMAVE;-36,37;21662,25;21625,88;8729;-36,37;21625,88;2016-07-25;25/07/2016;REST;Gastos_Ocio y transporte;Restaurantes;7;VARIABLES
27/07/2016;26/07/2016;T/ TABASA CADI NORD 23-07-2016;-11,57;21625,88;21614,31;8730;-11,57;21614,31;2016-07-23;23/07/2016;TABASA;Gastos_Ocio y transporte;Parking y peaje;7;VARIABLES
28/07/2016;28/07/2016;HAB. INFORMACIO I TECNOLOGIA DE CAT;1615,93;21614,31;23230,24;8731;1615,93;23230,24;2016-07-28;28/07/2016;HAB;Ingresos;Nomina;7;FIJO
28/07/2016;28/07/2016;HAB. FOMENT DE TERRASSA S.A. Transf;1790,36;23230,24;25020,60;8732;1790,36;25020,60;2016-07-28;28/07/2016;HAB;Ingresos;Nomina;7;FIJO
28/07/2016;26/07/2016;T/ VIENA;-11,00;25020,60;25009,60;8733;-11,00;25009,60;2016-07-26;26/07/2016;VIENA;Gastos_Ocio y transporte;Restaurantes;7;VARIABLES
28/07/2016;26/07/2016;T/ CAFE;-46,85;25009,60;24962,75;8734;-46,85;24962,75;2016-07-26;26/07/2016;CAFE;Gastos_Ocio y transporte;Restaurantes;7;VARIABLES
28/07/2016;26/07/2016;T/ CAMP RABASSA, SA;-6,80;24962,75;24955,95;8735;-6,80;24955,95;2016-07-26;26/07/2016;CAMP;Gastos_Ocio y transporte;Vacaciones;7;VARIABLES
29/07/2016;29/07/2016;R/ AJUNTAMENT D TAXA RESIDUS CA;-52,01;24955,95;24903,94;8736;-52,01;24903,94;2016-07-29;29/07/2016;AJUNTAMENT;Gastos_Banco y organismos;Ayuntamiento;7;FIJO
29/07/2016;27/07/2016;T/ VIENA CARLEMANY;-6,90;24903,94;24897,04;8737;-6,90;24897,04;2016-07-27;27/07/2016;VIENA;Gastos_Ocio y transporte;Restaurantes;7;VARIABLES
29/07/2016;27/07/2016;T/ EL REBOST IBERIC;-32,95;24897,04;24864,09;8738;-32,95;24864,09;2016-07-27;27/07/2016;REBOST;Gastos_Ocio y transporte;Restaurantes;7;VARIABLES
29/07/2016;27/07/2016;T/ CINEMES CARLEMANY;-20,00;24864,09;24844,09;8739;-20,00;24844,09;2016-07-27;27/07/2016;CINEMES;Gastos_Ocio y transporte;Espectáculos;7;VARIABLES
29/07/2016;27/07/2016;T/ EL TURCO II;-26,30;24844,09;24817,79;8740;-26,30;24817,79;2016-07-27;27/07/2016;TURCO;Gastos_Ocio y transporte;Restaurantes;7;VARIABLES
30/07/2016;28/07/2016;T/ HOTEL COMPTES D URGELL;-14,00;24817,79;24803,79;8741;-14,00;24803,79;2016-07-28;28/07/2016;HOTEL;Gastos_Ocio y transporte;Vacaciones;7;VARIABLES
30/07/2016;28/07/2016;T/ E.S CEPSA L OBAC;-13,16;24803,79;24790,63;8742;-13,16;24790,63;2016-07-28;28/07/2016;CEPSA;Gastos_Ocio y transporte;Gasolina;7;VARIABLES
30/07/2016;28/07/2016;T/ AUTOPISTAS TERR;-4,22;24790,63;24786,41;8743;-4,22;24786,41;2016-07-28;28/07/2016;AUTOPISTAS;Gastos_Ocio y transporte;Parking y peaje;7;VARIABLES
30/07/2016;01/08/2016;INT. 210560613010013266;0,31;24786,41;24786,72;8744;0,31;24786,72;2016-08-01;01/08/2016;INT;Ingresos;Rendimientos;8;
30/07/2016;01/08/2016;RET.REND.CAP.M;-0,06;24786,72;24786,66;8745;-0,06;24786,66;2016-08-01;01/08/2016;RETRENDCAPM;Gastos_Banco y organismos;Impuestos;8;FIJO
31/07/2016;31/07/2016;REC. 6061.9600001223;-514,31;24786,66;24272,35;8746;-514,31;24272,35;2016-07-31;31/07/2016;REC;Gastos_Banco y organismos;Hipoteca;7;FIJO
31/07/2016;31/07/2016;T/ PARC VALLES \ 28-07-2016;-22,02;24272,35;24250,33;8747;-22,02;24250,33;2016-07-28;28/07/2016;PARC;Gastos_Compras;Supermercado;7;VARIABLES
31/07/2016;31/07/2016;FACT TARJETAS TARJ.CREDITO 07126017 16-08-01;-104,97;24250,33;24145,36;8748;-104,97;24145,36;2016-08-01;31/07/2016;FACT 07126017;Gastos_Banco y organismos;Credito Bea;7;VARIABLE
31/07/2016;31/07/2016;FACT TARJETAS TARJ.CREDITO 42689013 16-08-01;-941,81;24145,36;23203,55;8749;-941,81;23203,55;2016-08-01;31/07/2016;FACT;No computable;Recibo Tarjeta;7;
01/08/2016;01/08/2016;O/ GENERALITAT DE CATALUNYA-BENES;372,17;23203,55;23575,72;8750;372,17;23575,72;2016-08-01;01/08/2016;GENERALITAT;Ingresos;Subvenciones;8;
01/08/2016;01/08/2016;LIMPIEZA;-130,00;23575,72;23445,72;8751;-130,00;23445,72;2016-08-01;01/08/2016;LIMPIEZA;Gastos_Vivienda y vehiculo;Serv. domestico;8;FIJO
02/08/2016;02/08/2016;COM. 64970028 SVRED CAJ OFI;-2,00;23445,72;23443,72;8752;-2,00;23443,72;2016-08-02;02/08/2016;COM;Gastos_Banco y organismos;Cargos banco;8;FIJO
02/08/2016;30/07/2016;T/ AUTOPISTAS TERR;-2,51;23443,72;23441,21;8753;-2,51;23441,21;2016-07-30;30/07/2016;AUTOPISTAS;Gastos_Ocio y transporte;Parking y peaje;7;VARIABLES
02/08/2016;02/08/2016;T/ PORTAVENTURA REST\V 30-07-2016;-10,85;23441,21;23430,36;8754;-10,85;23430,36;2016-07-30;30/07/2016;PORTAVENTURA;Gastos_Ocio y transporte;Vacaciones;7;VARIABLES
02/08/2016;02/08/2016;T/ PORTAVENTURA \V 30-07-2016;-33,80;23430,36;23396,56;8755;-33,80;23396,56;2016-07-30;30/07/2016;PORTAVENTURA;Gastos_Ocio y transporte;Vacaciones;7;VARIABLES
02/08/2016;02/08/2016;T/ PORT AVENTURA TIE\V 30-07-2016;-15,00;23396,56;23381,56;8756;-15,00;23381,56;2016-07-30;30/07/2016;PORT;Gastos_Ocio y transporte;Vacaciones;7;VARIABLES
02/08/2016;02/08/2016;T/ E.S. RUBI II 30-07-2016;-19,41;23381,56;23362,15;8757;-19,41;23362,15;2016-07-30;30/07/2016;RUBI;Gastos_Ocio y transporte;Gasolina;7;VARIABLES
02/08/2016;02/08/2016;T/ PORTAVENTURA REST\V 30-07-2016;-8,85;23362,15;23353,30;8758;-8,85;23353,30;2016-07-30;30/07/2016;PORTAVENTURA;Gastos_Ocio y transporte;Vacaciones;7;VARIABLES
02/08/2016;02/08/2016;CAJ. AJENO CAIXABANK \XERTA;-170,00;23353,30;23183,30;8759;-170,00;23183,30;2016-08-02;02/08/2016;CAJ;Gastos_Gastos varios;Efectivo;8;VARIABLES
03/08/2016;03/08/2016;T/ PORTAVENTURA REST\V 31-07-2016;-8,90;23183,30;23174,40;8760;-8,90;23174,40;2016-07-31;31/07/2016;PORTAVENTURA;Gastos_Ocio y transporte;Vacaciones;7;VARIABLES
03/08/2016;03/08/2016;T/ PORTAVENTURA REST\V 31-07-2016;-35,40;23174,40;23139,00;8761;-35,40;23139,00;2016-07-31;31/07/2016;PORTAVENTURA;Gastos_Ocio y transporte;Vacaciones;7;VARIABLES
03/08/2016;03/08/2016;T/ PORT AVENTURA TIE\V 31-07-2016;-2,90;23139,00;23136,10;8762;-2,90;23136,10;2016-07-31;31/07/2016;PORT;Gastos_Ocio y transporte;Vacaciones;7;VARIABLES
03/08/2016;03/08/2016;T/ PORTAVENTURA REST\V 31-07-2016;-3,60;23136,10;23132,50;8763;-3,60;23132,50;2016-07-31;31/07/2016;PORTAVENTURA;Gastos_Ocio y transporte;Vacaciones;7;VARIABLES
03/08/2016;03/08/2016;T/ PORTAVENTURA REST\V 31-07-2016;-2,90;23132,50;23129,60;8764;-2,90;23129,60;2016-07-31;31/07/2016;PORTAVENTURA;Gastos_Ocio y transporte;Vacaciones;7;VARIABLES
04/08/2016;04/08/2016;R/ BLITZ 40, S. Alquiler mes en c;-72,50;23129,60;23057,10;8765;-72,50;23057,10;2016-08-04;04/08/2016;BLITZ;Gastos_Vivienda y vehiculo;Alquiler Parking;8;FIJO
04/08/2016;04/08/2016;T/ PORTAVENTURA \V 01-08-2016;-30,50;23057,10;23026,60;8766;-30,50;23026,60;2016-08-01;01/08/2016;PORTAVENTURA;Gastos_Ocio y transporte;Vacaciones;8;VARIABLES
04/08/2016;04/08/2016;T/ PORTAVENTURA REST\V 01-08-2016;-7,30;23026,60;23019,30;8767;-7,30;23019,30;2016-08-01;01/08/2016;PORTAVENTURA;Gastos_Ocio y transporte;Vacaciones;8;VARIABLES
04/08/2016;04/08/2016;T/ LIDL VILA SECA \V 01-08-2016;-9,61;23019,30;23009,69;8768;-9,61;23009,69;2016-08-01;01/08/2016;LIDL;Gastos_Compras;Supermercado;8;VARIABLES
04/08/2016;04/08/2016;T/ PORTAVENTURA REST\V 01-08-2016;-2,90;23009,69;23006,79;8769;-2,90;23006,79;2016-08-01;01/08/2016;PORTAVENTURA;Gastos_Ocio y transporte;Vacaciones;8;VARIABLES
04/08/2016;04/08/2016;T/ PORTAVENTURA REST\V 01-08-2016;-3,20;23006,79;23003,59;8770;-3,20;23003,59;2016-08-01;01/08/2016;PORTAVENTURA;Gastos_Ocio y transporte;Vacaciones;8;VARIABLES
04/08/2016;04/08/2016;T/ PORTAVENTURA REST\V 01-08-2016;-2,90;23003,59;23000,69;8771;-2,90;23000,69;2016-08-01;01/08/2016;PORTAVENTURA;Gastos_Ocio y transporte;Vacaciones;8;VARIABLES
04/08/2016;02/08/2016;T/ A.C.E.S.A B MART -S 30-07-2016;-10,55;23000,69;22990,14;8772;-10,55;22990,14;2016-07-30;30/07/2016;ACESA;Gastos_Ocio y transporte;Parking y peaje;7;VARIABLES
05/08/2016;05/08/2016;R/ SEGUROS ADESLAS CENT MODULAR CO;-113,89;22990,14;22876,25;8773;-113,89;22876,25;2016-08-05;05/08/2016;ADESLAS;Gastos_Salud, saber y deporte;Medico;8;VARIABLES
05/08/2016;27/07/2016;T/ PARKING PRAT DEL RI 24-07-2016;-3,00;22876,25;22873,25;8774;-3,00;22873,25;2016-07-24;24/07/2016;PARKING;Gastos_Ocio y transporte;Parking y peaje;7;VARIABLES
06/08/2016;06/08/2016;T/ CINES OSCAR \ 03-08-2016;-11,70;22873,25;22861,55;8775;-11,70;22861,55;2016-08-03;03/08/2016;CINES;Gastos_Ocio y transporte;Espectáculos;8;VARIABLES
06/08/2016;06/08/2016;T/ CINES OSCAR \ 03-08-2016;-6,96;22861,55;22854,59;8776;-6,96;22854,59;2016-08-03;03/08/2016;CINES;Gastos_Ocio y transporte;Espectáculos;8;VARIABLES
08/08/2016;08/08/2016;T/ MERCADONA TORTOSA 05-08-2016;-24,79;22854,59;22829,80;8777;-24,79;22829,80;2016-08-05;05/08/2016;MERCADONA;Gastos_Compras;Supermercado;8;VARIABLES
08/08/2016;08/08/2016;T/ DECATHLON TORTOSA 05-08-2016;-20,96;22829,80;22808,84;8778;-20,96;22808,84;2016-08-05;05/08/2016;DECATHLON;Gastos_Compras;Deportivo;8;VARIABLES
08/08/2016;08/08/2016;T/ ALDI TORTOSA TDA 05-08-2016;-20,09;22808,84;22788,75;8779;-20,09;22788,75;2016-08-05;05/08/2016;ALDI;Gastos_Compras;Supermercado;8;VARIABLES
10/08/2016;10/08/2016;R/ LUZ ENDESA ENERG FACTURA DE ELE;-51,36;22788,75;22737,39;8780;-51,36;22737,39;2016-08-10;10/08/2016;ELE;Gastos_Servicios tipicos;Electricidad;8;FIJO
10/08/2016;10/08/2016;R/ LUZ ENDESA ENERG FACTURA DE GAS;-67,95;22737,39;22669,44;8781;-67,95;22669,44;2016-08-10;10/08/2016;GAS;Gastos_Servicios tipicos;Gas;8;FIJO
10/08/2016;10/08/2016;T/ CINES OSCAR \ 07-08-2016;-40,50;22669,44;22628,94;8782;-40,50;22628,94;2016-08-07;07/08/2016;CINES;Gastos_Ocio y transporte;Espectáculos;8;VARIABLES
12/08/2016;12/08/2016;R/ LUZ IBERDROLA CL IBERDROLA OTRO;-10,79;22628,94;22618,15;8783;-10,79;22618,15;2016-08-12;12/08/2016;LUZ;Gastos_Servicios tipicos;Electricidad;8;FIJO
16/08/2016;16/08/2016;R/ EMTE SERVICE Factura GB16-0655;-73,54;22618,15;22544,61;8784;-73,54;22544,61;2016-08-16;16/08/2016;EMTE;Gastos_Servicios tipicos;Otros servicios;8;VARIABLES
16/08/2016;16/08/2016;R/ SEGUROS CCM VIDA Y P Recibo:138;-21,97;22544,61;22522,64;8785;-21,97;22522,64;2016-08-16;16/08/2016;CCM;Gastos_Seguros;Seguro vida;8;FIJO
16/08/2016;16/08/2016;R/ SEGUROS CCM VIDA Y P Recibo:138;-16,99;22522,64;22505,65;8786;-16,99;22505,65;2016-08-16;16/08/2016;CCM;Gastos_Seguros;Seguro vida;8;FIJO
17/08/2016;17/08/2016;R/ TELEFONO Vodafone Ono ONOAU16-0;-155,91;22505,65;22349,74;8787;-155,91;22349,74;2016-08-17;17/08/2016;TELEFONO;Gastos_Servicios tipicos;Telecomunicaciones;8;FIJO
17/08/2016;15/08/2016;T/ AUTOPISTAS TERR;-2,51;22349,74;22347,23;8788;-2,51;22347,23;2016-08-15;15/08/2016;AUTOPISTAS;Gastos_Ocio y transporte;Parking y peaje;8;VARIABLES
17/08/2016;17/08/2016;T/ CATEDRAL DEL V\EL P 14-08-2016;-32,50;22347,23;22314,73;8789;-32,50;22314,73;2016-08-14;14/08/2016;CATEDRAL;Gastos_Ocio y transporte;Restaurantes;8;VARIABLES
17/08/2016;17/08/2016;T/ TEMPS DE TERRA 14-08-2016;-70,00;22314,73;22244,73;8790;-70,00;22244,73;2016-08-14;14/08/2016;TEMPS;Gastos_Ocio y transporte;Restaurantes;8;VARIABLES
18/08/2016;18/08/2016;T/ REDPIZZA \ 15-08-2016;-13,95;22244,73;22230,78;8791;-13,95;22230,78;2016-08-15;15/08/2016;REDPIZZA;Gastos_Ocio y transporte;Restaurantes;8;VARIABLES
18/08/2016;18/08/2016;T/ TEMPLE 15-08-2016;-25,18;22230,78;22205,60;8792;-25,18;22205,60;2016-08-15;15/08/2016;TEMPLE;Gastos_Ocio y transporte;Gasolina;8;VARIABLES
19/08/2016;18/08/2016;T/ AUTOPISTA MARE NOST 15-08-2016;-7,10;22205,60;22198,50;8793;-7,10;22198,50;2016-08-15;15/08/2016;AUTOPISTA;Gastos_Ocio y transporte;Parking y peaje;8;VARIABLES
19/08/2016;18/08/2016;T/ A.C.E.S.A LIM SCAP7 15-08-2016;-10,55;22198,50;22187,95;8794;-10,55;22187,95;2016-08-15;15/08/2016;ACESA;Gastos_Ocio y transporte;Parking y peaje;8;VARIABLES
20/08/2016;20/08/2016;CAJ. AJENO SERVIRED \XERTA;-150,00;22187,95;22037,95;8795;-150,00;22037,95;2016-08-20;20/08/2016;CAJ;Gastos_Gastos varios;Efectivo;8;VARIABLES
20/08/2016;20/08/2016;COM. 64970028 SVRED CAJ OFI;-1,87;22037,95;22036,08;8796;-1,87;22036,08;2016-08-20;20/08/2016;COM;Gastos_Banco y organismos;Cargos banco;8;FIJO
23/08/2016;21/08/2016;T/ AUTOPISTAS TERR;-2,51;22036,08;22033,57;8797;-2,51;22033,57;2016-08-21;21/08/2016;AUTOPISTAS;Gastos_Ocio y transporte;Parking y peaje;8;VARIABLES
24/08/2016;24/08/2016;O/ GAS NATURAL SERVICIOS S.A GNS2;44,42;22033,57;22077,99;8798;44,42;22077,99;2016-08-24;24/08/2016;GAS;Gastos_Servicios tipicos;Gas;8;FIJO
24/08/2016;24/08/2016;T/ AUTOPISTA MARE NOST 21-08-2016;-7,10;22077,99;22070,89;8799;-7,10;22070,89;2016-08-21;21/08/2016;AUTOPISTA;Gastos_Ocio y transporte;Parking y peaje;8;VARIABLES
24/08/2016;24/08/2016;T/ A.C.E.S.A LIM SCAP7 21-08-2016;-10,55;22070,89;22060,34;8800;-10,55;22060,34;2016-08-21;21/08/2016;ACESA;Gastos_Ocio y transporte;Parking y peaje;8;VARIABLES
24/08/2016;24/08/2016;T/ TEMPLE 21-08-2016;-45,92;22060,34;22014,42;8801;-45,92;22014,42;2016-08-21;21/08/2016;TEMPLE;Gastos_Ocio y transporte;Gasolina;8;VARIABLES
24/08/2016;24/08/2016;T/ REDPIZZA \ 21-08-2016;-17,65;22014,42;21996,77;8802;-17,65;21996,77;2016-08-21;21/08/2016;REDPIZZA;Gastos_Ocio y transporte;Restaurantes;8;VARIABLES
25/08/2016;25/08/2016;T/ LIDL TERRASSA LES \ 22-08-2016;-17,05;21996,77;21979,72;8803;-17,05;21979,72;2016-08-22;22/08/2016;LIDL;Gastos_Compras;Supermercado;8;VARIABLES
25/08/2016;25/08/2016;T/ CAFET.C T PRAT\PRAT 22-08-2016;-4,50;21979,72;21975,22;8804;-4,50;21975,22;2016-08-22;22/08/2016;CAFETC;Gastos_Ocio y transporte;Restaurantes;8;VARIABLES
25/08/2016;25/08/2016;T/ IKEA REST. SABADEL\ 22-08-2016;-16,90;21975,22;21958,32;8805;-16,90;21958,32;2016-08-22;22/08/2016;IKEA;Gastos_Vivienda y vehiculo;Mnto. hogar;8;VARIABLES
25/08/2016;25/08/2016;T/ IKEA REST. SABADEL\ 22-08-2016;-6,55;21958,32;21951,77;8806;-6,55;21951,77;2016-08-22;22/08/2016;IKEA;Gastos_Vivienda y vehiculo;Mnto. hogar;8;VARIABLES
25/08/2016;25/08/2016;T/ CAFET.C T PRAT\PRAT 22-08-2016;-2,90;21951,77;21948,87;8807;-2,90;21948,87;2016-08-22;22/08/2016;CAFETC;Gastos_Ocio y transporte;Restaurantes;8;VARIABLES
25/08/2016;25/08/2016;T/ IKEA SABADELL \ 22-08-2016;-42,71;21948,87;21906,16;8808;-42,71;21906,16;2016-08-22;22/08/2016;IKEA;Gastos_Vivienda y vehiculo;Mnto. hogar;8;VARIABLES
25/08/2016;25/08/2016;T/ IKEA REST. SABADEL\ 22-08-2016;-7,99;21906,16;21898,17;8809;-7,99;21898,17;2016-08-22;22/08/2016;IKEA;Gastos_Vivienda y vehiculo;Mnto. hogar;8;VARIABLES
26/08/2016;26/08/2016;HAB. FOMENT DE TERRASSA S.A. Transf;2454,31;21898,17;24352,48;8810;2454,31;24352,48;2016-08-26;26/08/2016;HAB;Ingresos;Nomina;8;FIJO
26/08/2016;24/08/2016;T/ AUTOPISTAS TERR;-1,38;24352,48;24351,10;8811;-1,38;24351,10;2016-08-24;24/08/2016;AUTOPISTAS;Gastos_Ocio y transporte;Parking y peaje;8;VARIABLES
26/08/2016;26/08/2016;T/ HIPOPOTAMO \ 23-08-2016;-15,90;24351,10;24335,20;8812;-15,90;24335,20;2016-08-23;23/08/2016;HIPOPOTAMO;Gastos_Compras;Otras compras;8;VARIABLES
26/08/2016;26/08/2016;T/ ALDI TERRASSA LES \ 23-08-2016;-29,64;24335,20;24305,56;8813;-29,64;24305,56;2016-08-23;23/08/2016;ALDI;Gastos_Compras;Supermercado;8;VARIABLES
26/08/2016;26/08/2016;T/ CAFET.C T PRAT\PRAT 23-08-2016;-3,00;24305,56;24302,56;8814;-3,00;24302,56;2016-08-23;23/08/2016;CAFETC;Gastos_Ocio y transporte;Restaurantes;8;VARIABLES
26/08/2016;26/08/2016;T/ VIENA PARC VALLES \ 23-08-2016;-23,95;24302,56;24278,61;8815;-23,95;24278,61;2016-08-23;23/08/2016;VIENA;Gastos_Ocio y transporte;Restaurantes;8;VARIABLES
28/08/2016;28/08/2016;T/ IKEA SABADELL \ 25-08-2016;-46,41;24278,61;24232,20;8816;-46,41;24232,20;2016-08-25;25/08/2016;IKEA;Gastos_Vivienda y vehiculo;Mnto. hogar;8;VARIABLES
29/08/2016;29/08/2016;HAB. INFORMACIO I TECNOLOGIA DE CAT;1615,93;24232,20;25848,13;8817;1615,93;25848,13;2016-08-29;29/08/2016;HAB;Ingresos;Nomina;8;FIJO
29/08/2016;29/08/2016;T/ CAFET.C T PRAT\PRAT 26-08-2016;-3,65;25848,13;25844,48;8818;-3,65;25844,48;2016-08-26;26/08/2016;CAFETC;Gastos_Ocio y transporte;Restaurantes;8;VARIABLES
29/08/2016;29/08/2016;T/ LIDL TERRASSA LES \ 26-08-2016;-29,78;25844,48;25814,70;8819;-29,78;25814,70;2016-08-26;26/08/2016;LIDL;Gastos_Compras;Supermercado;8;VARIABLES
31/08/2016;31/08/2016;REC. 6061.9600001223;-514,31;25814,70;25300,39;8820;-514,31;25300,39;2016-08-31;31/08/2016;REC;Gastos_Banco y organismos;Hipoteca;8;FIJO
31/08/2016;29/08/2016;T/ AUTOPISTAS TERR;-1,38;25300,39;25299,01;8821;-1,38;25299,01;2016-08-29;29/08/2016;AUTOPISTAS;Gastos_Ocio y transporte;Parking y peaje;8;VARIABLES
31/08/2016;31/08/2016;ENTR.ANT.PTMO 6061.9600001223 U;-5000,00;25299,01;20299,01;8822;-5000,00;20299,01;2016-08-31;31/08/2016;ENTRANTPTMO;Gastos_Banco y organismos;Hipoteca;8;FIJO
31/08/2016;01/09/2016;INT. 210560613010013266;0,30;20299,01;20299,31;8823;0,30;20299,31;2016-09-01;01/09/2016;INT;Ingresos;Rendimientos;9;
31/08/2016;01/09/2016;RET.REND.CAP.M;-0,06;20299,31;20299,25;8824;-0,06;20299,25;2016-09-01;01/09/2016;RETRENDCAPM;Gastos_Banco y organismos;Impuestos;9;FIJO
31/08/2016;31/08/2016;FACT TARJETAS TARJ.CREDITO 07126017 16-09-01;-437,57;20299,25;19861,68;8825;-437,57;19861,68;2016-09-01;31/08/2016;FACT 07126017;Gastos_Banco y organismos;Credito Bea;8;VARIABLE
31/08/2016;31/08/2016;FACT TARJETAS TARJ.CREDITO 42689013 16-09-01;-606,45;19861,68;19255,23;8826;-606,45;19255,23;2016-09-01;31/08/2016;FACT;No computable;Recibo Tarjeta;8;
01/09/2016;01/09/2016;CAJ. AJENO SERVIRED \PRAT DE LLOBR;-100,00;19255,23;19155,23;8827;-100,00;19155,23;2016-09-01;01/09/2016;CAJ;Gastos_Gastos varios;Efectivo;9;VARIABLES
01/09/2016;01/09/2016;COM. 64970028 SVRED CAJ OFI;-1,87;19155,23;19153,36;8828;-1,87;19153,36;2016-09-01;01/09/2016;COM;Gastos_Banco y organismos;Cargos banco;9;FIJO
01/09/2016;01/09/2016;T/ CAFET.C T PRAT\PRAT 29-08-2016;-3,00;19153,36;19150,36;8829;-3,00;19150,36;2016-08-29;29/08/2016;CAFETC;Gastos_Ocio y transporte;Restaurantes;8;VARIABLES
01/09/2016;01/09/2016;T/ VIENA PARC VALLES \ 29-08-2016;-21,55;19150,36;19128,81;8830;-21,55;19128,81;2016-08-29;29/08/2016;VIENA;Gastos_Ocio y transporte;Restaurantes;8;VARIABLES
01/09/2016;01/09/2016;LIMPIEZA;-130,00;19128,81;18998,81;8831;-130,00;18998,81;2016-09-01;01/09/2016;LIMPIEZA;Gastos_Vivienda y vehiculo;Serv. domestico;9;FIJO
02/09/2016;02/09/2016;R/ LUZ IBERDROLA CL IBERDROLA ELEC;-7,18;18998,81;18991,63;8832;-7,18;18991,63;2016-09-02;02/09/2016;LUZ;Gastos_Servicios tipicos;Electricidad;9;FIJO
02/09/2016;02/09/2016;T/ AUTOPISTAS TERR 30-08-2016;-1,38;18991,63;18990,25;8833;-1,38;18990,25;2016-08-30;30/08/2016;AUTOPISTAS;Gastos_Ocio y transporte;Parking y peaje;8;VARIABLES
03/09/2016;03/09/2016;T/ CAFET.C T PRAT\PRAT 31-08-2016;-4,10;18990,25;18986,15;8834;-4,10;18986,15;2016-08-31;31/08/2016;CAFETC;Gastos_Ocio y transporte;Restaurantes;8;VARIABLES
03/09/2016;03/09/2016;T/ AUTOPISTAS TERR 31-08-2016;-1,38;18986,15;18984,77;8835;-1,38;18984,77;2016-08-31;31/08/2016;AUTOPISTAS;Gastos_Ocio y transporte;Parking y peaje;8;VARIABLES
03/09/2016;03/09/2016;T/ FRANKFURT LES LLET\ 31-08-2016;-4,70;18984,77;18980,07;8836;-4,70;18980,07;2016-08-31;31/08/2016;FRANKFURT;Gastos_Ocio y transporte;Restaurantes;8;VARIABLES
03/09/2016;03/09/2016;T/ AUTOPISTAS TERR 31-08-2016;-1,38;18980,07;18978,69;8837;-1,38;18978,69;2016-08-31;31/08/2016;AUTOPISTAS;Gastos_Ocio y transporte;Parking y peaje;8;VARIABLES
04/09/2016;04/09/2016;T/ MONALISA \ 01-09-2016;-70,00;18978,69;18908,69;8838;-70,00;18908,69;2016-09-01;01/09/2016;MONALISA;Gastos_Salud, saber y deporte;Belleza;9;VARIABLES
04/09/2016;04/09/2016;T/ CAPRABO \ 01-09-2016;-4,99;18908,69;18903,70;8839;-4,99;18903,70;2016-09-01;01/09/2016;CAPRABO;Gastos_Compras;Supermercado;9;VARIABLES
04/09/2016;04/09/2016;T/ FRANKFURT LES LLET\ 01-09-2016;-4,00;18903,70;18899,70;8840;-4,00;18899,70;2016-09-01;01/09/2016;FRANKFURT;Gastos_Ocio y transporte;Restaurantes;9;VARIABLES
04/09/2016;04/09/2016;T/ TOCINERIES VENTURA\ 01-09-2016;-13,92;18899,70;18885,78;8841;-13,92;18885,78;2016-09-01;01/09/2016;TOCINERIES;Gastos_Compras;Supermercado;9;VARIABLES
05/09/2016;05/09/2016;R/ SEGUROS ADESLAS CENT MODULAR CO;-113,89;18885,78;18771,89;8842;-113,89;18771,89;2016-09-05;05/09/2016;ADESLAS;Gastos_Salud, saber y deporte;Medico;9;VARIABLES
06/09/2016;06/09/2016;R/ BLITZ 40, S. Alquiler mes en c;-72,50;18771,89;18699,39;8843;-72,50;18699,39;2016-09-06;06/09/2016;BLITZ;Gastos_Vivienda y vehiculo;Alquiler Parking;9;FIJO
06/09/2016;04/09/2016;T/ AUTOPISTAS TERR 01-09-2016;-1,38;18699,39;18698,01;8844;-1,38;18698,01;2016-09-01;01/09/2016;AUTOPISTAS;Gastos_Ocio y transporte;Parking y peaje;9;VARIABLES
08/09/2016;08/09/2016;T/ CAFET.C T PRAT\PRAT 05-09-2016;-3,65;18698,01;18694,36;8845;-3,65;18694,36;2016-09-05;05/09/2016;CAFETC;Gastos_Ocio y transporte;Restaurantes;9;VARIABLES
09/09/2016;09/09/2016;CAJ. AJENO SISTEMA 4B \TERRASSA;-70,00;18694,36;18624,36;8846;-70,00;18624,36;2016-09-09;09/09/2016;CAJ;Gastos_Gastos varios;Efectivo;9;VARIABLES
09/09/2016;09/09/2016;COM. 64970028 4b CAJ4 OFI9376;-1,85;18624,36;18622,51;8847;-1,85;18622,51;2016-09-09;09/09/2016;COM;Gastos_Banco y organismos;Cargos banco;9;FIJO
09/09/2016;09/09/2016;T/ RODELAS PERRUQUERS\ 06-09-2016;-20,00;18622,51;18602,51;8848;-20,00;18602,51;2016-09-06;06/09/2016;RODELAS;Gastos_Salud, saber y deporte;Belleza;9;VARIABLES
09/09/2016;09/09/2016;T/ IKEA REST. SABADEL\ 06-09-2016;-4,95;18602,51;18597,56;8849;-4,95;18597,56;2016-09-06;06/09/2016;IKEA;Gastos_Vivienda y vehiculo;Mnto. hogar;9;VARIABLES
09/09/2016;09/09/2016;T/ FRANKFURT LES LLET\ 06-09-2016;-2,70;18597,56;18594,86;8850;-2,70;18594,86;2016-09-06;06/09/2016;FRANKFURT;Gastos_Ocio y transporte;Restaurantes;9;VARIABLES
09/09/2016;09/09/2016;CAJ. AJENO SERVIRED \TERRASSA;-60,00;18594,86;18534,86;8851;-60,00;18534,86;2016-09-09;09/09/2016;CAJ;Gastos_Gastos varios;Efectivo;9;VARIABLES
09/09/2016;09/09/2016;COM. 76985025 SVRED CAJ OFI;-1,87;18534,86;18532,99;8852;-1,87;18532,99;2016-09-09;09/09/2016;COM;Gastos_Banco y organismos;Cargos banco;9;FIJO
10/09/2016;10/09/2016;T/ AUTOPISTAS TERR 07-09-2016;-1,38;18532,99;18531,61;8853;-1,38;18531,61;2016-09-07;07/09/2016;AUTOPISTAS;Gastos_Ocio y transporte;Parking y peaje;9;VARIABLES
10/09/2016;10/09/2016;T/ FRANKFURT LES LLET\ 07-09-2016;-2,70;18531,61;18528,91;8854;-2,70;18528,91;2016-09-07;07/09/2016;FRANKFURT;Gastos_Ocio y transporte;Restaurantes;9;VARIABLES
11/09/2016;11/09/2016;T/ CAFET.C T PRAT\PRAT 08-09-2016;-3,15;18528,91;18525,76;8855;-3,15;18525,76;2016-09-08;08/09/2016;CAFETC;Gastos_Ocio y transporte;Restaurantes;9;VARIABLES
11/09/2016;11/09/2016;T/ AUTOPISTAS TERR 08-09-2016;-1,38;18525,76;18524,38;8856;-1,38;18524,38;2016-09-08;08/09/2016;AUTOPISTAS;Gastos_Ocio y transporte;Parking y peaje;9;VARIABLES
11/09/2016;11/09/2016;T/ FRANKFURT LES LLET\ 08-09-2016;-4,85;18524,38;18519,53;8857;-4,85;18519,53;2016-09-08;08/09/2016;FRANKFURT;Gastos_Ocio y transporte;Restaurantes;9;VARIABLES
11/09/2016;11/09/2016;T/ AUTOPISTAS TERR 08-09-2016;-1,38;18519,53;18518,15;8858;-1,38;18518,15;2016-09-08;08/09/2016;AUTOPISTAS;Gastos_Ocio y transporte;Parking y peaje;9;VARIABLES
11/09/2016;11/09/2016;T/ CINESA PARC VALLES\ 08-09-2016;-19,80;18518,15;18498,35;8859;-19,80;18498,35;2016-09-08;08/09/2016;CINESA;Gastos_Ocio y transporte;Espectáculos;9;VARIABLES
11/09/2016;11/09/2016;T/ TOCINERIES VENTURA\ 08-09-2016;-19,78;18498,35;18478,57;8860;-19,78;18478,57;2016-09-08;08/09/2016;TOCINERIES;Gastos_Compras;Supermercado;9;VARIABLES
11/09/2016;11/09/2016;T/ CINESA PARC VALLES\ 08-09-2016;-20,10;18478,57;18458,47;8861;-20,10;18458,47;2016-09-08;08/09/2016;CINESA;Gastos_Ocio y transporte;Espectáculos;9;VARIABLES
12/09/2016;12/09/2016;R/ GAS GAS NATURAL GNS27630480916;-4,57;18458,47;18453,90;8862;-4,57;18453,90;2016-09-12;12/09/2016;GAS;Gastos_Servicios tipicos;Gas;9;FIJO
12/09/2016;12/09/2016;S/OR. ESCOLA DE NATURA;-150,00;18453,90;18303,90;8863;-150,00;18303,90;2016-09-12;12/09/2016;ESCOLA;Gastos_Salud, saber y deporte;Estudios;9;VARIABLES
12/09/2016;12/09/2016;S/OR. ESCOLA SALA I BADRINAS;-222,00;18303,90;18081,90;8864;-222,00;18081,90;2016-09-12;12/09/2016;ESCOLA;Gastos_Salud, saber y deporte;Estudios;9;VARIABLES
12/09/2016;12/09/2016;S/OR. ESCOLA SALA I BADRINAS;-197,00;18081,90;17884,90;8865;-197,00;17884,90;2016-09-12;12/09/2016;ESCOLA;Gastos_Salud, saber y deporte;Estudios;9;VARIABLES
12/09/2016;12/09/2016;COM. TRANSFERENCIAS;-2,00;17884,90;17882,90;8866;-2,00;17882,90;2016-09-12;12/09/2016;COM;Gastos_Banco y organismos;Cargos banco;9;FIJO
12/09/2016;12/09/2016;T/ VIENA TERRASSA CEN\ 09-09-2016;-10,80;17882,90;17872,10;8867;-10,80;17872,10;2016-09-09;09/09/2016;VIENA;Gastos_Ocio y transporte;Restaurantes;9;VARIABLES
12/09/2016;12/09/2016;T/ CRACK \ 09-09-2016;-6,97;17872,10;17865,13;8868;-6,97;17865,13;2016-09-09;09/09/2016;CRACK;Gastos_Compras;Otras compras;9;VARIABLES
12/09/2016;12/09/2016;T/ FRANKFURT LES LLET\ 09-09-2016;-2,70;17865,13;17862,43;8869;-2,70;17862,43;2016-09-09;09/09/2016;FRANKFURT;Gastos_Ocio y transporte;Restaurantes;9;VARIABLES
12/09/2016;12/09/2016;T/ PARKING VAPOR GRAN\ 09-09-2016;-4,15;17862,43;17858,28;8870;-4,15;17858,28;2016-09-09;09/09/2016;PARKING;Gastos_Ocio y transporte;Parking y peaje;9;VARIABLES
12/09/2016;12/09/2016;T/ FRANKFURT LES LLET\ 09-09-2016;-4,90;17858,28;17853,38;8871;-4,90;17853,38;2016-09-09;09/09/2016;FRANKFURT;Gastos_Ocio y transporte;Restaurantes;9;VARIABLES
13/09/2016;13/09/2016;T/ BON AREA 10-09-2016;-31,61;17853,38;17821,77;8872;-31,61;17821,77;2016-09-10;10/09/2016;BON;Gastos_Compras;Supermercado;9;VARIABLES
13/09/2016;13/09/2016;'T/ KINO''S BAKERY \ 10-09-2016';-9,30;17821,77;17812,47;8873;-9,30;17812,47;2016-09-10;10/09/2016;KINOS;Gastos_Ocio y transporte;Restaurantes;9;VARIABLES
13/09/2016;13/09/2016;T/ VILANOVA COMELLAS \ 10-09-2016;-40,20;17812,47;17772,27;8874;-40,20;17772,27;2016-09-10;10/09/2016;VILANOVA;Gastos_Salud, saber y deporte;Belleza;9;VARIABLES
13/09/2016;12/09/2016;T/ AUTOPISTAS TERR 09-09-2016;-1,38;17772,27;17770,89;8875;-1,38;17770,89;2016-09-09;09/09/2016;AUTOPISTAS;Gastos_Ocio y transporte;Parking y peaje;9;VARIABLES
13/09/2016;12/09/2016;T/ AUTOPISTAS TERR 09-09-2016;-1,38;17770,89;17769,51;8876;-1,38;17769,51;2016-09-09;09/09/2016;AUTOPISTAS;Gastos_Ocio y transporte;Parking y peaje;9;VARIABLES
13/09/2016;12/09/2016;T/ AUTOPISTAS TERR 09-09-2016;-1,38;17769,51;17768,13;8877;-1,38;17768,13;2016-09-09;09/09/2016;AUTOPISTAS;Gastos_Ocio y transporte;Parking y peaje;9;VARIABLES
14/09/2016;14/09/2016;R/ MINA PUBLICA AIGUES T.01A75789;-49,05;17768,13;17719,08;8878;-49,05;17719,08;2016-09-14;14/09/2016;MINA;Gastos_Servicios tipicos;Agua;9;FIJO
14/09/2016;14/09/2016;R/ LUZ IBERDROLA CL IBERDROLA OTRO;-10,79;17719,08;17708,29;8879;-10,79;17708,29;2016-09-14;14/09/2016;LUZ;Gastos_Servicios tipicos;Electricidad;9;FIJO
15/09/2016;15/09/2016;R/ LUZ IBERDROLA CL IBERDROLA ELEC;-7,18;17708,29;17701,11;8880;-7,18;17701,11;2016-09-15;15/09/2016;LUZ;Gastos_Servicios tipicos;Electricidad;9;FIJO
15/09/2016;15/09/2016;T/ AUTOPISTAS TERR 12-09-2016;-1,38;17701,11;17699,73;8881;-1,38;17699,73;2016-09-12;12/09/2016;AUTOPISTAS;Gastos_Ocio y transporte;Parking y peaje;9;VARIABLES
15/09/2016;15/09/2016;T/ CAPRABO \ 12-09-2016;-7,72;17699,73;17692,01;8882;-7,72;17692,01;2016-09-12;12/09/2016;CAPRABO;Gastos_Compras;Supermercado;9;VARIABLES
15/09/2016;15/09/2016;T/ PARC VALLES \ 12-09-2016;-27,71;17692,01;17664,30;8883;-27,71;17664,30;2016-09-12;12/09/2016;PARC;Gastos_Compras;Supermercado;9;VARIABLES
15/09/2016;15/09/2016;T/ CAFET.C T PRAT\PRAT 12-09-2016;-3,20;17664,30;17661,10;8884;-3,20;17661,10;2016-09-12;12/09/2016;CAFETC;Gastos_Ocio y transporte;Restaurantes;9;VARIABLES
16/09/2016;16/09/2016;R/ SEGUROS CCM VIDA Y P Recibo:138;-15,97;17661,10;17645,13;8885;-15,97;17645,13;2016-09-16;16/09/2016;CCM;Gastos_Seguros;Seguro vida;9;FIJO
16/09/2016;16/09/2016;R/ SEGUROS CCM VIDA Y P Recibo:138;-20,65;17645,13;17624,48;8886;-20,65;17624,48;2016-09-16;16/09/2016;CCM;Gastos_Seguros;Seguro vida;9;FIJO
16/09/2016;16/09/2016;R/ LUZ ENDESA ENERG FACTURA DE ELE;-56,52;17624,48;17567,96;8887;-56,52;17567,96;2016-09-16;16/09/2016;ELE;Gastos_Servicios tipicos;Electricidad;9;FIJO
16/09/2016;16/09/2016;T/ AUTOPISTAS TERR 13-09-2016;-1,38;17567,96;17566,58;8888;-1,38;17566,58;2016-09-13;13/09/2016;AUTOPISTAS;Gastos_Ocio y transporte;Parking y peaje;9;VARIABLES
16/09/2016;16/09/2016;T/ AUTOPISTAS TERR 13-09-2016;-1,38;17566,58;17565,20;8889;-1,38;17565,20;2016-09-13;13/09/2016;AUTOPISTAS;Gastos_Ocio y transporte;Parking y peaje;9;VARIABLES
16/09/2016;16/09/2016;T/ CAFET.C T PRAT\PRAT 13-09-2016;-3,20;17565,20;17562,00;8890;-3,20;17562,00;2016-09-13;13/09/2016;CAFETC;Gastos_Ocio y transporte;Restaurantes;9;VARIABLES
16/09/2016;16/09/2016;T/ CAPRABO \ 13-09-2016;-4,74;17562,00;17557,26;8891;-4,74;17557,26;2016-09-13;13/09/2016;CAPRABO;Gastos_Compras;Supermercado;9;VARIABLES
17/09/2016;17/09/2016;T/ CAPRABO \ 14-09-2016;-6,40;17557,26;17550,86;8892;-6,40;17550,86;2016-09-14;14/09/2016;CAPRABO;Gastos_Compras;Supermercado;9;VARIABLES
17/09/2016;17/09/2016;T/ AUTOPISTAS TERR 14-09-2016;-1,38;17550,86;17549,48;8893;-1,38;17549,48;2016-09-14;14/09/2016;AUTOPISTAS;Gastos_Ocio y transporte;Parking y peaje;9;VARIABLES
17/09/2016;17/09/2016;T/ CAFET.C T PRAT\PRAT 14-09-2016;-3,45;17549,48;17546,03;8894;-3,45;17546,03;2016-09-14;14/09/2016;CAFETC;Gastos_Ocio y transporte;Restaurantes;9;VARIABLES
18/09/2016;18/09/2016;T/ AUTOPISTAS TERR 15-09-2016;-1,38;17546,03;17544,65;8895;-1,38;17544,65;2016-09-15;15/09/2016;AUTOPISTAS;Gastos_Ocio y transporte;Parking y peaje;9;VARIABLES
18/09/2016;18/09/2016;T/ AUTOPISTAS TERR 15-09-2016;-1,38;17544,65;17543,27;8896;-1,38;17543,27;2016-09-15;15/09/2016;AUTOPISTAS;Gastos_Ocio y transporte;Parking y peaje;9;VARIABLES
18/09/2016;18/09/2016;T/ CAPRABO \ 15-09-2016;-6,98;17543,27;17536,29;8897;-6,98;17536,29;2016-09-15;15/09/2016;CAPRABO;Gastos_Compras;Supermercado;9;VARIABLES
19/09/2016;19/09/2016;R/ TELEFONO VODAFONE ONO ONOAU16-0;-120,84;17536,29;17415,45;8898;-120,84;17415,45;2016-09-19;19/09/2016;TELEFONO;Gastos_Servicios tipicos;Telecomunicaciones;9;FIJO
19/09/2016;19/09/2016;T/ RODELAS PERRUQUERS\ 16-09-2016;-15,90;17415,45;17399,55;8899;-15,90;17399,55;2016-09-16;16/09/2016;RODELAS;Gastos_Salud, saber y deporte;Belleza;9;VARIABLES
19/09/2016;19/09/2016;T/ BON AREA 16-09-2016;-8,50;17399,55;17391,05;8900;-8,50;17391,05;2016-09-16;16/09/2016;BON;Gastos_Compras;Supermercado;9;VARIABLES
19/09/2016;19/09/2016;T/ LA TERRASSETA \ 16-09-2016;-10,80;17391,05;17380,25;8901;-10,80;17380,25;2016-09-16;16/09/2016;TERRASSETA;Gastos_Ocio y transporte;Restaurantes;9;VARIABLES
19/09/2016;19/09/2016;T/ CAFET.C T PRAT\PRAT 16-09-2016;-3,65;17380,25;17376,60;8902;-3,65;17376,60;2016-09-16;16/09/2016;CAFETC;Gastos_Ocio y transporte;Restaurantes;9;VARIABLES
20/09/2016;17/09/2016;T/ CARREFOUR VALLE;-68,84;17376,60;17307,76;8903;-68,84;17307,76;2016-09-17;17/09/2016;CARREFOUR;Gastos_Compras;Supermercado;9;VARIABLES
20/09/2016;20/09/2016;T/ DECATHLON SA TERRA\ 17-09-2016;-26,05;17307,76;17281,71;8904;-26,05;17281,71;2016-09-17;17/09/2016;DECATHLON;Gastos_Compras;Deportivo;9;VARIABLES
20/09/2016;20/09/2016;T/ SATURN E515 EL\PRAT 17-09-2016;-17,98;17281,71;17263,73;8905;-17,98;17263,73;2016-09-17;17/09/2016;SATURN;Gastos_Compras;Hobbys;9;VARIABLES
20/09/2016;19/09/2016;T/ AUTOPISTAS TERR 16-09-2016;-1,38;17263,73;17262,35;8906;-1,38;17262,35;2016-09-16;16/09/2016;AUTOPISTAS;Gastos_Ocio y transporte;Parking y peaje;9;VARIABLES
20/09/2016;19/09/2016;T/ AUTOPISTAS TERR 16-09-2016;-1,38;17262,35;17260,97;8907;-1,38;17260,97;2016-09-16;16/09/2016;AUTOPISTAS;Gastos_Ocio y transporte;Parking y peaje;9;VARIABLES
21/09/2016;21/09/2016;T/ FOCS A ST JORDI \ 18-09-2016;-16,65;17260,97;17244,32;8908;-16,65;17244,32;2016-09-18;18/09/2016;FOCS;Gastos_Compras;Libreria;9;VARIABLES
21/09/2016;21/09/2016;COM. 76985025 4b CAJ4 OFI9376;-1,85;17244,32;17242,47;8909;-1,85;17242,47;2016-09-21;21/09/2016;COM;Gastos_Banco y organismos;Cargos banco;9;FIJO
21/09/2016;21/09/2016;CAJ. AJENO SISTEMA 4B \TERRASSA;-70,00;17242,47;17172,47;8910;-70,00;17172,47;2016-09-21;21/09/2016;CAJ;Gastos_Gastos varios;Efectivo;9;VARIABLES
22/09/2016;22/09/2016;R/ LUZ IBERDROLA CL IBERDROLA ELEC;-2,40;17172,47;17170,07;8911;-2,40;17170,07;2016-09-22;22/09/2016;LUZ;Gastos_Servicios tipicos;Electricidad;9;FIJO
22/09/2016;22/09/2016;T/ CAFET.C T PRAT\PRAT 19-09-2016;-0,75;17170,07;17169,32;8912;-0,75;17169,32;2016-09-19;19/09/2016;CAFETC;Gastos_Ocio y transporte;Restaurantes;9;VARIABLES
22/09/2016;22/09/2016;T/ AUTOPISTAS TERR 19-09-2016;-1,38;17169,32;17167,94;8913;-1,38;17167,94;2016-09-19;19/09/2016;AUTOPISTAS;Gastos_Ocio y transporte;Parking y peaje;9;VARIABLES
22/09/2016;22/09/2016;T/ AUTOPISTAS TERR 19-09-2016;-1,38;17167,94;17166,56;8914;-1,38;17166,56;2016-09-19;19/09/2016;AUTOPISTAS;Gastos_Ocio y transporte;Parking y peaje;9;VARIABLES
22/09/2016;22/09/2016;T/ CAFET.C T PRAT\PRAT 19-09-2016;-2,15;17166,56;17164,41;8915;-2,15;17164,41;2016-09-19;19/09/2016;CAFETC;Gastos_Ocio y transporte;Restaurantes;9;VARIABLES
23/09/2016;23/09/2016;T/ LIDL TERRASSA LES \ 20-09-2016;-31,47;17164,41;17132,94;8916;-31,47;17132,94;2016-09-20;20/09/2016;LIDL;Gastos_Compras;Supermercado;9;VARIABLES
23/09/2016;23/09/2016;T/ CAFET.C T PRAT\PRAT 20-09-2016;-3,35;17132,94;17129,59;8917;-3,35;17129,59;2016-09-20;20/09/2016;CAFETC;Gastos_Ocio y transporte;Restaurantes;9;VARIABLES
23/09/2016;23/09/2016;T/ AUTOPISTAS TERR 20-09-2016;-1,38;17129,59;17128,21;8918;-1,38;17128,21;2016-09-20;20/09/2016;AUTOPISTAS;Gastos_Ocio y transporte;Parking y peaje;9;VARIABLES
23/09/2016;23/09/2016;T/ AUTOPISTAS TERR 20-09-2016;-1,38;17128,21;17126,83;8919;-1,38;17126,83;2016-09-20;20/09/2016;AUTOPISTAS;Gastos_Ocio y transporte;Parking y peaje;9;VARIABLES
24/09/2016;24/09/2016;T/ CAFET.C T PRAT\PRAT 21-09-2016;-3,65;17126,83;17123,18;8920;-3,65;17123,18;2016-09-21;21/09/2016;CAFETC;Gastos_Ocio y transporte;Restaurantes;9;VARIABLES
24/09/2016;24/09/2016;T/ AUTOPISTAS TERR 21-09-2016;-1,38;17123,18;17121,80;8921;-1,38;17121,80;2016-09-21;21/09/2016;AUTOPISTAS;Gastos_Ocio y transporte;Parking y peaje;9;VARIABLES
24/09/2016;24/09/2016;T/ AUTOPISTAS TERR 21-09-2016;-1,38;17121,80;17120,42;8922;-1,38;17120,42;2016-09-21;21/09/2016;AUTOPISTAS;Gastos_Ocio y transporte;Parking y peaje;9;VARIABLES
24/09/2016;24/09/2016;T/ FRANKFURT LES LLET\ 21-09-2016;-10,70;17120,42;17109,72;8923;-10,70;17109,72;2016-09-21;21/09/2016;FRANKFURT;Gastos_Ocio y transporte;Restaurantes;9;VARIABLES
25/09/2016;25/09/2016;T/ CAFET.C T PRAT\PRAT 22-09-2016;-4,00;17109,72;17105,72;8924;-4,00;17105,72;2016-09-22;22/09/2016;CAFETC;Gastos_Ocio y transporte;Restaurantes;9;VARIABLES
25/09/2016;25/09/2016;T/ AUTOPISTAS TERR 22-09-2016;-1,38;17105,72;17104,34;8925;-1,38;17104,34;2016-09-22;22/09/2016;AUTOPISTAS;Gastos_Ocio y transporte;Parking y peaje;9;VARIABLES
25/09/2016;25/09/2016;T/ AUTOPISTAS TERR 22-09-2016;-1,38;17104,34;17102,96;8926;-1,38;17102,96;2016-09-22;22/09/2016;AUTOPISTAS;Gastos_Ocio y transporte;Parking y peaje;9;VARIABLES
25/09/2016;25/09/2016;T/ FRANKFURT LES LLET\ 22-09-2016;-2,70;17102,96;17100,26;8927;-2,70;17100,26;2016-09-22;22/09/2016;FRANKFURT;Gastos_Ocio y transporte;Restaurantes;9;VARIABLES
25/09/2016;25/09/2016;T/ FRANKFURT LES LLET\ 22-09-2016;-5,70;17100,26;17094,56;8928;-5,70;17094,56;2016-09-22;22/09/2016;FRANKFURT;Gastos_Ocio y transporte;Restaurantes;9;VARIABLES
25/09/2016;25/09/2016;T/ FRANKFURT LES LLET\ 22-09-2016;-12,20;17094,56;17082,36;8929;-12,20;17082,36;2016-09-22;22/09/2016;FRANKFURT;Gastos_Ocio y transporte;Restaurantes;9;VARIABLES
26/09/2016;26/09/2016;T/ CAPRABO \ 23-09-2016;-6,37;17082,36;17075,99;8930;-6,37;17075,99;2016-09-23;23/09/2016;CAPRABO;Gastos_Compras;Supermercado;9;VARIABLES
26/09/2016;26/09/2016;T/ FRANKFURT LES LLET\ 23-09-2016;-2,70;17075,99;17073,29;8931;-2,70;17073,29;2016-09-23;23/09/2016;FRANKFURT;Gastos_Ocio y transporte;Restaurantes;9;VARIABLES
27/09/2016;27/09/2016;R/ EDICIO DE PR Factura N 376496;-48,00;17073,29;17025,29;8932;-48,00;17025,29;2016-09-27;27/09/2016;EDICIO;Gastos_Compras;Libreria;9;VARIABLES
27/09/2016;27/09/2016;T/ DRIM PARC VALLES 24-09-2016;-11,99;17025,29;17013,30;8933;-11,99;17013,30;2016-09-24;24/09/2016;DRIM;Gastos_Compras;Niños;9;VARIABLES
28/09/2016;28/09/2016;HAB. FOMENT DE TERRASSA S.A. Transf;1785,88;17013,30;18799,18;8934;1785,88;18799,18;2016-09-28;28/09/2016;HAB;Ingresos;Nomina;9;FIJO
29/09/2016;29/09/2016;HAB. INFORMACIO I TECNOLOGIA DE CAT;2216,62;18799,18;21015,80;8935;2216,62;21015,80;2016-09-29;29/09/2016;HAB;Ingresos;Nomina;9;FIJO
29/09/2016;29/09/2016;T/ AUTOPISTAS TERR 26-09-2016;-1,38;21015,80;21014,42;8936;-1,38;21014,42;2016-09-26;26/09/2016;AUTOPISTAS;Gastos_Ocio y transporte;Parking y peaje;9;VARIABLES
29/09/2016;29/09/2016;T/ FRANKFURT LES LLET\ 26-09-2016;-2,70;21014,42;21011,72;8937;-2,70;21011,72;2016-09-26;26/09/2016;FRANKFURT;Gastos_Ocio y transporte;Restaurantes;9;VARIABLES
29/09/2016;29/09/2016;T/ TABASA VALLVI S. 26-09-2016;-4,16;21011,72;21007,56;8938;-4,16;21007,56;2016-09-26;26/09/2016;TABASA;Gastos_Ocio y transporte;Parking y peaje;9;VARIABLES
29/09/2016;29/09/2016;T/ AUTOPISTAS TERR 26-09-2016;-1,38;21007,56;21006,18;8939;-1,38;21006,18;2016-09-26;26/09/2016;AUTOPISTAS;Gastos_Ocio y transporte;Parking y peaje;9;VARIABLES
29/09/2016;29/09/2016;T/ CAFET.C T PRAT\PRAT 26-09-2016;-1,25;21006,18;21004,93;8940;-1,25;21004,93;2016-09-26;26/09/2016;CAFETC;Gastos_Ocio y transporte;Restaurantes;9;VARIABLES
29/09/2016;29/09/2016;T/ BON AREA 26-09-2016;-19,90;21004,93;20985,03;8941;-19,90;20985,03;2016-09-26;26/09/2016;BON;Gastos_Compras;Supermercado;9;VARIABLES
29/09/2016;23/09/2016;T/ TUNELS BARCELONA I 20-09-2016;-3,70;20985,03;20981,33;8942;-3,70;20981,33;2016-09-20;20/09/2016;TUNELS;Gastos_Ocio y transporte;Parking y peaje;9;VARIABLES
30/09/2016;30/09/2016;R/ AJUNTAMENT D I.B.I. CA D.ALBI;-45,65;20981,33;20935,68;8943;-45,65;20935,68;2016-09-30;30/09/2016;AJUNTAMENT;Gastos_Banco y organismos;Ayuntamiento;9;FIJO
30/09/2016;30/09/2016;REC. 6061.9600001223;-485,11;20935,68;20450,57;8944;-485,11;20450,57;2016-09-30;30/09/2016;REC;Gastos_Banco y organismos;Hipoteca;9;FIJO
30/09/2016;30/09/2016;T/ AUTOPISTAS TERR 27-09-2016;-1,38;20450,57;20449,19;8945;-1,38;20449,19;2016-09-27;27/09/2016;AUTOPISTAS;Gastos_Ocio y transporte;Parking y peaje;9;VARIABLES
30/09/2016;30/09/2016;T/ FRANKFURT LES LLET\ 27-09-2016;-4,85;20449,19;20444,34;8946;-4,85;20444,34;2016-09-27;27/09/2016;FRANKFURT;Gastos_Ocio y transporte;Restaurantes;9;VARIABLES
30/09/2016;30/09/2016;T/ FRANKFURT LES LLET\ 27-09-2016;-13,25;20444,34;20431,09;8947;-13,25;20431,09;2016-09-27;27/09/2016;FRANKFURT;Gastos_Ocio y transporte;Restaurantes;9;VARIABLES
30/09/2016;30/09/2016;FACT TARJETAS TARJ.CREDITO 07126017 16-10-01;-121,91;20431,09;20309,18;8948;-121,91;20309,18;2016-10-01;30/09/2016;FACT 07126017;Gastos_Banco y organismos;Credito Bea;9;VARIABLE
30/09/2016;30/09/2016;FACT TARJETAS TARJ.CREDITO 42689013 16-10-01;-452,66;20309,18;19856,52;8949;-452,66;19856,52;2016-10-01;30/09/2016;FACT;No computable;Recibo Tarjeta;9;
01/10/2016;01/10/2016;T/ CAFET.C T PRAT\PRAT 28-09-2016;-3,45;19856,52;19853,07;8950;-3,45;19853,07;2016-09-28;28/09/2016;CAFETC;Gastos_Ocio y transporte;Restaurantes;9;VARIABLES
01/10/2016;01/10/2016;T/ AUTOPISTAS TERR 28-09-2016;-1,38;19853,07;19851,69;8951;-1,38;19851,69;2016-09-28;28/09/2016;AUTOPISTAS;Gastos_Ocio y transporte;Parking y peaje;9;VARIABLES
01/10/2016;01/10/2016;T/ FRANKFURT LES LLET\ 28-09-2016;-2,70;19851,69;19848,99;8952;-2,70;19848,99;2016-09-28;28/09/2016;FRANKFURT;Gastos_Ocio y transporte;Restaurantes;9;VARIABLES
01/10/2016;01/10/2016;T/ LIDL TERRASSA LES \ 28-09-2016;-8,96;19848,99;19840,03;8953;-8,96;19840,03;2016-09-28;28/09/2016;LIDL;Gastos_Compras;Supermercado;9;VARIABLES
01/10/2016;01/10/2016;INT. 210560613010013266;0,09;19840,03;19840,12;8954;0,09;19840,12;2016-10-01;01/10/2016;INT;Ingresos;Rendimientos;10;
01/10/2016;01/10/2016;RET.REND.CAP.M;-0,02;19840,12;19840,10;8955;-0,02;19840,10;2016-10-01;01/10/2016;RETRENDCAPM;Gastos_Banco y organismos;Impuestos;10;FIJO
01/10/2016;01/10/2016;LIMPIEZA;-130,00;19840,10;19710,10;8956;-130,00;19710,10;2016-10-01;01/10/2016;LIMPIEZA;Gastos_Vivienda y vehiculo;Serv. domestico;10;FIJO
02/10/2016;02/10/2016;T/ FRANKFURT LES LLET\ 29-09-2016;-8,85;19710,10;19701,25;8957;-8,85;19701,25;2016-09-29;29/09/2016;FRANKFURT;Gastos_Ocio y transporte;Restaurantes;9;VARIABLES
02/10/2016;02/10/2016;T/ AUTOPISTAS TERR 29-09-2016;-1,38;19701,25;19699,87;8958;-1,38;19699,87;2016-09-29;29/09/2016;AUTOPISTAS;Gastos_Ocio y transporte;Parking y peaje;9;VARIABLES
02/10/2016;02/10/2016;T/ AUTOPISTAS TERR 29-09-2016;-1,38;19699,87;19698,49;8959;-1,38;19698,49;2016-09-29;29/09/2016;AUTOPISTAS;Gastos_Ocio y transporte;Parking y peaje;9;VARIABLES
02/10/2016;02/10/2016;T/ FARMA.ANGEL MORENO\ 29-09-2016;-20,95;19698,49;19677,54;8960;-20,95;19677,54;2016-09-29;29/09/2016;FARMAANGEL;Gastos_Salud, saber y deporte;Farmacia;9;VARIABLES
02/10/2016;02/10/2016;T/ AUTOPISTAS TERR 29-09-2016;-1,38;19677,54;19676,16;8961;-1,38;19676,16;2016-09-29;29/09/2016;AUTOPISTAS;Gastos_Ocio y transporte;Parking y peaje;9;VARIABLES
02/10/2016;02/10/2016;T/ CAFET.C T PRAT\PRAT 29-09-2016;-3,65;19676,16;19672,51;8962;-3,65;19672,51;2016-09-29;29/09/2016;CAFETC;Gastos_Ocio y transporte;Restaurantes;9;VARIABLES
03/10/2016;03/10/2016;T/ A RUA NOVA \EL PR 30-09-2016;-4,70;19672,51;19667,81;8963;-4,70;19667,81;2016-09-30;30/09/2016;RUA;Gastos_Ocio y transporte;Restaurantes;9;VARIABLES
03/10/2016;03/10/2016;S/OR. Integral Lara;-1000,00;19667,81;18667,81;8964;-1000,00;18667,81;2016-10-03;03/10/2016;INTEGRAL;Gastos_Vivienda y vehiculo;Otros vivienda;10;VARIABLES
04/10/2016;04/10/2016;R/ SEGUROS SEGUROS CATA INCLUIDO S;-319,02;18667,81;18348,79;8965;-319,02;18348,79;2016-10-04;04/10/2016;CATA;Gastos_Seguros;Seguro auto;10;FIJO
04/10/2016;04/10/2016;T/ COSTA COFFEE \B 01-10-2016;-3,95;18348,79;18344,84;8966;-3,95;18344,84;2016-10-01;01/10/2016;COSTA;Gastos_Ocio y transporte;Restaurantes;10;VARIABLES
04/10/2016;04/10/2016;T/ DULCINEA \B 01-10-2016;-21,70;18344,84;18323,14;8967;-21,70;18323,14;2016-10-01;01/10/2016;DULCINEA;Gastos_Ocio y transporte;Restaurantes;10;VARIABLES
04/10/2016;04/10/2016;T/ COSTA COFFEE \B 01-10-2016;-7,70;18323,14;18315,44;8968;-7,70;18315,44;2016-10-01;01/10/2016;COSTA;Gastos_Ocio y transporte;Restaurantes;10;VARIABLES
04/10/2016;03/10/2016;T/ AUTOPISTAS TERR 30-09-2016;-1,38;18315,44;18314,06;8969;-1,38;18314,06;2016-09-30;30/09/2016;AUTOPISTAS;Gastos_Ocio y transporte;Parking y peaje;9;VARIABLES
05/10/2016;05/10/2016;COM. 76985025 4b CAJ4 OFI9376;-1,85;18314,06;18312,21;8970;-1,85;18312,21;2016-10-05;05/10/2016;COM;Gastos_Banco y organismos;Cargos banco;10;FIJO
05/10/2016;05/10/2016;CAJ. AJENO SISTEMA 4B \TERRASSA;-40,00;18312,21;18272,21;8971;-40,00;18272,21;2016-10-05;05/10/2016;CAJ;Gastos_Gastos varios;Efectivo;10;VARIABLES
05/10/2016;05/10/2016;COM. 76985025 4b CAJ4 OFI9376;-1,85;18272,21;18270,36;8972;-1,85;18270,36;2016-10-05;05/10/2016;COM;Gastos_Banco y organismos;Cargos banco;10;FIJO
05/10/2016;05/10/2016;ABO.COMIS. 76985025 4b CAJ3700 OFI0511;1,85;18270,36;18272,21;8973;1,85;18272,21;2016-10-05;05/10/2016;ABOCOMIS;Ingresos;Devoluciones;10;VARIABLES
06/10/2016;06/10/2016;T/ FRANKFURT LES LLET\ 03-10-2016;-2,70;18272,21;18269,51;8974;-2,70;18269,51;2016-10-03;03/10/2016;FRANKFURT;Gastos_Ocio y transporte;Restaurantes;10;VARIABLES
06/10/2016;06/10/2016;T/ FRANKFURT LES LLET\ 03-10-2016;-2,85;18269,51;18266,66;8975;-2,85;18266,66;2016-10-03;03/10/2016;FRANKFURT;Gastos_Ocio y transporte;Restaurantes;10;VARIABLES
06/10/2016;06/10/2016;T/ BON AREA 03-10-2016;-23,20;18266,66;18243,46;8976;-23,20;18243,46;2016-10-03;03/10/2016;BON;Gastos_Compras;Supermercado;10;VARIABLES
07/10/2016;07/10/2016;T/ CAPRABO \ 04-10-2016;-12,36;18243,46;18231,10;8977;-12,36;18231,10;2016-10-04;04/10/2016;CAPRABO;Gastos_Compras;Supermercado;10;VARIABLES
07/10/2016;07/10/2016;T/ 44 MISTER MINIT PR\ 04-10-2016;-21,90;18231,10;18209,20;8978;-21,90;18209,20;2016-10-04;04/10/2016;MISTER;Gastos_Compras;Hogar;10;VARIABLES
07/10/2016;07/10/2016;T/ FRANKFURT LES LLET\ 04-10-2016;-2,70;18209,20;18206,50;8979;-2,70;18206,50;2016-10-04;04/10/2016;FRANKFURT;Gastos_Ocio y transporte;Restaurantes;10;VARIABLES
08/10/2016;08/10/2016;T/ MERCADONA QUATRE C\TERRASSA;-139,48;18206,50;18067,02;8980;-139,48;18067,02;2016-10-08;08/10/2016;MERCADONA;Gastos_Compras;Supermercado;10;VARIABLES
08/10/2016;08/10/2016;T/ SONORA SPORT TABE\B 05-10-2016;-5,15;18067,02;18061,87;8981;-5,15;18061,87;2016-10-05;05/10/2016;SONORA;Gastos_Ocio y transporte;Restaurantes;10;VARIABLES
08/10/2016;08/10/2016;T/ FRANKFURT LES LLET\ 05-10-2016;-2,70;18061,87;18059,17;8982;-2,70;18059,17;2016-10-05;05/10/2016;FRANKFURT;Gastos_Ocio y transporte;Restaurantes;10;VARIABLES
08/10/2016;08/10/2016;T/ LA TERRASSETA \ 05-10-2016;-10,00;18059,17;18049,17;8983;-10,00;18049,17;2016-10-05;05/10/2016;TERRASSETA;Gastos_Ocio y transporte;Restaurantes;10;VARIABLES
09/10/2016;09/10/2016;CAJ. AJENO SERVIRED \TARRASA/TERRA;-150,00;18049,17;17899,17;8984;-150,00;17899,17;2016-10-09;09/10/2016;CAJ;Gastos_Gastos varios;Efectivo;10;VARIABLES
09/10/2016;09/10/2016;COM. 64970028 SVRED CAJ OFI;-1,87;17899,17;17897,30;8985;-1,87;17897,30;2016-10-09;09/10/2016;COM;Gastos_Banco y organismos;Cargos banco;10;FIJO
09/10/2016;09/10/2016;T/ CINESA PARC VALLES\ 06-10-2016;-20,10;17897,30;17877,20;8986;-20,10;17877,20;2016-10-06;06/10/2016;CINESA;Gastos_Ocio y transporte;Espectáculos;10;VARIABLES
09/10/2016;09/10/2016;T/ FRANKFURT LES LLET\ 06-10-2016;-5,80;17877,20;17871,40;8987;-5,80;17871,40;2016-10-06;06/10/2016;FRANKFURT;Gastos_Ocio y transporte;Restaurantes;10;VARIABLES
09/10/2016;09/10/2016;T/ CINESA PARC VALLES\ 06-10-2016;-13,40;17871,40;17858,00;8988;-13,40;17858,00;2016-10-06;06/10/2016;CINESA;Gastos_Ocio y transporte;Espectáculos;10;VARIABLES
09/10/2016;09/10/2016;T/ REDPIZZA \ 06-10-2016;-16,45;17858,00;17841,55;8989;-16,45;17841,55;2016-10-06;06/10/2016;REDPIZZA;Gastos_Ocio y transporte;Restaurantes;10;VARIABLES
10/10/2016;10/10/2016;T/ LA TERRASSETA \ 07-10-2016;-7,90;17841,55;17833,65;8990;-7,90;17833,65;2016-10-07;07/10/2016;TERRASSETA;Gastos_Ocio y transporte;Restaurantes;10;VARIABLES
10/10/2016;10/10/2016;T/ SONORA SPORT TABE\B 07-10-2016;-4,00;17833,65;17829,65;8991;-4,00;17829,65;2016-10-07;07/10/2016;SONORA;Gastos_Ocio y transporte;Restaurantes;10;VARIABLES
10/10/2016;10/10/2016;T/ SONORA SPORT TABE\B 07-10-2016;-2,10;17829,65;17827,55;8992;-2,10;17827,55;2016-10-07;07/10/2016;SONORA;Gastos_Ocio y transporte;Restaurantes;10;VARIABLES
10/10/2016;10/10/2016;T/ BON AREA 07-10-2016;-24,29;17827,55;17803,26;8993;-24,29;17803,26;2016-10-07;07/10/2016;BON;Gastos_Compras;Supermercado;10;VARIABLES
11/10/2016;11/10/2016;R/ BLITZ 40, S. Alquiler mes en c;-72,50;17803,26;17730,76;8994;-72,50;17730,76;2016-10-11;11/10/2016;BLITZ;Gastos_Vivienda y vehiculo;Alquiler Parking;10;FIJO
11/10/2016;11/10/2016;T/ UDON PARC VALLES \ 08-10-2016;-60,75;17730,76;17670,01;8995;-60,75;17670,01;2016-10-08;08/10/2016;UDON;Gastos_Ocio y transporte;Restaurantes;10;VARIABLES
11/10/2016;11/10/2016;T/ LIDL TERRASSA LES \ 08-10-2016;-35,53;17670,01;17634,48;8996;-35,53;17634,48;2016-10-08;08/10/2016;LIDL;Gastos_Compras;Supermercado;10;VARIABLES
11/10/2016;08/10/2016;CARREFOUR-[moda];-90,42;17634,48;17544,06;8997;-90,42;17544,06;2016-10-08;08/10/2016;CARREFOURMODA;Gastos_Compras;Supermercado;10;VARIABLES
12/10/2016;12/10/2016;R/ LUZ IBERDROLA CL IBERDROLA OTRO;-10,79;17544,06;17533,27;8998;-10,79;17533,27;2016-10-12;12/10/2016;LUZ;Gastos_Servicios tipicos;Electricidad;10;FIJO
13/10/2016;13/10/2016;T/ CITY HOGAR YAOJI \ 10-10-2016;-22,28;17533,27;17510,99;8999;-22,28;17510,99;2016-10-10;10/10/2016;CITY;Gastos_Compras;Otras compras;10;VARIABLES
13/10/2016;13/10/2016;T/ CAPRABO \ 10-10-2016;-7,95;17510,99;17503,04;9000;-7,95;17503,04;2016-10-10;10/10/2016;CAPRABO;Gastos_Compras;Supermercado;10;VARIABLES
13/10/2016;13/10/2016;T/ AUTOPISTAS TERR 10-10-2016;-1,38;17503,04;17501,66;9001;-1,38;17501,66;2016-10-10;10/10/2016;AUTOPISTAS;Gastos_Ocio y transporte;Parking y peaje;10;VARIABLES
13/10/2016;13/10/2016;T/ TABASA VALLVI S. 10-10-2016;-4,16;17501,66;17497,50;9002;-4,16;17497,50;2016-10-10;10/10/2016;TABASA;Gastos_Ocio y transporte;Parking y peaje;10;VARIABLES
13/10/2016;13/10/2016;T/ AUTOPISTAS TERR 10-10-2016;-1,38;17497,50;17496,12;9003;-1,38;17496,12;2016-10-10;10/10/2016;AUTOPISTAS;Gastos_Ocio y transporte;Parking y peaje;10;VARIABLES
13/10/2016;13/10/2016;T/ VILANOVA COMELLAS \ 10-10-2016;-27,20;17496,12;17468,92;9004;-27,20;17468,92;2016-10-10;10/10/2016;VILANOVA;Gastos_Salud, saber y deporte;Belleza;10;VARIABLES
13/10/2016;13/10/2016;T/ CAFET.C T PRAT\PRAT 10-10-2016;-3,65;17468,92;17465,27;9005;-3,65;17465,27;2016-10-10;10/10/2016;CAFETC;Gastos_Ocio y transporte;Restaurantes;10;VARIABLES
14/10/2016;14/10/2016;T/ CAFET.C T PRAT\PRAT 11-10-2016;-4,10;17465,27;17461,17;9006;-4,10;17461,17;2016-10-11;11/10/2016;CAFETC;Gastos_Ocio y transporte;Restaurantes;10;VARIABLES
14/10/2016;14/10/2016;T/ FRANKFURT LES LLET\ 11-10-2016;-2,70;17461,17;17458,47;9007;-2,70;17458,47;2016-10-11;11/10/2016;FRANKFURT;Gastos_Ocio y transporte;Restaurantes;10;VARIABLES
14/10/2016;14/10/2016;T/ AUTOPISTAS TERR 11-10-2016;-1,38;17458,47;17457,09;9008;-1,38;17457,09;2016-10-11;11/10/2016;AUTOPISTAS;Gastos_Ocio y transporte;Parking y peaje;10;VARIABLES
14/10/2016;14/10/2016;T/ AUTOPISTAS TERR 11-10-2016;-1,38;17457,09;17455,71;9009;-1,38;17455,71;2016-10-11;11/10/2016;AUTOPISTAS;Gastos_Ocio y transporte;Parking y peaje;10;VARIABLES
14/10/2016;14/10/2016;T/ BON AREA 11-10-2016;-22,12;17455,71;17433,59;9010;-22,12;17433,59;2016-10-11;11/10/2016;BON;Gastos_Compras;Supermercado;10;VARIABLES
14/10/2016;14/10/2016;R/ GAS GAS NATURAL GNS27630481016;-4,57;17433,59;17429,02;9011;-4,57;17429,02;2016-10-14;14/10/2016;GAS;Gastos_Servicios tipicos;Gas;10;FIJO
16/10/2016;16/10/2016;T/ CAFET.C T PRAT\PRAT 13-10-2016;-3,65;17429,02;17425,37;9012;-3,65;17425,37;2016-10-13;13/10/2016;CAFETC;Gastos_Ocio y transporte;Restaurantes;10;VARIABLES
16/10/2016;16/10/2016;T/ GLT STORE HOME \ 13-10-2016;-14,69;17425,37;17410,68;9013;-14,69;17410,68;2016-10-13;13/10/2016;GLT;Gastos_Compras;Otras compras;10;VARIABLES
16/10/2016;16/10/2016;T/ FRANKFURT LES LLET\ 13-10-2016;-2,70;17410,68;17407,98;9014;-2,70;17407,98;2016-10-13;13/10/2016;FRANKFURT;Gastos_Ocio y transporte;Restaurantes;10;VARIABLES
16/10/2016;16/10/2016;T/ AUTOPISTAS TERR 13-10-2016;-1,38;17407,98;17406,60;9015;-1,38;17406,60;2016-10-13;13/10/2016;AUTOPISTAS;Gastos_Ocio y transporte;Parking y peaje;10;VARIABLES
16/10/2016;16/10/2016;T/ E.S. RUBI II 13-10-2016;-43,28;17406,60;17363,32;9016;-43,28;17363,32;2016-10-13;13/10/2016;RUBI;Gastos_Ocio y transporte;Gasolina;10;VARIABLES
16/10/2016;16/10/2016;T/ AUTOPISTAS TERR 13-10-2016;-1,38;17363,32;17361,94;9017;-1,38;17361,94;2016-10-13;13/10/2016;AUTOPISTAS;Gastos_Ocio y transporte;Parking y peaje;10;VARIABLES
17/10/2016;16/10/2016;T/ TABASA VALLVI S. 13-10-2016;-4,16;17361,94;17357,78;9018;-4,16;17357,78;2016-10-13;13/10/2016;TABASA;Gastos_Ocio y transporte;Parking y peaje;10;VARIABLES
17/10/2016;17/10/2016;R/ LUZ ENDESA ENERG FACTURA DE GAS;-52,37;17357,78;17305,41;9019;-52,37;17305,41;2016-10-17;17/10/2016;GAS;Gastos_Servicios tipicos;Gas;10;FIJO
17/10/2016;17/10/2016;R/ SEGUROS CCM VIDA Y P Recibo:139;-20,65;17305,41;17284,76;9020;-20,65;17284,76;2016-10-17;17/10/2016;CCM;Gastos_Seguros;Seguro vida;10;FIJO
17/10/2016;17/10/2016;R/ SEGUROS CCM VIDA Y P Recibo:139;-15,97;17284,76;17268,79;9021;-15,97;17268,79;2016-10-17;17/10/2016;CCM;Gastos_Seguros;Seguro vida;10;FIJO
17/10/2016;17/10/2016;R/ TELEFONO VODAFONE ONO ONOAU16-0;-120,84;17268,79;17147,95;9022;-120,84;17147,95;2016-10-17;17/10/2016;TELEFONO;Gastos_Servicios tipicos;Telecomunicaciones;10;FIJO
18/10/2016;17/10/2016;T/ AUTOPISTAS TERR 14-10-2016;-1,38;17147,95;17146,57;9023;-1,38;17146,57;2016-10-14;14/10/2016;AUTOPISTAS;Gastos_Ocio y transporte;Parking y peaje;10;VARIABLES
18/10/2016;18/10/2016;T/ INNOMATICA SER\ALCA 15-10-2016;-48,08;17146,57;17098,49;9024;-48,08;17098,49;2016-10-15;15/10/2016;INNOMATICA;Gastos_Compras;Otras compras;10;VARIABLES
18/10/2016;18/10/2016;T/ VIENA PARC VALLES \ 15-10-2016;-19,35;17098,49;17079,14;9025;-19,35;17079,14;2016-10-15;15/10/2016;VIENA;Gastos_Ocio y transporte;Restaurantes;10;VARIABLES
18/10/2016;18/10/2016;COM. 64970028 SVRED CAJ OFI;-1,87;17079,14;17077,27;9026;-1,87;17077,27;2016-10-18;18/10/2016;COM;Gastos_Banco y organismos;Cargos banco;10;FIJO
18/10/2016;18/10/2016;S/OR. integral Lara;-698,90;17077,27;16378,37;9027;-698,90;16378,37;2016-10-18;18/10/2016;INTEGRAL;Gastos_Vivienda y vehiculo;Otros vivienda;10;VARIABLES
18/10/2016;18/10/2016;S/OR. integral Lara;-300,00;16378,37;16078,37;9028;-300,00;16078,37;2016-10-18;18/10/2016;INTEGRAL;Gastos_Vivienda y vehiculo;Otros vivienda;10;VARIABLES
19/10/2016;19/10/2016;R/ SEGUROS ADESLAS CENT MODULAR CO;-113,89;16078,37;15964,48;9029;-113,89;15964,48;2016-10-19;19/10/2016;ADESLAS;Gastos_Salud, saber y deporte;Medico;10;VARIABLES
20/10/2016;20/10/2016;T/ GLT STORE HOME \ 17-10-2016;-15,83;15964,48;15948,65;9030;-15,83;15948,65;2016-10-17;17/10/2016;GLT;Gastos_Compras;Otras compras;10;VARIABLES
20/10/2016;20/10/2016;T/ AUTOPISTAS TERR 17-10-2016;-1,38;15948,65;15947,27;9031;-1,38;15947,27;2016-10-17;17/10/2016;AUTOPISTAS;Gastos_Ocio y transporte;Parking y peaje;10;VARIABLES
21/10/2016;21/10/2016;T/ CAFET.C T PRAT\PRAT 18-10-2016;-2,95;15947,27;15944,32;9032;-2,95;15944,32;2016-10-18;18/10/2016;CAFETC;Gastos_Ocio y transporte;Restaurantes;10;VARIABLES
21/10/2016;21/10/2016;T/ AUTOPISTAS TERR 18-10-2016;-1,38;15944,32;15942,94;9033;-1,38;15942,94;2016-10-18;18/10/2016;AUTOPISTAS;Gastos_Ocio y transporte;Parking y peaje;10;VARIABLES
21/10/2016;21/10/2016;T/ AUTOPISTAS TERR 18-10-2016;-1,38;15942,94;15941,56;9034;-1,38;15941,56;2016-10-18;18/10/2016;AUTOPISTAS;Gastos_Ocio y transporte;Parking y peaje;10;VARIABLES
21/10/2016;21/10/2016;R/ SERHS FOOD A MENJADOR SERHS SE;-89,25;15941,56;15852,31;9035;-89,25;15852,31;2016-10-21;21/10/2016;SERHS;Gastos_Salud, saber y deporte;Menjador;10;FIJO
21/10/2016;21/10/2016;R/ SERHS FOOD A MENJADOR SERHS SE;-89,25;15852,31;15763,06;9036;-89,25;15763,06;2016-10-21;21/10/2016;SERHS;Gastos_Salud, saber y deporte;Menjador;10;FIJO
22/10/2016;22/10/2016;T/ AUTOPISTAS TERR 19-10-2016;-1,38;15763,06;15761,68;9037;-1,38;15761,68;2016-10-19;19/10/2016;AUTOPISTAS;Gastos_Ocio y transporte;Parking y peaje;10;VARIABLES
22/10/2016;22/10/2016;T/ AUTOPISTAS TERR 19-10-2016;-1,38;15761,68;15760,30;9038;-1,38;15760,30;2016-10-19;19/10/2016;AUTOPISTAS;Gastos_Ocio y transporte;Parking y peaje;10;VARIABLES
23/10/2016;23/10/2016;T/ FRANKFURT LES LLET\ 20-10-2016;-2,70;15760,30;15757,60;9039;-2,70;15757,60;2016-10-20;20/10/2016;FRANKFURT;Gastos_Ocio y transporte;Restaurantes;10;VARIABLES
23/10/2016;23/10/2016;T/ AUTOPISTAS TERR 20-10-2016;-1,38;15757,60;15756,22;9040;-1,38;15756,22;2016-10-20;20/10/2016;AUTOPISTAS;Gastos_Ocio y transporte;Parking y peaje;10;VARIABLES
23/10/2016;23/10/2016;T/ CAPRABO \ 20-10-2016;-11,08;15756,22;15745,14;9041;-11,08;15745,14;2016-10-20;20/10/2016;CAPRABO;Gastos_Compras;Supermercado;10;VARIABLES
24/10/2016;24/10/2016;T/ CAFET.C T PRAT\PRAT 21-10-2016;-3,65;15745,14;15741,49;9042;-3,65;15741,49;2016-10-21;21/10/2016;CAFETC;Gastos_Ocio y transporte;Restaurantes;10;VARIABLES
24/10/2016;24/10/2016;T/ BON AREA 21-10-2016;-20,78;15741,49;15720,71;9043;-20,78;15720,71;2016-10-21;21/10/2016;BON;Gastos_Compras;Supermercado;10;VARIABLES
24/10/2016;24/10/2016;T/ FRANKFURT LES LLET\ 21-10-2016;-4,85;15720,71;15715,86;9044;-4,85;15715,86;2016-10-21;21/10/2016;FRANKFURT;Gastos_Ocio y transporte;Restaurantes;10;VARIABLES
25/10/2016;24/10/2016;T/ AUTOPISTAS TERR 21-10-2016;-1,38;15715,86;15714,48;9045;-1,38;15714,48;2016-10-21;21/10/2016;AUTOPISTAS;Gastos_Ocio y transporte;Parking y peaje;10;VARIABLES
25/10/2016;25/10/2016;T/ BURGUER KING PARC \ 22-10-2016;-21,18;15714,48;15693,30;9046;-21,18;15693,30;2016-10-22;22/10/2016;BURGUER;Gastos_Ocio y transporte;Restaurantes;10;VARIABLES
26/10/2016;26/10/2016;COMIS.TARJETAS 5540550276985025;-18,00;15693,30;15675,30;9047;-18,00;15675,30;2016-10-26;26/10/2016;COMISTARJETAS;Gastos_Banco y organismos;Cargos banco;10;FIJO
26/10/2016;26/10/2016;BONIF.COM. 5540550276985025;18,00;15675,30;15693,30;9048;18,00;15693,30;2016-10-26;26/10/2016;BONIFCOM;Ingresos;Devoluciones;10;VARIABLES
26/10/2016;26/10/2016;T/ AAO OPTICO \TERRASSA;-284,00;15693,30;15409,30;9049;-284,00;15409,30;2016-10-26;26/10/2016;AAO;Gastos_Salud, saber y deporte;Optica;10;VARIABLES
27/10/2016;27/10/2016;COM. 64970028 SVRED CAJ OFI;-1,87;15409,30;15407,43;9050;-1,87;15407,43;2016-10-27;27/10/2016;COM;Gastos_Banco y organismos;Cargos banco;10;FIJO
27/10/2016;27/10/2016;T/ AUTOPISTAS TERR 24-10-2016;-1,38;15407,43;15406,05;9051;-1,38;15406,05;2016-10-24;24/10/2016;AUTOPISTAS;Gastos_Ocio y transporte;Parking y peaje;10;VARIABLES
27/10/2016;27/10/2016;T/ TABASA VALLVI S. 24-10-2016;-4,16;15406,05;15401,89;9052;-4,16;15401,89;2016-10-24;24/10/2016;TABASA;Gastos_Ocio y transporte;Parking y peaje;10;VARIABLES
27/10/2016;27/10/2016;T/ LLEPAT ELS DITS \ 24-10-2016;-8,05;15401,89;15393,84;9053;-8,05;15393,84;2016-10-24;24/10/2016;LLEPAT;Gastos_Ocio y transporte;Restaurantes;10;VARIABLES
27/10/2016;27/10/2016;T/ AUTOPISTAS TERR 24-10-2016;-1,38;15393,84;15392,46;9054;-1,38;15392,46;2016-10-24;24/10/2016;AUTOPISTAS;Gastos_Ocio y transporte;Parking y peaje;10;VARIABLES
27/10/2016;27/10/2016;T/ FRANKFURT LES LLET\ 24-10-2016;-19,35;15392,46;15373,11;9055;-19,35;15373,11;2016-10-24;24/10/2016;FRANKFURT;Gastos_Ocio y transporte;Restaurantes;10;VARIABLES
27/10/2016;27/10/2016;T/ CAFET.C T PRAT\PRAT 24-10-2016;-3,65;15373,11;15369,46;9056;-3,65;15369,46;2016-10-24;24/10/2016;CAFETC;Gastos_Ocio y transporte;Restaurantes;10;VARIABLES
27/10/2016;27/10/2016;CAJ. AJENO SERVIRED \TARRASA/TERRA;-170,00;15369,46;15199,46;9057;-170,00;15199,46;2016-10-27;27/10/2016;CAJ;Gastos_Gastos varios;Efectivo;10;VARIABLES
28/10/2016;28/10/2016;T/ E.S.RUBI 9 25-10-2016;-41,02;15199,46;15158,44;9058;-41,02;15158,44;2016-10-25;25/10/2016;ESRUBI;Gastos_Ocio y transporte;Gasolina;10;VARIABLES
28/10/2016;28/10/2016;T/ BON AREA 25-10-2016;-17,53;15158,44;15140,91;9059;-17,53;15140,91;2016-10-25;25/10/2016;BON;Gastos_Compras;Supermercado;10;VARIABLES
28/10/2016;28/10/2016;T/ AUTOPISTAS TERR 25-10-2016;-1,38;15140,91;15139,53;9060;-1,38;15139,53;2016-10-25;25/10/2016;AUTOPISTAS;Gastos_Ocio y transporte;Parking y peaje;10;VARIABLES
28/10/2016;28/10/2016;T/ FRANKFURT LES LLET\ 25-10-2016;-2,70;15139,53;15136,83;9061;-2,70;15136,83;2016-10-25;25/10/2016;FRANKFURT;Gastos_Ocio y transporte;Restaurantes;10;VARIABLES
28/10/2016;28/10/2016;T/ CAFET.C T PRAT\PRAT 25-10-2016;-3,60;15136,83;15133,23;9062;-3,60;15133,23;2016-10-25;25/10/2016;CAFETC;Gastos_Ocio y transporte;Restaurantes;10;VARIABLES
28/10/2016;28/10/2016;T/ MCDONALDS PRYC\PRAT 25-10-2016;-5,60;15133,23;15127,63;9063;-5,60;15127,63;2016-10-25;25/10/2016;MCDONALDS;Gastos_Ocio y transporte;Restaurantes;10;VARIABLES
28/10/2016;28/10/2016;T/ AUTOPISTAS TERR 25-10-2016;-1,38;15127,63;15126,25;9064;-1,38;15126,25;2016-10-25;25/10/2016;AUTOPISTAS;Gastos_Ocio y transporte;Parking y peaje;10;VARIABLES
28/10/2016;28/10/2016;T/ MCDONALDS PRYC\PRAT 25-10-2016;-7,55;15126,25;15118,70;9065;-7,55;15118,70;2016-10-25;25/10/2016;MCDONALDS;Gastos_Ocio y transporte;Restaurantes;10;VARIABLES
28/10/2016;28/10/2016;HAB. FOMENT DE TERRASSA S.A. Transf;1785,88;15118,70;16904,58;9066;1785,88;16904,58;2016-10-28;28/10/2016;HAB;Ingresos;Nomina;10;FIJO
29/10/2016;28/10/2016;T/ TABASA VALLVI S. 25-10-2016;-4,16;16904,58;16900,42;9067;-4,16;16900,42;2016-10-25;25/10/2016;TABASA;Gastos_Ocio y transporte;Parking y peaje;10;VARIABLES
29/10/2016;29/10/2016;T/ CAFET.C T PRAT\PRAT 26-10-2016;-4,25;16900,42;16896,17;9068;-4,25;16896,17;2016-10-26;26/10/2016;CAFETC;Gastos_Ocio y transporte;Restaurantes;10;VARIABLES
29/10/2016;29/10/2016;T/ FARMA.ANGEL MORENO\ 26-10-2016;-22,75;16896,17;16873,42;9069;-22,75;16873,42;2016-10-26;26/10/2016;FARMAANGEL;Gastos_Salud, saber y deporte;Farmacia;10;VARIABLES
29/10/2016;29/10/2016;T/ AUTOPISTAS TERR 26-10-2016;-1,38;16873,42;16872,04;9070;-1,38;16872,04;2016-10-26;26/10/2016;AUTOPISTAS;Gastos_Ocio y transporte;Parking y peaje;10;VARIABLES
29/10/2016;29/10/2016;T/ FRANKFURT LES LLET\ 26-10-2016;-2,70;16872,04;16869,34;9071;-2,70;16869,34;2016-10-26;26/10/2016;FRANKFURT;Gastos_Ocio y transporte;Restaurantes;10;VARIABLES
29/10/2016;29/10/2016;T/ TABASA VALLVI S. 26-10-2016;-4,16;16869,34;16865,18;9072;-4,16;16865,18;2016-10-26;26/10/2016;TABASA;Gastos_Ocio y transporte;Parking y peaje;10;VARIABLES
29/10/2016;29/10/2016;T/ AUTOPISTAS TERR 26-10-2016;-1,38;16865,18;16863,80;9073;-1,38;16863,80;2016-10-26;26/10/2016;AUTOPISTAS;Gastos_Ocio y transporte;Parking y peaje;10;VARIABLES
30/10/2016;30/10/2016;T/ AUTOPISTAS TERR 27-10-2016;-1,38;16863,80;16862,42;9074;-1,38;16862,42;2016-10-27;27/10/2016;AUTOPISTAS;Gastos_Ocio y transporte;Parking y peaje;10;VARIABLES
30/10/2016;30/10/2016;T/ FARMA.ANGEL MORENO\ 27-10-2016;-16,84;16862,42;16845,58;9075;-16,84;16845,58;2016-10-27;27/10/2016;FARMAANGEL;Gastos_Salud, saber y deporte;Farmacia;10;VARIABLES
30/10/2016;30/10/2016;T/ CAPRABO \ 27-10-2016;-8,63;16845,58;16836,95;9076;-8,63;16836,95;2016-10-27;27/10/2016;CAPRABO;Gastos_Compras;Supermercado;10;VARIABLES
30/10/2016;30/10/2016;T/ FARMACIA TORRAS \ 27-10-2016;-8,89;16836,95;16828,06;9077;-8,89;16828,06;2016-10-27;27/10/2016;FARMACIA;Gastos_Salud, saber y deporte;Farmacia;10;VARIABLES
30/10/2016;30/10/2016;T/ FRANKFURT LES LLET\ 27-10-2016;-2,70;16828,06;16825,36;9078;-2,70;16825,36;2016-10-27;27/10/2016;FRANKFURT;Gastos_Ocio y transporte;Restaurantes;10;VARIABLES
31/10/2016;31/10/2016;T/ CAPRABO \ 28-10-2016;-14,54;16825,36;16810,82;9079;-14,54;16810,82;2016-10-28;28/10/2016;CAPRABO;Gastos_Compras;Supermercado;10;VARIABLES
31/10/2016;31/10/2016;T/ FRANKFURT LES LLET\ 28-10-2016;-2,70;16810,82;16808,12;9080;-2,70;16808,12;2016-10-28;28/10/2016;FRANKFURT;Gastos_Ocio y transporte;Restaurantes;10;VARIABLES
31/10/2016;31/10/2016;HAB. INFORMACIO I TECNOLOGIA DE CAT;1605,36;16808,12;18413,48;9081;1605,36;18413,48;2016-10-31;31/10/2016;HAB;Ingresos;Nomina;10;FIJO
31/10/2016;31/10/2016;REC. 6061.9600001223;-485,11;18413,48;17928,37;9082;-485,11;17928,37;2016-10-31;31/10/2016;REC;Gastos_Banco y organismos;Hipoteca;10;FIJO
31/10/2016;31/10/2016;FACT TARJETAS TARJ.CREDITO 42689013 16-11-01;-463,89;17928,37;17464,48;9083;-463,89;17464,48;2016-11-01;31/10/2016;FACT;No computable;Recibo Tarjeta;10;
31/10/2016;31/10/2016;FACT TARJETAS TARJ.CREDITO 07126017 16-11-01;-195,64;17464,48;17268,84;9084;-195,64;17268,84;2016-11-01;31/10/2016;FACT 07126017;Gastos_Banco y organismos;Credito Bea;10;VARIABLE
01/11/2016;01/11/2016;T/ CINESA PARC VALLES\ 29-10-2016;-13,50;17268,84;17255,34;9085;-13,50;17255,34;2016-10-29;29/10/2016;CINESA;Gastos_Ocio y transporte;Espectáculos;10;VARIABLES
01/11/2016;01/11/2016;T/ CINESA PARC VALLES\ 29-10-2016;-14,80;17255,34;17240,54;9086;-14,80;17240,54;2016-10-29;29/10/2016;CINESA;Gastos_Ocio y transporte;Espectáculos;10;VARIABLES
03/11/2016;03/11/2016;T/ CINESA PARC VALLES\ 31-10-2016;-26,80;17240,54;17213,74;9087;-26,80;17213,74;2016-10-31;31/10/2016;CINESA;Gastos_Ocio y transporte;Espectáculos;10;VARIABLES
03/11/2016;03/11/2016;COM. 64970028 SVRED CAJ OFI;-1,87;17213,74;17211,87;9088;-1,87;17211,87;2016-11-03;03/11/2016;COM;Gastos_Banco y organismos;Cargos banco;11;FIJO
03/11/2016;03/11/2016;CAJ. AJENO SERVIRED \MADRID;-100,00;17211,87;17111,87;9089;-100,00;17111,87;2016-11-03;03/11/2016;CAJ;Gastos_Gastos varios;Efectivo;11;VARIABLES
04/11/2016;04/11/2016;T/ MUSEU HISTORIA CA\B 01-11-2016;-7,00;17111,87;17104,87;9090;-7,00;17104,87;2016-11-01;01/11/2016;MUSEU;Gastos_Ocio y transporte;Espectáculos;11;VARIABLES
05/11/2016;05/11/2016;T/ FRANKFURT LES LLET\ 02-11-2016;-2,70;17104,87;17102,17;9091;-2,70;17102,17;2016-11-02;02/11/2016;FRANKFURT;Gastos_Ocio y transporte;Restaurantes;11;VARIABLES
05/11/2016;05/11/2016;T/ VILANOVA COMELLAS \ 02-11-2016;-19,90;17102,17;17082,27;9092;-19,90;17082,27;2016-11-02;02/11/2016;VILANOVA;Gastos_Salud, saber y deporte;Belleza;11;VARIABLES
05/11/2016;05/11/2016;T/ CAFET.C T PRAT\PRAT 02-11-2016;-3,35;17082,27;17078,92;9093;-3,35;17078,92;2016-11-02;02/11/2016;CAFETC;Gastos_Ocio y transporte;Restaurantes;11;VARIABLES
06/11/2016;06/11/2016;T/ IZAKAYA TERRASSA \ 03-11-2016;-26,00;17078,92;17052,92;9094;-26,00;17052,92;2016-11-03;03/11/2016;IZAKAYA;Gastos_Ocio y transporte;Restaurantes;11;VARIABLES
06/11/2016;06/11/2016;T/ TABASA VALLVI S. 03-11-2016;-4,16;17052,92;17048,76;9095;-4,16;17048,76;2016-11-03;03/11/2016;TABASA;Gastos_Ocio y transporte;Parking y peaje;11;VARIABLES
09/11/2016;06/11/2016;T/ AUTOPISTAS TERR 03-11-2016;-1,38;17048,76;17047,38;9096;-1,38;17047,38;2016-11-03;03/11/2016;AUTOPISTAS;Gastos_Ocio y transporte;Parking y peaje;11;VARIABLES
09/11/2016;07/11/2016;T/ AUTOPISTAS TERR 04-11-2016;-1,38;17047,38;17046,00;9097;-1,38;17046,00;2016-11-04;04/11/2016;AUTOPISTAS;Gastos_Ocio y transporte;Parking y peaje;11;VARIABLES
09/11/2016;07/11/2016;T/ AUTOPISTAS TERR 04-11-2016;-1,38;17046,00;17044,62;9098;-1,38;17044,62;2016-11-04;04/11/2016;AUTOPISTAS;Gastos_Ocio y transporte;Parking y peaje;11;VARIABLES
10/11/2016;07/11/2016;T/ TABASA VALLVI S. 04-11-2016;-4,16;17044,62;17040,46;9099;-4,16;17040,46;2016-11-04;04/11/2016;TABASA;Gastos_Ocio y transporte;Parking y peaje;11;VARIABLES
10/11/2016;10/11/2016;T/ VIENA PARC VALLES \ 07-11-2016;-19,75;17040,46;17020,71;9100;-19,75;17020,71;2016-11-07;07/11/2016;VIENA;Gastos_Ocio y transporte;Restaurantes;11;VARIABLES
10/11/2016;10/11/2016;T/ CAFET.C T PRAT\PRAT 07-11-2016;-3,45;17020,71;17017,26;9101;-3,45;17017,26;2016-11-07;07/11/2016;CAFETC;Gastos_Ocio y transporte;Restaurantes;11;VARIABLES
10/11/2016;10/11/2016;T/ BON AREA 07-11-2016;-25,99;17017,26;16991,27;9102;-25,99;16991,27;2016-11-07;07/11/2016;BON;Gastos_Compras;Supermercado;11;VARIABLES
10/11/2016;10/11/2016;T/ DECATHLON SA TERRA\ 07-11-2016;-45,95;16991,27;16945,32;9103;-45,95;16945,32;2016-11-07;07/11/2016;DECATHLON;Gastos_Compras;Deportivo;11;VARIABLES
10/11/2016;10/11/2016;T/ TABASA VALLVI N. 07-11-2016;-3,70;16945,32;16941,62;9104;-3,70;16941,62;2016-11-07;07/11/2016;TABASA;Gastos_Ocio y transporte;Parking y peaje;11;VARIABLES
10/11/2016;10/11/2016;T/ AUTOPISTAS TERR 07-11-2016;-1,38;16941,62;16940,24;9105;-1,38;16940,24;2016-11-07;07/11/2016;AUTOPISTAS;Gastos_Ocio y transporte;Parking y peaje;11;VARIABLES
10/11/2016;10/11/2016;R/ GAS GAS NATURAL GNS27630481116;-4,57;16940,24;16935,67;9106;-4,57;16935,67;2016-11-10;10/11/2016;GAS;Gastos_Servicios tipicos;Gas;11;FIJO
10/11/2016;10/11/2016;R/ SERHS FOOD A MENJADOR SERHS OC;-113,05;16935,67;16822,62;9107;-113,05;16822,62;2016-11-10;10/11/2016;SERHS;Gastos_Salud, saber y deporte;Menjador;11;FIJO
10/11/2016;10/11/2016;R/ SERHS FOOD A MENJADOR SERHS OC;-113,05;16822,62;16709,57;9108;-113,05;16709,57;2016-11-10;10/11/2016;SERHS;Gastos_Salud, saber y deporte;Menjador;11;FIJO
11/11/2016;11/11/2016;T/ VILANOVA COMELLAS \ 08-11-2016;-46,70;16709,57;16662,87;9109;-46,70;16662,87;2016-11-08;08/11/2016;VILANOVA;Gastos_Salud, saber y deporte;Belleza;11;VARIABLES
11/11/2016;11/11/2016;T/ FARMACIA ANARTE \ 08-11-2016;-17,89;16662,87;16644,98;9110;-17,89;16644,98;2016-11-08;08/11/2016;FARMACIA;Gastos_Salud, saber y deporte;Farmacia;11;VARIABLES
11/11/2016;11/11/2016;T/ CAFET.C T PRAT\PRAT 08-11-2016;-3,35;16644,98;16641,63;9111;-3,35;16641,63;2016-11-08;08/11/2016;CAFETC;Gastos_Ocio y transporte;Restaurantes;11;VARIABLES
11/11/2016;11/11/2016;T/ MERCADONA QUATRE C\ 08-11-2016;-106,02;16641,63;16535,61;9112;-106,02;16535,61;2016-11-08;08/11/2016;MERCADONA;Gastos_Compras;Supermercado;11;VARIABLES
11/11/2016;11/11/2016;T/ ES LA RIERA \EL PR 08-11-2016;-30,00;16535,61;16505,61;9113;-30,00;16505,61;2016-11-08;08/11/2016;RIERA;Gastos_Ocio y transporte;Gasolina;11;VARIABLES
11/11/2016;11/11/2016;T/ TABASA VALLVI S. 08-11-2016;-3,70;16505,61;16501,91;9114;-3,70;16501,91;2016-11-08;08/11/2016;TABASA;Gastos_Ocio y transporte;Parking y peaje;11;VARIABLES
11/11/2016;11/11/2016;T/ AUTOPISTAS TERR 08-11-2016;-1,38;16501,91;16500,53;9115;-1,38;16500,53;2016-11-08;08/11/2016;AUTOPISTAS;Gastos_Ocio y transporte;Parking y peaje;11;VARIABLES
11/11/2016;11/11/2016;T/ AUTOPISTAS TERR 08-11-2016;-1,38;16500,53;16499,15;9116;-1,38;16499,15;2016-11-08;08/11/2016;AUTOPISTAS;Gastos_Ocio y transporte;Parking y peaje;11;VARIABLES
12/11/2016;12/11/2016;T/ REDPIZZA \ 09-11-2016;-19,60;16499,15;16479,55;9117;-19,60;16479,55;2016-11-09;09/11/2016;REDPIZZA;Gastos_Ocio y transporte;Restaurantes;11;VARIABLES
12/11/2016;12/11/2016;T/ CAFET.C T PRAT\PRAT 09-11-2016;-3,65;16479,55;16475,90;9118;-3,65;16475,90;2016-11-09;09/11/2016;CAFETC;Gastos_Ocio y transporte;Restaurantes;11;VARIABLES
12/11/2016;12/11/2016;T/ TABASA VALLVI S. 09-11-2016;-3,70;16475,90;16472,20;9119;-3,70;16472,20;2016-11-09;09/11/2016;TABASA;Gastos_Ocio y transporte;Parking y peaje;11;VARIABLES
12/11/2016;12/11/2016;T/ AUTOPISTAS TERR 09-11-2016;-1,38;16472,20;16470,82;9120;-1,38;16470,82;2016-11-09;09/11/2016;AUTOPISTAS;Gastos_Ocio y transporte;Parking y peaje;11;VARIABLES
12/11/2016;12/11/2016;T/ AUTOPISTAS TERR 09-11-2016;-1,38;16470,82;16469,44;9121;-1,38;16469,44;2016-11-09;09/11/2016;AUTOPISTAS;Gastos_Ocio y transporte;Parking y peaje;11;VARIABLES
13/11/2016;13/11/2016;T/ AUTOPISTAS TERR 10-11-2016;-1,38;16469,44;16468,06;9122;-1,38;16468,06;2016-11-10;10/11/2016;AUTOPISTAS;Gastos_Ocio y transporte;Parking y peaje;11;VARIABLES
13/11/2016;13/11/2016;T/ TABASA VALLVI S. 10-11-2016;-4,16;16468,06;16463,90;9123;-4,16;16463,90;2016-11-10;10/11/2016;TABASA;Gastos_Ocio y transporte;Parking y peaje;11;VARIABLES
13/11/2016;13/11/2016;T/ FRANKFURT LES LLET\ 10-11-2016;-10,45;16463,90;16453,45;9124;-10,45;16453,45;2016-11-10;10/11/2016;FRANKFURT;Gastos_Ocio y transporte;Restaurantes;11;VARIABLES
13/11/2016;13/11/2016;T/ CAFET.C T PRAT\PRAT 10-11-2016;-3,45;16453,45;16450,00;9125;-3,45;16450,00;2016-11-10;10/11/2016;CAFETC;Gastos_Ocio y transporte;Restaurantes;11;VARIABLES
14/11/2016;14/11/2016;T/ REDPIZZA \ 11-11-2016;-19,60;16450,00;16430,40;9126;-19,60;16430,40;2016-11-11;11/11/2016;REDPIZZA;Gastos_Ocio y transporte;Restaurantes;11;VARIABLES
14/11/2016;14/11/2016;R/ LUZ IBERDROLA CL IBERDROLA OTRO;-10,79;16430,40;16419,61;9127;-10,79;16419,61;2016-11-14;14/11/2016;LUZ;Gastos_Servicios tipicos;Electricidad;11;FIJO
15/11/2016;15/11/2016;T/ AUTOPISTAS TERR 11-11-2016;-1,38;16419,61;16418,23;9128;-1,38;16418,23;2016-11-11;11/11/2016;AUTOPISTAS;Gastos_Ocio y transporte;Parking y peaje;11;VARIABLES
15/11/2016;15/11/2016;T/ AUTOPISTAS TERR 11-11-2016;-1,38;16418,23;16416,85;9129;-1,38;16416,85;2016-11-11;11/11/2016;AUTOPISTAS;Gastos_Ocio y transporte;Parking y peaje;11;VARIABLES
15/11/2016;07/11/2016;T/ KIABI.ES;-101,33;16416,85;16315,52;9130;-101,33;16315,52;2016-11-07;07/11/2016;KIABIES;Gastos_Compras;Ropa;11;VARIABLES
16/11/2016;16/11/2016;R/ SEGUROS CCM VIDA Y P Recibo:139;-20,51;16315,52;16295,01;9131;-20,51;16295,01;2016-11-16;16/11/2016;CCM;Gastos_Seguros;Seguro vida;11;FIJO
16/11/2016;16/11/2016;R/ SEGUROS CCM VIDA Y P Recibo:139;-15,87;16295,01;16279,14;9132;-15,87;16279,14;2016-11-16;16/11/2016;CCM;Gastos_Seguros;Seguro vida;11;FIJO
17/11/2016;17/11/2016;T/ FRANKFURT LES LLET\ 14-11-2016;-5,85;16279,14;16273,29;9133;-5,85;16273,29;2016-11-14;14/11/2016;FRANKFURT;Gastos_Ocio y transporte;Restaurantes;11;VARIABLES
17/11/2016;17/11/2016;T/ FRANKFURT LES LLET\ 14-11-2016;-2,70;16273,29;16270,59;9134;-2,70;16270,59;2016-11-14;14/11/2016;FRANKFURT;Gastos_Ocio y transporte;Restaurantes;11;VARIABLES
17/11/2016;17/11/2016;T/ AUTOPISTAS TERR 14-11-2016;-1,38;16270,59;16269,21;9135;-1,38;16269,21;2016-11-14;14/11/2016;AUTOPISTAS;Gastos_Ocio y transporte;Parking y peaje;11;VARIABLES
17/11/2016;17/11/2016;R/ TELEFONO VODAFONE ONO ONOAU16-0;-125,54;16269,21;16143,67;9136;-125,54;16143,67;2016-11-17;17/11/2016;TELEFONO;Gastos_Servicios tipicos;Telecomunicaciones;11;FIJO
18/11/2016;18/11/2016;T/ FRANKFURT LES LLET\ 15-11-2016;-2,70;16143,67;16140,97;9137;-2,70;16140,97;2016-11-15;15/11/2016;FRANKFURT;Gastos_Ocio y transporte;Restaurantes;11;VARIABLES
18/11/2016;18/11/2016;T/ BON AREA 15-11-2016;-24,83;16140,97;16116,14;9138;-24,83;16116,14;2016-11-15;15/11/2016;BON;Gastos_Compras;Supermercado;11;VARIABLES
18/11/2016;18/11/2016;R/ LUZ ENDESA ENERG FACTURA DE ELE;-116,27;16116,14;15999,87;9139;-116,27;15999,87;2016-11-18;18/11/2016;ELE;Gastos_Servicios tipicos;Electricidad;11;FIJO
18/11/2016;18/11/2016;R/ BLITZ 40, S. Alquiler mes en c;-72,50;15999,87;15927,37;9140;-72,50;15927,37;2016-11-18;18/11/2016;BLITZ;Gastos_Vivienda y vehiculo;Alquiler Parking;11;FIJO
18/11/2016;18/11/2016;R/ SEGUROS ADESLAS CENT MODULAR CO;-113,89;15927,37;15813,48;9141;-113,89;15813,48;2016-11-18;18/11/2016;ADESLAS;Gastos_Salud, saber y deporte;Medico;11;VARIABLES
19/11/2016;19/11/2016;'T/ KINO''S BAKERY \ 16-11-2016';-9,85;15813,48;15803,63;9142;-9,85;15803,63;2016-11-16;16/11/2016;KINOS;Gastos_Ocio y transporte;Restaurantes;11;VARIABLES
19/11/2016;19/11/2016;COM. 76985025 SVRED CAJ OFI;-1,50;15803,63;15802,13;9143;-1,50;15802,13;2016-11-19;19/11/2016;COM;Gastos_Banco y organismos;Cargos banco;11;FIJO
19/11/2016;19/11/2016;CAJ. AJENO SERVIRED \TERRASSA;-100,00;15802,13;15702,13;9144;-100,00;15702,13;2016-11-19;19/11/2016;CAJ;Gastos_Gastos varios;Efectivo;11;VARIABLES
20/11/2016;20/11/2016;T/ FRANKFURT LES LLET\ 17-11-2016;-5,80;15702,13;15696,33;9145;-5,80;15696,33;2016-11-17;17/11/2016;FRANKFURT;Gastos_Ocio y transporte;Restaurantes;11;VARIABLES
21/11/2016;21/11/2016;T/ FRANKFURT LES LLET\ 18-11-2016;-2,70;15696,33;15693,63;9146;-2,70;15693,63;2016-11-18;18/11/2016;FRANKFURT;Gastos_Ocio y transporte;Restaurantes;11;VARIABLES
22/11/2016;22/11/2016;T/ VIENA TERRASSA CEN\ 19-11-2016;-7,70;15693,63;15685,93;9147;-7,70;15685,93;2016-11-19;19/11/2016;VIENA;Gastos_Ocio y transporte;Restaurantes;11;VARIABLES
23/11/2016;23/11/2016;T/ REDPIZZA \ 20-11-2016;-14,95;15685,93;15670,98;9148;-14,95;15670,98;2016-11-20;20/11/2016;REDPIZZA;Gastos_Ocio y transporte;Restaurantes;11;VARIABLES
24/11/2016;24/11/2016;T/ TABASA VALLVI S. 21-11-2016;-3,70;15670,98;15667,28;9149;-3,70;15667,28;2016-11-21;21/11/2016;TABASA;Gastos_Ocio y transporte;Parking y peaje;11;VARIABLES
24/11/2016;24/11/2016;T/ AUTOPISTAS TERR 21-11-2016;-1,38;15667,28;15665,90;9150;-1,38;15665,90;2016-11-21;21/11/2016;AUTOPISTAS;Gastos_Ocio y transporte;Parking y peaje;11;VARIABLES
25/11/2016;25/11/2016;T/ FRANKFURT LES LLET\ 22-11-2016;-3,90;15665,90;15662,00;9151;-3,90;15662,00;2016-11-22;22/11/2016;FRANKFURT;Gastos_Ocio y transporte;Restaurantes;11;VARIABLES
25/11/2016;25/11/2016;T/ CAFET.C T PRAT\PRAT 22-11-2016;-0,90;15662,00;15661,10;9152;-0,90;15661,10;2016-11-22;22/11/2016;CAFETC;Gastos_Ocio y transporte;Restaurantes;11;VARIABLES
26/11/2016;26/11/2016;T/ AUTOPISTAS TERR 23-11-2016;-1,38;15661,10;15659,72;9153;-1,38;15659,72;2016-11-23;23/11/2016;AUTOPISTAS;Gastos_Ocio y transporte;Parking y peaje;11;VARIABLES
26/11/2016;26/11/2016;T/ E.S.RUBI 9 23-11-2016;-45,18;15659,72;15614,54;9154;-45,18;15614,54;2016-11-23;23/11/2016;ESRUBI;Gastos_Ocio y transporte;Gasolina;11;VARIABLES
26/11/2016;26/11/2016;T/ FRANKFURT LES LLET\ 23-11-2016;-5,40;15614,54;15609,14;9155;-5,40;15609,14;2016-11-23;23/11/2016;FRANKFURT;Gastos_Ocio y transporte;Restaurantes;11;VARIABLES
27/11/2016;27/11/2016;T/ AUTOPISTAS TERR 24-11-2016;-1,38;15609,14;15607,76;9156;-1,38;15607,76;2016-11-24;24/11/2016;AUTOPISTAS;Gastos_Ocio y transporte;Parking y peaje;11;VARIABLES
27/11/2016;27/11/2016;T/ AUTOPISTAS TERR 24-11-2016;-1,38;15607,76;15606,38;9157;-1,38;15606,38;2016-11-24;24/11/2016;AUTOPISTAS;Gastos_Ocio y transporte;Parking y peaje;11;VARIABLES
27/11/2016;27/11/2016;T/ AUTOPISTAS TERR 24-11-2016;-1,38;15606,38;15605,00;9158;-1,38;15605,00;2016-11-24;24/11/2016;AUTOPISTAS;Gastos_Ocio y transporte;Parking y peaje;11;VARIABLES
27/11/2016;27/11/2016;T/ FRANKFURT LES LLET\ 24-11-2016;-2,70;15605,00;15602,30;9159;-2,70;15602,30;2016-11-24;24/11/2016;FRANKFURT;Gastos_Ocio y transporte;Restaurantes;11;VARIABLES
27/11/2016;27/11/2016;T/ PARC VALLES \ 24-11-2016;-11,58;15602,30;15590,72;9160;-11,58;15590,72;2016-11-24;24/11/2016;PARC;Gastos_Compras;Supermercado;11;VARIABLES
27/11/2016;27/11/2016;T/ CAFET.C T PRAT\PRAT 24-11-2016;-3,60;15590,72;15587,12;9161;-3,60;15587,12;2016-11-24;24/11/2016;CAFETC;Gastos_Ocio y transporte;Restaurantes;11;VARIABLES
28/11/2016;28/11/2016;HAB. INFORMACIO I TECNOLOGIA DE CAT;1575,86;15587,12;17162,98;9162;1575,86;17162,98;2016-11-28;28/11/2016;HAB;Ingresos;Nomina;11;FIJO
28/11/2016;28/11/2016;HAB. FOMENT DE TERRASSA S.A. Transf;1785,88;17162,98;18948,86;9163;1785,88;18948,86;2016-11-28;28/11/2016;HAB;Ingresos;Nomina;11;FIJO
28/11/2016;28/11/2016;T/ CAFET.C T PRAT\PRAT 25-11-2016;-3,65;18948,86;18945,21;9164;-3,65;18945,21;2016-11-25;25/11/2016;CAFETC;Gastos_Ocio y transporte;Restaurantes;11;VARIABLES
28/11/2016;28/11/2016;T/ EL CELLER DE LA PA\ 25-11-2016;-13,50;18945,21;18931,71;9165;-13,50;18931,71;2016-11-25;25/11/2016;CELLER;Gastos_Ocio y transporte;Restaurantes;11;VARIABLES
28/11/2016;28/11/2016;T/ TAGLIATELLA PARC V\ 25-11-2016;-73,65;18931,71;18858,06;9166;-73,65;18858,06;2016-11-25;25/11/2016;TAGLIATELLA;Gastos_Ocio y transporte;Restaurantes;11;VARIABLES
30/11/2016;30/11/2016;R/ AJUNTAMENT D I.B.I. CA D.ALBI;-45,66;18858,06;18812,40;9167;-45,66;18812,40;2016-11-30;30/11/2016;AJUNTAMENT;Gastos_Banco y organismos;Ayuntamiento;11;FIJO
30/11/2016;30/11/2016;REC. 6061.9600001223;-485,11;18812,40;18327,29;9168;-485,11;18327,29;2016-11-30;30/11/2016;REC;Gastos_Banco y organismos;Hipoteca;11;FIJO
30/11/2016;30/11/2016;CAJ. AJENO SISTEMA 4B \TERRASSA;-140,00;18327,29;18187,29;9169;-140,00;18187,29;2016-11-30;30/11/2016;CAJ;Gastos_Gastos varios;Efectivo;11;VARIABLES
30/11/2016;30/11/2016;COM. 76985025 4b CAJ4 OFI9376;-1,85;18187,29;18185,44;9170;-1,85;18185,44;2016-11-30;30/11/2016;COM;Gastos_Banco y organismos;Cargos banco;11;FIJO
30/11/2016;30/11/2016;T/ AUTOPISTAS TERR 25-11-2016;-1,38;18185,44;18184,06;9171;-1,38;18184,06;2016-11-25;25/11/2016;AUTOPISTAS;Gastos_Ocio y transporte;Parking y peaje;11;VARIABLES
30/11/2016;30/11/2016;T/ TABASA VALLVI N. 25-11-2016;-3,70;18184,06;18180,36;9172;-3,70;18180,36;2016-11-25;25/11/2016;TABASA;Gastos_Ocio y transporte;Parking y peaje;11;VARIABLES
30/11/2016;30/11/2016;T/ TABASA VALLVI S. 25-11-2016;-3,70;18180,36;18176,66;9173;-3,70;18176,66;2016-11-25;25/11/2016;TABASA;Gastos_Ocio y transporte;Parking y peaje;11;VARIABLES
30/11/2016;30/11/2016;T/ AUTOPISTAS TERR 25-11-2016;-1,38;18176,66;18175,28;9174;-1,38;18175,28;2016-11-25;25/11/2016;AUTOPISTAS;Gastos_Ocio y transporte;Parking y peaje;11;VARIABLES
30/11/2016;30/11/2016;T/ CATALANA DIAG.I CIR 24-11-2016;-4,45;18175,28;18170,83;9175;-4,45;18170,83;2016-11-24;24/11/2016;CATALANA;Gastos_Ocio y transporte;Parking y peaje;11;VARIABLES
01/12/2016;01/12/2016;FACT TARJETAS TARJ.CREDITO 07126017 16-12-01;-132,54;18170,83;18038,29;9176;-132,54;18038,29;2016-12-01;30/11/2016;FACT 07126017;Gastos_Banco y organismos;Credito Bea;11;VARIABLE
01/12/2016;01/12/2016;FACT TARJETAS TARJ.CREDITO 42689013 16-12-01;-291,17;18038,29;17747,12;9177;-291,17;17747,12;2016-12-01;30/11/2016;FACT;No computable;Recibo Tarjeta;11;
01/12/2016;01/12/2016;T/ CAFET.C T PRAT\PRAT 28-11-2016;-3,35;17747,12;17743,77;9178;-3,35;17743,77;2016-11-28;28/11/2016;CAFETC;Gastos_Ocio y transporte;Restaurantes;11;VARIABLES
01/12/2016;01/12/2016;T/ AUTOPISTAS TERR 28-11-2016;-1,38;17743,77;17742,39;9179;-1,38;17742,39;2016-11-28;28/11/2016;AUTOPISTAS;Gastos_Ocio y transporte;Parking y peaje;11;VARIABLES
01/12/2016;01/12/2016;T/ TABASA VALLVI S. 28-11-2016;-3,70;17742,39;17738,69;9180;-3,70;17738,69;2016-11-28;28/11/2016;TABASA;Gastos_Ocio y transporte;Parking y peaje;11;VARIABLES
01/12/2016;01/12/2016;T/ AUTOPISTAS TERR 28-11-2016;-1,38;17738,69;17737,31;9181;-1,38;17737,31;2016-11-28;28/11/2016;AUTOPISTAS;Gastos_Ocio y transporte;Parking y peaje;11;VARIABLES
01/12/2016;01/12/2016;T/ LIDL TERRASSA LES \ 28-11-2016;-81,20;17737,31;17656,11;9182;-81,20;17656,11;2016-11-28;28/11/2016;LIDL;Gastos_Compras;Supermercado;11;VARIABLES
02/12/2016;02/12/2016;T/ AUTOPISTAS TERR 29-11-2016;-1,38;17656,11;17654,73;9183;-1,38;17654,73;2016-11-29;29/11/2016;AUTOPISTAS;Gastos_Ocio y transporte;Parking y peaje;11;VARIABLES
02/12/2016;02/12/2016;T/ AUTOPISTAS TERR 29-11-2016;-1,38;17654,73;17653,35;9184;-1,38;17653,35;2016-11-29;29/11/2016;AUTOPISTAS;Gastos_Ocio y transporte;Parking y peaje;11;VARIABLES
02/12/2016;02/12/2016;T/ FRANKFURT LES LLET\ 29-11-2016;-2,70;17653,35;17650,65;9185;-2,70;17650,65;2016-11-29;29/11/2016;FRANKFURT;Gastos_Ocio y transporte;Restaurantes;11;VARIABLES
02/12/2016;02/12/2016;T/ CAFET.C T PRAT\PRAT 29-11-2016;-3,45;17650,65;17647,20;9186;-3,45;17647,20;2016-11-29;29/11/2016;CAFETC;Gastos_Ocio y transporte;Restaurantes;11;VARIABLES
02/12/2016;02/12/2016;T/ REDPIZZA \ 29-11-2016;-16,90;17647,20;17630,30;9187;-16,90;17630,30;2016-11-29;29/11/2016;REDPIZZA;Gastos_Ocio y transporte;Restaurantes;11;VARIABLES
03/12/2016;03/12/2016;T/ CAFET.C T PRAT\PRAT 30-11-2016;-3,45;17630,30;17626,85;9188;-3,45;17626,85;2016-11-30;30/11/2016;CAFETC;Gastos_Ocio y transporte;Restaurantes;11;VARIABLES
03/12/2016;03/12/2016;T/ RODELAS PERRUQUERS\ 30-11-2016;-14,90;17626,85;17611,95;9189;-14,90;17611,95;2016-11-30;30/11/2016;RODELAS;Gastos_Salud, saber y deporte;Belleza;11;VARIABLES
03/12/2016;03/12/2016;T/ AUTOPISTAS TERR 30-11-2016;-1,38;17611,95;17610,57;9190;-1,38;17610,57;2016-11-30;30/11/2016;AUTOPISTAS;Gastos_Ocio y transporte;Parking y peaje;11;VARIABLES
03/12/2016;03/12/2016;T/ FRANKFURT LES LLET\ 30-11-2016;-2,70;17610,57;17607,87;9191;-2,70;17607,87;2016-11-30;30/11/2016;FRANKFURT;Gastos_Ocio y transporte;Restaurantes;11;VARIABLES
03/12/2016;03/12/2016;T/ TABASA VALLVI S. 30-11-2016;-4,16;17607,87;17603,71;9192;-4,16;17603,71;2016-11-30;30/11/2016;TABASA;Gastos_Ocio y transporte;Parking y peaje;11;VARIABLES
03/12/2016;03/12/2016;T/ AUTOPISTAS TERR 30-11-2016;-1,38;17603,71;17602,33;9193;-1,38;17602,33;2016-11-30;30/11/2016;AUTOPISTAS;Gastos_Ocio y transporte;Parking y peaje;11;VARIABLES
03/12/2016;03/12/2016;T/ BON AREA 30-11-2016;-21,15;17602,33;17581,18;9194;-21,15;17581,18;2016-11-30;30/11/2016;BON;Gastos_Compras;Supermercado;11;VARIABLES
04/12/2016;04/12/2016;T/ AUTOPISTAS TERR 01-12-2016;-1,38;17581,18;17579,80;9195;-1,38;17579,80;2016-12-01;01/12/2016;AUTOPISTAS;Gastos_Ocio y transporte;Parking y peaje;12;VARIABLES
04/12/2016;04/12/2016;T/ CINESA PARC VALLES\ 01-12-2016;-15,80;17579,80;17564,00;9196;-15,80;17564,00;2016-12-01;01/12/2016;CINESA;Gastos_Ocio y transporte;Espectáculos;12;VARIABLES
04/12/2016;04/12/2016;T/ CAFET.C T PRAT\PRAT 01-12-2016;-3,35;17564,00;17560,65;9197;-3,35;17560,65;2016-12-01;01/12/2016;CAFETC;Gastos_Ocio y transporte;Restaurantes;12;VARIABLES
04/12/2016;04/12/2016;T/ TABASA VALLVI S. 01-12-2016;-4,16;17560,65;17556,49;9198;-4,16;17556,49;2016-12-01;01/12/2016;TABASA;Gastos_Ocio y transporte;Parking y peaje;12;VARIABLES
04/12/2016;04/12/2016;T/ AUTOPISTAS TERR 01-12-2016;-1,38;17556,49;17555,11;9199;-1,38;17555,11;2016-12-01;01/12/2016;AUTOPISTAS;Gastos_Ocio y transporte;Parking y peaje;12;VARIABLES
04/12/2016;04/12/2016;T/ VIENA PARC VALLES \ 01-12-2016;-16,55;17555,11;17538,56;9200;-16,55;17538,56;2016-12-01;01/12/2016;VIENA;Gastos_Ocio y transporte;Restaurantes;12;VARIABLES
05/12/2016;05/12/2016;R/ SEGUROS CAJA DE SEGU POL.953975;-407,15;17538,56;17131,41;9201;-407,15;17131,41;2016-12-05;05/12/2016;CAJA;Gastos_Seguros;Seguro hogar;12;FIJO
05/12/2016;05/12/2016;T/ CAFET.C T PRAT\PRAT 02-12-2016;-3,65;17131,41;17127,76;9202;-3,65;17127,76;2016-12-02;02/12/2016;CAFETC;Gastos_Ocio y transporte;Restaurantes;12;VARIABLES
05/12/2016;05/12/2016;T/ FRANKFURT LES LLET\ 02-12-2016;-2,70;17127,76;17125,06;9203;-2,70;17125,06;2016-12-02;02/12/2016;FRANKFURT;Gastos_Ocio y transporte;Restaurantes;12;VARIABLES
06/12/2016;06/12/2016;T/ PARKING BARCELONA\B 03-12-2016;-3,30;17125,06;17121,76;9204;-3,30;17121,76;2016-12-03;03/12/2016;PARKING;Gastos_Ocio y transporte;Parking y peaje;12;VARIABLES
06/12/2016;06/12/2016;T/ BAR ESTACIO DE FR\B 03-12-2016;-17,50;17121,76;17104,26;9205;-17,50;17104,26;2016-12-03;03/12/2016;BAR;Gastos_Ocio y transporte;Restaurantes;12;VARIABLES
06/12/2016;06/12/2016;T/ RENFE CERCAN`AS 7\B 03-12-2016;-20,50;17104,26;17083,76;9206;-20,50;17083,76;2016-12-03;03/12/2016;RENFE;Gastos_Ocio y transporte;Transporte;12;VARIABLES
06/12/2016;06/12/2016;T/ RENFE CERCAN`AS 7\B 03-12-2016;-13,50;17083,76;17070,26;9207;-13,50;17070,26;2016-12-03;03/12/2016;RENFE;Gastos_Ocio y transporte;Transporte;12;VARIABLES
06/12/2016;06/12/2016;T/ AKI 104 - TERRASSA\ 03-12-2016;-15,65;17070,26;17054,61;9208;-15,65;17054,61;2016-12-03;03/12/2016;AKI;Gastos_Vivienda y vehiculo;Mnto. hogar;12;VARIABLES
06/12/2016;06/12/2016;T/ AUTOPISTAS TERR 02-12-2016;-1,38;17054,61;17053,23;9209;-1,38;17053,23;2016-12-02;02/12/2016;AUTOPISTAS;Gastos_Ocio y transporte;Parking y peaje;12;VARIABLES
06/12/2016;06/12/2016;T/ AUTOPISTAS TERR 02-12-2016;-1,38;17053,23;17051,85;9210;-1,38;17051,85;2016-12-02;02/12/2016;AUTOPISTAS;Gastos_Ocio y transporte;Parking y peaje;12;VARIABLES
07/12/2016;07/12/2016;R/ SERHS FOOD A MENJADOR SERHS NO;-124,95;17051,85;16926,90;9211;-124,95;16926,90;2016-12-07;07/12/2016;SERHS;Gastos_Salud, saber y deporte;Menjador;12;FIJO
07/12/2016;07/12/2016;R/ SERHS FOOD A MENJADOR SERHS DE;-71,40;16926,90;16855,50;9212;-71,40;16855,50;2016-12-07;07/12/2016;SERHS;Gastos_Salud, saber y deporte;Menjador;12;FIJO
07/12/2016;07/12/2016;R/ SERHS FOOD A MENJADOR SERHS NO;-124,95;16855,50;16730,55;9213;-124,95;16730,55;2016-12-07;07/12/2016;SERHS;Gastos_Salud, saber y deporte;Menjador;12;FIJO
07/12/2016;07/12/2016;R/ SERHS FOOD A MENJADOR SERHS DE;-71,40;16730,55;16659,15;9214;-71,40;16659,15;2016-12-07;07/12/2016;SERHS;Gastos_Salud, saber y deporte;Menjador;12;FIJO
07/12/2016;07/12/2016;T/ LEROY MERLIN SABAD\ 04-12-2016;-11,35;16659,15;16647,80;9215;-11,35;16647,80;2016-12-04;04/12/2016;LEROY;Gastos_Vivienda y vehiculo;Mnto. hogar;12;VARIABLES
07/12/2016;07/12/2016;T/ VIENA XALET SABADE\ 04-12-2016;-6,85;16647,80;16640,95;9216;-6,85;16640,95;2016-12-04;04/12/2016;VIENA;Gastos_Ocio y transporte;Restaurantes;12;VARIABLES
07/12/2016;07/12/2016;T/ REDPIZZA \ 04-12-2016;-13,10;16640,95;16627,85;9217;-13,10;16627,85;2016-12-04;04/12/2016;REDPIZZA;Gastos_Ocio y transporte;Restaurantes;12;VARIABLES
08/12/2016;08/12/2016;T/ CAFET.C T PRAT\PRAT 05-12-2016;-4,10;16627,85;16623,75;9218;-4,10;16623,75;2016-12-05;05/12/2016;CAFETC;Gastos_Ocio y transporte;Restaurantes;12;VARIABLES
08/12/2016;08/12/2016;T/ AUTOPISTAS TERR 05-12-2016;-1,38;16623,75;16622,37;9219;-1,38;16622,37;2016-12-05;05/12/2016;AUTOPISTAS;Gastos_Ocio y transporte;Parking y peaje;12;VARIABLES
08/12/2016;08/12/2016;T/ TABASA VALLVI N. 02-12-2016;-3,70;16622,37;16618,67;9220;-3,70;16618,67;2016-12-02;02/12/2016;TABASA;Gastos_Ocio y transporte;Parking y peaje;12;VARIABLES
08/12/2016;08/12/2016;T/ TABASA VALLVI S. 02-12-2016;-3,70;16618,67;16614,97;9221;-3,70;16614,97;2016-12-02;02/12/2016;TABASA;Gastos_Ocio y transporte;Parking y peaje;12;VARIABLES
09/12/2016;09/12/2016;R/ BLITZ 40, S. Alquiler mes en c;-72,50;16614,97;16542,47;9222;-72,50;16542,47;2016-12-09;09/12/2016;BLITZ;Gastos_Vivienda y vehiculo;Alquiler Parking;12;FIJO
09/12/2016;09/12/2016;T/ FORN DE PA CAL PORT 06-12-2016;-12,40;16542,47;16530,07;9223;-12,40;16530,07;2016-12-06;06/12/2016;FORN;Gastos_Compras;Supermercado;12;VARIABLES
09/12/2016;09/12/2016;T/ BAR XIMO 06-12-2016;-25,20;16530,07;16504,87;9224;-25,20;16504,87;2016-12-06;06/12/2016;BAR;Gastos_Ocio y transporte;Restaurantes;12;VARIABLES
09/12/2016;09/12/2016;T/ TABASA VALLVI S. 05-12-2016;-4,16;16504,87;16500,71;9225;-4,16;16500,71;2016-12-05;05/12/2016;TABASA;Gastos_Ocio y transporte;Parking y peaje;12;VARIABLES
11/12/2016;11/12/2016;T/ FORN DE PA CAL PORT 08-12-2016;-8,40;16500,71;16492,31;9226;-8,40;16492,31;2016-12-08;08/12/2016;FORN;Gastos_Compras;Supermercado;12;VARIABLES
12/12/2016;12/12/2016;R/ LUZ ENDESA ENERG FACTURA DE GAS;-66,85;16492,31;16425,46;9227;-66,85;16425,46;2016-12-12;12/12/2016;GAS;Gastos_Servicios tipicos;Gas;12;FIJO
12/12/2016;12/12/2016;T/ ASIA 09-12-2016;-14,90;16425,46;16410,56;9228;-14,90;16410,56;2016-12-09;09/12/2016;ASIA;Gastos_Compras;Hogar;12;VARIABLES
12/12/2016;12/12/2016;T/ MERCADONA TORTOSA 09-12-2016;-20,46;16410,56;16390,10;9229;-20,46;16390,10;2016-12-09;09/12/2016;MERCADONA;Gastos_Compras;Supermercado;12;VARIABLES
13/12/2016;13/12/2016;R/ GAS GAS NATURAL GNS27630481216;-4,57;16390,10;16385,53;9230;-4,57;16385,53;2016-12-13;13/12/2016;GAS;Gastos_Servicios tipicos;Gas;12;FIJO
13/12/2016;13/12/2016;R/ SEGUROS ADESLAS CENT MODULAR CO;-113,89;16385,53;16271,64;9231;-113,89;16271,64;2016-12-13;13/12/2016;ADESLAS;Gastos_Salud, saber y deporte;Medico;12;VARIABLES
13/12/2016;13/12/2016;T/ FORN DE PA CAL PORT 10-12-2016;-6,80;16271,64;16264,84;9232;-6,80;16264,84;2016-12-10;10/12/2016;FORN;Gastos_Compras;Supermercado;12;VARIABLES
14/12/2016;14/12/2016;R/ LUZ IBERDROLA CL IBERDROLA OTRO;-10,79;16264,84;16254,05;9233;-10,79;16254,05;2016-12-14;14/12/2016;LUZ;Gastos_Servicios tipicos;Electricidad;12;FIJO
14/12/2016;14/12/2016;T/ REDPIZZA \ 11-12-2016;-17,65;16254,05;16236,40;9234;-17,65;16236,40;2016-12-11;11/12/2016;REDPIZZA;Gastos_Ocio y transporte;Restaurantes;12;VARIABLES
15/12/2016;15/12/2016;CAJ. AJENO SISTEMA 4B \TERRASSA;-80,00;16116,40;16036,40;9235;-80,00;16156,40;2016-12-15;15/12/2016;CAJ;Gastos_Gastos varios;Efectivo;12;VARIABLES
15/12/2016;15/12/2016;COM. 76985025 4b CAJ4 OFI9376;-1,85;16036,40;16034,55;9236;-1,85;16154,55;2016-12-15;15/12/2016;COM;Gastos_Banco y organismos;Cargos banco;12;FIJO
16/12/2016;16/12/2016;R/ SEGUROS CCM VIDA Y P Recibo:140;-16,91;16034,55;16017,64;9237;-16,91;16137,64;2016-12-16;16/12/2016;CCM;Gastos_Seguros;Seguro vida;12;FIJO
16/12/2016;16/12/2016;R/ SEGUROS CCM VIDA Y P Recibo:140;-20,44;16017,64;15997,20;9238;-20,44;16117,20;2016-12-16;16/12/2016;CCM;Gastos_Seguros;Seguro vida;12;FIJO
16/12/2016;16/12/2016;HAB. INFORMACIO I TECNOLOGIA DE CAT;1779,17;15997,20;17776,37;9239;1779,17;17896,37;2016-12-16;16/12/2016;HAB;Ingresos;Nomina;12;FIJO
17/12/2016;17/12/2016;T/ FRANKFURT LES LLET\ 14-12-2016;-5,85;17776,37;17770,52;9240;-5,85;17890,52;2016-12-14;14/12/2016;FRANKFURT;Gastos_Ocio y transporte;Restaurantes;12;VARIABLES
19/12/2016;19/12/2016;R/ VODAFONE ONOZI16-000104270;-120,84;17770,52;17649,68;9241;-120,84;17769,68;2016-12-19;19/12/2016;VODAFONE;Gastos_Servicios tipicos;Telecomunicaciones;12;FIJO
19/12/2016;19/12/2016;T/ CAPRABO \ 16-12-2016;-9,28;17649,68;17640,40;9242;-9,28;17760,40;2016-12-16;16/12/2016;CAPRABO;Gastos_Compras;Supermercado;12;VARIABLES
20/12/2016;20/12/2016;T/ CINESA PARC VALLES\ 17-12-2016;-14,80;17640,40;17625,60;9243;-14,80;17745,60;2016-12-17;17/12/2016;CINESA;Gastos_Ocio y transporte;Espectáculos;12;VARIABLES
20/12/2016;20/12/2016;T/ TIGER STORES SPAIN\ 17-12-2016;-17,10;17625,60;17608,50;9244;-17,10;17728,50;2016-12-17;17/12/2016;TIGER;Gastos_Compras;Otras compras;12;VARIABLES
21/12/2016;21/12/2016;R/ MINA PUBLICA AIGUES T.01A75789;-36,72;17608,50;17571,78;9245;-36,72;17691,78;2016-12-21;21/12/2016;MINA;Gastos_Servicios tipicos;Agua;12;FIJO
21/12/2016;21/12/2016;T/ HENNES & MAURITZ S\ 18-12-2016;-10,48;17571,78;17561,30;9246;-10,48;17681,30;2016-12-18;18/12/2016;HENNES;Gastos_Compras;Ropa;12;VARIABLES
22/12/2016;22/12/2016;HAB. FOMENT DE TERRASSA S.A. Transf;3741,22;17561,30;21302,52;9247;3741,22;21422,52;2016-12-22;22/12/2016;HAB;Ingresos;Nomina;12;FIJO
22/12/2016;22/12/2016;T/ BON AREA 19-12-2016;-37,49;21302,52;21265,03;9248;-37,49;21385,03;2016-12-19;19/12/2016;BON;Gastos_Compras;Supermercado;12;VARIABLES
23/12/2016;23/12/2016;T/ AUTOPISTAS TERR 20-12-2016;-1,38;21265,03;21263,65;9249;-1,38;21383,65;2016-12-20;20/12/2016;AUTOPISTAS;Gastos_Ocio y transporte;Parking y peaje;12;VARIABLES
23/12/2016;23/12/2016;T/ PC BOX TERRASS\TARRASA/TERR;-100,15;21263,65;21163,50;9250;-100,15;21283,50;2016-12-23;23/12/2016;BOX;Gastos_Compras;Hobbys;12;VARIABLES
23/12/2016;23/12/2016;T/ PORTAVENTURA WEB \VILA-SECA;-285,60;21163,50;20877,90;9251;-285,60;20997,90;2016-12-23;23/12/2016;PORTAVENTURA;Gastos_Ocio y transporte;Vacaciones;12;VARIABLES
23/12/2016;23/12/2016;T/ EROSKI TERRASSA \TERRASSA;-42,81;20877,90;20835,09;9252;-42,81;20955,09;2016-12-23;23/12/2016;EROSKI;Gastos_Compras;Supermercado;12;VARIABLES
24/12/2016;24/12/2016;T/ VIENA PARC VALLES \TERRASSA;-19,85;20835,09;20815,24;9253;-19,85;20935,24;2016-12-24;24/12/2016;VIENA;Gastos_Ocio y transporte;Restaurantes;12;VARIABLES
24/12/2016;22/12/2016;T/ AMAZON SPAIN RETAIL AM;-3,94;20815,24;20811,30;9254;-3,94;20931,30;2016-12-22;22/12/2016;AMAZON;Gastos_Compras;Hobbys;12;VARIABLES
24/12/2016;24/12/2016;T/ PC BOX TERRASS\TARR 21-12-2016;-20,00;20811,30;20791,30;9255;-20,00;20911,30;2016-12-21;21/12/2016;BOX;Gastos_Compras;Hobbys;12;VARIABLES
24/12/2016;24/12/2016;T/ PARC VALLES \ 21-12-2016;-92,98;20791,30;20698,32;9256;-92,98;20818,32;2016-12-21;21/12/2016;PARC;Gastos_Compras;Supermercado;12;VARIABLES
24/12/2016;24/12/2016;T/ PAIPAS CARNE S L \ 21-12-2016;-3,47;20698,32;20694,85;9257;-3,47;20814,85;2016-12-21;21/12/2016;PAIPAS;Gastos_Compras;Supermercado;12;VARIABLES
25/12/2016;25/12/2016;T/ VIENA TERRASSA CEN\ 22-12-2016;-21,10;20694,85;20673,75;9258;-21,10;20793,75;2016-12-22;22/12/2016;VIENA;Gastos_Ocio y transporte;Restaurantes;12;VARIABLES
25/12/2016;25/12/2016;T/ SATSA PL. VELLA TER 22-12-2016;-2,70;20673,75;20671,05;9259;-2,70;20791,05;2016-12-22;22/12/2016;SATSA;Gastos_Ocio y transporte;Parking y peaje;12;VARIABLES
25/12/2016;25/12/2016;T/ TIGER STORES SPAIN\ 22-12-2016;-11,00;20671,05;20660,05;9260;-11,00;20780,05;2016-12-22;22/12/2016;TIGER;Gastos_Compras;Otras compras;12;VARIABLES
25/12/2016;25/12/2016;T/ MS MODE TERRASSA \ 22-12-2016;-15,00;20660,05;20645,05;9261;-15,00;20765,05;2016-12-22;22/12/2016;MODE;Gastos_Compras;Ropa;12;VARIABLES
25/12/2016;25/12/2016;T/ TIGER STORES SPAIN\ 22-12-2016;-39,15;20645,05;20605,90;9262;-39,15;20725,90;2016-12-22;22/12/2016;TIGER;Gastos_Compras;Otras compras;12;VARIABLES
25/12/2016;25/12/2016;T/ CAFET.C T PRAT\PRAT 22-12-2016;-5,75;20605,90;20600,15;9263;-5,75;20720,15;2016-12-22;22/12/2016;CAFETC;Gastos_Ocio y transporte;Restaurantes;12;VARIABLES
26/12/2016;26/12/2016;T/ CAFET.C T PRAT\PRAT 23-12-2016;-3,65;20600,15;20596,50;9264;-3,65;20716,50;2016-12-23;23/12/2016;CAFETC;Gastos_Ocio y transporte;Restaurantes;12;VARIABLES
26/12/2016;26/12/2016;T/ VIENA MONTSERRAT \ 23-12-2016;-17,55;20596,50;20578,95;9265;-17,55;20698,95;2016-12-23;23/12/2016;VIENA;Gastos_Ocio y transporte;Restaurantes;12;VARIABLES
26/12/2016;26/12/2016;T/ LIDL TERRASSA \ 23-12-2016;-24,14;20578,95;20554,81;9266;-24,14;20674,81;2016-12-23;23/12/2016;LIDL;Gastos_Compras;Supermercado;12;VARIABLES
26/12/2016;26/12/2016;T/ MERCACHINA TERRASS\ 23-12-2016;-12,75;20554,81;20542,06;9267;-12,75;20662,06;2016-12-23;23/12/2016;MERCACHINA;Gastos_Compras;Otras compras;12;VARIABLES
26/12/2016;26/12/2016;T/ REDPIZZA \ 23-12-2016;-17,65;20542,06;20524,41;9268;-17,65;20644,41;2016-12-23;23/12/2016;REDPIZZA;Gastos_Ocio y transporte;Restaurantes;12;VARIABLES
27/12/2016;27/12/2016;R/ AJUNTAMENT D TAXA RESIDUS CA;-52,01;20524,41;20472,40;9269;-52,01;20592,40;2016-12-27;27/12/2016;AJUNTAMENT;Gastos_Banco y organismos;Ayuntamiento;12;FIJO
27/12/2016;27/12/2016;T/ EGARVIA, S.A. 21-12-2016;-0,90;20472,40;20471,50;9270;-0,90;20591,50;2016-12-21;21/12/2016;EGARVIA;Gastos_Ocio y transporte;Parking y peaje;12;VARIABLES
28/12/2016;28/12/2016;T/ AUTOPISTAS TERR 23-12-2016;-1,38;20471,50;20470,12;9271;-1,38;20590,12;2016-12-23;23/12/2016;AUTOPISTAS;Gastos_Ocio y transporte;Parking y peaje;12;VARIABLES
28/12/2016;28/12/2016;T/ AUTOPISTAS TERR 23-12-2016;-1,38;20470,12;20468,74;9272;-1,38;20588,74;2016-12-23;23/12/2016;AUTOPISTAS;Gastos_Ocio y transporte;Parking y peaje;12;VARIABLES
28/12/2016;28/12/2016;T/ AUTOPISTAS TERR 22-12-2016;-1,38;20468,74;20467,36;9273;-1,38;20587,36;2016-12-22;22/12/2016;AUTOPISTAS;Gastos_Ocio y transporte;Parking y peaje;12;VARIABLES
28/12/2016;28/12/2016;T/ AUTOPISTAS TERR 22-12-2016;-1,38;20467,36;20465,98;9274;-1,38;20585,98;2016-12-22;22/12/2016;AUTOPISTAS;Gastos_Ocio y transporte;Parking y peaje;12;VARIABLES
29/12/2016;29/12/2016;HAB. INFORMACIO I TECNOLOGIA DE CAT;1623,97;20465,98;22089,95;9275;1623,97;22209,95;2016-12-29;29/12/2016;HAB;Ingresos;Nomina;12;FIJO
29/12/2016;29/12/2016;T/ FARMACIA SEGLE XX \ 26-12-2016;-24,08;22089,95;22065,87;9276;-24,08;22185,87;2016-12-26;26/12/2016;FARMACIA;Gastos_Salud, saber y deporte;Farmacia;12;VARIABLES
30/12/2016;28/12/2016;T/ AMAZON.ES COMPRA;-53,80;22065,87;22012,07;9277;-53,80;22132,07;2016-12-28;28/12/2016;AMAZONES;Gastos_Compras;Hobbys;12;VARIABLES
30/12/2016;30/12/2016;T/ CAFET.C T PRAT\PRAT 27-12-2016;-4,05;22012,07;22008,02;9278;-4,05;22128,02;2016-12-27;27/12/2016;CAFETC;Gastos_Ocio y transporte;Restaurantes;12;VARIABLES
30/12/2016;30/12/2016;T/ AUTOPISTAS TERR 27-12-2016;-1,38;22008,02;22006,64;9279;-1,38;22126,64;2016-12-27;27/12/2016;AUTOPISTAS;Gastos_Ocio y transporte;Parking y peaje;12;VARIABLES
30/12/2016;30/12/2016;T/ AUTOPISTAS TERR 27-12-2016;-1,38;22006,64;22005,26;9280;-1,38;22125,26;2016-12-27;27/12/2016;AUTOPISTAS;Gastos_Ocio y transporte;Parking y peaje;12;VARIABLES
30/12/2016;30/12/2016;T/ DECATHLON SA TERRA\TERRASSA;-81,95;22005,26;21923,31;9281;-81,95;22043,31;2016-12-30;30/12/2016;DECATHLON;Gastos_Compras;Deportivo;12;VARIABLES
31/12/2016;31/12/2016;REC. 6061.9600001223;-485,11;21923,31;21438,20;9282;-485,11;21558,20;2016-12-31;31/12/2016;REC;Gastos_Banco y organismos;Hipoteca;12;FIJO
31/12/2016;29/12/2016;T/ CARREFOUR VALLE;-37,20;21438,20;21401,00;9283;-37,20;21521,00;2016-12-29;29/12/2016;CARREFOUR;Gastos_Compras;Supermercado;12;VARIABLES
31/12/2016;31/12/2016;T/ CAFET.C T PRAT\PRAT 28-12-2016;-3,05;21401,00;21397,95;9284;-3,05;21517,95;2016-12-28;28/12/2016;CAFETC;Gastos_Ocio y transporte;Restaurantes;12;VARIABLES
31/12/2016;31/12/2016;T/ CINESA PARC VALLES\ 28-12-2016;-19,60;21397,95;21378,35;9285;-19,60;21498,35;2016-12-28;28/12/2016;CINESA;Gastos_Ocio y transporte;Espectáculos;12;VARIABLES
31/12/2016;31/12/2016;T/ VIENA PARC VALLES \ 28-12-2016;-17,20;21378,35;21361,15;9286;-17,20;21481,15;2016-12-28;28/12/2016;VIENA;Gastos_Ocio y transporte;Restaurantes;12;VARIABLES
31/12/2016;31/12/2016;T/ CAPRABO - 427 TERR\ 28-12-2016;-34,87;21361,15;21326,28;9287;-34,87;21446,28;2016-12-28;28/12/2016;CAPRABO;Gastos_Compras;Supermercado;12;VARIABLES
31/12/2016;31/12/2016;T/ AUTOPISTAS TERR 28-12-2016;-1,38;21326,28;21324,90;9288;-1,38;21444,90;2016-12-28;28/12/2016;AUTOPISTAS;Gastos_Ocio y transporte;Parking y peaje;12;VARIABLES
31/12/2016;31/12/2016;T/ AUTOPISTAS TERR 28-12-2016;-1,38;21324,90;21323,52;9289;-1,38;21443,52;2016-12-28;28/12/2016;AUTOPISTAS;Gastos_Ocio y transporte;Parking y peaje;12;VARIABLES
31/12/2016;31/12/2016;T/ E.S. RUBI II 28-12-2016;-46,46;21323,52;21277,06;9290;-46,46;21397,06;2016-12-28;28/12/2016;RUBI;Gastos_Ocio y transporte;Gasolina;12;VARIABLES
01/01/2017;01/01/2017;FACT TARJETAS TARJ.CREDITO 07126017 17-01-01;-344,69;21277,06;20932,37;9291;-344,69;21052,37;2017-01-01;31/12/2016;FACT 07126017;Gastos_Banco y organismos;Credito Bea;12;VARIABLE
01/01/2017;01/01/2017;FACT TARJETAS TARJ.CREDITO 42689013 17-01-01;-1023,89;20932,37;19908,48;9292;-1023,89;20028,48;2017-01-01;31/12/2016;FACT;No computable;Recibo Tarjeta;12;
01/01/2017;01/01/2017;T/ VIENA TERRASSA CEN\ 29-12-2016;-12,55;19908,48;19895,93;9293;-12,55;20015,93;2016-12-29;29/12/2016;VIENA;Gastos_Ocio y transporte;Restaurantes;12;VARIABLES
02/01/2017;02/01/2017;T/ FRANKFURT LES LLET\ 30-12-2016;-2,70;19895,93;19893,23;9294;-2,70;20013,23;2016-12-30;30/12/2016;FRANKFURT;Gastos_Ocio y transporte;Restaurantes;12;VARIABLES
02/01/2017;02/01/2017;T/ MCDONALS-CARRE\TARR 30-12-2016;-10,90;19893,23;19882,33;9295;-10,90;20002,33;2016-12-30;30/12/2016;MCDONALSCARRETARR;Gastos_Ocio y transporte;Restaurantes;12;VARIABLES
02/01/2017;02/01/2017;T/ REDPIZZA \ 30-12-2016;-17,65;19882,33;19864,68;9296;-17,65;19984,68;2016-12-30;30/12/2016;REDPIZZA;Gastos_Ocio y transporte;Restaurantes;12;VARIABLES
03/01/2017;03/01/2017;R/ LUZ IBERDROLA CL IBERDROLA OTRO;-7,02;19864,68;19857,66;9297;-7,02;19977,66;2017-01-03;03/01/2017;LUZ;Gastos_Servicios tipicos;Electricidad;1;FIJO
03/01/2017;29/12/2016;T/ AUTOPISTAS TERR;-1,38;19857,66;19856,28;9298;-1,38;19976,28;2016-12-29;29/12/2016;AUTOPISTAS;Gastos_Ocio y transporte;Parking y peaje;12;VARIABLES
03/01/2017;30/12/2016;T/ AUTOPISTAS TERR;-1,38;19856,28;19854,90;9299;-1,38;19974,90;2016-12-30;30/12/2016;AUTOPISTAS;Gastos_Ocio y transporte;Parking y peaje;12;VARIABLES
03/01/2017;30/12/2016;T/ AUTOPISTAS TERR;-1,38;19854,90;19853,52;9300;-1,38;19973,52;2016-12-30;30/12/2016;AUTOPISTAS;Gastos_Ocio y transporte;Parking y peaje;12;VARIABLES
03/01/2017;30/12/2016;T/ CARREFOUR VALLE;-26,33;19853,52;19827,19;9301;-26,33;19947,19;2016-12-30;30/12/2016;CARREFOUR;Gastos_Compras;Supermercado;12;VARIABLES
03/01/2017;03/01/2017;T/ MERCADONA AVDA. EST 31-12-2016;-11,94;19827,19;19815,25;9302;-11,94;19935,25;2016-12-31;31/12/2016;MERCADONA;Gastos_Compras;Supermercado;12;VARIABLES
03/01/2017;03/01/2017;T/ FORN DE PA GERMANS 31-12-2016;-56,70;19815,25;19758,55;9303;-56,70;19878,55;2016-12-31;31/12/2016;FORN;Gastos_Compras;Supermercado;12;VARIABLES
03/01/2017;03/01/2017;T/ VIENA PARC VALLES \ 31-12-2016;-20,00;19758,55;19738,55;9304;-20,00;19858,55;2016-12-31;31/12/2016;VIENA;Gastos_Ocio y transporte;Restaurantes;12;VARIABLES
03/01/2017;03/01/2017;T/ AUTOPISTAS TERR 29-12-2016;-1,38;19738,55;19737,17;9305;-1,38;19857,17;2016-12-29;29/12/2016;AUTOPISTAS;Gastos_Ocio y transporte;Parking y peaje;12;VARIABLES
04/01/2017;04/01/2017;T/ PARC VALLES \TERRASSA;-36,73;19737,17;19700,44;9306;-36,73;19820,44;2017-01-04;04/01/2017;PARC;Gastos_Compras;Supermercado;1;VARIABLES
05/01/2017;03/01/2017;DEV.COMPRA TJ AMAZON.ES COMPRA;53,80;19700,44;19754,24;9307;53,80;19874,24;2017-01-03;03/01/2017;DEVCOMPRA;Ingresos;Devoluciones;1;VARIABLES
05/01/2017;05/01/2017;T/ PORTAVENTURA HOTE\V 02-01-2017;-46,20;19754,24;19708,04;9308;-46,20;19828,04;2017-01-02;02/01/2017;PORTAVENTURA;Gastos_Ocio y transporte;Vacaciones;1;VARIABLES
05/01/2017;05/01/2017;T/ PORTAVENTURA REST\V 02-01-2017;-36,30;19708,04;19671,74;9309;-36,30;19791,74;2017-01-02;02/01/2017;PORTAVENTURA;Gastos_Ocio y transporte;Vacaciones;1;VARIABLES
06/01/2017;06/01/2017;R/ LUZ IBERDROLA CL IBERDROLA OTRO;-11,18;19671,74;19660,56;9310;-11,18;19780,56;2017-01-06;06/01/2017;LUZ;Gastos_Servicios tipicos;Electricidad;1;FIJO
06/01/2017;06/01/2017;T/ AUTOPISTAS TERR 03-01-2017;-1,39;19660,56;19659,17;9311;-1,39;19779,17;2017-01-03;03/01/2017;AUTOPISTAS;Gastos_Ocio y transporte;Parking y peaje;1;VARIABLES
06/01/2017;06/01/2017;T/ PORTAVENTURA REST\V 03-01-2017;-68,80;19659,17;19590,37;9312;-68,80;19710,37;2017-01-03;03/01/2017;PORTAVENTURA;Gastos_Ocio y transporte;Vacaciones;1;VARIABLES
06/01/2017;06/01/2017;T/ A.C.E.S.A SALOU-B M 03-01-2017;-10,50;19590,37;19579,87;9313;-10,50;19699,87;2017-01-03;03/01/2017;ACESA;Gastos_Ocio y transporte;Parking y peaje;1;VARIABLES
06/01/2017;06/01/2017;T/ PORTAVENTURA REST\V 03-01-2017;-10,10;19579,87;19569,77;9314;-10,10;19689,77;2017-01-03;03/01/2017;PORTAVENTURA;Gastos_Ocio y transporte;Vacaciones;1;VARIABLES
06/01/2017;06/01/2017;T/ PORTAVENTURA REST\V 03-01-2017;-4,00;19569,77;19565,77;9315;-4,00;19685,77;2017-01-03;03/01/2017;PORTAVENTURA;Gastos_Ocio y transporte;Vacaciones;1;VARIABLES
07/01/2017;07/01/2017;T/ CINESA PARC VALLES\ 04-01-2017;-12,10;19565,77;19553,67;9316;-12,10;19673,67;2017-01-04;04/01/2017;CINESA;Gastos_Ocio y transporte;Espectáculos;1;VARIABLES
07/01/2017;07/01/2017;T/ CINESA PARC VALLES\ 04-01-2017;-19,60;19553,67;19534,07;9317;-19,60;19654,07;2017-01-04;04/01/2017;CINESA;Gastos_Ocio y transporte;Espectáculos;1;VARIABLES
08/01/2017;08/01/2017;T/ WWW.JUST-EAT.ES 05-01-2017;-25,74;19534,07;19508,33;9318;-25,74;19628,33;2017-01-05;05/01/2017;WWWJUSTEATES;Gastos_Ocio y transporte;Restaurantes;1;VARIABLES
09/01/2017;09/01/2017;R/ BLITZ 40, S. Alquiler mes en c;-72,50;19508,33;19435,83;9319;-72,50;19555,83;2017-01-09;09/01/2017;BLITZ;Gastos_Vivienda y vehiculo;Alquiler Parking;1;FIJO
10/01/2017;10/01/2017;T/ VIENA PARC VALLES \ 07-01-2017;-3,10;19435,83;19432,73;9320;-3,10;19552,73;2017-01-07;07/01/2017;VIENA;Gastos_Ocio y transporte;Restaurantes;1;VARIABLES
10/01/2017;10/01/2017;T/ DRIM PARC VALLES 07-01-2017;-17,99;19432,73;19414,74;9321;-17,99;19534,74;2017-01-07;07/01/2017;DRIM;Gastos_Compras;Niños;1;VARIABLES
10/01/2017;10/01/2017;T/ TERRACASA \ 07-01-2017;-42,20;19414,74;19372,54;9322;-42,20;19492,54;2017-01-07;07/01/2017;TERRACASA;Gastos_Compras;Otras compras;1;VARIABLES
12/01/2017;12/01/2017;R/ GAS GAS NATURAL GNS27630480117;-4,57;19372,54;19367,97;9323;-4,57;19487,97;2017-01-12;12/01/2017;GAS;Gastos_Servicios tipicos;Gas;1;FIJO
12/01/2017;10/01/2017;T/ Amazon *Mktplce EU-ES;-7,99;19367,97;19359,98;9324;-7,99;19479,98;2017-01-10;10/01/2017;AMAZON;Gastos_Compras;Hobbys;1;VARIABLES
12/01/2017;10/01/2017;T/ AMAZON.ES COMPRA;-21,91;19359,98;19338,07;9325;-21,91;19458,07;2017-01-10;10/01/2017;AMAZONES;Gastos_Compras;Hobbys;1;VARIABLES
12/01/2017;12/01/2017;T/ E.S.RUBI 9 09-01-2017;-44,73;19338,07;19293,34;9326;-44,73;19413,34;2017-01-09;09/01/2017;ESRUBI;Gastos_Ocio y transporte;Gasolina;1;VARIABLES
12/01/2017;12/01/2017;T/ AUTOPISTAS TERR 09-01-2017;-1,39;19293,34;19291,95;9327;-1,39;19411,95;2017-01-09;09/01/2017;AUTOPISTAS;Gastos_Ocio y transporte;Parking y peaje;1;VARIABLES
12/01/2017;12/01/2017;T/ BON AREA 09-01-2017;-23,51;19291,95;19268,44;9328;-23,51;19388,44;2017-01-09;09/01/2017;BON;Gastos_Compras;Supermercado;1;VARIABLES
12/01/2017;12/01/2017;T/ AUTOPISTAS TERR 09-01-2017;-1,39;19268,44;19267,05;9329;-1,39;19387,05;2017-01-09;09/01/2017;AUTOPISTAS;Gastos_Ocio y transporte;Parking y peaje;1;VARIABLES
12/01/2017;12/01/2017;T/ TUNELS VALLVI S. 09-01-2017;-4,18;19267,05;19262,87;9330;-4,18;19382,87;2017-01-09;09/01/2017;TUNELS;Gastos_Ocio y transporte;Parking y peaje;1;VARIABLES
12/01/2017;12/01/2017;T/ FRANKFURT LES LLET\ 09-01-2017;-2,70;19262,87;19260,17;9331;-2,70;19380,17;2017-01-09;09/01/2017;FRANKFURT;Gastos_Ocio y transporte;Restaurantes;1;VARIABLES
12/01/2017;12/01/2017;T/ FARMACIA TORRAS \ 09-01-2017;-11,50;19260,17;19248,67;9332;-11,50;19368,67;2017-01-09;09/01/2017;FARMACIA;Gastos_Salud, saber y deporte;Farmacia;1;VARIABLES
12/01/2017;12/01/2017;T/ CAFET.C T PRAT\PRAT 09-01-2017;-3,60;19248,67;19245,07;9333;-3,60;19365,07;2017-01-09;09/01/2017;CAFETC;Gastos_Ocio y transporte;Restaurantes;1;VARIABLES
13/01/2017;13/01/2017;R/ SEGUROS ADESLAS CENT MODULAR CO;-113,89;19245,07;19131,18;9334;-113,89;19251,18;2017-01-13;13/01/2017;ADESLAS;Gastos_Salud, saber y deporte;Medico;1;VARIABLES
13/01/2017;13/01/2017;T/ CAFET.C T PRAT\PRAT 10-01-2017;-3,60;19131,18;19127,58;9335;-3,60;19247,58;2017-01-10;10/01/2017;CAFETC;Gastos_Ocio y transporte;Restaurantes;1;VARIABLES
13/01/2017;13/01/2017;T/ BON AREA 10-01-2017;-20,44;19127,58;19107,14;9336;-20,44;19227,14;2017-01-10;10/01/2017;BON;Gastos_Compras;Supermercado;1;VARIABLES
13/01/2017;13/01/2017;T/ AUTOPISTAS TERR 10-01-2017;-1,39;19107,14;19105,75;9337;-1,39;19225,75;2017-01-10;10/01/2017;AUTOPISTAS;Gastos_Ocio y transporte;Parking y peaje;1;VARIABLES
13/01/2017;13/01/2017;T/ AUTOPISTAS TERR 10-01-2017;-1,39;19105,75;19104,36;9338;-1,39;19224,36;2017-01-10;10/01/2017;AUTOPISTAS;Gastos_Ocio y transporte;Parking y peaje;1;VARIABLES
13/01/2017;13/01/2017;T/ TUNELS VALLVI S. 10-01-2017;-4,18;19104,36;19100,18;9339;-4,18;19220,18;2017-01-10;10/01/2017;TUNELS;Gastos_Ocio y transporte;Parking y peaje;1;VARIABLES
13/01/2017;13/01/2017;T/ FRANKFURT LES LLET\ 10-01-2017;-2,70;19100,18;19097,48;9340;-2,70;19217,48;2017-01-10;10/01/2017;FRANKFURT;Gastos_Ocio y transporte;Restaurantes;1;VARIABLES
13/01/2017;13/01/2017;T/ VIENA PARC VALLES \ 10-01-2017;-21,60;19097,48;19075,88;9341;-21,60;19195,88;2017-01-10;10/01/2017;VIENA;Gastos_Ocio y transporte;Restaurantes;1;VARIABLES
13/01/2017;13/01/2017;T/ RODELAS PERRUQUERS\ 10-01-2017;-36,51;19075,88;19039,37;9342;-36,51;19159,37;2017-01-10;10/01/2017;RODELAS;Gastos_Salud, saber y deporte;Belleza;1;VARIABLES
14/01/2017;14/01/2017;T/ AUTOPISTAS TERR 11-01-2017;-1,39;19039,37;19037,98;9343;-1,39;19157,98;2017-01-11;11/01/2017;AUTOPISTAS;Gastos_Ocio y transporte;Parking y peaje;1;VARIABLES
14/01/2017;14/01/2017;T/ TUNELS VALLVI S. 11-01-2017;-4,18;19037,98;19033,80;9344;-4,18;19153,80;2017-01-11;11/01/2017;TUNELS;Gastos_Ocio y transporte;Parking y peaje;1;VARIABLES
14/01/2017;14/01/2017;T/ AUTOPISTAS TERR 11-01-2017;-1,39;19033,80;19032,41;9345;-1,39;19152,41;2017-01-11;11/01/2017;AUTOPISTAS;Gastos_Ocio y transporte;Parking y peaje;1;VARIABLES
14/01/2017;14/01/2017;T/ FRANKFURT LES LLET\ 11-01-2017;-2,70;19032,41;19029,71;9346;-2,70;19149,71;2017-01-11;11/01/2017;FRANKFURT;Gastos_Ocio y transporte;Restaurantes;1;VARIABLES
14/01/2017;14/01/2017;T/ CAFET.C T PRAT\PRAT 11-01-2017;-3,35;19029,71;19026,36;9347;-3,35;19146,36;2017-01-11;11/01/2017;CAFETC;Gastos_Ocio y transporte;Restaurantes;1;VARIABLES
15/01/2017;15/01/2017;T/ CAFET.C T PRAT\PRAT 12-01-2017;-3,65;19026,36;19022,71;9348;-3,65;19142,71;2017-01-12;12/01/2017;CAFETC;Gastos_Ocio y transporte;Restaurantes;1;VARIABLES
15/01/2017;15/01/2017;T/ CAPRABO \ 12-01-2017;-16,46;19022,71;19006,25;9349;-16,46;19126,25;2017-01-12;12/01/2017;CAPRABO;Gastos_Compras;Supermercado;1;VARIABLES
15/01/2017;15/01/2017;T/ AUTOPISTAS TERR 12-01-2017;-1,39;19006,25;19004,86;9350;-1,39;19124,86;2017-01-12;12/01/2017;AUTOPISTAS;Gastos_Ocio y transporte;Parking y peaje;1;VARIABLES
15/01/2017;15/01/2017;T/ TUNELS VALLVI S. 12-01-2017;-3,72;19004,86;19001,14;9351;-3,72;19121,14;2017-01-12;12/01/2017;TUNELS;Gastos_Ocio y transporte;Parking y peaje;1;VARIABLES
15/01/2017;15/01/2017;T/ AUTOPISTAS TERR 12-01-2017;-1,39;19001,14;18999,75;9352;-1,39;19119,75;2017-01-12;12/01/2017;AUTOPISTAS;Gastos_Ocio y transporte;Parking y peaje;1;VARIABLES
15/01/2017;15/01/2017;T/ FRANKFURT LES LLET\ 12-01-2017;-2,70;18999,75;18997,05;9353;-2,70;19117,05;2017-01-12;12/01/2017;FRANKFURT;Gastos_Ocio y transporte;Restaurantes;1;VARIABLES
16/01/2017;16/01/2017;R/ SERHS FOOD A MENJADOR SERHS GE;-101,15;18997,05;18895,90;9354;-101,15;19015,90;2017-01-16;16/01/2017;SERHS;Gastos_Salud, saber y deporte;Menjador;1;FIJO
16/01/2017;16/01/2017;R/ SERHS FOOD A MENJADOR SERHS GE;-98,77;18895,90;18797,13;9355;-98,77;18917,13;2017-01-16;16/01/2017;SERHS;Gastos_Salud, saber y deporte;Menjador;1;FIJO
16/01/2017;16/01/2017;T/ VIENA PARC VALLES \ 13-01-2017;-11,60;18797,13;18785,53;9356;-11,60;18905,53;2017-01-13;13/01/2017;VIENA;Gastos_Ocio y transporte;Restaurantes;1;VARIABLES
16/01/2017;16/01/2017;T/ FRANKFURT LES LLET\ 13-01-2017;-3,90;18785,53;18781,63;9357;-3,90;18901,63;2017-01-13;13/01/2017;FRANKFURT;Gastos_Ocio y transporte;Restaurantes;1;VARIABLES
16/01/2017;16/01/2017;T/ FRANKFURT LES LLET\ 13-01-2017;-2,70;18781,63;18778,93;9358;-2,70;18898,93;2017-01-13;13/01/2017;FRANKFURT;Gastos_Ocio y transporte;Restaurantes;1;VARIABLES
16/01/2017;16/01/2017;T/ CAFET.C T PRAT\PRAT 13-01-2017;-3,65;18778,93;18775,28;9359;-3,65;18895,28;2017-01-13;13/01/2017;CAFETC;Gastos_Ocio y transporte;Restaurantes;1;VARIABLES
17/01/2017;17/01/2017;R/ SEGUROS CCM VIDA Y P Recibo:141;-20,37;18775,28;18754,91;9360;-20,37;18874,91;2017-01-17;17/01/2017;CCM;Gastos_Seguros;Seguro vida;1;FIJO
17/01/2017;17/01/2017;R/ SEGUROS CCM VIDA Y P Recibo:140;-16,84;18754,91;18738,07;9361;-16,84;18858,07;2017-01-17;17/01/2017;CCM;Gastos_Seguros;Seguro vida;1;FIJO
17/01/2017;17/01/2017;R/ TELECOMUNICACI VODAFONE;-126,86;18738,07;18611,21;9362;-126,86;18731,21;2017-01-17;17/01/2017;TELECOMUNICACI;Gastos_Servicios tipicos;Telecomunicaciones;1;FIJO
18/01/2017;18/01/2017;T/ REDPIZZA \ 15-01-2017;-17,65;18611,21;18593,56;9363;-17,65;18713,56;2017-01-15;15/01/2017;REDPIZZA;Gastos_Ocio y transporte;Restaurantes;1;VARIABLES
18/01/2017;18/01/2017;T/ AUTOPISTAS TERR 13-01-2017;-1,39;18593,56;18592,17;9364;-1,39;18712,17;2017-01-13;13/01/2017;AUTOPISTAS;Gastos_Ocio y transporte;Parking y peaje;1;VARIABLES
18/01/2017;18/01/2017;T/ TUNELS VALLVI S. 13-01-2017;-3,72;18592,17;18588,45;9365;-3,72;18708,45;2017-01-13;13/01/2017;TUNELS;Gastos_Ocio y transporte;Parking y peaje;1;VARIABLES
18/01/2017;18/01/2017;T/ AUTOPISTAS TERR 13-01-2017;-1,39;18588,45;18587,06;9366;-1,39;18707,06;2017-01-13;13/01/2017;AUTOPISTAS;Gastos_Ocio y transporte;Parking y peaje;1;VARIABLES
19/01/2017;19/01/2017;R/ LUZ ENDESA ENERG FACTURA DE ELE;-98,92;18587,06;18488,14;9367;-98,92;18608,14;2017-01-19;19/01/2017;ELE;Gastos_Servicios tipicos;Electricidad;1;FIJO
19/01/2017;19/01/2017;T/ MERCADONA QUATRE C\ 16-01-2017;-11,70;18488,14;18476,44;9368;-11,70;18596,44;2017-01-16;16/01/2017;MERCADONA;Gastos_Compras;Supermercado;1;VARIABLES
19/01/2017;19/01/2017;T/ AUTOPISTAS TERR 16-01-2017;-1,39;18476,44;18475,05;9369;-1,39;18595,05;2017-01-16;16/01/2017;AUTOPISTAS;Gastos_Ocio y transporte;Parking y peaje;1;VARIABLES
19/01/2017;19/01/2017;T/ FRANKFURT LES LLET\ 16-01-2017;-2,70;18475,05;18472,35;9370;-2,70;18592,35;2017-01-16;16/01/2017;FRANKFURT;Gastos_Ocio y transporte;Restaurantes;1;VARIABLES
19/01/2017;19/01/2017;T/ TUNELS VALLVI S. 16-01-2017;-3,72;18472,35;18468,63;9371;-3,72;18588,63;2017-01-16;16/01/2017;TUNELS;Gastos_Ocio y transporte;Parking y peaje;1;VARIABLES
19/01/2017;19/01/2017;T/ AUTOPISTAS TERR 16-01-2017;-1,39;18468,63;18467,24;9372;-1,39;18587,24;2017-01-16;16/01/2017;AUTOPISTAS;Gastos_Ocio y transporte;Parking y peaje;1;VARIABLES
19/01/2017;19/01/2017;T/ CAFET.C T PRAT\PRAT 16-01-2017;-3,00;18467,24;18464,24;9373;-3,00;18584,24;2017-01-16;16/01/2017;CAFETC;Gastos_Ocio y transporte;Restaurantes;1;VARIABLES
20/01/2017;20/01/2017;T/ AUTOPISTAS TERR 17-01-2017;-1,39;18464,24;18462,85;9374;-1,39;18582,85;2017-01-17;17/01/2017;AUTOPISTAS;Gastos_Ocio y transporte;Parking y peaje;1;VARIABLES
20/01/2017;20/01/2017;T/ FRANKFURT LES LLET\ 17-01-2017;-2,70;18462,85;18460,15;9375;-2,70;18580,15;2017-01-17;17/01/2017;FRANKFURT;Gastos_Ocio y transporte;Restaurantes;1;VARIABLES
20/01/2017;20/01/2017;T/ AUTOPISTAS TERR 17-01-2017;-1,39;18460,15;18458,76;9376;-1,39;18578,76;2017-01-17;17/01/2017;AUTOPISTAS;Gastos_Ocio y transporte;Parking y peaje;1;VARIABLES
21/01/2017;21/01/2017;T/ DRIM PARC VALLES 18-01-2017;-7,98;18458,76;18450,78;9377;-7,98;18570,78;2017-01-18;18/01/2017;DRIM;Gastos_Compras;Niños;1;VARIABLES
21/01/2017;21/01/2017;T/ AUTOPISTAS TERR 18-01-2017;-1,39;18450,78;18449,39;9378;-1,39;18569,39;2017-01-18;18/01/2017;AUTOPISTAS;Gastos_Ocio y transporte;Parking y peaje;1;VARIABLES
21/01/2017;21/01/2017;T/ CAPRABO - 427 TERR\ 18-01-2017;-17,41;18449,39;18431,98;9379;-17,41;18551,98;2017-01-18;18/01/2017;CAPRABO;Gastos_Compras;Supermercado;1;VARIABLES
22/01/2017;22/01/2017;T/ TUNELS VALLVI S. 19-01-2017;-3,72;18431,98;18428,26;9380;-3,72;18548,26;2017-01-19;19/01/2017;TUNELS;Gastos_Ocio y transporte;Parking y peaje;1;VARIABLES
22/01/2017;22/01/2017;T/ AUTOPISTAS TERR 19-01-2017;-1,39;18428,26;18426,87;9381;-1,39;18546,87;2017-01-19;19/01/2017;AUTOPISTAS;Gastos_Ocio y transporte;Parking y peaje;1;VARIABLES
22/01/2017;22/01/2017;T/ CAPRABO \ 19-01-2017;-5,99;18426,87;18420,88;9382;-5,99;18540,88;2017-01-19;19/01/2017;CAPRABO;Gastos_Compras;Supermercado;1;VARIABLES
22/01/2017;22/01/2017;T/ CAFET.C T PRAT\PRAT 19-01-2017;-3,45;18420,88;18417,43;9383;-3,45;18537,43;2017-01-19;19/01/2017;CAFETC;Gastos_Ocio y transporte;Restaurantes;1;VARIABLES
23/01/2017;23/01/2017;T/ FRANKFURT LES LLET\ 20-01-2017;-2,70;18417,43;18414,73;9384;-2,70;18534,73;2017-01-20;20/01/2017;FRANKFURT;Gastos_Ocio y transporte;Restaurantes;1;VARIABLES
23/01/2017;23/01/2017;T/ PARC VALLES \ 20-01-2017;-62,18;18414,73;18352,55;9385;-62,18;18472,55;2017-01-20;20/01/2017;PARC;Gastos_Compras;Supermercado;1;VARIABLES
23/01/2017;23/01/2017;T/ CAFET.C T PRAT\PRAT 20-01-2017;-3,60;18352,55;18348,95;9386;-3,60;18468,95;2017-01-20;20/01/2017;CAFETC;Gastos_Ocio y transporte;Restaurantes;1;VARIABLES
24/01/2017;24/01/2017;T/ AUTOPISTAS TERR 20-01-2017;-1,39;18348,95;18347,56;9387;-1,39;18467,56;2017-01-20;20/01/2017;AUTOPISTAS;Gastos_Ocio y transporte;Parking y peaje;1;VARIABLES
24/01/2017;24/01/2017;T/ AUTOPISTAS TERR 20-01-2017;-1,39;18347,56;18346,17;9388;-1,39;18466,17;2017-01-20;20/01/2017;AUTOPISTAS;Gastos_Ocio y transporte;Parking y peaje;1;VARIABLES
25/01/2017;25/01/2017;T/ TUNELS VALLVI S. 20-01-2017;-3,72;18346,17;18342,45;9389;-3,72;18462,45;2017-01-20;20/01/2017;TUNELS;Gastos_Ocio y transporte;Parking y peaje;1;VARIABLES
26/01/2017;26/01/2017;T/ AUTOPISTAS TERR 23-01-2017;-1,39;18342,45;18341,06;9390;-1,39;18461,06;2017-01-23;23/01/2017;AUTOPISTAS;Gastos_Ocio y transporte;Parking y peaje;1;VARIABLES
27/01/2017;27/01/2017;HAB. FOMENT DE TERRASSA S.A. Transf;1789,68;18341,06;20130,74;9391;1789,68;20250,74;2017-01-27;27/01/2017;HAB;Ingresos;Nomina;1;FIJO
27/01/2017;27/01/2017;O/ CASER, S.A. /FRA/1630872146600;120,15;20130,74;20250,89;9392;120,15;20370,89;2017-01-27;27/01/2017;CASER;Ingresos;Transferencias;1;VARIABLES
27/01/2017;27/01/2017;T/ FRANKFURT LES LLET\ 24-01-2017;-20,30;20250,89;20230,59;9393;-20,30;20350,59;2017-01-24;24/01/2017;FRANKFURT;Gastos_Ocio y transporte;Restaurantes;1;VARIABLES
27/01/2017;27/01/2017;T/ TUNELS VALLVI S. 24-01-2017;-4,18;20230,59;20226,41;9394;-4,18;20346,41;2017-01-24;24/01/2017;TUNELS;Gastos_Ocio y transporte;Parking y peaje;1;VARIABLES
27/01/2017;27/01/2017;T/ AUTOPISTAS TERR 24-01-2017;-1,39;20226,41;20225,02;9395;-1,39;20345,02;2017-01-24;24/01/2017;AUTOPISTAS;Gastos_Ocio y transporte;Parking y peaje;1;VARIABLES
27/01/2017;27/01/2017;T/ CAFET.C T PRAT\PRAT 24-01-2017;-3,45;20225,02;20221,57;9396;-3,45;20341,57;2017-01-24;24/01/2017;CAFETC;Gastos_Ocio y transporte;Restaurantes;1;VARIABLES
28/01/2017;28/01/2017;T/ CAFET.C T PRAT\PRAT 25-01-2017;-3,65;20221,57;20217,92;9397;-3,65;20337,92;2017-01-25;25/01/2017;CAFETC;Gastos_Ocio y transporte;Restaurantes;1;VARIABLES
28/01/2017;28/01/2017;T/ AUTOPISTAS TERR 25-01-2017;-1,39;20217,92;20216,53;9398;-1,39;20336,53;2017-01-25;25/01/2017;AUTOPISTAS;Gastos_Ocio y transporte;Parking y peaje;1;VARIABLES
28/01/2017;28/01/2017;T/ TUNELS VALLVI S. 25-01-2017;-3,72;20216,53;20212,81;9399;-3,72;20332,81;2017-01-25;25/01/2017;TUNELS;Gastos_Ocio y transporte;Parking y peaje;1;VARIABLES
28/01/2017;28/01/2017;T/ AUTOPISTAS TERR 25-01-2017;-1,39;20212,81;20211,42;9400;-1,39;20331,42;2017-01-25;25/01/2017;AUTOPISTAS;Gastos_Ocio y transporte;Parking y peaje;1;VARIABLES
29/01/2017;29/01/2017;T/ AUTOPISTAS TERR 26-01-2017;-1,39;20211,42;20210,03;9401;-1,39;20330,03;2017-01-26;26/01/2017;AUTOPISTAS;Gastos_Ocio y transporte;Parking y peaje;1;VARIABLES
29/01/2017;29/01/2017;T/ FRANKFURT LES LLET\ 26-01-2017;-2,90;20210,03;20207,13;9402;-2,90;20327,13;2017-01-26;26/01/2017;FRANKFURT;Gastos_Ocio y transporte;Restaurantes;1;VARIABLES
29/01/2017;29/01/2017;T/ VIENA PARC VALLES \ 26-01-2017;-10,70;20207,13;20196,43;9403;-10,70;20316,43;2017-01-26;26/01/2017;VIENA;Gastos_Ocio y transporte;Restaurantes;1;VARIABLES
29/01/2017;29/01/2017;T/ FARMA.ANGEL MORENO\ 26-01-2017;-22,87;20196,43;20173,56;9404;-22,87;20293,56;2017-01-26;26/01/2017;FARMAANGEL;Gastos_Salud, saber y deporte;Farmacia;1;VARIABLES
29/01/2017;29/01/2017;T/ WWW.JUST-EAT.ES 26-01-2017;-16,20;20173,56;20157,36;9405;-16,20;20277,36;2017-01-26;26/01/2017;WWWJUSTEATES;Gastos_Ocio y transporte;Restaurantes;1;VARIABLES
30/01/2017;30/01/2017;HAB. INFORMACIO I TECNOLOGIA DE CAT;1623,02;20157,36;21780,38;9406;1623,02;21900,38;2017-01-30;30/01/2017;HAB;Ingresos;Nomina;1;FIJO
30/01/2017;30/01/2017;T/ CAFET.C T PRAT\PRAT 27-01-2017;-3,65;21780,38;21776,73;9407;-3,65;21896,73;2017-01-27;27/01/2017;CAFETC;Gastos_Ocio y transporte;Restaurantes;1;VARIABLES
31/01/2017;31/01/2017;R/ AJUNTAMENT D I.B.I. CA D.ALBI;-45,65;21776,73;21731,08;9408;-45,65;21851,08;2017-01-31;31/01/2017;AJUNTAMENT;Gastos_Banco y organismos;Ayuntamiento;1;FIJO
31/01/2017;31/01/2017;REC. 6061.9600001223;-485,11;21731,08;21245,97;9409;-485,11;21365,97;2017-01-31;31/01/2017;REC;Gastos_Banco y organismos;Hipoteca;1;FIJO
31/01/2017;31/01/2017;T/ AUTOPISTAS TERR 27-01-2017;-1,39;21245,97;21244,58;9410;-1,39;21364,58;2017-01-27;27/01/2017;AUTOPISTAS;Gastos_Ocio y transporte;Parking y peaje;1;VARIABLES
31/01/2017;31/01/2017;T/ AUTOPISTAS TERR 27-01-2017;-1,39;21244,58;21243,19;9411;-1,39;21363,19;2017-01-27;27/01/2017;AUTOPISTAS;Gastos_Ocio y transporte;Parking y peaje;1;VARIABLES
31/01/2017;31/01/2017;LIMPIEZA REDUCIMOS EFECTIVO 15/12 -200;-120,00;21243,19;21123,19;9412;-120,00;21243,19;2017-01-31;31/01/2017;LIMPIEZA;Gastos_Vivienda y vehiculo;Serv. domestico;1;FIJO
01/02/2017;01/02/2017;FACT TARJETAS TARJ.CREDITO 07126017 17-02-01;-226,59;21243,19;21016,60;9413;-226,59;21016,60;2017-02-01;31/01/2017;FACT 07126017;Gastos_Banco y organismos;Credito Bea;1;VARIABLE
01/02/2017;01/02/2017;FACT TARJETAS TARJ.CREDITO 42689013 17-02-01;-310,49;21016,60;20706,11;9414;-310,49;20706,11;2017-02-01;31/01/2017;FACT;No computable;Recibo Tarjeta;1;
01/02/2017;01/02/2017;T/ TUNELS VALLVI S. 27-01-2017;-4,18;20706,11;20701,93;9415;-4,18;20701,93;2017-01-27;27/01/2017;TUNELS;Gastos_Ocio y transporte;Parking y peaje;1;VARIABLES
01/02/2017;01/02/2017;T/ CATALANA DIAG.I CIR 26-01-2017;-4,30;20701,93;20697,63;9416;-4,30;20697,63;2017-01-26;26/01/2017;CATALANA;Gastos_Ocio y transporte;Parking y peaje;1;VARIABLES
02/02/2017;02/02/2017;T/ CAPRABO \ 30-01-2017;-6,54;20697,63;20691,09;9417;-6,54;20691,09;2017-01-30;30/01/2017;CAPRABO;Gastos_Compras;Supermercado;1;VARIABLES
03/02/2017;03/02/2017;R/ SEGUROS ADESLAS CENT MODULAR CO;-113,89;20691,09;20577,20;9418;-113,89;20577,20;2017-02-03;03/02/2017;ADESLAS;Gastos_Salud, saber y deporte;Medico;2;VARIABLES
03/02/2017;03/02/2017;T/ BON AREA 31-01-2017;-32,03;20577,20;20545,17;9419;-32,03;20545,17;2017-01-31;31/01/2017;BON;Gastos_Compras;Supermercado;1;VARIABLES
04/02/2017;04/02/2017;T/ EL SALON THE BARBE\ 01-02-2017;-47,98;20545,17;20497,19;9420;-47,98;20497,19;2017-02-01;01/02/2017;SALON;Gastos_Salud, saber y deporte;Belleza;2;VARIABLES
04/02/2017;04/02/2017;T/ FRANKFURT LES LLET\ 01-02-2017;-2,90;20497,19;20494,29;9421;-2,90;20494,29;2017-02-01;01/02/2017;FRANKFURT;Gastos_Ocio y transporte;Restaurantes;2;VARIABLES
04/02/2017;04/02/2017;T/ CAPRABO \ 01-02-2017;-8,11;20494,29;20486,18;9422;-8,11;20486,18;2017-02-01;01/02/2017;CAPRABO;Gastos_Compras;Supermercado;2;VARIABLES
05/02/2017;05/02/2017;T/ FRANKFURT LES LLET\ 02-02-2017;-2,70;20486,18;20483,48;9423;-2,70;20483,48;2017-02-02;02/02/2017;FRANKFURT;Gastos_Ocio y transporte;Restaurantes;2;VARIABLES
05/02/2017;05/02/2017;T/ FRANKFURT LES LLET\ 02-02-2017;-14,65;20483,48;20468,83;9424;-14,65;20468,83;2017-02-02;02/02/2017;FRANKFURT;Gastos_Ocio y transporte;Restaurantes;2;VARIABLES
06/02/2017;06/02/2017;R/ SERHS FOOD A SERHS SALA I BADR;-113,05;20468,83;20355,78;9425;-113,05;20355,78;2017-02-06;06/02/2017;SERHS;Gastos_Salud, saber y deporte;Menjador;2;FIJO
06/02/2017;06/02/2017;R/ SERHS FOOD A SERHS SALA I BADR;-113,05;20355,78;20242,73;9426;-113,05;20242,73;2017-02-06;06/02/2017;SERHS;Gastos_Salud, saber y deporte;Menjador;2;FIJO
06/02/2017;06/02/2017;R/ BLITZ 40, S. Alquiler mes en c;-72,50;20242,73;20170,23;9427;-72,50;20170,23;2017-02-06;06/02/2017;BLITZ;Gastos_Vivienda y vehiculo;Alquiler Parking;2;FIJO
06/02/2017;06/02/2017;R/ LUZ ENDESA ENERG FACTURA DE GAS;-100,38;20170,23;20069,85;9428;-100,38;20069,85;2017-02-06;06/02/2017;GAS;Gastos_Servicios tipicos;Gas;2;FIJO
06/02/2017;06/02/2017;O/ CASER, S.A. /FRA/1730852995100;495,01;20069,85;20564,86;9429;495,01;20564,86;2017-02-06;06/02/2017;CASER;Ingresos;Transferencias;2;VARIABLES
06/02/2017;06/02/2017;T/ IKEA REST. SABADEL\ 03-02-2017;-5,00;20564,86;20559,86;9430;-5,00;20559,86;2017-02-03;03/02/2017;IKEA;Gastos_Vivienda y vehiculo;Mnto. hogar;2;VARIABLES
06/02/2017;06/02/2017;T/ FRANKFURT LES LLET\ 03-02-2017;-5,80;20559,86;20554,06;9431;-5,80;20554,06;2017-02-03;03/02/2017;FRANKFURT;Gastos_Ocio y transporte;Restaurantes;2;VARIABLES
08/02/2017;08/02/2017;CAJ/ BARCELONA;-130,00;20434,06;20304,06;9432;-130,00;20424,06;2017-02-08;08/02/2017;CAJ;Gastos_Gastos varios;Efectivo;2;VARIABLES
09/02/2017;09/02/2017;T/ FRANKFURT LES LLET\ 06-02-2017;-2,90;20304,06;20301,16;9433;-2,90;20421,16;2017-02-06;06/02/2017;FRANKFURT;Gastos_Ocio y transporte;Restaurantes;2;VARIABLES
09/02/2017;09/02/2017;T/ CAPRABO \ 06-02-2017;-7,19;20301,16;20293,97;9434;-7,19;20413,97;2017-02-06;06/02/2017;CAPRABO;Gastos_Compras;Supermercado;2;VARIABLES
10/02/2017;10/02/2017;T/ FRANKFURT LES LLET\ 07-02-2017;-5,70;20293,97;20288,27;9435;-5,70;20408,27;2017-02-07;07/02/2017;FRANKFURT;Gastos_Ocio y transporte;Restaurantes;2;VARIABLES
10/02/2017;10/02/2017;T/ FRANKFURT LES LLET\ 07-02-2017;-2,90;20288,27;20285,37;9436;-2,90;20405,37;2017-02-07;07/02/2017;FRANKFURT;Gastos_Ocio y transporte;Restaurantes;2;VARIABLES
11/02/2017;11/02/2017;T/ RODELAS PERRUQUERS\ 08-02-2017;-12,90;20285,37;20272,47;9437;-12,90;20392,47;2017-02-08;08/02/2017;RODELAS;Gastos_Salud, saber y deporte;Belleza;2;VARIABLES
11/02/2017;11/02/2017;T/ FRANKFURT LES LLET\ 08-02-2017;-2,90;20272,47;20269,57;9438;-2,90;20389,57;2017-02-08;08/02/2017;FRANKFURT;Gastos_Ocio y transporte;Restaurantes;2;VARIABLES
12/02/2017;12/02/2017;T/ NORDEN RESTAURANT \ 09-02-2017;-13,20;20269,57;20256,37;9439;-13,20;20376,37;2017-02-09;09/02/2017;NORDEN;Gastos_Ocio y transporte;Restaurantes;2;VARIABLES
12/02/2017;12/02/2017;T/ FRANKFURT LES LLET\ 09-02-2017;-2,90;20256,37;20253,47;9440;-2,90;20373,47;2017-02-09;09/02/2017;FRANKFURT;Gastos_Ocio y transporte;Restaurantes;2;VARIABLES
13/02/2017;13/02/2017;R/ TELECOMUNICACI VODAFONE;-121,58;20253,47;20131,89;9441;-121,58;20251,89;2017-02-13;13/02/2017;TELECOMUNICACI;Gastos_Servicios tipicos;Telecomunicaciones;2;FIJO
13/02/2017;13/02/2017;R/ GAS GAS NATURAL GNS27630480217;-4,57;20131,89;20127,32;9442;-4,57;20247,32;2017-02-13;13/02/2017;GAS;Gastos_Servicios tipicos;Gas;2;FIJO
13/02/2017;13/02/2017;T/ TOCINERIES VENTURA\ 10-02-2017;-20,99;20127,32;20106,33;9443;-20,99;20226,33;2017-02-10;10/02/2017;TOCINERIES;Gastos_Compras;Supermercado;2;VARIABLES
13/02/2017;13/02/2017;T/ FRANKFURT LES LLET\ 10-02-2017;-2,90;20106,33;20103,43;9444;-2,90;20223,43;2017-02-10;10/02/2017;FRANKFURT;Gastos_Ocio y transporte;Restaurantes;2;VARIABLES
13/02/2017;13/02/2017;T/ CITY HOGAR YAOJI \ 10-02-2017;-10,45;20103,43;20092,98;9445;-10,45;20212,98;2017-02-10;10/02/2017;CITY;Gastos_Compras;Otras compras;2;VARIABLES
14/02/2017;14/02/2017;O/ CASER, S.A. /FRA/1730852995100;500,00;20092,98;20592,98;9446;500,00;20712,98;2017-02-14;14/02/2017;CASER;Ingresos;Transferencias;2;VARIABLES
15/02/2017;15/02/2017;T/ BON AREA 12-02-2017;-10,59;20592,98;20582,39;9447;-10,59;20702,39;2017-02-12;12/02/2017;BON;Gastos_Compras;Supermercado;2;VARIABLES
15/02/2017;15/02/2017;T/ TUNELS VALLVI S. 10-02-2017;-4,18;20582,39;20578,21;9448;-4,18;20698,21;2017-02-10;10/02/2017;TUNELS;Gastos_Ocio y transporte;Parking y peaje;2;VARIABLES
15/02/2017;15/02/2017;T/ AUTOPISTAS TERR 10-02-2017;-1,39;20578,21;20576,82;9449;-1,39;20696,82;2017-02-10;10/02/2017;AUTOPISTAS;Gastos_Ocio y transporte;Parking y peaje;2;VARIABLES
16/02/2017;16/02/2017;R/ SEGUROS CCM VIDA Y P Recibo:141;-16,78;20576,82;20560,04;9450;-16,78;20680,04;2017-02-16;16/02/2017;CCM;Gastos_Seguros;Seguro vida;2;FIJO
16/02/2017;16/02/2017;R/ SEGUROS CCM VIDA Y P Recibo:141;-20,29;20560,04;20539,75;9451;-20,29;20659,75;2017-02-16;16/02/2017;CCM;Gastos_Seguros;Seguro vida;2;FIJO
16/02/2017;16/02/2017;T/ FRANKFURT LES LLET\ 13-02-2017;-2,90;20539,75;20536,85;9452;-2,90;20656,85;2017-02-13;13/02/2017;FRANKFURT;Gastos_Ocio y transporte;Restaurantes;2;VARIABLES
17/02/2017;17/02/2017;T/ CAPRABO \ 14-02-2017;-9,24;20536,85;20527,61;9453;-9,24;20647,61;2017-02-14;14/02/2017;CAPRABO;Gastos_Compras;Supermercado;2;VARIABLES
17/02/2017;17/02/2017;T/ FRANKFURT LES LLET\ 14-02-2017;-2,90;20527,61;20524,71;9454;-2,90;20644,71;2017-02-14;14/02/2017;FRANKFURT;Gastos_Ocio y transporte;Restaurantes;2;VARIABLES
19/02/2017;19/02/2017;T/ FRANKFURT LES LLET\ 16-02-2017;-2,90;20524,71;20521,81;9455;-2,90;20641,81;2017-02-16;16/02/2017;FRANKFURT;Gastos_Ocio y transporte;Restaurantes;2;VARIABLES
19/02/2017;19/02/2017;T/ FRANKFURT LES LLET\ 16-02-2017;-9,50;20521,81;20512,31;9456;-9,50;20632,31;2017-02-16;16/02/2017;FRANKFURT;Gastos_Ocio y transporte;Restaurantes;2;VARIABLES
19/02/2017;19/02/2017;T/ REDPIZZA \ 16-02-2017;-17,65;20512,31;20494,66;9457;-17,65;20614,66;2017-02-16;16/02/2017;REDPIZZA;Gastos_Ocio y transporte;Restaurantes;2;VARIABLES
20/02/2017;20/02/2017;T/ FRANKFURT LES LLET\ 17-02-2017;-2,90;20494,66;20491,76;9458;-2,90;20611,76;2017-02-17;17/02/2017;FRANKFURT;Gastos_Ocio y transporte;Restaurantes;2;VARIABLES
20/02/2017;20/02/2017;T/ MERCADONA QUATRE C\ 17-02-2017;-117,63;20491,76;20374,13;9459;-117,63;20494,13;2017-02-17;17/02/2017;MERCADONA;Gastos_Compras;Supermercado;2;VARIABLES
22/02/2017;20/02/2017;T/ AMAZON.ES COMPRA;-293,21;20374,13;20080,92;9460;-293,21;20200,92;2017-02-20;20/02/2017;AMAZONES;Gastos_Compras;Hobbys;2;VARIABLES
23/02/2017;21/02/2017;T/ AMAZON SPAIN RETAIL AM;-45,79;20080,92;20035,13;9461;-45,79;20155,13;2017-02-21;21/02/2017;AMAZON;Gastos_Compras;Hobbys;2;VARIABLES
23/02/2017;23/02/2017;T/ IKEA REST. SABADEL\ 20-02-2017;-6,90;20035,13;20028,23;9462;-6,90;20148,23;2017-02-20;20/02/2017;IKEA;Gastos_Vivienda y vehiculo;Mnto. hogar;2;VARIABLES
24/02/2017;24/02/2017;HAB. FOMENT DE TERRASSA S.A. Transf;1799,62;20028,23;21827,85;9463;1799,62;21947,85;2017-02-24;24/02/2017;HAB;Ingresos;Nomina;2;FIJO
24/02/2017;24/02/2017;T/ CAPRABO \ 21-02-2017;-8,60;21827,85;21819,25;9464;-8,60;21939,25;2017-02-21;21/02/2017;CAPRABO;Gastos_Compras;Supermercado;2;VARIABLES
25/02/2017;25/02/2017;T/ SATURN E515 EL\PRAT DE LLOB;-194,74;21819,25;21624,51;9465;-194,74;21744,51;2017-02-25;25/02/2017;SATURN;Gastos_Compras;Hobbys;2;VARIABLES
25/02/2017;25/02/2017;T/ BON AREA 22-02-2017;-30,47;21624,51;21594,04;9466;-30,47;21714,04;2017-02-22;22/02/2017;BON;Gastos_Compras;Supermercado;2;VARIABLES
26/02/2017;26/02/2017;T/ PARKING VAPOR GRAN\ 23-02-2017;-3,75;21594,04;21590,29;9467;-3,75;21710,29;2017-02-23;23/02/2017;PARKING;Gastos_Ocio y transporte;Parking y peaje;2;VARIABLES
26/02/2017;26/02/2017;T/ AUTOPISTAS TERR 23-02-2017;-1,39;21590,29;21588,90;9468;-1,39;21708,90;2017-02-23;23/02/2017;AUTOPISTAS;Gastos_Ocio y transporte;Parking y peaje;2;VARIABLES
26/02/2017;26/02/2017;T/ FRANKFURT LES LLET\ 23-02-2017;-6,00;21588,90;21582,90;9469;-6,00;21702,90;2017-02-23;23/02/2017;FRANKFURT;Gastos_Ocio y transporte;Restaurantes;2;VARIABLES
27/02/2017;27/02/2017;HAB. INFORMACIO I TECNOLOGIA DE CAT;1624,31;21582,90;23207,21;9470;1624,31;23327,21;2017-02-27;27/02/2017;HAB;Ingresos;Nomina;2;FIJO
28/02/2017;28/02/2017;REC. 6061.9600001223;-485,11;23207,21;22722,10;9471;-485,11;22842,10;2017-02-28;28/02/2017;REC;Gastos_Banco y organismos;Hipoteca;2;FIJO
28/02/2017;28/02/2017;T/ PCM BARICENTRO\BARB 25-02-2017;-7,95;22722,10;22714,15;9472;-7,95;22834,15;2017-02-25;25/02/2017;PCM;Gastos_Ocio y transporte;Restaurantes;2;VARIABLES
28/02/2017;28/02/2017;T/ PCM BARICENTRO\BARB 25-02-2017;-20,55;22714,15;22693,60;9473;-20,55;22813,60;2017-02-25;25/02/2017;PCM;Gastos_Ocio y transporte;Restaurantes;2;VARIABLES
28/02/2017;28/02/2017;LIMPIEZA REDUCIMOS EFECTIVO 8/2 -250;-120,00;22693,60;22573,60;9474;-120,00;22693,60;2017-02-28;28/02/2017;LIMPIEZA;Gastos_Vivienda y vehiculo;Serv. domestico;2;FIJO
01/03/2017;01/03/2017;FACT TARJETAS TARJ.CREDITO 07126017 17-03-01;-31,88;22693,60;22661,72;9475;-31,88;22661,72;2017-03-01;28/02/2017;FACT 07126017;Gastos_Banco y organismos;Credito Bea;2;VARIABLE
01/03/2017;01/03/2017;FACT TARJETAS TARJ.CREDITO 42689013 17-03-01;-848,78;22661,72;21812,94;9476;-848,78;21812,94;2017-03-01;28/02/2017;FACT;No computable;Recibo Tarjeta;2;
01/03/2017;01/03/2017;CAJ. AJENO SERVIRED \MADRID;-180,00;21692,94;21512,94;9477;-180,00;21632,94;2017-03-01;01/03/2017;CAJ;Gastos_Gastos varios;Efectivo;3;VARIABLES
01/03/2017;01/03/2017;COM. 64970036 SVRED CAJ OFI;-1,87;21512,94;21511,07;9478;-1,87;21631,07;2017-03-01;01/03/2017;COM;Gastos_Banco y organismos;Cargos banco;3;FIJO
01/03/2017;27/02/2017;T/ CARREFOUR VALLE;-33,90;21511,07;21477,17;9479;-33,90;21597,17;2017-02-27;27/02/2017;CARREFOUR;Gastos_Compras;Supermercado;2;VARIABLES
02/03/2017;02/03/2017;T/ AUTOPISTAS TERR 27-02-2017;-1,39;21477,17;21475,78;9480;-1,39;21595,78;2017-02-27;27/02/2017;AUTOPISTAS;Gastos_Ocio y transporte;Parking y peaje;2;VARIABLES
02/03/2017;02/03/2017;T/ 44 MISTER MINIT PR\ 27-02-2017;-16,90;21475,78;21458,88;9481;-16,90;21578,88;2017-02-27;27/02/2017;MISTER;Gastos_Compras;Hogar;2;VARIABLES
03/03/2017;03/03/2017;CAJ. AJENO SISTEMA 4B \TERRASSA;-200,00;21458,88;21258,88;9482;-200,00;21378,88;2017-03-03;03/03/2017;CAJ;Gastos_Gastos varios;Efectivo;3;VARIABLES
03/03/2017;03/03/2017;COM. 76985025 4b CAJ4 OFI9376;-1,85;21258,88;21257,03;9483;-1,85;21377,03;2017-03-03;03/03/2017;COM;Gastos_Banco y organismos;Cargos banco;3;FIJO
03/03/2017;03/03/2017;T/ VIENA PARC VALLES \ 28-02-2017;-18,20;21257,03;21238,83;9484;-18,20;21358,83;2017-02-28;28/02/2017;VIENA;Gastos_Ocio y transporte;Restaurantes;2;VARIABLES
03/03/2017;03/03/2017;T/ CAFET.C T PRAT\PRAT 28-02-2017;-4,25;21238,83;21234,58;9485;-4,25;21354,58;2017-02-28;28/02/2017;CAFETC;Gastos_Ocio y transporte;Restaurantes;2;VARIABLES
03/03/2017;03/03/2017;T/ AUTOPISTAS TERR 28-02-2017;-1,39;21234,58;21233,19;9486;-1,39;21353,19;2017-02-28;28/02/2017;AUTOPISTAS;Gastos_Ocio y transporte;Parking y peaje;2;VARIABLES
03/03/2017;03/03/2017;T/ MERKAL BARICEN\BARB 28-02-2017;-34,99;21233,19;21198,20;9487;-34,99;21318,20;2017-02-28;28/02/2017;MERKAL;Gastos_Compras;Ropa;2;VARIABLES
03/03/2017;03/03/2017;T/ ES LA RIERA \EL PR 28-02-2017;-30,00;21198,20;21168,20;9488;-30,00;21288,20;2017-02-28;28/02/2017;RIERA;Gastos_Ocio y transporte;Gasolina;2;VARIABLES
04/03/2017;26/02/2017;T/ KIABI.ES;-106,50;21168,20;21061,70;9489;-106,50;21181,70;2017-02-26;26/02/2017;KIABIES;Gastos_Compras;Ropa;2;VARIABLES
04/03/2017;04/03/2017;T/ IKEA REST. SABADEL\ 01-03-2017;-14,90;21061,70;21046,80;9490;-14,90;21166,80;2017-03-01;01/03/2017;IKEA;Gastos_Vivienda y vehiculo;Mnto. hogar;3;VARIABLES
04/03/2017;04/03/2017;T/ AUTOPISTAS TERR 01-03-2017;-1,39;21046,80;21045,41;9491;-1,39;21165,41;2017-03-01;01/03/2017;AUTOPISTAS;Gastos_Ocio y transporte;Parking y peaje;3;VARIABLES
04/03/2017;04/03/2017;T/ IKEA REST. SABADEL\ 01-03-2017;-6,50;21045,41;21038,91;9492;-6,50;21158,91;2017-03-01;01/03/2017;IKEA;Gastos_Vivienda y vehiculo;Mnto. hogar;3;VARIABLES
04/03/2017;04/03/2017;T/ IKEA REST. SABADEL\ 01-03-2017;-10,45;21038,91;21028,46;9493;-10,45;21148,46;2017-03-01;01/03/2017;IKEA;Gastos_Vivienda y vehiculo;Mnto. hogar;3;VARIABLES
05/03/2017;05/03/2017;T/ FRANKFURT LES LLET\ 02-03-2017;-2,90;21028,46;21025,56;9494;-2,90;21145,56;2017-03-02;02/03/2017;FRANKFURT;Gastos_Ocio y transporte;Restaurantes;3;VARIABLES
06/03/2017;06/03/2017;T/ BURGUER KING PARC \ 03-03-2017;-21,18;21025,56;21004,38;9495;-21,18;21124,38;2017-03-03;03/03/2017;BURGUER;Gastos_Ocio y transporte;Restaurantes;3;VARIABLES
06/03/2017;06/03/2017;T/ TIGER STORES SPAIN\ 03-03-2017;-20,10;21004,38;20984,28;9496;-20,10;21104,28;2017-03-03;03/03/2017;TIGER;Gastos_Compras;Otras compras;3;VARIABLES
06/03/2017;06/03/2017;T/ CAPRABO - 427 TERR\ 03-03-2017;-15,12;20984,28;20969,16;9497;-15,12;21089,16;2017-03-03;03/03/2017;CAPRABO;Gastos_Compras;Supermercado;3;VARIABLES
06/03/2017;06/03/2017;T/ FRANKFURT LES LLET\ 03-03-2017;-2,90;20969,16;20966,26;9498;-2,90;21086,26;2017-03-03;03/03/2017;FRANKFURT;Gastos_Ocio y transporte;Restaurantes;3;VARIABLES
06/03/2017;06/03/2017;T/ CAFET.C T PRAT\PRAT 03-03-2017;-3,00;20966,26;20963,26;9499;-3,00;21083,26;2017-03-03;03/03/2017;CAFETC;Gastos_Ocio y transporte;Restaurantes;3;VARIABLES
07/03/2017;07/03/2017;R/ SEGUROS ADESLAS CENT MODULAR CO;-144,67;20963,26;20818,59;9500;-144,67;20938,59;2017-03-07;07/03/2017;ADESLAS;Gastos_Salud, saber y deporte;Medico;3;VARIABLES
08/03/2017;08/03/2017;S/OR. CARLOS ROQUE BENEDETTI MAS_CAJ. AJENO SISTEMA 4B \TERRASSA;-300,00;20818,59;20518,59;9501;-300,00;20638,59;2017-03-08;08/03/2017;CARLOS;Gastos_Vivienda y vehiculo;Otros vivienda;3;VARIABLES
08/03/2017;08/03/2017;COM. 64970036 SVRED CAJ OFI;-1,87;20518,59;20516,72;9502;-1,87;20636,72;2017-03-08;08/03/2017;COM;Gastos_Banco y organismos;Cargos banco;3;FIJO
08/03/2017;08/03/2017;S/OR. CARLOS ROQUE BENEDETTI MAS_CAJ. AJENO SISTEMA 4B \TERRASSA;-300,00;20516,72;20216,72;9503;-300,00;20336,72;2017-03-08;08/03/2017;CARLOS;Gastos_Vivienda y vehiculo;Otros vivienda;3;VARIABLES
08/03/2017;08/03/2017;COM. 76985025 4b CAJ4 OFI9376;-1,85;20216,72;20214,87;9504;-1,85;20334,87;2017-03-08;08/03/2017;COM;Gastos_Banco y organismos;Cargos banco;3;FIJO
08/03/2017;08/03/2017;T/ AUTOPISTAS TERR 03-03-2017;-1,39;20214,87;20213,48;9505;-1,39;20333,48;2017-03-03;03/03/2017;AUTOPISTAS;Gastos_Ocio y transporte;Parking y peaje;3;VARIABLES
08/03/2017;08/03/2017;T/ AUTOPISTAS TERR 03-03-2017;-1,39;20213,48;20212,09;9506;-1,39;20332,09;2017-03-03;03/03/2017;AUTOPISTAS;Gastos_Ocio y transporte;Parking y peaje;3;VARIABLES
08/03/2017;08/03/2017;T/ TUNELS VALLVI S. 03-03-2017;-4,18;20212,09;20207,91;9507;-4,18;20327,91;2017-03-03;03/03/2017;TUNELS;Gastos_Ocio y transporte;Parking y peaje;3;VARIABLES
09/03/2017;09/03/2017;R/ SERHS FOOD A SERHS SALA I BADR;-136,85;20207,91;20071,06;9508;-136,85;20191,06;2017-03-09;09/03/2017;SERHS;Gastos_Salud, saber y deporte;Menjador;3;FIJO
09/03/2017;09/03/2017;R/ SERHS FOOD A SERHS SALA I BADR;-136,85;20071,06;19934,21;9509;-136,85;20054,21;2017-03-09;09/03/2017;SERHS;Gastos_Salud, saber y deporte;Menjador;3;FIJO
09/03/2017;09/03/2017;T/ CAFET.C T PRAT\PRAT 06-03-2017;-3,45;19934,21;19930,76;9510;-3,45;20050,76;2017-03-06;06/03/2017;CAFETC;Gastos_Ocio y transporte;Restaurantes;3;VARIABLES
10/03/2017;10/03/2017;R/ FINQUES GASS Vto 01-03-17 Rec;-72,60;19930,76;19858,16;9511;-72,60;19978,16;2017-03-01;01/03/2017;FINQUES;Gastos_Vivienda y vehiculo;Alquiler Parking;3;FIJO
10/03/2017;10/03/2017;T/ CAFET.C T PRAT\PRAT 07-03-2017;-3,35;19858,16;19854,81;9512;-3,35;19974,81;2017-03-07;07/03/2017;CAFETC;Gastos_Ocio y transporte;Restaurantes;3;VARIABLES
10/03/2017;10/03/2017;S/OR. CARLOS ROQUE BENEDETTI MAS_CAJ. AJENO SISTEMA 4B \TERRASSA;-300,00;19854,81;19554,81;9513;-300,00;19674,81;2017-03-10;10/03/2017;CARLOS;Gastos_Vivienda y vehiculo;Otros vivienda;3;VARIABLES
10/03/2017;10/03/2017;COM. 76985025 4b CAJ4 OFI9376;-1,85;19554,81;19552,96;9514;-1,85;19672,96;2017-03-10;10/03/2017;COM;Gastos_Banco y organismos;Cargos banco;3;FIJO
11/03/2017;11/03/2017;T/ FRANKFURT LES LLET\ 08-03-2017;-6,00;19552,96;19546,96;9515;-6,00;19666,96;2017-03-08;08/03/2017;FRANKFURT;Gastos_Ocio y transporte;Restaurantes;3;VARIABLES
11/03/2017;11/03/2017;T/ RODELAS PERRUQUERS\ 08-03-2017;-20,00;19546,96;19526,96;9516;-20,00;19646,96;2017-03-08;08/03/2017;RODELAS;Gastos_Salud, saber y deporte;Belleza;3;VARIABLES
11/03/2017;11/03/2017;T/ AUTOPISTAS TERR 08-03-2017;-1,39;19526,96;19525,57;9517;-1,39;19645,57;2017-03-08;08/03/2017;AUTOPISTAS;Gastos_Ocio y transporte;Parking y peaje;3;VARIABLES
11/03/2017;11/03/2017;T/ LIDL TERRASSA LES \ 08-03-2017;-32,96;19525,57;19492,61;9518;-32,96;19612,61;2017-03-08;08/03/2017;LIDL;Gastos_Compras;Supermercado;3;VARIABLES
11/03/2017;11/03/2017;T/ CAPRABO \ 08-03-2017;-6,50;19492,61;19486,11;9519;-6,50;19606,11;2017-03-08;08/03/2017;CAPRABO;Gastos_Compras;Supermercado;3;VARIABLES
11/03/2017;11/03/2017;T/ CAFET.C T PRAT\PRAT 08-03-2017;-3,65;19486,11;19482,46;9520;-3,65;19602,46;2017-03-08;08/03/2017;CAFETC;Gastos_Ocio y transporte;Restaurantes;3;VARIABLES
12/03/2017;12/03/2017;T/ CAPRABO \ 09-03-2017;-4,04;19482,46;19478,42;9521;-4,04;19598,42;2017-03-09;09/03/2017;CAPRABO;Gastos_Compras;Supermercado;3;VARIABLES
12/03/2017;12/03/2017;T/ AUTOPISTAS TERR 09-03-2017;-1,39;19478,42;19477,03;9522;-1,39;19597,03;2017-03-09;09/03/2017;AUTOPISTAS;Gastos_Ocio y transporte;Parking y peaje;3;VARIABLES
12/03/2017;12/03/2017;T/ AUTOPISTAS TERR 09-03-2017;-1,39;19477,03;19475,64;9523;-1,39;19595,64;2017-03-09;09/03/2017;AUTOPISTAS;Gastos_Ocio y transporte;Parking y peaje;3;VARIABLES
12/03/2017;12/03/2017;T/ TUNELS VALLVI S. 09-03-2017;-4,18;19475,64;19471,46;9524;-4,18;19591,46;2017-03-09;09/03/2017;TUNELS;Gastos_Ocio y transporte;Parking y peaje;3;VARIABLES
12/03/2017;12/03/2017;T/ FRANKFURT LES LLET\ 09-03-2017;-2,90;19471,46;19468,56;9525;-2,90;19588,56;2017-03-09;09/03/2017;FRANKFURT;Gastos_Ocio y transporte;Restaurantes;3;VARIABLES
12/03/2017;12/03/2017;T/ CAFET.C T PRAT\PRAT 09-03-2017;-2,70;19468,56;19465,86;9526;-2,70;19585,86;2017-03-09;09/03/2017;CAFETC;Gastos_Ocio y transporte;Restaurantes;3;VARIABLES
12/03/2017;12/03/2017;T/ TUNELS VALLVI S. 08-03-2017;-4,18;19465,86;19461,68;9527;-4,18;19581,68;2017-03-08;08/03/2017;TUNELS;Gastos_Ocio y transporte;Parking y peaje;3;VARIABLES
13/03/2017;13/03/2017;R/ TELECOMUNICACI VODAFONE;-141,05;19461,68;19320,63;9528;-141,05;19440,63;2017-03-13;13/03/2017;TELECOMUNICACI;Gastos_Servicios tipicos;Telecomunicaciones;3;FIJO
13/03/2017;13/03/2017;R/ GAS GAS NATURAL GNS27630480317;-4,57;19320,63;19316,06;9529;-4,57;19436,06;2017-03-13;13/03/2017;GAS;Gastos_Servicios tipicos;Gas;3;FIJO
13/03/2017;13/03/2017;R/ LUZ ENDESA ENERG FACTURA DE ELE;-113,64;19316,06;19202,42;9530;-113,64;19322,42;2017-03-13;13/03/2017;ELE;Gastos_Servicios tipicos;Electricidad;3;FIJO
13/03/2017;13/03/2017;T/ MS MODE TERRASSA \ 10-03-2017;-14,99;19202,42;19187,43;9531;-14,99;19307,43;2017-03-10;10/03/2017;MODE;Gastos_Compras;Ropa;3;VARIABLES
13/03/2017;13/03/2017;T/ FRANKFURT LES LLET\ 10-03-2017;-2,90;19187,43;19184,53;9532;-2,90;19304,53;2017-03-10;10/03/2017;FRANKFURT;Gastos_Ocio y transporte;Restaurantes;3;VARIABLES
13/03/2017;13/03/2017;T/ LA TERRASSETA \ 10-03-2017;-14,20;19184,53;19170,33;9533;-14,20;19290,33;2017-03-10;10/03/2017;TERRASSETA;Gastos_Ocio y transporte;Restaurantes;3;VARIABLES
14/03/2017;14/03/2017;T/ LIDL TERRASSA LES \ 11-03-2017;-50,21;19170,33;19120,12;9534;-50,21;19240,12;2017-03-11;11/03/2017;LIDL;Gastos_Compras;Supermercado;3;VARIABLES
14/03/2017;14/03/2017;T/ AKI 104 - TERRASSA\ 11-03-2017;-28,69;19120,12;19091,43;9535;-28,69;19211,43;2017-03-11;11/03/2017;AKI;Gastos_Vivienda y vehiculo;Mnto. hogar;3;VARIABLES
14/03/2017;12/03/2017;T/ Amazon *Mktplce EU-ES;-59,16;19091,43;19032,27;9536;-59,16;19152,27;2017-03-12;12/03/2017;AMAZON;Gastos_Compras;Hobbys;3;VARIABLES
14/03/2017;14/03/2017;T/ BON AREA \LLEIDA;-24,48;19032,27;19007,79;9537;-24,48;19127,79;2017-03-14;14/03/2017;BON;Gastos_Compras;Supermercado;3;VARIABLES
15/03/2017;15/03/2017;T/ CINESA PARC VALLES\ 12-03-2017;-4,60;19007,79;19003,19;9538;-4,60;19123,19;2017-03-12;12/03/2017;CINESA;Gastos_Ocio y transporte;Espectáculos;3;VARIABLES
15/03/2017;15/03/2017;T/ CINESA WEB \B 12-03-2017;-14,80;19003,19;18988,39;9539;-14,80;19108,39;2017-03-12;12/03/2017;CINESA;Gastos_Ocio y transporte;Espectáculos;3;VARIABLES
15/03/2017;15/03/2017;T/ TERRACASA \TERRASSA;-37,90;18988,39;18950,49;9540;-37,90;19070,49;2017-03-15;15/03/2017;TERRACASA;Gastos_Compras;Otras compras;3;VARIABLES
16/03/2017;16/03/2017;R/ SEGUROS CCM VIDA Y P Recibo:142;-20,22;18950,49;18930,27;9541;-20,22;19050,27;2017-03-16;16/03/2017;CCM;Gastos_Seguros;Seguro vida;3;FIJO
16/03/2017;16/03/2017;R/ SEGUROS CCM VIDA Y P Recibo:142;-16,73;18930,27;18913,54;9542;-16,73;19033,54;2017-03-16;16/03/2017;CCM;Gastos_Seguros;Seguro vida;3;FIJO
16/03/2017;16/03/2017;T/ CAFET.C T PRAT\PRAT 13-03-2017;-4,20;18913,54;18909,34;9543;-4,20;19029,34;2017-03-13;13/03/2017;CAFETC;Gastos_Ocio y transporte;Restaurantes;3;VARIABLES
16/03/2017;16/03/2017;T/ EL SALON THE BARBE\ 13-03-2017;-56,97;18909,34;18852,37;9544;-56,97;18972,37;2017-03-13;13/03/2017;SALON;Gastos_Salud, saber y deporte;Belleza;3;VARIABLES
16/03/2017;16/03/2017;T/ AUTOPISTAS TERR 13-03-2017;-1,39;18852,37;18850,98;9545;-1,39;18970,98;2017-03-13;13/03/2017;AUTOPISTAS;Gastos_Ocio y transporte;Parking y peaje;3;VARIABLES
16/03/2017;16/03/2017;T/ AUTOPISTAS TERR 13-03-2017;-1,39;18850,98;18849,59;9546;-1,39;18969,59;2017-03-13;13/03/2017;AUTOPISTAS;Gastos_Ocio y transporte;Parking y peaje;3;VARIABLES
16/03/2017;16/03/2017;T/ TUNELS VALLVI S. 13-03-2017;-4,18;18849,59;18845,41;9547;-4,18;18965,41;2017-03-13;13/03/2017;TUNELS;Gastos_Ocio y transporte;Parking y peaje;3;VARIABLES
17/03/2017;17/03/2017;T/ FRANKFURT LES LLET\ 14-03-2017;-2,70;18845,41;18842,71;9548;-2,70;18962,71;2017-03-14;14/03/2017;FRANKFURT;Gastos_Ocio y transporte;Restaurantes;3;VARIABLES
17/03/2017;17/03/2017;T/ CAPRABO \ 14-03-2017;-4,88;18842,71;18837,83;9549;-4,88;18957,83;2017-03-14;14/03/2017;CAPRABO;Gastos_Compras;Supermercado;3;VARIABLES
17/03/2017;17/03/2017;T/ PARKING VAPOR GRAN\ 14-03-2017;-7,55;18837,83;18830,28;9550;-7,55;18950,28;2017-03-14;14/03/2017;PARKING;Gastos_Ocio y transporte;Parking y peaje;3;VARIABLES
17/03/2017;17/03/2017;T/ EL SALON THE BARBE\ 14-03-2017;-35,94;18830,28;18794,34;9551;-35,94;18914,34;2017-03-14;14/03/2017;SALON;Gastos_Salud, saber y deporte;Belleza;3;VARIABLES
17/03/2017;17/03/2017;T/ ADESLAS DENTAL TER\ 14-03-2017;-91,50;18794,34;18702,84;9552;-91,50;18822,84;2017-03-14;14/03/2017;ADESLAS;Gastos_Salud, saber y deporte;Medico;3;VARIABLES
17/03/2017;17/03/2017;T/ CAFET.C T PRAT\PRAT 14-03-2017;-3,00;18702,84;18699,84;9553;-3,00;18819,84;2017-03-14;14/03/2017;CAFETC;Gastos_Ocio y transporte;Restaurantes;3;VARIABLES
17/03/2017;17/03/2017;T/ FARMA.ANGEL MORENO\ 14-03-2017;-19,96;18699,84;18679,88;9554;-19,96;18799,88;2017-03-14;14/03/2017;FARMAANGEL;Gastos_Salud, saber y deporte;Farmacia;3;VARIABLES
18/03/2017;18/03/2017;T/ LA TERRASSETA \ 15-03-2017;-12,90;18679,88;18666,98;9555;-12,90;18786,98;2017-03-15;15/03/2017;TERRASSETA;Gastos_Ocio y transporte;Restaurantes;3;VARIABLES
18/03/2017;18/03/2017;T/ FRANKFURT LES LLET\ 15-03-2017;-2,90;18666,98;18664,08;9556;-2,90;18784,08;2017-03-15;15/03/2017;FRANKFURT;Gastos_Ocio y transporte;Restaurantes;3;VARIABLES
18/03/2017;18/03/2017;T/ AUTOPISTAS TERR 15-03-2017;-1,39;18664,08;18662,69;9557;-1,39;18782,69;2017-03-15;15/03/2017;AUTOPISTAS;Gastos_Ocio y transporte;Parking y peaje;3;VARIABLES
18/03/2017;18/03/2017;T/ TUNELS VALLVI S. 15-03-2017;-4,18;18662,69;18658,51;9558;-4,18;18778,51;2017-03-15;15/03/2017;TUNELS;Gastos_Ocio y transporte;Parking y peaje;3;VARIABLES
18/03/2017;18/03/2017;T/ AUTOPISTAS TERR 15-03-2017;-1,39;18658,51;18657,12;9559;-1,39;18777,12;2017-03-15;15/03/2017;AUTOPISTAS;Gastos_Ocio y transporte;Parking y peaje;3;VARIABLES
18/03/2017;18/03/2017;T/ CAFET.C T PRAT\PRAT 15-03-2017;-3,60;18657,12;18653,52;9560;-3,60;18773,52;2017-03-15;15/03/2017;CAFETC;Gastos_Ocio y transporte;Restaurantes;3;VARIABLES
19/03/2017;19/03/2017;T/ AUTOPISTAS TERR 16-03-2017;-1,39;18653,52;18652,13;9561;-1,39;18772,13;2017-03-16;16/03/2017;AUTOPISTAS;Gastos_Ocio y transporte;Parking y peaje;3;VARIABLES
19/03/2017;19/03/2017;T/ AUTOPISTAS TERR 16-03-2017;-1,39;18652,13;18650,74;9562;-1,39;18770,74;2017-03-16;16/03/2017;AUTOPISTAS;Gastos_Ocio y transporte;Parking y peaje;3;VARIABLES
19/03/2017;19/03/2017;T/ CAFET.C T PRAT\PRAT 16-03-2017;-2,90;18650,74;18647,84;9563;-2,90;18767,84;2017-03-16;16/03/2017;CAFETC;Gastos_Ocio y transporte;Restaurantes;3;VARIABLES
19/03/2017;19/03/2017;T/ TOCINERIES VENTURA\ 16-03-2017;-16,91;18647,84;18630,93;9564;-16,91;18750,93;2017-03-16;16/03/2017;TOCINERIES;Gastos_Compras;Supermercado;3;VARIABLES
19/03/2017;19/03/2017;T/ FRANKFURT LES LLET\ 16-03-2017;-7,30;18630,93;18623,63;9565;-7,30;18743,63;2017-03-16;16/03/2017;FRANKFURT;Gastos_Ocio y transporte;Restaurantes;3;VARIABLES
19/03/2017;19/03/2017;T/ FRANKFURT LES LLET\ 16-03-2017;-2,90;18623,63;18620,73;9566;-2,90;18740,73;2017-03-16;16/03/2017;FRANKFURT;Gastos_Ocio y transporte;Restaurantes;3;VARIABLES
19/03/2017;19/03/2017;T/ TUNELS VALLVI S. 16-03-2017;-4,18;18620,73;18616,55;9567;-4,18;18736,55;2017-03-16;16/03/2017;TUNELS;Gastos_Ocio y transporte;Parking y peaje;3;VARIABLES
20/03/2017;20/03/2017;T/ CAFET.C T PRAT\PRAT 17-03-2017;-4,10;18616,55;18612,45;9568;-4,10;18732,45;2017-03-17;17/03/2017;CAFETC;Gastos_Ocio y transporte;Restaurantes;3;VARIABLES
20/03/2017;20/03/2017;T/ CAMBALACHE \EL PR 17-03-2017;-14,00;18612,45;18598,45;9569;-14,00;18718,45;2017-03-17;17/03/2017;CAMBALACHE;Gastos_Ocio y transporte;Restaurantes;3;VARIABLES
20/03/2017;20/03/2017;T/ CAPRABO \ 17-03-2017;-3,96;18598,45;18594,49;9570;-3,96;18714,49;2017-03-17;17/03/2017;CAPRABO;Gastos_Compras;Supermercado;3;VARIABLES
20/03/2017;20/03/2017;T/ FRANKFURT LES LLET\ 17-03-2017;-2,90;18594,49;18591,59;9571;-2,90;18711,59;2017-03-17;17/03/2017;FRANKFURT;Gastos_Ocio y transporte;Restaurantes;3;VARIABLES
20/03/2017;20/03/2017;T/ LA TERRASSETA \ 17-03-2017;-16,25;18591,59;18575,34;9572;-16,25;18695,34;2017-03-17;17/03/2017;TERRASSETA;Gastos_Ocio y transporte;Restaurantes;3;VARIABLES
21/03/2017;21/03/2017;T/ WWW.JUST-EAT.ES 18-03-2017;-27,65;18575,34;18547,69;9573;-27,65;18667,69;2017-03-18;18/03/2017;WWWJUSTEATES;Gastos_Ocio y transporte;Restaurantes;3;VARIABLES
22/03/2017;22/03/2017;R/ MINA PUBLICA AIGUES T.01A75789;-40,17;18547,69;18507,52;9574;-40,17;18627,52;2017-03-22;22/03/2017;MINA;Gastos_Servicios tipicos;Agua;3;FIJO
22/03/2017;22/03/2017;T/ BON AREA 19-03-2017;-36,83;18507,52;18470,69;9575;-36,83;18590,69;2017-03-19;19/03/2017;BON;Gastos_Compras;Supermercado;3;VARIABLES
23/03/2017;23/03/2017;T/ ADESLAS DENTAL TER\TERRASSA;-103,50;18470,69;18367,19;9576;-103,50;18487,19;2017-03-23;23/03/2017;ADESLAS;Gastos_Salud, saber y deporte;Medico;3;VARIABLES
23/03/2017;23/03/2017;T/ LIDL TERRASSA \ 20-03-2017;-30,48;18367,19;18336,71;9577;-30,48;18456,71;2017-03-20;20/03/2017;LIDL;Gastos_Compras;Supermercado;3;VARIABLES
23/03/2017;23/03/2017;T/ FRANKFURT LES LLET\ 20-03-2017;-2,90;18336,71;18333,81;9578;-2,90;18453,81;2017-03-20;20/03/2017;FRANKFURT;Gastos_Ocio y transporte;Restaurantes;3;VARIABLES
24/03/2017;24/03/2017;T/ AUTOPISTAS TERR 21-03-2017;-1,39;18333,81;18332,42;9579;-1,39;18452,42;2017-03-21;21/03/2017;AUTOPISTAS;Gastos_Ocio y transporte;Parking y peaje;3;VARIABLES
24/03/2017;24/03/2017;T/ AUTOPISTAS TERR 21-03-2017;-1,39;18332,42;18331,03;9580;-1,39;18451,03;2017-03-21;21/03/2017;AUTOPISTAS;Gastos_Ocio y transporte;Parking y peaje;3;VARIABLES
24/03/2017;24/03/2017;T/ TUNELS VALLVI S. 21-03-2017;-4,18;18331,03;18326,85;9581;-4,18;18446,85;2017-03-21;21/03/2017;TUNELS;Gastos_Ocio y transporte;Parking y peaje;3;VARIABLES
24/03/2017;24/03/2017;T/ GLT STORE HOME \ 21-03-2017;-9,98;18326,85;18316,87;9582;-9,98;18436,87;2017-03-21;21/03/2017;GLT;Gastos_Compras;Otras compras;3;VARIABLES
24/03/2017;24/03/2017;T/ CAFET.C T PRAT\PRAT 21-03-2017;-3,35;18316,87;18313,52;9583;-3,35;18433,52;2017-03-21;21/03/2017;CAFETC;Gastos_Ocio y transporte;Restaurantes;3;VARIABLES
24/03/2017;24/03/2017;T/ LIDL TERRASSA LES \ 21-03-2017;-47,66;18313,52;18265,86;9584;-47,66;18385,86;2017-03-21;21/03/2017;LIDL;Gastos_Compras;Supermercado;3;VARIABLES
25/03/2017;25/03/2017;T/ AUTOPISTAS TERR 22-03-2017;-1,39;18265,86;18264,47;9585;-1,39;18384,47;2017-03-22;22/03/2017;AUTOPISTAS;Gastos_Ocio y transporte;Parking y peaje;3;VARIABLES
25/03/2017;25/03/2017;T/ AUTOPISTAS TERR 22-03-2017;-1,39;18264,47;18263,08;9586;-1,39;18383,08;2017-03-22;22/03/2017;AUTOPISTAS;Gastos_Ocio y transporte;Parking y peaje;3;VARIABLES
25/03/2017;25/03/2017;T/ NAVAN \ 22-03-2017;-70,00;18263,08;18193,08;9587;-70,00;18313,08;2017-03-22;22/03/2017;NAVAN;Gastos_Salud, saber y deporte;Solidaridad;3;VARIABLES
25/03/2017;25/03/2017;T/ PARKING VAPOR GRAN\ 22-03-2017;-7,60;18193,08;18185,48;9588;-7,60;18305,48;2017-03-22;22/03/2017;PARKING;Gastos_Ocio y transporte;Parking y peaje;3;VARIABLES
25/03/2017;25/03/2017;T/ FRANKFURT LES LLET\ 22-03-2017;-2,90;18185,48;18182,58;9589;-2,90;18302,58;2017-03-22;22/03/2017;FRANKFURT;Gastos_Ocio y transporte;Restaurantes;3;VARIABLES
25/03/2017;25/03/2017;T/ CAFET.C T PRAT\PRAT 22-03-2017;-3,60;18182,58;18178,98;9590;-3,60;18298,98;2017-03-22;22/03/2017;CAFETC;Gastos_Ocio y transporte;Restaurantes;3;VARIABLES
26/03/2017;26/03/2017;T/ CAPRABO \ 23-03-2017;-4,31;18178,98;18174,67;9591;-4,31;18294,67;2017-03-23;23/03/2017;CAPRABO;Gastos_Compras;Supermercado;3;VARIABLES
26/03/2017;26/03/2017;T/ AUTOPISTAS TERR 23-03-2017;-1,39;18174,67;18173,28;9592;-1,39;18293,28;2017-03-23;23/03/2017;AUTOPISTAS;Gastos_Ocio y transporte;Parking y peaje;3;VARIABLES
26/03/2017;26/03/2017;T/ AUTOPISTAS TERR 23-03-2017;-1,39;18173,28;18171,89;9593;-1,39;18291,89;2017-03-23;23/03/2017;AUTOPISTAS;Gastos_Ocio y transporte;Parking y peaje;3;VARIABLES
26/03/2017;26/03/2017;T/ CAFET.C T PRAT\PRAT 23-03-2017;-3,45;18171,89;18168,44;9594;-3,45;18288,44;2017-03-23;23/03/2017;CAFETC;Gastos_Ocio y transporte;Restaurantes;3;VARIABLES
26/03/2017;26/03/2017;T/ FRANKFURT LES LLET\ 23-03-2017;-2,90;18168,44;18165,54;9595;-2,90;18285,54;2017-03-23;23/03/2017;FRANKFURT;Gastos_Ocio y transporte;Restaurantes;3;VARIABLES
26/03/2017;26/03/2017;T/ TUNELS VALLVI S. 23-03-2017;-4,18;18165,54;18161,36;9596;-4,18;18281,36;2017-03-23;23/03/2017;TUNELS;Gastos_Ocio y transporte;Parking y peaje;3;VARIABLES
26/03/2017;26/03/2017;T/ PETROSABA S.L.\VILA 23-03-2017;-38,39;18161,36;18122,97;9597;-38,39;18242,97;2017-03-23;23/03/2017;PETROSABA;Gastos_Ocio y transporte;Gasolina;3;VARIABLES
26/03/2017;26/03/2017;T/ CERTIO ITV VIL\VILA 23-03-2017;-45,30;18122,97;18077,67;9598;-45,30;18197,67;2017-03-23;23/03/2017;CERTIO;Gastos_Vivienda y vehiculo;Mnto. vehiculo;3;VARIABLE
26/03/2017;26/03/2017;T/ PARKING VAPOR GRAN\ 23-03-2017;-1,75;18077,67;18075,92;9599;-1,75;18195,92;2017-03-23;23/03/2017;PARKING;Gastos_Ocio y transporte;Parking y peaje;3;VARIABLES
26/03/2017;26/03/2017;T/ TUNELS VALLVI S. 22-03-2017;-3,72;18075,92;18072,20;9600;-3,72;18192,20;2017-03-22;22/03/2017;TUNELS;Gastos_Ocio y transporte;Parking y peaje;3;VARIABLES
27/03/2017;27/03/2017;S/OR. CARLOS ROQUE BENEDETTI MAS;-484,00;18072,20;17588,20;9601;-484,00;17708,20;2017-03-27;27/03/2017;CARLOS;Gastos_Vivienda y vehiculo;Otros vivienda;3;VARIABLES
27/03/2017;27/03/2017;T/ LIDL TERRASSA LES \ 24-03-2017;-51,80;17588,20;17536,40;9602;-51,80;17656,40;2017-03-24;24/03/2017;LIDL;Gastos_Compras;Supermercado;3;VARIABLES
27/03/2017;27/03/2017;T/ CAFET.C T PRAT\PRAT 24-03-2017;-3,65;17536,40;17532,75;9603;-3,65;17652,75;2017-03-24;24/03/2017;CAFETC;Gastos_Ocio y transporte;Restaurantes;3;VARIABLES
27/03/2017;27/03/2017;T/ VIENA PARC VALLES \ 24-03-2017;-22,15;17532,75;17510,60;9604;-22,15;17630,60;2017-03-24;24/03/2017;VIENA;Gastos_Ocio y transporte;Restaurantes;3;VARIABLES
27/03/2017;27/03/2017;T/ REDPIZZA \ 24-03-2017;-21,95;17510,60;17488,65;9605;-21,95;17608,65;2017-03-24;24/03/2017;REDPIZZA;Gastos_Ocio y transporte;Restaurantes;3;VARIABLES
28/03/2017;28/03/2017;HAB. INFORMACIO I TECNOLOGIA DE CAT;1624,31;17488,65;19112,96;9606;1624,31;19232,96;2017-03-28;28/03/2017;HAB;Ingresos;Nomina;3;FIJO
28/03/2017;28/03/2017;HAB. FOMENT DE TERRASSA S.A. Transf;1804,34;19112,96;20917,30;9607;1804,34;21037,30;2017-03-28;28/03/2017;HAB;Ingresos;Nomina;3;FIJO
28/03/2017;28/03/2017;T/ AUTOPISTAS TERR 24-03-2017;-1,39;20917,30;20915,91;9608;-1,39;21035,91;2017-03-24;24/03/2017;AUTOPISTAS;Gastos_Ocio y transporte;Parking y peaje;3;VARIABLES
28/03/2017;28/03/2017;T/ AUTOPISTAS TERR 24-03-2017;-1,39;20915,91;20914,52;9609;-1,39;21034,52;2017-03-24;24/03/2017;AUTOPISTAS;Gastos_Ocio y transporte;Parking y peaje;3;VARIABLES
29/03/2017;29/03/2017;T/ BON AREA 26-03-2017;-9,28;20914,52;20905,24;9610;-9,28;21025,24;2017-03-26;26/03/2017;BON;Gastos_Compras;Supermercado;3;VARIABLES
29/03/2017;29/03/2017;T/ TUNELS VALLVI S. 24-03-2017;-3,72;20905,24;20901,52;9611;-3,72;21021,52;2017-03-24;24/03/2017;TUNELS;Gastos_Ocio y transporte;Parking y peaje;3;VARIABLES
30/03/2017;30/03/2017;T/ FRANKFURT LES LLET\ 27-03-2017;-1,40;20901,52;20900,12;9612;-1,40;21020,12;2017-03-27;27/03/2017;FRANKFURT;Gastos_Ocio y transporte;Restaurantes;3;VARIABLES
30/03/2017;30/03/2017;T/ PARKING VAPOR GRAN\ 27-03-2017;-5,35;20900,12;20894,77;9613;-5,35;21014,77;2017-03-27;27/03/2017;PARKING;Gastos_Ocio y transporte;Parking y peaje;3;VARIABLES
30/03/2017;30/03/2017;T/ TOCINERIES VENTURA\ 27-03-2017;-9,27;20894,77;20885,50;9614;-9,27;21005,50;2017-03-27;27/03/2017;TOCINERIES;Gastos_Compras;Supermercado;3;VARIABLES
31/03/2017;31/03/2017;R/ AJUNTAMENT D I.B.I. CA D.ALBI;-45,65;20885,50;20839,85;9615;-45,65;20959,85;2017-03-31;31/03/2017;AJUNTAMENT;Gastos_Banco y organismos;Ayuntamiento;3;FIJO
31/03/2017;31/03/2017;REC. 6061.9600001223;-485,11;20839,85;20354,74;9616;-485,11;20474,74;2017-03-31;31/03/2017;REC;Gastos_Banco y organismos;Hipoteca;3;FIJO
31/03/2017;31/03/2017;T/ AUTOPISTAS TERR 28-03-2017;-1,39;20354,74;20353,35;9617;-1,39;20473,35;2017-03-28;28/03/2017;AUTOPISTAS;Gastos_Ocio y transporte;Parking y peaje;3;VARIABLES
31/03/2017;31/03/2017;T/ AUTOPISTAS TERR 28-03-2017;-1,39;20353,35;20351,96;9618;-1,39;20471,96;2017-03-28;28/03/2017;AUTOPISTAS;Gastos_Ocio y transporte;Parking y peaje;3;VARIABLES
31/03/2017;31/03/2017;T/ FRANKFURT LES LLET\ 28-03-2017;-9,75;20351,96;20342,21;9619;-9,75;20462,21;2017-03-28;28/03/2017;FRANKFURT;Gastos_Ocio y transporte;Restaurantes;3;VARIABLES
31/03/2017;31/03/2017;T/ TUNELS VALLVI S. 28-03-2017;-3,72;20342,21;20338,49;9620;-3,72;20458,49;2017-03-28;28/03/2017;TUNELS;Gastos_Ocio y transporte;Parking y peaje;3;VARIABLES
31/03/2017;31/03/2017;T/ PARKING VAPOR GRAN\ 28-03-2017;-4,65;20338,49;20333,84;9621;-4,65;20453,84;2017-03-28;28/03/2017;PARKING;Gastos_Ocio y transporte;Parking y peaje;3;VARIABLES
31/03/2017;31/03/2017;LIMPIEZA REDUCIMOS EFECTIVO 1/03 -300;-120,00;20333,84;20213,84;9622;-120,00;20333,84;2017-03-31;31/03/2017;LIMPIEZA;Gastos_Vivienda y vehiculo;Serv. domestico;3;FIJO
01/04/2017;01/04/2017;FACT TARJETAS TARJ.CREDITO 07126017 17-04-01;-2,53;20333,84;20331,31;9623;-2,53;20331,31;2017-04-01;31/03/2017;FACT 07126017;Gastos_Banco y organismos;Credito Bea;3;VARIABLE
01/04/2017;01/04/2017;FACT TARJETAS TARJ.CREDITO 42689013 17-04-01;-1008,30;20331,31;19323,01;9624;-1008,30;19323,01;2017-04-01;31/03/2017;FACT;No computable;Recibo Tarjeta;3;
01/04/2017;01/04/2017;T/ TOCINERIES VENTURA\ 29-03-2017;-11,04;19323,01;19311,97;9625;-11,04;19311,97;2017-03-29;29/03/2017;TOCINERIES;Gastos_Compras;Supermercado;3;VARIABLES
01/04/2017;01/04/2017;T/ AUTOPISTAS TERR 29-03-2017;-1,39;19311,97;19310,58;9626;-1,39;19310,58;2017-03-29;29/03/2017;AUTOPISTAS;Gastos_Ocio y transporte;Parking y peaje;3;VARIABLES
01/04/2017;01/04/2017;T/ AUTOPISTAS TERR 29-03-2017;-1,39;19310,58;19309,19;9627;-1,39;19309,19;2017-03-29;29/03/2017;AUTOPISTAS;Gastos_Ocio y transporte;Parking y peaje;3;VARIABLES
01/04/2017;01/04/2017;T/ LA TERRASSETA \ 29-03-2017;-27,30;19309,19;19281,89;9628;-27,30;19281,89;2017-03-29;29/03/2017;TERRASSETA;Gastos_Ocio y transporte;Restaurantes;3;VARIABLES
01/04/2017;01/04/2017;T/ TUNELS VALLVI S. 29-03-2017;-3,72;19281,89;19278,17;9629;-3,72;19278,17;2017-03-29;29/03/2017;TUNELS;Gastos_Ocio y transporte;Parking y peaje;3;VARIABLES
02/04/2017;02/04/2017;T/ AUTOPISTAS TERR 30-03-2017;-1,39;19278,17;19276,78;9630;-1,39;19276,78;2017-03-30;30/03/2017;AUTOPISTAS;Gastos_Ocio y transporte;Parking y peaje;3;VARIABLES
02/04/2017;02/04/2017;T/ AUTOPISTAS TERR 30-03-2017;-1,39;19276,78;19275,39;9631;-1,39;19275,39;2017-03-30;30/03/2017;AUTOPISTAS;Gastos_Ocio y transporte;Parking y peaje;3;VARIABLES
02/04/2017;02/04/2017;T/ LIDL EL PRAT D\PRAT 30-03-2017;-3,85;19275,39;19271,54;9632;-3,85;19271,54;2017-03-30;30/03/2017;LIDL;Gastos_Compras;Supermercado;3;VARIABLES
02/04/2017;02/04/2017;T/ TUNELS VALLVI S. 30-03-2017;-4,18;19271,54;19267,36;9633;-4,18;19267,36;2017-03-30;30/03/2017;TUNELS;Gastos_Ocio y transporte;Parking y peaje;3;VARIABLES
03/04/2017;03/04/2017;T/ TOCINERIES VENTURA\ 31-03-2017;-25,50;19267,36;19241,86;9634;-25,50;19241,86;2017-03-31;31/03/2017;TOCINERIES;Gastos_Compras;Supermercado;3;VARIABLES
04/04/2017;04/04/2017;R/ SEGUROS SEGUROS CATA INCLUIDO S;-327,04;19241,86;18914,82;9635;-327,04;18914,82;2017-04-04;04/04/2017;CATA;Gastos_Seguros;Seguro auto;4;FIJO
04/04/2017;04/04/2017;T/ LIDL TERRASSA LES \ 01-04-2017;-51,83;18914,82;18862,99;9636;-51,83;18862,99;2017-04-01;01/04/2017;LIDL;Gastos_Compras;Supermercado;4;VARIABLES
04/04/2017;04/04/2017;T/ AUTOPISTAS TERR 31-03-2017;-1,39;18862,99;18861,60;9637;-1,39;18861,60;2017-03-31;31/03/2017;AUTOPISTAS;Gastos_Ocio y transporte;Parking y peaje;3;VARIABLES
05/04/2017;05/04/2017;R/ LUZ ENDESA ENERG FACTURA DE GAS;-134,21;18861,60;18727,39;9638;-134,21;18727,39;2017-04-05;05/04/2017;GAS;Gastos_Servicios tipicos;Gas;4;FIJO
06/04/2017;06/04/2017;R/ SEGUROS ADESLAS CENT MODULAR CO;-144,67;18727,39;18582,72;9639;-144,67;18582,72;2017-04-06;06/04/2017;ADESLAS;Gastos_Salud, saber y deporte;Medico;4;VARIABLES
06/04/2017;06/04/2017;T/ MERCADONA QUATRE C\ 03-04-2017;-17,41;18582,72;18565,31;9640;-17,41;18565,31;2017-04-03;03/04/2017;MERCADONA;Gastos_Compras;Supermercado;4;VARIABLES
06/04/2017;06/04/2017;T/ AUTOPISTAS TERR 03-04-2017;-1,39;18565,31;18563,92;9641;-1,39;18563,92;2017-04-03;03/04/2017;AUTOPISTAS;Gastos_Ocio y transporte;Parking y peaje;4;VARIABLES
06/04/2017;06/04/2017;T/ AUTOPISTAS TERR 03-04-2017;-1,39;18563,92;18562,53;9642;-1,39;18562,53;2017-04-03;03/04/2017;AUTOPISTAS;Gastos_Ocio y transporte;Parking y peaje;4;VARIABLES
06/04/2017;06/04/2017;T/ TUNELS VALLVI S. 03-04-2017;-4,18;18562,53;18558,35;9643;-4,18;18558,35;2017-04-03;03/04/2017;TUNELS;Gastos_Ocio y transporte;Parking y peaje;4;VARIABLES
06/04/2017;06/04/2017;T/ BON AREA 03-04-2017;-2,51;18558,35;18555,84;9644;-2,51;18555,84;2017-04-03;03/04/2017;BON;Gastos_Compras;Supermercado;4;VARIABLES
06/04/2017;06/04/2017;T/ FRANKFURT LES LLET\ 03-04-2017;-22,65;18555,84;18533,19;9645;-22,65;18533,19;2017-04-03;03/04/2017;FRANKFURT;Gastos_Ocio y transporte;Restaurantes;4;VARIABLES
06/04/2017;06/04/2017;T/ DECATHLON SA TERRA\ 03-04-2017;-3,99;18533,19;18529,20;9646;-3,99;18529,20;2017-04-03;03/04/2017;DECATHLON;Gastos_Compras;Deportivo;4;VARIABLES
06/04/2017;06/04/2017;T/ PARAFARM.NOVA, SCP\ 03-04-2017;-9,95;18529,20;18519,25;9647;-9,95;18519,25;2017-04-03;03/04/2017;PARAFARMNOVA;Gastos_Salud, saber y deporte;Farmacia;4;VARIABLES
07/04/2017;07/04/2017;R/ SERHS FOOD A SERHS SALA I BADR;-76,16;18519,25;18443,09;9648;-76,16;18443,09;2017-04-07;07/04/2017;SERHS;Gastos_Salud, saber y deporte;Menjador;4;FIJO
07/04/2017;07/04/2017;R/ SERHS FOOD A SERHS SALA I BADR;-83,30;18443,09;18359,79;9649;-83,30;18359,79;2017-04-07;07/04/2017;SERHS;Gastos_Salud, saber y deporte;Menjador;4;FIJO
07/04/2017;07/04/2017;R/ FINQUES GASS Vto 01-04-17 Rec;-72,60;18359,79;18287,19;9650;-72,60;18287,19;2017-04-01;01/04/2017;FINQUES;Gastos_Vivienda y vehiculo;Alquiler Parking;4;FIJO
07/04/2017;07/04/2017;T/ PARKING VAPOR GRAN\ 04-04-2017;-2,40;18287,19;18284,79;9651;-2,40;18284,79;2017-04-04;04/04/2017;PARKING;Gastos_Ocio y transporte;Parking y peaje;4;VARIABLES
07/04/2017;07/04/2017;T/ AUTOPISTAS TERR 04-04-2017;-1,39;18284,79;18283,40;9652;-1,39;18283,40;2017-04-04;04/04/2017;AUTOPISTAS;Gastos_Ocio y transporte;Parking y peaje;4;VARIABLES
07/04/2017;07/04/2017;T/ AUTOPISTAS TERR 04-04-2017;-1,39;18283,40;18282,01;9653;-1,39;18282,01;2017-04-04;04/04/2017;AUTOPISTAS;Gastos_Ocio y transporte;Parking y peaje;4;VARIABLES
07/04/2017;07/04/2017;T/ KIABI BARICENT\BARB 04-04-2017;-13,00;18282,01;18269,01;9654;-13,00;18269,01;2017-04-04;04/04/2017;KIABI;Gastos_Compras;Ropa;4;VARIABLES
07/04/2017;07/04/2017;T/ FRANKFURT LES LLET\ 04-04-2017;-13,80;18269,01;18255,21;9655;-13,80;18255,21;2017-04-04;04/04/2017;FRANKFURT;Gastos_Ocio y transporte;Restaurantes;4;VARIABLES
07/04/2017;07/04/2017;T/ TUNELS VALLVI S. 04-04-2017;-3,72;18255,21;18251,49;9656;-3,72;18251,49;2017-04-04;04/04/2017;TUNELS;Gastos_Ocio y transporte;Parking y peaje;4;VARIABLES
07/04/2017;07/04/2017;T/ LIDL EL PRAT D\PRAT 04-04-2017;-6,53;18251,49;18244,96;9657;-6,53;18244,96;2017-04-04;04/04/2017;LIDL;Gastos_Compras;Supermercado;4;VARIABLES
07/04/2017;07/04/2017;T/ E.S.RUBI 9 04-04-2017;-43,48;18244,96;18201,48;9658;-43,48;18201,48;2017-04-04;04/04/2017;ESRUBI;Gastos_Ocio y transporte;Gasolina;4;VARIABLES
07/04/2017;07/04/2017;T/ BARICENTRO L 4\BARB 04-04-2017;-10,20;18201,48;18191,28;9659;-10,20;18191,28;2017-04-04;04/04/2017;BARICENTRO;Gastos_Ocio y transporte;Restaurantes;4;VARIABLES
08/04/2017;08/04/2017;CAJ. AJENO SERVIRED \XERTA;-180,00;18071,28;17891,28;9660;-180,00;18011,28;2017-04-08;08/04/2017;CAJ;Gastos_Gastos varios;Efectivo;4;VARIABLES
08/04/2017;08/04/2017;COM. 64970036 SVRED CAJ OFI;-1,87;17891,28;17889,41;9661;-1,87;18009,41;2017-04-08;08/04/2017;COM;Gastos_Banco y organismos;Cargos banco;4;FIJO
08/04/2017;08/04/2017;T/ CAPRABO \ 05-04-2017;-4,25;17889,41;17885,16;9662;-4,25;18005,16;2017-04-05;05/04/2017;CAPRABO;Gastos_Compras;Supermercado;4;VARIABLES
08/04/2017;08/04/2017;T/ FRANKFURT LES LLET\ 05-04-2017;-2,90;17885,16;17882,26;9663;-2,90;18002,26;2017-04-05;05/04/2017;FRANKFURT;Gastos_Ocio y transporte;Restaurantes;4;VARIABLES
08/04/2017;08/04/2017;T/ PARKING VAPOR GRAN\ 05-04-2017;-4,25;17882,26;17878,01;9664;-4,25;17998,01;2017-04-05;05/04/2017;PARKING;Gastos_Ocio y transporte;Parking y peaje;4;VARIABLES
08/04/2017;08/04/2017;T/ AUTOPISTAS TERR 05-04-2017;-1,39;17878,01;17876,62;9665;-1,39;17996,62;2017-04-05;05/04/2017;AUTOPISTAS;Gastos_Ocio y transporte;Parking y peaje;4;VARIABLES
08/04/2017;08/04/2017;T/ AUTOPISTAS TERR 05-04-2017;-1,39;17876,62;17875,23;9666;-1,39;17995,23;2017-04-05;05/04/2017;AUTOPISTAS;Gastos_Ocio y transporte;Parking y peaje;4;VARIABLES
08/04/2017;08/04/2017;T/ TUNELS VALLVI S. 05-04-2017;-4,18;17875,23;17871,05;9667;-4,18;17991,05;2017-04-05;05/04/2017;TUNELS;Gastos_Ocio y transporte;Parking y peaje;4;VARIABLES
09/04/2017;09/04/2017;T/ AUTOPISTAS TERR 06-04-2017;-1,39;17871,05;17869,66;9668;-1,39;17989,66;2017-04-06;06/04/2017;AUTOPISTAS;Gastos_Ocio y transporte;Parking y peaje;4;VARIABLES
09/04/2017;09/04/2017;T/ AUTOPISTAS TERR 06-04-2017;-1,39;17869,66;17868,27;9669;-1,39;17988,27;2017-04-06;06/04/2017;AUTOPISTAS;Gastos_Ocio y transporte;Parking y peaje;4;VARIABLES
09/04/2017;09/04/2017;T/ TUNELS VALLVI S. 06-04-2017;-3,72;17868,27;17864,55;9670;-3,72;17984,55;2017-04-06;06/04/2017;TUNELS;Gastos_Ocio y transporte;Parking y peaje;4;VARIABLES
09/04/2017;09/04/2017;T/ LIDL TERRASSA LES \ 06-04-2017;-39,56;17864,55;17824,99;9671;-39,56;17944,99;2017-04-06;06/04/2017;LIDL;Gastos_Compras;Supermercado;4;VARIABLES
09/04/2017;09/04/2017;T/ NAVAN \ 06-04-2017;-14,34;17824,99;17810,65;9672;-14,34;17930,65;2017-04-06;06/04/2017;NAVAN;Gastos_Salud, saber y deporte;Solidaridad;4;VARIABLES
10/04/2017;10/04/2017;'R/ L''EINA COOPE Rebut: 10737, A.';-10,00;17810,65;17800,65;9673;-10,00;17920,65;2017-04-10;10/04/2017;LEINA;Gastos_Salud, saber y deporte;Estudios;4;VARIABLES
10/04/2017;10/04/2017;T/ VIENA PARC VALLES \ 07-04-2017;-20,05;17800,65;17780,60;9674;-20,05;17900,60;2017-04-07;07/04/2017;VIENA;Gastos_Ocio y transporte;Restaurantes;4;VARIABLES
12/04/2017;12/04/2017;R/ TELECOMUNICACI VODAFONE;-129,34;17780,60;17651,26;9675;-129,34;17771,26;2017-04-12;12/04/2017;TELECOMUNICACI;Gastos_Servicios tipicos;Telecomunicaciones;4;FIJO
12/04/2017;12/04/2017;'T/ PARKING MUNICI\L''AM 09-04-2017';-3,30;17651,26;17647,96;9676;-3,30;17767,96;2017-04-09;09/04/2017;PARKING;Gastos_Ocio y transporte;Parking y peaje;4;VARIABLES
12/04/2017;12/04/2017;T/ AUTOPISTAS TERR 09-04-2017;-2,53;17647,96;17645,43;9677;-2,53;17765,43;2017-04-09;09/04/2017;AUTOPISTAS;Gastos_Ocio y transporte;Parking y peaje;4;VARIABLES
12/04/2017;12/04/2017;T/ TUNELS VALLVI S. 07-04-2017;-4,18;17645,43;17641,25;9678;-4,18;17761,25;2017-04-07;07/04/2017;TUNELS;Gastos_Ocio y transporte;Parking y peaje;4;VARIABLES
12/04/2017;12/04/2017;T/ AUTOPISTAS TERR 07-04-2017;-1,39;17641,25;17639,86;9679;-1,39;17759,86;2017-04-07;07/04/2017;AUTOPISTAS;Gastos_Ocio y transporte;Parking y peaje;4;VARIABLES
12/04/2017;12/04/2017;T/ AUTOPISTAS TERR 07-04-2017;-1,39;17639,86;17638,47;9680;-1,39;17758,47;2017-04-07;07/04/2017;AUTOPISTAS;Gastos_Ocio y transporte;Parking y peaje;4;VARIABLES
12/04/2017;12/04/2017;T/ AUTOPISTAS TERR 07-04-2017;-1,39;17638,47;17637,08;9681;-1,39;17757,08;2017-04-07;07/04/2017;AUTOPISTAS;Gastos_Ocio y transporte;Parking y peaje;4;VARIABLES
13/04/2017;13/04/2017;R/ GAS GAS NATURAL GNS27630480417;-4,57;17637,08;17632,51;9682;-4,57;17752,51;2017-04-13;13/04/2017;GAS;Gastos_Servicios tipicos;Gas;4;FIJO
13/04/2017;13/04/2017;T/ AUTOPISTAS TERR 10-04-2017;-1,39;17632,51;17631,12;9683;-1,39;17751,12;2017-04-10;10/04/2017;AUTOPISTAS;Gastos_Ocio y transporte;Parking y peaje;4;VARIABLES
13/04/2017;13/04/2017;T/ AUTOPISTAS TERR 10-04-2017;-1,39;17631,12;17629,73;9684;-1,39;17749,73;2017-04-10;10/04/2017;AUTOPISTAS;Gastos_Ocio y transporte;Parking y peaje;4;VARIABLES
13/04/2017;13/04/2017;T/ LIDL TERRASSA LES \ 10-04-2017;-13,47;17629,73;17616,26;9685;-13,47;17736,26;2017-04-10;10/04/2017;LIDL;Gastos_Compras;Supermercado;4;VARIABLES
13/04/2017;13/04/2017;T/ AUTOPISTA MARE NOST 09-04-2017;-4,55;17616,26;17611,71;9686;-4,55;17731,71;2017-04-09;09/04/2017;AUTOPISTA;Gastos_Ocio y transporte;Parking y peaje;4;VARIABLES
13/04/2017;13/04/2017;T/ A.C.E.S.A LIM SCAP7 09-04-2017;-10,50;17611,71;17601,21;9687;-10,50;17721,21;2017-04-09;09/04/2017;ACESA;Gastos_Ocio y transporte;Parking y peaje;4;VARIABLES
13/04/2017;13/04/2017;T/ AUTOPISTA MARE NOST 07-04-2017;-7,05;17601,21;17594,16;9688;-7,05;17714,16;2017-04-07;07/04/2017;AUTOPISTA;Gastos_Ocio y transporte;Parking y peaje;4;VARIABLES
13/04/2017;13/04/2017;T/ A.C.E.S.A B MART -L 07-04-2017;-10,50;17594,16;17583,66;9689;-10,50;17703,66;2017-04-07;07/04/2017;ACESA;Gastos_Ocio y transporte;Parking y peaje;4;VARIABLES
14/04/2017;14/04/2017;T/ AUTOPISTAS TERR 11-04-2017;-1,39;17583,66;17582,27;9690;-1,39;17702,27;2017-04-11;11/04/2017;AUTOPISTAS;Gastos_Ocio y transporte;Parking y peaje;4;VARIABLES
14/04/2017;14/04/2017;T/ AUTOPISTAS TERR 11-04-2017;-1,39;17582,27;17580,88;9691;-1,39;17700,88;2017-04-11;11/04/2017;AUTOPISTAS;Gastos_Ocio y transporte;Parking y peaje;4;VARIABLES
14/04/2017;14/04/2017;T/ E.S. RUBI II 11-04-2017;-44,80;17580,88;17536,08;9692;-44,80;17656,08;2017-04-11;11/04/2017;RUBI;Gastos_Ocio y transporte;Gasolina;4;VARIABLES
15/04/2017;15/04/2017;T/ AUTOPISTA MARE NOST 12-04-2017;-7,05;17536,08;17529,03;9693;-7,05;17649,03;2017-04-12;12/04/2017;AUTOPISTA;Gastos_Ocio y transporte;Parking y peaje;4;VARIABLES
15/04/2017;15/04/2017;T/ A.C.E.S.A B MART -L 12-04-2017;-10,50;17529,03;17518,53;9694;-10,50;17638,53;2017-04-12;12/04/2017;ACESA;Gastos_Ocio y transporte;Parking y peaje;4;VARIABLES
18/04/2017;18/04/2017;T/ PARKING OCEANOGRAF\ 15-04-2017;-6,00;17518,53;17512,53;9695;-6,00;17632,53;2017-04-15;15/04/2017;PARKING;Gastos_Ocio y transporte;Parking y peaje;4;VARIABLES
19/04/2017;19/04/2017;R/ SEGUROS CCM VIDA Y P Recibo:142;-20,15;17512,53;17492,38;9696;-20,15;17612,38;2017-04-19;19/04/2017;CCM;Gastos_Seguros;Seguro vida;4;FIJO
19/04/2017;19/04/2017;R/ SEGUROS CCM VIDA Y P Recibo:142;-16,67;17492,38;17475,71;9697;-16,67;17595,71;2017-04-19;19/04/2017;CCM;Gastos_Seguros;Seguro vida;4;FIJO
19/04/2017;15/04/2017;T/ HOTEL MEDIUM VALENCIA;-432,00;17475,71;17043,71;9698;-432,00;17163,71;2017-04-15;15/04/2017;HOTEL;Gastos_Ocio y transporte;Vacaciones;4;VARIABLES
20/04/2017;20/04/2017;T/ AUTOPISTAS TERR 12-04-2017;-1,39;17043,71;17042,32;9699;-1,39;17162,32;2017-04-12;12/04/2017;AUTOPISTAS;Gastos_Ocio y transporte;Parking y peaje;4;VARIABLES
21/04/2017;21/04/2017;T/ AUTOPISTAS TERR 18-04-2017;-1,39;17042,32;17040,93;9700;-1,39;17160,93;2017-04-18;18/04/2017;AUTOPISTAS;Gastos_Ocio y transporte;Parking y peaje;4;VARIABLES
21/04/2017;21/04/2017;T/ AUTOPISTAS TERR 18-04-2017;-1,39;17040,93;17039,54;9701;-1,39;17159,54;2017-04-18;18/04/2017;AUTOPISTAS;Gastos_Ocio y transporte;Parking y peaje;4;VARIABLES
21/04/2017;21/04/2017;T/ MERCADONA QUATRE C\ 18-04-2017;-4,64;17039,54;17034,90;9702;-4,64;17154,90;2017-04-18;18/04/2017;MERCADONA;Gastos_Compras;Supermercado;4;VARIABLES
21/04/2017;21/04/2017;T/ TUNELS VALLVI S. 18-04-2017;-3,72;17034,90;17031,18;9703;-3,72;17151,18;2017-04-18;18/04/2017;TUNELS;Gastos_Ocio y transporte;Parking y peaje;4;VARIABLES
21/04/2017;21/04/2017;T/ ALDI TERRASSA LES \ 18-04-2017;-36,56;17031,18;16994,62;9704;-36,56;17114,62;2017-04-18;18/04/2017;ALDI;Gastos_Compras;Supermercado;4;VARIABLES
22/04/2017;22/04/2017;T/ IKEA SABADELL \SABADELL;-1851,32;16994,62;15143,30;9705;-1851,32;15263,30;2017-04-22;22/04/2017;IKEA;Gastos_Vivienda y vehiculo;Mnto. hogar;4;VARIABLES
22/04/2017;22/04/2017;T/ E.S.RUBI 9 19-04-2017;-44,79;15143,30;15098,51;9706;-44,79;15218,51;2017-04-19;19/04/2017;ESRUBI;Gastos_Ocio y transporte;Gasolina;4;VARIABLES
22/04/2017;22/04/2017;T/ AUTOPISTAS TERR 19-04-2017;-1,39;15098,51;15097,12;9707;-1,39;15217,12;2017-04-19;19/04/2017;AUTOPISTAS;Gastos_Ocio y transporte;Parking y peaje;4;VARIABLES
22/04/2017;22/04/2017;T/ AUTOPISTAS TERR 19-04-2017;-1,39;15097,12;15095,73;9708;-1,39;15215,73;2017-04-19;19/04/2017;AUTOPISTAS;Gastos_Ocio y transporte;Parking y peaje;4;VARIABLES
22/04/2017;22/04/2017;T/ BON AREA 19-04-2017;-15,93;15095,73;15079,80;9709;-15,93;15199,80;2017-04-19;19/04/2017;BON;Gastos_Compras;Supermercado;4;VARIABLES
22/04/2017;22/04/2017;T/ TUNELS VALLVI S. 19-04-2017;-4,18;15079,80;15075,62;9710;-4,18;15195,62;2017-04-19;19/04/2017;TUNELS;Gastos_Ocio y transporte;Parking y peaje;4;VARIABLES
22/04/2017;22/04/2017;T/ PARKING VAPOR GRAN\ 19-04-2017;-2,10;15075,62;15073,52;9711;-2,10;15193,52;2017-04-19;19/04/2017;PARKING;Gastos_Ocio y transporte;Parking y peaje;4;VARIABLES
23/04/2017;23/04/2017;T/ AUTOPISTAS TERR 20-04-2017;-1,39;15073,52;15072,13;9712;-1,39;15192,13;2017-04-20;20/04/2017;AUTOPISTAS;Gastos_Ocio y transporte;Parking y peaje;4;VARIABLES
23/04/2017;23/04/2017;T/ TUNELS VALLVI S. 20-04-2017;-3,72;15072,13;15068,41;9713;-3,72;15188,41;2017-04-20;20/04/2017;TUNELS;Gastos_Ocio y transporte;Parking y peaje;4;VARIABLES
23/04/2017;23/04/2017;T/ NAVAN \ 20-04-2017;-23,07;15068,41;15045,34;9714;-23,07;15165,34;2017-04-20;20/04/2017;NAVAN;Gastos_Salud, saber y deporte;Solidaridad;4;VARIABLES
27/04/2017;27/04/2017;HAB. INFORMACIO I TECNOLOGIA DE CAT;1624,63;15045,34;16669,97;9715;1624,63;16789,97;2017-04-27;27/04/2017;HAB;Ingresos;Nomina;4;FIJO
28/04/2017;28/04/2017;R/ AJUNTAMENT D I.B.I. CA D.ALBI;-45,65;16669,97;16624,32;9716;-45,65;16744,32;2017-04-28;28/04/2017;AJUNTAMENT;Gastos_Banco y organismos;Ayuntamiento;4;FIJO
28/04/2017;28/04/2017;HAB. FOMENT DE TERRASSA S.A. Transf;1813,67;16624,32;18437,99;9717;1813,67;18557,99;2017-04-28;28/04/2017;HAB;Ingresos;Nomina;4;FIJO
28/04/2017;28/04/2017;T/ SUPER.BON PREU S16\ 25-04-2017;-7,65;18437,99;18430,34;9718;-7,65;18550,34;2017-04-25;25/04/2017;SUPERBON;Gastos_Compras;Supermercado;4;VARIABLES
29/04/2017;29/04/2017;T/ PARKING VAPOR GRAN\ 26-04-2017;-1,95;18430,34;18428,39;9719;-1,95;18548,39;2017-04-26;26/04/2017;PARKING;Gastos_Ocio y transporte;Parking y peaje;4;VARIABLES
29/04/2017;29/04/2017;T/ DRIM CAN PARELLADA\ 26-04-2017;-13,98;18428,39;18414,41;9720;-13,98;18534,41;2017-04-26;26/04/2017;DRIM;Gastos_Compras;Niños;4;VARIABLES
29/04/2017;29/04/2017;T/ PARKING VAPOR GRAN\ 26-04-2017;-1,70;18414,41;18412,71;9721;-1,70;18532,71;2017-04-26;26/04/2017;PARKING;Gastos_Ocio y transporte;Parking y peaje;4;VARIABLES
29/04/2017;29/04/2017;T/ AUTOPISTAS TERR 26-04-2017;-1,39;18412,71;18411,32;9722;-1,39;18531,32;2017-04-26;26/04/2017;AUTOPISTAS;Gastos_Ocio y transporte;Parking y peaje;4;VARIABLES
29/04/2017;29/04/2017;T/ UDON PARC VALLES \ 26-04-2017;-49,55;18411,32;18361,77;9723;-49,55;18481,77;2017-04-26;26/04/2017;UDON;Gastos_Ocio y transporte;Restaurantes;4;VARIABLES
29/04/2017;29/04/2017;T/ AKI 104 - TERRASSA\ 26-04-2017;-32,79;18361,77;18328,98;9724;-32,79;18448,98;2017-04-26;26/04/2017;AKI;Gastos_Vivienda y vehiculo;Mnto. hogar;4;VARIABLES
30/04/2017;30/04/2017;REC. 6061.9600001223;-485,11;18328,98;17843,87;9725;-485,11;17963,87;2017-04-30;30/04/2017;REC;Gastos_Banco y organismos;Hipoteca;4;FIJO
30/04/2017;30/04/2017;T/ AUTOPISTAS TERR 27-04-2017;-1,39;17843,87;17842,48;9726;-1,39;17962,48;2017-04-27;27/04/2017;AUTOPISTAS;Gastos_Ocio y transporte;Parking y peaje;4;VARIABLES
30/04/2017;30/04/2017;T/ AUTOPISTAS TERR 27-04-2017;-1,39;17842,48;17841,09;9727;-1,39;17961,09;2017-04-27;27/04/2017;AUTOPISTAS;Gastos_Ocio y transporte;Parking y peaje;4;VARIABLES
30/04/2017;30/04/2017;T/ TUNELS VALLVI S. 27-04-2017;-4,18;17841,09;17836,91;9728;-4,18;17956,91;2017-04-27;27/04/2017;TUNELS;Gastos_Ocio y transporte;Parking y peaje;4;VARIABLES
30/04/2017;30/04/2017;T/ CAFET.C T PRAT\PRAT 27-04-2017;-2,60;17836,91;17834,31;9729;-2,60;17954,31;2017-04-27;27/04/2017;CAFETC;Gastos_Ocio y transporte;Restaurantes;4;VARIABLES
30/04/2017;30/04/2017;LIMPIEZA REDUCIMOS EFECTIVO 08/04;-120,00;17834,31;17714,31;9730;-120,00;17834,31;2017-04-30;30/04/2017;LIMPIEZA;Gastos_Vivienda y vehiculo;Serv. domestico;4;FIJO
01/05/2017;01/05/2017;FACT TARJETAS TARJ.CREDITO 07126017 17-05-01;-475,85;17834,31;17358,46;9731;-475,85;17358,46;2017-05-01;30/04/2017;FACT 07126017;Gastos_Banco y organismos;Credito Bea;4;VARIABLE
01/05/2017;01/05/2017;FACT TARJETAS TARJ.CREDITO 42689013 17-05-01;-799,74;17358,46;16558,72;9732;-799,74;16558,72;2017-05-01;30/04/2017;FACT;No computable;Recibo Tarjeta;4;
01/05/2017;01/05/2017;T/ EL SALON THE BARBE\ 28-04-2017;-48,46;16558,72;16510,26;9733;-48,46;16510,26;2017-04-28;28/04/2017;SALON;Gastos_Salud, saber y deporte;Belleza;4;VARIABLES
02/05/2017;02/05/2017;T/ RODELAS PERRUQUERS\ 29-04-2017;-12,90;16510,26;16497,36;9734;-12,90;16497,36;2017-04-29;29/04/2017;RODELAS;Gastos_Salud, saber y deporte;Belleza;4;VARIABLES
04/05/2017;04/05/2017;CAJ. AJENO SERVIRED \MADRID -300€;-180,00;16377,36;16197,36;9735;-180,00;16317,36;2017-05-04;04/05/2017;CAJ;Gastos_Gastos varios;Efectivo;5;VARIABLES
04/05/2017;04/05/2017;COM. 64970036 SVRED CAJ OFI;-1,87;16197,36;16195,49;9736;-1,87;16315,49;2017-05-04;04/05/2017;COM;Gastos_Banco y organismos;Cargos banco;5;FIJO
04/05/2017;04/05/2017;T/ LA BRASA \ 01-05-2017;-32,01;16195,49;16163,48;9737;-32,01;16283,48;2017-05-01;01/05/2017;BRASA;Gastos_Ocio y transporte;Restaurantes;5;VARIABLES
05/05/2017;05/05/2017;T/ TUNELS VALLVI S. 02-05-2017;-4,18;16163,48;16159,30;9738;-4,18;16279,30;2017-05-02;02/05/2017;TUNELS;Gastos_Ocio y transporte;Parking y peaje;5;VARIABLES
05/05/2017;05/05/2017;T/ AUTOPISTAS TERR 02-05-2017;-1,39;16159,30;16157,91;9739;-1,39;16277,91;2017-05-02;02/05/2017;AUTOPISTAS;Gastos_Ocio y transporte;Parking y peaje;5;VARIABLES
05/05/2017;05/05/2017;T/ CATALANA DIAG.I CIR 26-04-2017;-4,45;16157,91;16153,46;9740;-4,45;16273,46;2017-04-26;26/04/2017;CATALANA;Gastos_Ocio y transporte;Parking y peaje;4;VARIABLES
06/05/2017;06/05/2017;T/ AAO OPTICO \TERRASSA;-146,00;16153,46;16007,46;9741;-146,00;16127,46;2017-05-06;06/05/2017;AAO;Gastos_Salud, saber y deporte;Optica;5;VARIABLES
06/05/2017;06/05/2017;T/ PARKING VAPOR GRAN\ 03-05-2017;-1,95;16007,46;16005,51;9742;-1,95;16125,51;2017-05-03;03/05/2017;PARKING;Gastos_Ocio y transporte;Parking y peaje;5;VARIABLES
06/05/2017;06/05/2017;T/ NAVAN \ 03-05-2017;-19,96;16005,51;15985,55;9743;-19,96;16105,55;2017-05-03;03/05/2017;NAVAN;Gastos_Salud, saber y deporte;Solidaridad;5;VARIABLES
06/05/2017;06/05/2017;T/ FARMACIA TORRAS \ 03-05-2017;-7,75;15985,55;15977,80;9744;-7,75;16097,80;2017-05-03;03/05/2017;FARMACIA;Gastos_Salud, saber y deporte;Farmacia;5;VARIABLES
06/05/2017;06/05/2017;T/ AUTOPISTAS TERR 03-05-2017;-1,39;15977,80;15976,41;9745;-1,39;16096,41;2017-05-03;03/05/2017;AUTOPISTAS;Gastos_Ocio y transporte;Parking y peaje;5;VARIABLES
06/05/2017;06/05/2017;T/ AUTOPISTAS TERR 03-05-2017;-1,39;15976,41;15975,02;9746;-1,39;16095,02;2017-05-03;03/05/2017;AUTOPISTAS;Gastos_Ocio y transporte;Parking y peaje;5;VARIABLES
06/05/2017;06/05/2017;T/ TUNELS VALLVI S. 03-05-2017;-4,18;15975,02;15970,84;9747;-4,18;16090,84;2017-05-03;03/05/2017;TUNELS;Gastos_Ocio y transporte;Parking y peaje;5;VARIABLES
06/05/2017;06/05/2017;T/ E.S. RUBI II 03-05-2017;-43,11;15970,84;15927,73;9748;-43,11;16047,73;2017-05-03;03/05/2017;RUBI;Gastos_Ocio y transporte;Gasolina;5;VARIABLES
06/05/2017;06/05/2017;T/ FRANKFURT LES LLET\ 03-05-2017;-7,30;15927,73;15920,43;9749;-7,30;16040,43;2017-05-03;03/05/2017;FRANKFURT;Gastos_Ocio y transporte;Restaurantes;5;VARIABLES
06/05/2017;06/05/2017;T/ CAFET.C T PRAT\PRAT 03-05-2017;-2,05;15920,43;15918,38;9750;-2,05;16038,38;2017-05-03;03/05/2017;CAFETC;Gastos_Ocio y transporte;Restaurantes;5;VARIABLES
07/05/2017;07/05/2017;T/ LIDL TERRASSA LES \ 04-05-2017;-20,44;15918,38;15897,94;9751;-20,44;16017,94;2017-05-04;04/05/2017;LIDL;Gastos_Compras;Supermercado;5;VARIABLES
07/05/2017;07/05/2017;T/ AUTOPISTAS TERR 04-05-2017;-1,39;15897,94;15896,55;9752;-1,39;16016,55;2017-05-04;04/05/2017;AUTOPISTAS;Gastos_Ocio y transporte;Parking y peaje;5;VARIABLES
07/05/2017;07/05/2017;T/ AUTOPISTAS TERR 04-05-2017;-1,39;15896,55;15895,16;9753;-1,39;16015,16;2017-05-04;04/05/2017;AUTOPISTAS;Gastos_Ocio y transporte;Parking y peaje;5;VARIABLES
07/05/2017;07/05/2017;T/ TUNELS VALLVI S. 04-05-2017;-4,18;15895,16;15890,98;9754;-4,18;16010,98;2017-05-04;04/05/2017;TUNELS;Gastos_Ocio y transporte;Parking y peaje;5;VARIABLES
08/05/2017;08/05/2017;R/ SERHS FOOD A SERHS SALA I BADR;-124,95;15890,98;15766,03;9755;-124,95;15886,03;2017-05-08;08/05/2017;SERHS;Gastos_Salud, saber y deporte;Menjador;5;FIJO
08/05/2017;08/05/2017;R/ SERHS FOOD A SERHS SALA I BADR;-124,95;15766,03;15641,08;9756;-124,95;15761,08;2017-05-08;08/05/2017;SERHS;Gastos_Salud, saber y deporte;Menjador;5;FIJO
08/05/2017;08/05/2017;DEV.COMPRA TJ AKI 104 - TERRASSA\TERRASSA;49,95;15641,08;15691,03;9757;49,95;15811,03;2017-05-08;08/05/2017;DEVCOMPRA;Ingresos;Devoluciones;5;VARIABLES
08/05/2017;08/05/2017;T/ CAPRABO \ 05-05-2017;-3,99;15691,03;15687,04;9758;-3,99;15807,04;2017-05-05;05/05/2017;CAPRABO;Gastos_Compras;Supermercado;5;VARIABLES
08/05/2017;08/05/2017;T/ CAFET.C T PRAT\PRAT 05-05-2017;-3,70;15687,04;15683,34;9759;-3,70;15803,34;2017-05-05;05/05/2017;CAFETC;Gastos_Ocio y transporte;Restaurantes;5;VARIABLES
09/05/2017;09/05/2017;T/ AKI 104 - TERRASSA\ 06-05-2017;-61,94;15683,34;15621,40;9760;-61,94;15741,40;2017-05-06;06/05/2017;AKI;Gastos_Vivienda y vehiculo;Mnto. hogar;5;VARIABLES
10/05/2017;10/05/2017;T/ SR. FROS \ 07-05-2017;-34,90;15621,40;15586,50;9761;-34,90;15706,50;2017-05-07;07/05/2017;FROS;Gastos_Ocio y transporte;Restaurantes;5;VARIABLES
10/05/2017;10/05/2017;T/ TUNELS VALLVI S. 05-05-2017;-4,18;15586,50;15582,32;9762;-4,18;15702,32;2017-05-05;05/05/2017;TUNELS;Gastos_Ocio y transporte;Parking y peaje;5;VARIABLES
10/05/2017;10/05/2017;T/ AUTOPISTAS TERR 05-05-2017;-1,39;15582,32;15580,93;9763;-1,39;15700,93;2017-05-05;05/05/2017;AUTOPISTAS;Gastos_Ocio y transporte;Parking y peaje;5;VARIABLES
11/05/2017;11/05/2017;R/ FINQUES GASS Vto 01-05-17 Rec;-72,60;15580,93;15508,33;9764;-72,60;15628,33;2017-05-01;01/05/2017;FINQUES;Gastos_Vivienda y vehiculo;Alquiler Parking;5;FIJO
11/05/2017;11/05/2017;R/ SEGUROS ADESLAS CENT MODULAR CO;-144,67;15508,33;15363,66;9765;-144,67;15483,66;2017-05-11;11/05/2017;ADESLAS;Gastos_Salud, saber y deporte;Medico;5;VARIABLES
11/05/2017;11/05/2017;R/ GAS GAS NATURAL GNS27630480517;-4,57;15363,66;15359,09;9766;-4,57;15479,09;2017-05-11;11/05/2017;GAS;Gastos_Servicios tipicos;Gas;5;FIJO
11/05/2017;09/05/2017;T/ WWWFLORAQUEENCOM;-52,00;15359,09;15307,09;9767;-52,00;15427,09;2017-05-09;09/05/2017;WWWFLORAQUEENCOM;Gastos_Compras;Regalos;5;VARIABLES
11/05/2017;11/05/2017;T/ LIDL EL PRAT D\PRAT 08-05-2017;-2,08;15307,09;15305,01;9768;-2,08;15425,01;2017-05-08;08/05/2017;LIDL;Gastos_Compras;Supermercado;5;VARIABLES
11/05/2017;11/05/2017;T/ AUTOPISTAS TERR 08-05-2017;-1,39;15305,01;15303,62;9769;-1,39;15423,62;2017-05-08;08/05/2017;AUTOPISTAS;Gastos_Ocio y transporte;Parking y peaje;5;VARIABLES
11/05/2017;11/05/2017;T/ TUNELS VALLVI S. 08-05-2017;-4,18;15303,62;15299,44;9770;-4,18;15419,44;2017-05-08;08/05/2017;TUNELS;Gastos_Ocio y transporte;Parking y peaje;5;VARIABLES
11/05/2017;11/05/2017;T/ AUTOPISTAS TERR 08-05-2017;-1,39;15299,44;15298,05;9771;-1,39;15418,05;2017-05-08;08/05/2017;AUTOPISTAS;Gastos_Ocio y transporte;Parking y peaje;5;VARIABLES
11/05/2017;11/05/2017;T/ AKI 104 - TERRASSA\ 08-05-2017;-92,90;15298,05;15205,15;9772;-92,90;15325,15;2017-05-08;08/05/2017;AKI;Gastos_Vivienda y vehiculo;Mnto. hogar;5;VARIABLES
12/05/2017;12/05/2017;R/ TELECOMUNICACI Vodafone;-133,95;15205,15;15071,20;9773;-133,95;15191,20;2017-05-12;12/05/2017;TELECOMUNICACI;Gastos_Servicios tipicos;Telecomunicaciones;5;FIJO
12/05/2017;12/05/2017;R/ LUZ ENDESA ENERG FACTURA DE ELE;-114,15;15071,20;14957,05;9774;-114,15;15077,05;2017-05-12;12/05/2017;ELE;Gastos_Servicios tipicos;Electricidad;5;FIJO
12/05/2017;12/05/2017;T/ TUNELS VALLVI S. 09-05-2017;-4,18;14957,05;14952,87;9775;-4,18;15072,87;2017-05-09;09/05/2017;TUNELS;Gastos_Ocio y transporte;Parking y peaje;5;VARIABLES
13/05/2017;13/05/2017;T/ VIDAL FORNERS \ 10-05-2017;-17,43;14952,87;14935,44;9776;-17,43;15055,44;2017-05-10;10/05/2017;VIDAL;Gastos_Compras;Supermercado;5;VARIABLES
13/05/2017;13/05/2017;T/ AUTOPISTAS TERR 10-05-2017;-1,39;14935,44;14934,05;9777;-1,39;15054,05;2017-05-10;10/05/2017;AUTOPISTAS;Gastos_Ocio y transporte;Parking y peaje;5;VARIABLES
13/05/2017;13/05/2017;T/ AUTOPISTAS TERR 10-05-2017;-1,39;14934,05;14932,66;9778;-1,39;15052,66;2017-05-10;10/05/2017;AUTOPISTAS;Gastos_Ocio y transporte;Parking y peaje;5;VARIABLES
13/05/2017;13/05/2017;T/ AUTOPISTAS TERR 10-05-2017;-1,39;14932,66;14931,27;9779;-1,39;15051,27;2017-05-10;10/05/2017;AUTOPISTAS;Gastos_Ocio y transporte;Parking y peaje;5;VARIABLES
13/05/2017;13/05/2017;T/ AUTOPISTAS TERR 10-05-2017;-1,39;14931,27;14929,88;9780;-1,39;15049,88;2017-05-10;10/05/2017;AUTOPISTAS;Gastos_Ocio y transporte;Parking y peaje;5;VARIABLES
13/05/2017;13/05/2017;T/ TUNELS VALLVI S. 10-05-2017;-4,18;14929,88;14925,70;9781;-4,18;15045,70;2017-05-10;10/05/2017;TUNELS;Gastos_Ocio y transporte;Parking y peaje;5;VARIABLES
13/05/2017;13/05/2017;T/ CAPRABO - 427 TERR\ 10-05-2017;-13,60;14925,70;14912,10;9782;-13,60;15032,10;2017-05-10;10/05/2017;CAPRABO;Gastos_Compras;Supermercado;5;VARIABLES
13/05/2017;13/05/2017;T/ FF.CC.GENERALITAT\B 10-05-2017;-3,00;14912,10;14909,10;9783;-3,00;15029,10;2017-05-10;10/05/2017;FFCCGENERALITATB;Gastos_Ocio y transporte;Transporte;5;VARIABLES
13/05/2017;13/05/2017;T/ VIENA PARC VALLES \ 10-05-2017;-21,90;14909,10;14887,20;9784;-21,90;15007,20;2017-05-10;10/05/2017;VIENA;Gastos_Ocio y transporte;Restaurantes;5;VARIABLES
13/05/2017;13/05/2017;T/ PARKING VAPOR GRAN\ 10-05-2017;-1,85;14887,20;14885,35;9785;-1,85;15005,35;2017-05-10;10/05/2017;PARKING;Gastos_Ocio y transporte;Parking y peaje;5;VARIABLES
13/05/2017;13/05/2017;T/ AUTOPISTAS TERR 09-05-2017;-1,39;14885,35;14883,96;9786;-1,39;15003,96;2017-05-09;09/05/2017;AUTOPISTAS;Gastos_Ocio y transporte;Parking y peaje;5;VARIABLES
13/05/2017;13/05/2017;T/ AUTOPISTAS TERR 09-05-2017;-1,39;14883,96;14882,57;9787;-1,39;15002,57;2017-05-09;09/05/2017;AUTOPISTAS;Gastos_Ocio y transporte;Parking y peaje;5;VARIABLES
14/05/2017;14/05/2017;T/ CAPRABO \ 11-05-2017;-3,99;14882,57;14878,58;9788;-3,99;14998,58;2017-05-11;11/05/2017;CAPRABO;Gastos_Compras;Supermercado;5;VARIABLES
14/05/2017;14/05/2017;T/ CAPRABO \ 11-05-2017;-8,48;14878,58;14870,10;9789;-8,48;14990,10;2017-05-11;11/05/2017;CAPRABO;Gastos_Compras;Supermercado;5;VARIABLES
14/05/2017;14/05/2017;T/ AUTOPISTAS TERR 11-05-2017;-1,39;14870,10;14868,71;9790;-1,39;14988,71;2017-05-11;11/05/2017;AUTOPISTAS;Gastos_Ocio y transporte;Parking y peaje;5;VARIABLES
14/05/2017;14/05/2017;T/ AUTOPISTAS TERR 11-05-2017;-1,39;14868,71;14867,32;9791;-1,39;14987,32;2017-05-11;11/05/2017;AUTOPISTAS;Gastos_Ocio y transporte;Parking y peaje;5;VARIABLES
14/05/2017;14/05/2017;T/ TUNELS VALLVI S. 11-05-2017;-4,18;14867,32;14863,14;9792;-4,18;14983,14;2017-05-11;11/05/2017;TUNELS;Gastos_Ocio y transporte;Parking y peaje;5;VARIABLES
15/05/2017;15/05/2017;S/OR. CASAL ESTIU CAN PALET;-496,00;14863,14;14367,14;9793;-496,00;14487,14;2017-05-15;15/05/2017;CASAL;Gastos_Salud, saber y deporte;Estudios;5;VARIABLES
15/05/2017;15/05/2017;T/ AAO OPTICO \ 12-05-2017;-18,00;14367,14;14349,14;9794;-18,00;14469,14;2017-05-12;12/05/2017;AAO;Gastos_Salud, saber y deporte;Optica;5;VARIABLES
15/05/2017;15/05/2017;T/ FRANKFURT LES LLET\ 12-05-2017;-18,65;14349,14;14330,49;9795;-18,65;14450,49;2017-05-12;12/05/2017;FRANKFURT;Gastos_Ocio y transporte;Restaurantes;5;VARIABLES
15/05/2017;15/05/2017;T/ PARKING VAPOR GRAN\ 12-05-2017;-4,40;14330,49;14326,09;9796;-4,40;14446,09;2017-05-12;12/05/2017;PARKING;Gastos_Ocio y transporte;Parking y peaje;5;VARIABLES
15/05/2017;15/05/2017;T/ FRANKFURT LES LLET\ 12-05-2017;-11,80;14326,09;14314,29;9797;-11,80;14434,29;2017-05-12;12/05/2017;FRANKFURT;Gastos_Ocio y transporte;Restaurantes;5;VARIABLES
15/05/2017;15/05/2017;T/ CAFET.C T PRAT\PRAT 12-05-2017;-2,95;14314,29;14311,34;9798;-2,95;14431,34;2017-05-12;12/05/2017;CAFETC;Gastos_Ocio y transporte;Restaurantes;5;VARIABLES
16/05/2017;16/05/2017;R/ SEGUROS CCM VIDA Y P Recibo:143;-16,61;14311,34;14294,73;9799;-16,61;14414,73;2017-05-16;16/05/2017;CCM;Gastos_Seguros;Seguro vida;5;FIJO
16/05/2017;16/05/2017;R/ SEGUROS CCM VIDA Y P Recibo:143;-20,07;14294,73;14274,66;9800;-20,07;14394,66;2017-05-16;16/05/2017;CCM;Gastos_Seguros;Seguro vida;5;FIJO
16/05/2017;12/05/2017;T/ CARREFOUR VALLE;-42,10;14274,66;14232,56;9801;-42,10;14352,56;2017-05-12;12/05/2017;CARREFOUR;Gastos_Compras;Supermercado;5;VARIABLES
16/05/2017;16/05/2017;T/ ALDI TERRASSA LES \ 13-05-2017;-42,29;14232,56;14190,27;9802;-42,29;14310,27;2017-05-13;13/05/2017;ALDI;Gastos_Compras;Supermercado;5;VARIABLES
16/05/2017;16/05/2017;T/ LIDL TERRASSA LES \ 13-05-2017;-69,88;14190,27;14120,39;9803;-69,88;14240,39;2017-05-13;13/05/2017;LIDL;Gastos_Compras;Supermercado;5;VARIABLES
16/05/2017;16/05/2017;T/ TOCINERIES VENTURA\ 13-05-2017;-18,17;14120,39;14102,22;9804;-18,17;14222,22;2017-05-13;13/05/2017;TOCINERIES;Gastos_Compras;Supermercado;5;VARIABLES
16/05/2017;16/05/2017;T/ AUTOPISTAS TERR 12-05-2017;-1,39;14102,22;14100,83;9805;-1,39;14220,83;2017-05-12;12/05/2017;AUTOPISTAS;Gastos_Ocio y transporte;Parking y peaje;5;VARIABLES
17/05/2017;16/05/2017;T/ E.S. CAN CASANOVES;-30,00;14100,83;14070,83;9806;-30,00;14190,83;2017-05-16;16/05/2017;CAN;Gastos_Ocio y transporte;Gasolina;5;VARIABLES
17/05/2017;17/05/2017;T/ TUNELS VALLVI S. 12-05-2017;-4,18;14070,83;14066,65;9807;-4,18;14186,65;2017-05-12;12/05/2017;TUNELS;Gastos_Ocio y transporte;Parking y peaje;5;VARIABLES
18/05/2017;18/05/2017;'R/ L''EINA COOPE Rebut: 12258, A.';-10,00;14066,65;14056,65;9808;-10,00;14176,65;2017-05-18;18/05/2017;LEINA;Gastos_Salud, saber y deporte;Estudios;5;VARIABLES
18/05/2017;18/05/2017;T/ CAFET.C T PRAT\PRAT 15-05-2017;-1,35;14056,65;14055,30;9809;-1,35;14175,30;2017-05-15;15/05/2017;CAFETC;Gastos_Ocio y transporte;Restaurantes;5;VARIABLES
18/05/2017;18/05/2017;T/ AUTOPISTAS TERR 15-05-2017;-1,39;14055,30;14053,91;9810;-1,39;14173,91;2017-05-15;15/05/2017;AUTOPISTAS;Gastos_Ocio y transporte;Parking y peaje;5;VARIABLES
18/05/2017;18/05/2017;T/ AUTOPISTAS TERR 15-05-2017;-1,39;14053,91;14052,52;9811;-1,39;14172,52;2017-05-15;15/05/2017;AUTOPISTAS;Gastos_Ocio y transporte;Parking y peaje;5;VARIABLES
18/05/2017;18/05/2017;T/ TUNELS VALLVI S. 15-05-2017;-4,18;14052,52;14048,34;9812;-4,18;14168,34;2017-05-15;15/05/2017;TUNELS;Gastos_Ocio y transporte;Parking y peaje;5;VARIABLES
18/05/2017;18/05/2017;T/ Frankfurt Splau \ 15-05-2017;-9,60;14048,34;14038,74;9813;-9,60;14158,74;2017-05-15;15/05/2017;FRANKFURT;Gastos_Ocio y transporte;Restaurantes;5;VARIABLES
19/05/2017;19/05/2017;T/ AUTOPISTAS TERR 16-05-2017;-1,39;14038,74;14037,35;9814;-1,39;14157,35;2017-05-16;16/05/2017;AUTOPISTAS;Gastos_Ocio y transporte;Parking y peaje;5;VARIABLES
19/05/2017;19/05/2017;T/ IKEA REST. SABADEL\ 16-05-2017;-10,45;14037,35;14026,90;9815;-10,45;14146,90;2017-05-16;16/05/2017;IKEA;Gastos_Vivienda y vehiculo;Mnto. hogar;5;VARIABLES
19/05/2017;19/05/2017;T/ TUNELS VALLVI S. 16-05-2017;-4,18;14026,90;14022,72;9816;-4,18;14142,72;2017-05-16;16/05/2017;TUNELS;Gastos_Ocio y transporte;Parking y peaje;5;VARIABLES
19/05/2017;19/05/2017;T/ IKEA REST. SABADEL\ 16-05-2017;-14,47;14022,72;14008,25;9817;-14,47;14128,25;2017-05-16;16/05/2017;IKEA;Gastos_Vivienda y vehiculo;Mnto. hogar;5;VARIABLES
19/05/2017;19/05/2017;T/ IKEA SABADELL \ 16-05-2017;-92,85;14008,25;13915,40;9818;-92,85;14035,40;2017-05-16;16/05/2017;IKEA;Gastos_Vivienda y vehiculo;Mnto. hogar;5;VARIABLES
20/05/2017;20/05/2017;T/ CINESA PARC VALLES\TERRASSA;-4,60;13915,40;13910,80;9819;-4,60;14030,80;2017-05-20;20/05/2017;CINESA;Gastos_Ocio y transporte;Espectáculos;5;VARIABLES
20/05/2017;20/05/2017;T/ AUTOPISTAS TERR 17-05-2017;-1,39;13910,80;13909,41;9820;-1,39;14029,41;2017-05-17;17/05/2017;AUTOPISTAS;Gastos_Ocio y transporte;Parking y peaje;5;VARIABLES
20/05/2017;20/05/2017;T/ TUNELS VALLVI S. 17-05-2017;-4,18;13909,41;13905,23;9821;-4,18;14025,23;2017-05-17;17/05/2017;TUNELS;Gastos_Ocio y transporte;Parking y peaje;5;VARIABLES
20/05/2017;20/05/2017;T/ AUTOPISTAS TERR 17-05-2017;-1,39;13905,23;13903,84;9822;-1,39;14023,84;2017-05-17;17/05/2017;AUTOPISTAS;Gastos_Ocio y transporte;Parking y peaje;5;VARIABLES
20/05/2017;20/05/2017;T/ FRANKFURT LES LLET\ 17-05-2017;-4,10;13903,84;13899,74;9823;-4,10;14019,74;2017-05-17;17/05/2017;FRANKFURT;Gastos_Ocio y transporte;Restaurantes;5;VARIABLES
20/05/2017;20/05/2017;TRANSFAVOR Tranferencia;2200,00;13899,74;16099,74;9824;2200,00;16219,74;2017-05-20;20/05/2017;TRANSFAVOR;Ingresos;Transferencias;5;VARIABLES
20/05/2017;20/05/2017;S/OR. COMUNIDAD PROPIETARRIOS DR.ALB 2016-2017;-480,00;16099,74;15619,74;9825;-480,00;15739,74;2017-05-20;20/05/2017;COMUNIDAD;Gastos_Vivienda y vehiculo;Comunidad;5;FIJO
21/05/2017;21/05/2017;T/ BON AREA \LLEIDA;-13,87;15619,74;15605,87;9826;-13,87;15725,87;2017-05-21;21/05/2017;BON;Gastos_Compras;Supermercado;5;VARIABLES
21/05/2017;21/05/2017;T/ AUTOPISTAS TERR 18-05-2017;-1,39;15605,87;15604,48;9827;-1,39;15724,48;2017-05-18;18/05/2017;AUTOPISTAS;Gastos_Ocio y transporte;Parking y peaje;5;VARIABLES
21/05/2017;21/05/2017;T/ AUTOPISTAS TERR 18-05-2017;-1,39;15604,48;15603,09;9828;-1,39;15723,09;2017-05-18;18/05/2017;AUTOPISTAS;Gastos_Ocio y transporte;Parking y peaje;5;VARIABLES
21/05/2017;21/05/2017;T/ SATSA PL. VELLA TER 18-05-2017;-0,80;15603,09;15602,29;9829;-0,80;15722,29;2017-05-18;18/05/2017;SATSA;Gastos_Ocio y transporte;Parking y peaje;5;VARIABLES
21/05/2017;21/05/2017;T/ TUNELS VALLVI S. 18-05-2017;-3,72;15602,29;15598,57;9830;-3,72;15718,57;2017-05-18;18/05/2017;TUNELS;Gastos_Ocio y transporte;Parking y peaje;5;VARIABLES
22/05/2017;22/05/2017;T/ CAFET.C T PRAT\PRAT 19-05-2017;-2,95;15598,57;15595,62;9831;-2,95;15715,62;2017-05-19;19/05/2017;CAFETC;Gastos_Ocio y transporte;Restaurantes;5;VARIABLES
22/05/2017;22/05/2017;T/ VIENA PARC VALLES \ 19-05-2017;-6,40;15595,62;15589,22;9832;-6,40;15709,22;2017-05-19;19/05/2017;VIENA;Gastos_Ocio y transporte;Restaurantes;5;VARIABLES
22/05/2017;22/05/2017;T/ AP DR. ROBERT TERRA 19-05-2017;-4,20;15589,22;15585,02;9833;-4,20;15705,02;2017-05-19;19/05/2017;ROBERT;Gastos_Ocio y transporte;Parking y peaje;5;VARIABLES
22/05/2017;22/05/2017;T/ DECATHLON SA TERRA\ 19-05-2017;-3,98;15585,02;15581,04;9834;-3,98;15701,04;2017-05-19;19/05/2017;DECATHLON;Gastos_Compras;Deportivo;5;VARIABLES
22/05/2017;22/05/2017;T/ FRANKFURT LES LLET\ 19-05-2017;-3,80;15581,04;15577,24;9835;-3,80;15697,24;2017-05-19;19/05/2017;FRANKFURT;Gastos_Ocio y transporte;Restaurantes;5;VARIABLES
22/05/2017;22/05/2017;T/ ABACUS TERRASSA \ 19-05-2017;-11,05;15577,24;15566,19;9836;-11,05;15686,19;2017-05-19;19/05/2017;ABACUS;Gastos_Salud, saber y deporte;Estudios;5;VARIABLES
22/05/2017;22/05/2017;T/ LIDL TERRASSA LES \TERRASSA;-74,75;15566,19;15491,44;9837;-74,75;15611,44;2017-05-22;22/05/2017;LIDL;Gastos_Compras;Supermercado;5;VARIABLES
23/05/2017;23/05/2017;T/ LA BRASA \ 20-05-2017;-69,71;15491,44;15421,73;9838;-69,71;15541,73;2017-05-20;20/05/2017;BRASA;Gastos_Ocio y transporte;Restaurantes;5;VARIABLES
23/05/2017;23/05/2017;T/ CINESA WEB \B 20-05-2017;-27,60;15421,73;15394,13;9839;-27,60;15514,13;2017-05-20;20/05/2017;CINESA;Gastos_Ocio y transporte;Espectáculos;5;VARIABLES
23/05/2017;23/05/2017;T/ E143 JYSK TERRASSA\ 20-05-2017;-36,92;15394,13;15357,21;9840;-36,92;15477,21;2017-05-20;20/05/2017;JYSK;Gastos_Vivienda y vehiculo;Mnto. hogar;5;VARIABLES
23/05/2017;23/05/2017;T/ SATURN E515 EL\PRAT 20-05-2017;-39,95;15357,21;15317,26;9841;-39,95;15437,26;2017-05-20;20/05/2017;SATURN;Gastos_Compras;Hobbys;5;VARIABLES
24/05/2017;24/05/2017;T/ TUNELS VALLVI S. 19-05-2017;-4,18;15317,26;15313,08;9842;-4,18;15433,08;2017-05-19;19/05/2017;TUNELS;Gastos_Ocio y transporte;Parking y peaje;5;VARIABLES
24/05/2017;24/05/2017;T/ AUTOPISTAS TERR 19-05-2017;-1,39;15313,08;15311,69;9843;-1,39;15431,69;2017-05-19;19/05/2017;AUTOPISTAS;Gastos_Ocio y transporte;Parking y peaje;5;VARIABLES
24/05/2017;24/05/2017;T/ AUTOPISTAS TERR 19-05-2017;-1,39;15311,69;15310,30;9844;-1,39;15430,30;2017-05-19;19/05/2017;AUTOPISTAS;Gastos_Ocio y transporte;Parking y peaje;5;VARIABLES
24/05/2017;24/05/2017;T/ FARMACIA TORRAS \TERRASSA;-16,97;15310,30;15293,33;9845;-16,97;15413,33;2017-05-24;24/05/2017;FARMACIA;Gastos_Salud, saber y deporte;Farmacia;5;VARIABLES
25/05/2017;25/05/2017;ABO. A.E.A.T. DEVOLUCIONES TRIBUTAR;222,00;15293,33;15515,33;9846;222,00;15635,33;2017-05-25;25/05/2017;ABO;Ingresos;Devoluciones;5;VARIABLES
25/05/2017;25/05/2017;T/ CAFET.C T PRAT\PRAT DE LLOB;-1,35;15515,33;15513,98;9847;-1,35;15633,98;2017-05-25;25/05/2017;CAFETC;Gastos_Ocio y transporte;Restaurantes;5;VARIABLES
25/05/2017;22/05/2017;T/ AP DR. ROBERT TERRASSA;-3,70;15513,98;15510,28;9848;-3,70;15630,28;2017-05-22;22/05/2017;ROBERT;Gastos_Ocio y transporte;Parking y peaje;5;VARIABLES
25/05/2017;22/05/2017;T/ TUNELS VALLVI S. C:2T;-3,72;15510,28;15506,56;9849;-3,72;15626,56;2017-05-22;22/05/2017;TUNELS;Gastos_Ocio y transporte;Parking y peaje;5;VARIABLES
25/05/2017;25/05/2017;T/ VIENA PARC VALLES \ 22-05-2017;-19,65;15506,56;15486,91;9850;-19,65;15606,91;2017-05-22;22/05/2017;VIENA;Gastos_Ocio y transporte;Restaurantes;5;VARIABLES
25/05/2017;25/05/2017;T/ AUTOPISTAS TERR 22-05-2017;-1,39;15486,91;15485,52;9851;-1,39;15605,52;2017-05-22;22/05/2017;AUTOPISTAS;Gastos_Ocio y transporte;Parking y peaje;5;VARIABLES
25/05/2017;25/05/2017;T/ AUTOPISTAS TERR 22-05-2017;-1,39;15485,52;15484,13;9852;-1,39;15604,13;2017-05-22;22/05/2017;AUTOPISTAS;Gastos_Ocio y transporte;Parking y peaje;5;VARIABLES
26/05/2017;26/05/2017;HAB. FOMENT DE TERRASSA S.A. Transf;1793,93;15484,13;17278,06;9853;1793,93;17398,06;2017-05-26;26/05/2017;HAB;Ingresos;Nomina;5;FIJO
26/05/2017;26/05/2017;T/ TUNELS VALLVI S. 23-05-2017;-4,18;17278,06;17273,88;9854;-4,18;17393,88;2017-05-23;23/05/2017;TUNELS;Gastos_Ocio y transporte;Parking y peaje;5;VARIABLES
26/05/2017;26/05/2017;T/ MERCADONA QUATRE C\ 23-05-2017;-126,36;17273,88;17147,52;9855;-126,36;17267,52;2017-05-23;23/05/2017;MERCADONA;Gastos_Compras;Supermercado;5;VARIABLES
26/05/2017;26/05/2017;T/ MERCADONA QUATRE C\ 23-05-2017;-7,54;17147,52;17139,98;9856;-7,54;17259,98;2017-05-23;23/05/2017;MERCADONA;Gastos_Compras;Supermercado;5;VARIABLES
26/05/2017;26/05/2017;T/ CEDIPSA 15838-1 EG\ 23-05-2017;-30,00;17139,98;17109,98;9857;-30,00;17229,98;2017-05-23;23/05/2017;CEDIPSA;Gastos_Ocio y transporte;Gasolina;5;VARIABLES
27/05/2017;27/05/2017;T/ VIDAL FORNERS \ 24-05-2017;-10,10;17109,98;17099,88;9858;-10,10;17219,88;2017-05-24;24/05/2017;VIDAL;Gastos_Compras;Supermercado;5;VARIABLES
27/05/2017;27/05/2017;T/ AUTOPISTAS TERR 24-05-2017;-1,39;17099,88;17098,49;9859;-1,39;17218,49;2017-05-24;24/05/2017;AUTOPISTAS;Gastos_Ocio y transporte;Parking y peaje;5;VARIABLES
27/05/2017;27/05/2017;T/ AUTOPISTAS TERR 24-05-2017;-1,39;17098,49;17097,10;9860;-1,39;17217,10;2017-05-24;24/05/2017;AUTOPISTAS;Gastos_Ocio y transporte;Parking y peaje;5;VARIABLES
27/05/2017;27/05/2017;T/ CAPRABO \ 24-05-2017;-6,89;17097,10;17090,21;9861;-6,89;17210,21;2017-05-24;24/05/2017;CAPRABO;Gastos_Compras;Supermercado;5;VARIABLES
27/05/2017;27/05/2017;T/ TUNELS VALLVI S. 24-05-2017;-3,72;17090,21;17086,49;9862;-3,72;17206,49;2017-05-24;24/05/2017;TUNELS;Gastos_Ocio y transporte;Parking y peaje;5;VARIABLES
27/05/2017;27/05/2017;T/ PARKING VAPOR GRAN\ 24-05-2017;-2,85;17086,49;17083,64;9863;-2,85;17203,64;2017-05-24;24/05/2017;PARKING;Gastos_Ocio y transporte;Parking y peaje;5;VARIABLES
27/05/2017;27/05/2017;T/ AUTOPISTAS TERR 23-05-2017;-1,39;17083,64;17082,25;9864;-1,39;17202,25;2017-05-23;23/05/2017;AUTOPISTAS;Gastos_Ocio y transporte;Parking y peaje;5;VARIABLES
28/05/2017;28/05/2017;T/ CAPRABO \ 25-05-2017;-5,39;17082,25;17076,86;9865;-5,39;17196,86;2017-05-25;25/05/2017;CAPRABO;Gastos_Compras;Supermercado;5;VARIABLES
28/05/2017;28/05/2017;T/ NAVAN \ 25-05-2017;-16,82;17076,86;17060,04;9866;-16,82;17180,04;2017-05-25;25/05/2017;NAVAN;Gastos_Salud, saber y deporte;Solidaridad;5;VARIABLES
28/05/2017;28/05/2017;T/ AUTOPISTAS TERR 25-05-2017;-1,39;17060,04;17058,65;9867;-1,39;17178,65;2017-05-25;25/05/2017;AUTOPISTAS;Gastos_Ocio y transporte;Parking y peaje;5;VARIABLES
28/05/2017;28/05/2017;T/ AUTOPISTAS TERR 25-05-2017;-1,39;17058,65;17057,26;9868;-1,39;17177,26;2017-05-25;25/05/2017;AUTOPISTAS;Gastos_Ocio y transporte;Parking y peaje;5;VARIABLES
28/05/2017;28/05/2017;T/ TUNELS VALLVI S. 25-05-2017;-4,18;17057,26;17053,08;9869;-4,18;17173,08;2017-05-25;25/05/2017;TUNELS;Gastos_Ocio y transporte;Parking y peaje;5;VARIABLES
29/05/2017;29/05/2017;HAB. INFORMACIO I TECNOLOGIA DE CAT;1624,63;17053,08;18677,71;9870;1624,63;18797,71;2017-05-29;29/05/2017;HAB;Ingresos;Nomina;5;FIJO
30/05/2017;30/05/2017;ABO. A.E.A.T. DEVOLUCIONES TRIBUTAR;1106,99;18677,71;19784,70;9871;1106,99;19904,70;2017-05-30;30/05/2017;ABO;Ingresos;Devoluciones;5;VARIABLES
30/05/2017;27/05/2017;T/ CARREF TARRASA;-18,76;19784,70;19765,94;9872;-18,76;19885,94;2017-05-27;27/05/2017;CARREF;Gastos_Compras;Supermercado;5;VARIABLES
30/05/2017;27/05/2017;T/ CARREFOUR TARRA;-140,89;19765,94;19625,05;9873;-140,89;19745,05;2017-05-27;27/05/2017;CARREFOUR;Gastos_Compras;Supermercado;5;VARIABLES
30/05/2017;30/05/2017;T/ VIENA MONTSERRAT \ 27-05-2017;-20,35;19625,05;19604,70;9874;-20,35;19724,70;2017-05-27;27/05/2017;VIENA;Gastos_Ocio y transporte;Restaurantes;5;VARIABLES
31/05/2017;31/05/2017;REC. 6061.9600001223;-485,11;19604,70;19119,59;9875;-485,11;19239,59;2017-05-31;31/05/2017;REC;Gastos_Banco y organismos;Hipoteca;5;FIJO
31/05/2017;31/05/2017;T/ TUNELS VALLVI S. 26-05-2017;-4,18;19119,59;19115,41;9876;-4,18;19235,41;2017-05-26;26/05/2017;TUNELS;Gastos_Ocio y transporte;Parking y peaje;5;VARIABLES
31/05/2017;31/05/2017;T/ AUTOPISTAS TERR 26-05-2017;-1,39;19115,41;19114,02;9877;-1,39;19234,02;2017-05-26;26/05/2017;AUTOPISTAS;Gastos_Ocio y transporte;Parking y peaje;5;VARIABLES
31/05/2017;31/05/2017;T/ AUTOPISTAS TERR 26-05-2017;-1,39;19114,02;19112,63;9878;-1,39;19232,63;2017-05-26;26/05/2017;AUTOPISTAS;Gastos_Ocio y transporte;Parking y peaje;5;VARIABLES
31/05/2017;31/05/2017;limPIEZA REDUCIMOS EFECTIVO 04/05;-120,00;18774,60;18654,60;9879;-120,00;19112,63;2017-05-31;31/05/2017;LIMPIEZA;Gastos_Vivienda y vehiculo;Serv. domestico;5;FIJO
01/06/2017;01/06/2017;FACT TARJETAS TARJ.CREDITO 07126017 17-06-01;-245,18;19112,63;18867,45;9880;-245,18;18867,45;2017-06-01;31/05/2017;FACT 07126017;Gastos_Banco y organismos;Credito Bea;5;VARIABLE
01/06/2017;01/06/2017;FACT TARJETAS TARJ.CREDITO 42689013 17-06-01;-88,47;18867,45;18778,98;9881;-88,47;18778,98;2017-06-01;31/05/2017;FACT;No computable;Recibo Tarjeta;5;
01/06/2017;01/06/2017;R/ LUZ ENDESA ENERG FACTURA DE GAS;-48,50;18778,98;18730,48;9882;-48,50;18730,48;2017-06-01;01/06/2017;GAS;Gastos_Servicios tipicos;Gas;6;FIJO
01/06/2017;30/05/2017;T/ CARREFOUR VALLE;-50,83;18730,48;18679,65;9883;-50,83;18679,65;2017-05-30;30/05/2017;CARREFOUR;Gastos_Compras;Supermercado;5;VARIABLES
01/06/2017;01/06/2017;S/OR. AMPA Escola Sala i Badrinas;-40,00;18679,65;18639,65;9884;-40,00;18639,65;2017-06-01;01/06/2017;AMPA;Gastos_Salud, saber y deporte;Estudios;6;VARIABLES
02/06/2017;02/06/2017;T/ LIDL TERRASSA LES \ 30-05-2017;-11,77;18639,65;18627,88;9885;-11,77;18627,88;2017-05-30;30/05/2017;LIDL;Gastos_Compras;Supermercado;5;VARIABLES
02/06/2017;02/06/2017;T/ GP PARRK VALLES \CE 30-05-2017;-14,00;18627,88;18613,88;9886;-14,00;18613,88;2017-05-30;30/05/2017;PARRK;Gastos_Ocio y transporte;Parking y peaje;5;VARIABLES
02/06/2017;02/06/2017;T/ AUTOPISTAS TERR 30-05-2017;-1,39;18613,88;18612,49;9887;-1,39;18612,49;2017-05-30;30/05/2017;AUTOPISTAS;Gastos_Ocio y transporte;Parking y peaje;5;VARIABLES
02/06/2017;02/06/2017;T/ AUTOPISTAS TERR 30-05-2017;-1,39;18612,49;18611,10;9888;-1,39;18611,10;2017-05-30;30/05/2017;AUTOPISTAS;Gastos_Ocio y transporte;Parking y peaje;5;VARIABLES
02/06/2017;02/06/2017;T/ TUNELS VALLVI S. 30-05-2017;-4,18;18611,10;18606,92;9889;-4,18;18606,92;2017-05-30;30/05/2017;TUNELS;Gastos_Ocio y transporte;Parking y peaje;5;VARIABLES
02/06/2017;02/06/2017;T/ VIENA PARC VALLES \ 30-05-2017;-20,95;18606,92;18585,97;9890;-20,95;18585,97;2017-05-30;30/05/2017;VIENA;Gastos_Ocio y transporte;Restaurantes;5;VARIABLES
03/06/2017;03/06/2017;T/ AUTOPISTAS TERR 31-05-2017;-1,39;18585,97;18584,58;9891;-1,39;18584,58;2017-05-31;31/05/2017;AUTOPISTAS;Gastos_Ocio y transporte;Parking y peaje;5;VARIABLES
03/06/2017;03/06/2017;T/ AUTOPISTAS TERR 31-05-2017;-1,39;18584,58;18583,19;9892;-1,39;18583,19;2017-05-31;31/05/2017;AUTOPISTAS;Gastos_Ocio y transporte;Parking y peaje;5;VARIABLES
03/06/2017;03/06/2017;T/ PARKING VAPOR GRAN\ 31-05-2017;-3,20;18583,19;18579,99;9893;-3,20;18579,99;2017-05-31;31/05/2017;PARKING;Gastos_Ocio y transporte;Parking y peaje;5;VARIABLES
03/06/2017;03/06/2017;T/ CAPRABO \ 31-05-2017;-4,44;18579,99;18575,55;9894;-4,44;18575,55;2017-05-31;31/05/2017;CAPRABO;Gastos_Compras;Supermercado;5;VARIABLES
04/06/2017;04/06/2017;T/ AUTOPISTAS TERR 01-06-2017;-1,39;18575,55;18574,16;9895;-1,39;18574,16;2017-06-01;01/06/2017;AUTOPISTAS;Gastos_Ocio y transporte;Parking y peaje;6;VARIABLES
04/06/2017;04/06/2017;T/ AUTOPISTAS TERR 01-06-2017;-1,39;18574,16;18572,77;9896;-1,39;18572,77;2017-06-01;01/06/2017;AUTOPISTAS;Gastos_Ocio y transporte;Parking y peaje;6;VARIABLES
04/06/2017;04/06/2017;T/ TUNELS VALLVI S. 01-06-2017;-4,18;18572,77;18568,59;9897;-4,18;18568,59;2017-06-01;01/06/2017;TUNELS;Gastos_Ocio y transporte;Parking y peaje;6;VARIABLES
04/06/2017;04/06/2017;T/ BON AREA 01-06-2017;-27,25;18568,59;18541,34;9898;-27,25;18541,34;2017-06-01;01/06/2017;BON;Gastos_Compras;Supermercado;6;VARIABLES
04/06/2017;04/06/2017;T/ E.S.RUBI 9 01-06-2017;-45,69;18541,34;18495,65;9899;-45,69;18495,65;2017-06-01;01/06/2017;ESRUBI;Gastos_Ocio y transporte;Gasolina;6;VARIABLES
05/06/2017;05/06/2017;T/ LIDL TERRASSA \ 02-06-2017;-18,95;18495,65;18476,70;9900;-18,95;18476,70;2017-06-02;02/06/2017;LIDL;Gastos_Compras;Supermercado;6;VARIABLES
05/06/2017;05/06/2017;T/ CAFET.C T PRAT\PRAT 02-06-2017;-2,95;18476,70;18473,75;9901;-2,95;18473,75;2017-06-02;02/06/2017;CAFETC;Gastos_Ocio y transporte;Restaurantes;6;VARIABLES
06/06/2017;06/06/2017;R/ AJUNTAMENT D IMPOST VEHICLES T;-62,78;18473,75;18410,97;9902;-62,78;18410,97;2017-06-06;06/06/2017;AJUNTAMENT;Gastos_Banco y organismos;Ayuntamiento;6;FIJO
06/06/2017;06/06/2017;R/ SERHS FOOD A SERHS SALA I BADR;-89,25;18410,97;18321,72;9903;-89,25;18321,72;2017-06-06;06/06/2017;SERHS;Gastos_Salud, saber y deporte;Menjador;6;FIJO
06/06/2017;06/06/2017;R/ SERHS FOOD A SERHS SALA I BADR;-89,25;18321,72;18232,47;9904;-89,25;18232,47;2017-06-06;06/06/2017;SERHS;Gastos_Salud, saber y deporte;Menjador;6;FIJO
06/06/2017;06/06/2017;R/ SEGUROS ADESLAS CENT MODULAR CO;-144,67;18232,47;18087,80;9905;-144,67;18087,80;2017-06-06;06/06/2017;ADESLAS;Gastos_Salud, saber y deporte;Medico;6;VARIABLES
06/06/2017;06/06/2017;T/ BON AREA 03-06-2017;-10,51;18087,80;18077,29;9906;-10,51;18077,29;2017-06-03;03/06/2017;BON;Gastos_Compras;Supermercado;6;VARIABLES
06/06/2017;06/06/2017;T/ FOCS A ST JORDI \ 03-06-2017;-13,45;18077,29;18063,84;9907;-13,45;18063,84;2017-06-03;03/06/2017;FOCS;Gastos_Compras;Libreria;6;VARIABLES
06/06/2017;06/06/2017;T/ FARMA.ANGEL MORENO\ 03-06-2017;-16,11;18063,84;18047,73;9908;-16,11;18047,73;2017-06-03;03/06/2017;FARMAANGEL;Gastos_Salud, saber y deporte;Farmacia;6;VARIABLES
07/06/2017;07/06/2017;'R/ L''EINA COOPE Rebut: 12668, SAL';-57,15;18047,73;17990,58;9909;-57,15;17990,58;2017-06-07;07/06/2017;LEINA;Gastos_Salud, saber y deporte;Estudios;6;VARIABLES
08/06/2017;08/06/2017;T/ AUTOPISTAS TERR 03-06-2017;-2,53;17990,58;17988,05;9910;-2,53;17988,05;2017-06-03;03/06/2017;AUTOPISTAS;Gastos_Ocio y transporte;Parking y peaje;6;VARIABLES
08/06/2017;08/06/2017;T/ AUTOPISTAS TERR 03-06-2017;-2,53;17988,05;17985,52;9911;-2,53;17985,52;2017-06-03;03/06/2017;AUTOPISTAS;Gastos_Ocio y transporte;Parking y peaje;6;VARIABLES
08/06/2017;08/06/2017;T/ TUNELS VALLVI S. 02-06-2017;-3,72;17985,52;17981,80;9912;-3,72;17981,80;2017-06-02;02/06/2017;TUNELS;Gastos_Ocio y transporte;Parking y peaje;6;VARIABLES
08/06/2017;08/06/2017;T/ AUTOPISTAS TERR 02-06-2017;-1,39;17981,80;17980,41;9913;-1,39;17980,41;2017-06-02;02/06/2017;AUTOPISTAS;Gastos_Ocio y transporte;Parking y peaje;6;VARIABLES
10/06/2017;10/06/2017;T/ PAIPAS CARNE S L \ 07-06-2017;-5,85;17980,41;17974,56;9914;-5,85;17974,56;2017-06-07;07/06/2017;PAIPAS;Gastos_Compras;Supermercado;6;VARIABLES
10/06/2017;10/06/2017;T/ FF.CC.GENERALITAT\B 07-06-2017;-6,00;17974,56;17968,56;9915;-6,00;17968,56;2017-06-07;07/06/2017;FFCCGENERALITATB;Gastos_Ocio y transporte;Transporte;6;VARIABLES
10/06/2017;10/06/2017;T/ NAVAN \ 07-06-2017;-19,98;17968,56;17948,58;9916;-19,98;17948,58;2017-06-07;07/06/2017;NAVAN;Gastos_Salud, saber y deporte;Solidaridad;6;VARIABLES
11/06/2017;11/06/2017;T/ CAFET.C T PRAT\PRAT 08-06-2017;-2,50;17948,58;17946,08;9917;-2,50;17946,08;2017-06-08;08/06/2017;CAFETC;Gastos_Ocio y transporte;Restaurantes;6;VARIABLES
11/06/2017;11/06/2017;T/ AUTOPISTAS TERR 08-06-2017;-1,39;17946,08;17944,69;9918;-1,39;17944,69;2017-06-08;08/06/2017;AUTOPISTAS;Gastos_Ocio y transporte;Parking y peaje;6;VARIABLES
12/06/2017;12/06/2017;R/ GAS GAS NATURAL GNS27630480617;-4,57;17944,69;17940,12;9919;-4,57;17940,12;2017-06-12;12/06/2017;GAS;Gastos_Servicios tipicos;Gas;6;FIJO
13/06/2017;13/06/2017;R/ . FINQUES GASS Vto 01-06-17 Rec;-72,60;17940,12;17867,52;9920;-72,60;17867,52;2017-06-01;01/06/2017;FINQUES;Gastos_Vivienda y vehiculo;Alquiler Parking;6;FIJO
13/06/2017;13/06/2017;R/ TELECOMUNICACI VODAFONE;-132,42;17867,52;17735,10;9921;-132,42;17735,10;2017-06-13;13/06/2017;TELECOMUNICACI;Gastos_Servicios tipicos;Telecomunicaciones;6;FIJO
13/06/2017;13/06/2017;T/ AKI 101 - BARI\BARB 10-06-2017;-19,90;17735,10;17715,20;9922;-19,90;17715,20;2017-06-10;10/06/2017;AKI;Gastos_Vivienda y vehiculo;Mnto. hogar;6;VARIABLES
13/06/2017;13/06/2017;T/ CATALANA DIAG.I CIR 10-06-2017;-6,85;17715,20;17708,35;9923;-6,85;17708,35;2017-06-10;10/06/2017;CATALANA;Gastos_Ocio y transporte;Parking y peaje;6;VARIABLES
14/06/2017;12/06/2017;T/ AMAZON.ES COMPRA;-179,00;17708,35;17529,35;9924;-179,00;17529,35;2017-06-12;12/06/2017;AMAZONES;Gastos_Compras;Hobbys;6;VARIABLES
14/06/2017;14/06/2017;CAJ. AJENO SISTEMA 4B \TERRASSA;-200,00;17529,35;17329,35;9925;-200,00;17329,35;2017-06-14;14/06/2017;CAJ;Gastos_Gastos varios;Efectivo;6;VARIABLES
14/06/2017;14/06/2017;COM. 76985025 4b CAJ4 OFI9376;-1,85;17329,35;17327,50;9926;-1,85;17327,50;2017-06-14;14/06/2017;COM;Gastos_Banco y organismos;Cargos banco;6;FIJO
15/06/2017;15/06/2017;T/ AUTOPISTAS TERR 12-06-2017;-1,39;17327,50;17326,11;9927;-1,39;17326,11;2017-06-12;12/06/2017;AUTOPISTAS;Gastos_Ocio y transporte;Parking y peaje;6;VARIABLES
15/06/2017;15/06/2017;T/ AUTOPISTAS TERR 12-06-2017;-1,39;17326,11;17324,72;9928;-1,39;17324,72;2017-06-12;12/06/2017;AUTOPISTAS;Gastos_Ocio y transporte;Parking y peaje;6;VARIABLES
15/06/2017;15/06/2017;T/ TUNELS VALLVI S. 12-06-2017;-4,18;17324,72;17320,54;9929;-4,18;17320,54;2017-06-12;12/06/2017;TUNELS;Gastos_Ocio y transporte;Parking y peaje;6;VARIABLES
16/06/2017;16/06/2017;T/ AUTOPISTAS TERR 13-06-2017;-1,39;17320,54;17319,15;9930;-1,39;17319,15;2017-06-13;13/06/2017;AUTOPISTAS;Gastos_Ocio y transporte;Parking y peaje;6;VARIABLES
17/06/2017;17/06/2017;T/ AUTOPISTAS TERR 14-06-2017;-1,39;17319,15;17317,76;9931;-1,39;17317,76;2017-06-14;14/06/2017;AUTOPISTAS;Gastos_Ocio y transporte;Parking y peaje;6;VARIABLES
17/06/2017;17/06/2017;T/ AUTOPISTAS TERR 14-06-2017;-1,39;17317,76;17316,37;9932;-1,39;17316,37;2017-06-14;14/06/2017;AUTOPISTAS;Gastos_Ocio y transporte;Parking y peaje;6;VARIABLES
17/06/2017;17/06/2017;T/ CAFET.C T PRAT\PRAT 14-06-2017;-2,50;17316,37;17313,87;9933;-2,50;17313,87;2017-06-14;14/06/2017;CAFETC;Gastos_Ocio y transporte;Restaurantes;6;VARIABLES
17/06/2017;17/06/2017;T/ TUNELS VALLVI S. 14-06-2017;-4,18;17313,87;17309,69;9934;-4,18;17309,69;2017-06-14;14/06/2017;TUNELS;Gastos_Ocio y transporte;Parking y peaje;6;VARIABLES
17/06/2017;17/06/2017;T/ FARMA.ANGEL MORENO\ 14-06-2017;-10,40;17309,69;17299,29;9935;-10,40;17299,29;2017-06-14;14/06/2017;FARMAANGEL;Gastos_Salud, saber y deporte;Farmacia;6;VARIABLES
17/06/2017;17/06/2017;T/ EL SALON THE BARBE\ 14-06-2017;-69,98;17299,29;17229,31;9936;-69,98;17229,31;2017-06-14;14/06/2017;SALON;Gastos_Salud, saber y deporte;Belleza;6;VARIABLES
18/06/2017;18/06/2017;T/ AUTOPISTAS TERR 15-06-2017;-1,39;17229,31;17227,92;9937;-1,39;17227,92;2017-06-15;15/06/2017;AUTOPISTAS;Gastos_Ocio y transporte;Parking y peaje;6;VARIABLES
18/06/2017;18/06/2017;T/ TUNELS VALLVI S. 15-06-2017;-4,18;17227,92;17223,74;9938;-4,18;17223,74;2017-06-15;15/06/2017;TUNELS;Gastos_Ocio y transporte;Parking y peaje;6;VARIABLES
18/06/2017;18/06/2017;T/ LUDINFANT, S.L. \TERRASSA;-334,00;17223,74;16889,74;9939;-334,00;16889,74;2017-06-18;18/06/2017;LUDINFANT;Gastos_Compras;Niños;6;VARIABLES
19/06/2017;19/06/2017;R/ SEGUROS CCM VIDA Y P Recibo:143;-16,55;16889,74;16873,19;9940;-16,55;16873,19;2017-06-19;19/06/2017;CCM;Gastos_Seguros;Seguro vida;6;FIJO
19/06/2017;19/06/2017;R/ SEGUROS CCM VIDA Y P Recibo:143;-20,01;16873,19;16853,18;9941;-20,01;16853,18;2017-06-19;19/06/2017;CCM;Gastos_Seguros;Seguro vida;6;FIJO
19/06/2017;19/06/2017;T/ WWW.JUST-EAT.ES 16-06-2017;-18,50;16853,18;16834,68;9942;-18,50;16834,68;2017-06-16;16/06/2017;WWWJUSTEATES;Gastos_Ocio y transporte;Restaurantes;6;VARIABLES
20/06/2017;20/06/2017;T/ PARC VALLES \ 17-06-2017;-129,08;16834,68;16705,60;9943;-129,08;16705,60;2017-06-17;17/06/2017;PARC;Gastos_Compras;Supermercado;6;VARIABLES
20/06/2017;20/06/2017;T/ FARMACIA OPTICA JORNET \ 17-06-2017;-16,90;16705,60;16688,70;9944;-16,90;16688,70;2017-06-17;17/06/2017;FARMACIA;Gastos_Salud, saber y deporte;Farmacia;6;VARIABLES
20/06/2017;20/06/2017;T/ SERRA \ 17-06-2017;-37,04;16688,70;16651,66;9945;-37,04;16651,66;2017-06-17;17/06/2017;SERRA;Gastos_Compras;Hogar;6;VARIABLES
21/06/2017;21/06/2017;R/ MINA PUBLICA AIGUES T.01A75789;-37,32;16651,66;16614,34;9946;-37,32;16614,34;2017-06-21;21/06/2017;MINA;Gastos_Servicios tipicos;Agua;6;FIJO
21/06/2017;21/06/2017;HAB. FOMENT DE TERRASSA S.A. Transf;3742,87;16614,34;20357,21;9947;3742,87;20357,21;2017-06-21;21/06/2017;HAB;Ingresos;Nomina;6;FIJO
22/06/2017;22/06/2017;T/ AUTOPISTAS TERR 19-06-2017;-1,39;20357,21;20355,82;9948;-1,39;20355,82;2017-06-19;19/06/2017;AUTOPISTAS;Gastos_Ocio y transporte;Parking y peaje;6;VARIABLES
22/06/2017;22/06/2017;T/ AUTOPISTAS TERR 19-06-2017;-1,39;20355,82;20354,43;9949;-1,39;20354,43;2017-06-19;19/06/2017;AUTOPISTAS;Gastos_Ocio y transporte;Parking y peaje;6;VARIABLES
22/06/2017;22/06/2017;T/ TUNELS VALLVI S. 19-06-2017;-4,18;20354,43;20350,25;9950;-4,18;20350,25;2017-06-19;19/06/2017;TUNELS;Gastos_Ocio y transporte;Parking y peaje;6;VARIABLES
22/06/2017;22/06/2017;T/ LIDL TERRASSA LES \ 19-06-2017;-31,96;20350,25;20318,29;9951;-31,96;20318,29;2017-06-19;19/06/2017;LIDL;Gastos_Compras;Supermercado;6;VARIABLES
24/06/2017;24/06/2017;T/ PARC VALLES \ 21-06-2017;-29,94;20318,29;20288,35;9952;-29,94;20288,35;2017-06-21;21/06/2017;PARC;Gastos_Compras;Supermercado;6;VARIABLES
24/06/2017;24/06/2017;T/ CAFET.C T PRAT\PRAT 21-06-2017;-1,35;20288,35;20287,00;9953;-1,35;20287,00;2017-06-21;21/06/2017;CAFETC;Gastos_Ocio y transporte;Restaurantes;6;VARIABLES
25/06/2017;25/06/2017;T/ FRANKFURT LES LLET\ 22-06-2017;-5,85;20287,00;20281,15;9954;-5,85;20281,15;2017-06-22;22/06/2017;FRANKFURT;Gastos_Ocio y transporte;Restaurantes;6;VARIABLES
25/06/2017;25/06/2017;T/ NAVAN \ 22-06-2017;-19,90;20281,15;20261,25;9955;-19,90;20261,25;2017-06-22;22/06/2017;NAVAN;Gastos_Salud, saber y deporte;Solidaridad;6;VARIABLES
25/06/2017;25/06/2017;T/ AUTOPISTAS TERR 21-06-2017;-1,39;20261,25;20259,86;9956;-1,39;20259,86;2017-06-21;21/06/2017;AUTOPISTAS;Gastos_Ocio y transporte;Parking y peaje;6;VARIABLES
25/06/2017;25/06/2017;T/ AUTOPISTAS TERR 21-06-2017;-1,39;20259,86;20258,47;9957;-1,39;20258,47;2017-06-21;21/06/2017;AUTOPISTAS;Gastos_Ocio y transporte;Parking y peaje;6;VARIABLES
25/06/2017;25/06/2017;T/ TUNELS VALLVI S. 21-06-2017;-3,72;20258,47;20254,75;9958;-3,72;20254,75;2017-06-21;21/06/2017;TUNELS;Gastos_Ocio y transporte;Parking y peaje;6;VARIABLES
26/06/2017;26/06/2017;T/ UDON PARC VALLES \ 23-06-2017;-37,70;20254,75;20217,05;9959;-37,70;20217,05;2017-06-23;23/06/2017;UDON;Gastos_Ocio y transporte;Restaurantes;6;VARIABLES
27/06/2017;27/06/2017;T/ CAPRABO \ 24-06-2017;-23,53;20217,05;20193,52;9960;-23,53;20193,52;2017-06-24;24/06/2017;CAPRABO;Gastos_Compras;Supermercado;6;VARIABLES
27/06/2017;27/06/2017;T/ FARMACIA SEGLE XX \ 24-06-2017;-21,92;20193,52;20171,60;9961;-21,92;20171,60;2017-06-24;24/06/2017;FARMACIA;Gastos_Salud, saber y deporte;Farmacia;6;VARIABLES
28/06/2017;28/06/2017;HAB. INFORMACIO I TECNOLOGIA DE CAT;1620,24;20171,60;21791,84;9962;1620,24;21791,84;2017-06-28;28/06/2017;HAB;Ingresos;Nomina;6;FIJO
29/06/2017;29/06/2017;T/ AUTOPISTAS TERR 26-06-2017;-1,39;21791,84;21790,45;9963;-1,39;21790,45;2017-06-26;26/06/2017;AUTOPISTAS;Gastos_Ocio y transporte;Parking y peaje;6;VARIABLES
29/06/2017;29/06/2017;T/ DECATHLON SA TERRA\ 26-06-2017;-85,93;21790,45;21704,52;9964;-85,93;21704,52;2017-06-26;26/06/2017;DECATHLON;Gastos_Compras;Deportivo;6;VARIABLES
29/06/2017;29/06/2017;T/ VIENA PARC VALLES \ 26-06-2017;-17,00;21704,52;21687,52;9965;-17,00;21687,52;2017-06-26;26/06/2017;VIENA;Gastos_Ocio y transporte;Restaurantes;6;VARIABLES
30/06/2017;30/06/2017;REC. 6061.9600001223;-485,11;21687,52;21202,41;9966;-485,11;21202,41;2017-06-30;30/06/2017;REC;Gastos_Banco y organismos;Hipoteca;6;FIJO
30/06/2017;30/06/2017;R/AJUNTAMENT D I.B.I;-45,65;21202,41;21156,76;9967;-45,65;21156,76;2017-06-30;30/06/2017;AJUNTAMENT;Gastos_Banco y organismos;Ayuntamiento;6;FIJO
30/06/2017;30/06/2017;T/ AUTOPISTAS TERR 27-06-2017;-1,39;21156,76;21155,37;9968;-1,39;21155,37;2017-06-27;27/06/2017;AUTOPISTAS;Gastos_Ocio y transporte;Parking y peaje;6;VARIABLES
30/06/2017;30/06/2017;T/ BON AREA 27-06-2017;-9,21;21155,37;21146,16;9969;-9,21;21146,16;2017-06-27;27/06/2017;BON;Gastos_Compras;Supermercado;6;VARIABLES
01/07/2017;01/07/2017;FACT TARJETAS TARJ.CREDITO 07126017 17-07-01;-254,47;21146,16;20891,69;9970;-254,47;20891,69;2017-07-01;30/06/2017;FACT 07126017;Gastos_Banco y organismos;Credito Bea;6;VARIABLE
01/07/2017;01/07/2017;FACT TARJETAS TARJ.CREDITO 42689013 17-07-01;-696,34;20891,69;20195,35;9971;-696,34;20195,35;2017-07-01;30/06/2017;FACT;No computable;Recibo Tarjeta;6;
01/07/2017;01/07/2017;T/ DECATHLON SA TERRA\ 28-06-2017;-8,99;20195,35;20186,36;9972;-8,99;20186,36;2017-06-28;28/06/2017;DECATHLON;Gastos_Compras;Deportivo;6;VARIABLES
01/07/2017;01/07/2017;T/ AUTOPISTAS TERR 28-06-2017;-1,39;20186,36;20184,97;9973;-1,39;20184,97;2017-06-28;28/06/2017;AUTOPISTAS;Gastos_Ocio y transporte;Parking y peaje;6;VARIABLES
01/07/2017;01/07/2017;T/ AUTOPISTAS TERR 28-06-2017;-1,39;20184,97;20183,58;9974;-1,39;20183,58;2017-06-28;28/06/2017;AUTOPISTAS;Gastos_Ocio y transporte;Parking y peaje;6;VARIABLES
01/07/2017;01/07/2017;T/ TUNELS VALLVI S. 28-06-2017;-3,72;20183,58;20179,86;9975;-3,72;20179,86;2017-06-28;28/06/2017;TUNELS;Gastos_Ocio y transporte;Parking y peaje;6;VARIABLES
01/07/2017;01/07/2017;T/ PARKING VAPOR GRAN\ 28-06-2017;-2,40;20179,86;20177,46;9976;-2,40;20177,46;2017-06-28;28/06/2017;PARKING;Gastos_Ocio y transporte;Parking y peaje;6;VARIABLES
02/07/2017;02/07/2017;T/ CAFET.C T PRAT\PRAT 29-06-2017;-2,65;20177,46;20174,81;9977;-2,65;20174,81;2017-06-29;29/06/2017;CAFETC;Gastos_Ocio y transporte;Restaurantes;6;VARIABLES
02/07/2017;02/07/2017;T/ AUTOPISTAS TERR 29-06-2017;-1,39;20174,81;20173,42;9978;-1,39;20173,42;2017-06-29;29/06/2017;AUTOPISTAS;Gastos_Ocio y transporte;Parking y peaje;6;VARIABLES
02/07/2017;02/07/2017;T/ CAFET.C T PRAT\PRAT 29-06-2017;-7,90;20173,42;20165,52;9979;-7,90;20165,52;2017-06-29;29/06/2017;CAFETC;Gastos_Ocio y transporte;Restaurantes;6;VARIABLES
02/07/2017;02/07/2017;T/ CEDIPSA 15838-1 EG\ 29-06-2017;-30,00;20165,52;20135,52;9980;-30,00;20135,52;2017-06-29;29/06/2017;CEDIPSA;Gastos_Ocio y transporte;Gasolina;6;VARIABLES
02/07/2017;02/07/2017;'T/ FUNDACIO JOSEP\L'' H 29-06-2017';-20,00;20135,52;20115,52;9981;-20,00;20115,52;2017-06-29;29/06/2017;FUNDACIO;Ingresos;Nomina;6;FIJO
02/07/2017;02/07/2017;T/ BON AREA 29-06-2017;-26,48;20115,52;20089,04;9982;-26,48;20089,04;2017-06-29;29/06/2017;BON;Gastos_Compras;Supermercado;6;VARIABLES
03/07/2017;03/07/2017;T/ CAFET.C T PRAT\PRAT 30-06-2017;-2,20;20089,04;20086,84;9983;-2,20;20086,84;2017-06-30;30/06/2017;CAFETC;Gastos_Ocio y transporte;Restaurantes;6;VARIABLES
04/07/2017;04/07/2017;T/ AUTOPISTAS TERR 30-06-2017;-1,39;20086,84;20085,45;9984;-1,39;20085,45;2017-06-30;30/06/2017;AUTOPISTAS;Gastos_Ocio y transporte;Parking y peaje;6;VARIABLES
05/07/2017;05/07/2017;T/ MANGO OUTLET-E\PALA 02-07-2017;-107,91;20085,45;19977,54;9985;-107,91;19977,54;2017-07-02;02/07/2017;MANGO;Gastos_Compras;Ropa;7;VARIABLES
05/07/2017;05/07/2017;T/ WWW.JUST-EAT.ES 02-07-2017;-19,00;19977,54;19958,54;9986;-19,00;19958,54;2017-07-02;02/07/2017;WWWJUSTEATES;Gastos_Ocio y transporte;Restaurantes;7;VARIABLES
05/07/2017;05/07/2017;T/ TUNELS VALLVI S. 30-06-2017;-3,72;19958,54;19954,82;9987;-3,72;19954,82;2017-06-30;30/06/2017;TUNELS;Gastos_Ocio y transporte;Parking y peaje;6;VARIABLES
06/07/2017;06/07/2017;R/ SEGUROS ADESLAS CENT MODULAR CO;-144,67;19954,82;19810,15;9988;-144,67;19810,15;2017-07-06;06/07/2017;ADESLAS;Gastos_Salud, saber y deporte;Medico;7;VARIABLES
06/07/2017;04/07/2017;T/ C&A Online GmbH;-50,03;19810,15;19760,12;9989;-50,03;19760,12;2017-07-04;04/07/2017;ONLINE;Gastos_Compras;Ropa;7;VARIABLES
06/07/2017;06/07/2017;T/ AUTOPISTAS TERR 03-07-2017;-1,39;19760,12;19758,73;9990;-1,39;19758,73;2017-07-03;03/07/2017;AUTOPISTAS;Gastos_Ocio y transporte;Parking y peaje;7;VARIABLES
06/07/2017;06/07/2017;T/ AUTOPISTAS TERR 03-07-2017;-1,39;19758,73;19757,34;9991;-1,39;19757,34;2017-07-03;03/07/2017;AUTOPISTAS;Gastos_Ocio y transporte;Parking y peaje;7;VARIABLES
06/07/2017;06/07/2017;T/ TUNELS VALLVI S. 03-07-2017;-3,72;19757,34;19753,62;9992;-3,72;19753,62;2017-07-03;03/07/2017;TUNELS;Gastos_Ocio y transporte;Parking y peaje;7;VARIABLES
06/07/2017;06/07/2017;T/ CINESA PARC VALLES\ 03-07-2017;-22,50;19753,62;19731,12;9993;-22,50;19731,12;2017-07-03;03/07/2017;CINESA;Gastos_Ocio y transporte;Espectáculos;7;VARIABLES
07/07/2017;07/07/2017;R/ . FINQUES GASS Vto 01-07-17 Rec;-72,60;19731,12;19658,52;9994;-72,60;19658,52;2017-07-01;01/07/2017;FINQUES;Gastos_Vivienda y vehiculo;Alquiler Parking;7;FIJO
07/07/2017;07/07/2017;T/ LIDL TERRASSA LES \ 04-07-2017;-14,15;19658,52;19644,37;9995;-14,15;19644,37;2017-07-04;04/07/2017;LIDL;Gastos_Compras;Supermercado;7;VARIABLES
07/07/2017;07/07/2017;T/ AUTOPISTAS TERR 04-07-2017;-1,39;19644,37;19642,98;9996;-1,39;19642,98;2017-07-04;04/07/2017;AUTOPISTAS;Gastos_Ocio y transporte;Parking y peaje;7;VARIABLES
07/07/2017;07/07/2017;T/ CAPRABO \ 04-07-2017;-7,21;19642,98;19635,77;9997;-7,21;19635,77;2017-07-04;04/07/2017;CAPRABO;Gastos_Compras;Supermercado;7;VARIABLES
07/07/2017;07/07/2017;T/ GLT STORE HOME \ 04-07-2017;-3,75;19635,77;19632,02;9998;-3,75;19632,02;2017-07-04;04/07/2017;GLT;Gastos_Compras;Otras compras;7;VARIABLES
08/07/2017;08/07/2017;T/ AP DR. ROBERT TERRA 05-07-2017;-2,35;19632,02;19629,67;9999;-2,35;19629,67;2017-07-05;05/07/2017;ROBERT;Gastos_Ocio y transporte;Parking y peaje;7;VARIABLES
08/07/2017;08/07/2017;T/ FRANKFURT LES LLET\ 05-07-2017;-4,10;19629,67;19625,57;10000;-4,10;19625,57;2017-07-05;05/07/2017;FRANKFURT;Gastos_Ocio y transporte;Restaurantes;7;VARIABLES
09/07/2017;09/07/2017;T/ NAVAN \ 06-07-2017;-16,82;19625,57;19608,75;10001;-16,82;19608,75;2017-07-06;06/07/2017;NAVAN;Gastos_Salud, saber y deporte;Solidaridad;7;VARIABLES
09/07/2017;09/07/2017;T/ FRANKFURT LES LLET\ 06-07-2017;-2,90;19608,75;19605,85;10002;-2,90;19605,85;2017-07-06;06/07/2017;FRANKFURT;Gastos_Ocio y transporte;Restaurantes;7;VARIABLES
10/07/2017;10/07/2017;T/ CAFET.C T PRAT\PRAT 07-07-2017;-1,85;19605,85;19604,00;10003;-1,85;19604,00;2017-07-07;07/07/2017;CAFETC;Gastos_Ocio y transporte;Restaurantes;7;VARIABLES
10/07/2017;10/07/2017;T/ E.S. RUBI II 07-07-2017;-45,56;19604,00;19558,44;10004;-45,56;19558,44;2017-07-07;07/07/2017;RUBI;Gastos_Ocio y transporte;Gasolina;7;VARIABLES
10/07/2017;10/07/2017;T/ IKEA REST. SABADEL\ 07-07-2017;-1,09;19558,44;19557,35;10005;-1,09;19557,35;2017-07-07;07/07/2017;IKEA;Gastos_Vivienda y vehiculo;Mnto. hogar;7;VARIABLES
11/07/2017;07/07/2017;T/ KIABI.ES;-70,50;19557,35;19486,85;10006;-70,50;19486,85;2017-07-07;07/07/2017;KIABIES;Gastos_Compras;Ropa;7;VARIABLES
11/07/2017;11/07/2017;T/ S.E. DE CORREOS Y \ 08-07-2017;-14,85;19486,85;19472,00;10007;-14,85;19472,00;2017-07-08;08/07/2017;CORREOS;Gastos_Compras;Otras compras;7;VARIABLES
12/07/2017;12/07/2017;DEV.COMPRA TJ MANGO OUTLET-E\PALAU SOLITA;49,96;19472,00;19521,96;10008;49,96;19521,96;2017-07-12;12/07/2017;DEVCOMPRA;Ingresos;Devoluciones;7;VARIABLES
12/07/2017;12/07/2017;T/ LA BRASA \ 09-07-2017;-30,15;19521,96;19491,81;10009;-30,15;19491,81;2017-07-09;09/07/2017;BRASA;Gastos_Ocio y transporte;Restaurantes;7;VARIABLES
12/07/2017;12/07/2017;T/ AUTOPISTAS TERR 07-07-2017;-1,39;19491,81;19490,42;10010;-1,39;19490,42;2017-07-07;07/07/2017;AUTOPISTAS;Gastos_Ocio y transporte;Parking y peaje;7;VARIABLES
12/07/2017;12/07/2017;CAJ. AJENO SISTEMA 4B \TERRASSA;-200,00;19490,42;19290,42;10011;-200,00;19290,42;2017-07-12;12/07/2017;CAJ;Gastos_Gastos varios;Efectivo;7;VARIABLES
12/07/2017;12/07/2017;COM. 76985025 4b CAJ4 OFI9376;-1,85;19290,42;19288,57;10012;-1,85;19288,57;2017-07-12;12/07/2017;COM;Gastos_Banco y organismos;Cargos banco;7;FIJO
13/07/2017;13/07/2017;R/ GAS GAS NATURAL GNS27630480717;-4,57;19288,57;19284,00;10013;-4,57;19284,00;2017-07-13;13/07/2017;GAS;Gastos_Servicios tipicos;Gas;7;FIJO
13/07/2017;13/07/2017;R/ TELECOMUNICACI VODAFONE;-135,31;19284,00;19148,69;10014;-135,31;19148,69;2017-07-13;13/07/2017;TELECOMUNICACI;Gastos_Servicios tipicos;Telecomunicaciones;7;FIJO
13/07/2017;13/07/2017;T/ AUTOPISTAS TERR 10-07-2017;-1,39;19148,69;19147,30;10015;-1,39;19147,30;2017-07-10;10/07/2017;AUTOPISTAS;Gastos_Ocio y transporte;Parking y peaje;7;VARIABLES
13/07/2017;13/07/2017;T/ AUTOPISTAS TERR 10-07-2017;-1,39;19147,30;19145,91;10016;-1,39;19145,91;2017-07-10;10/07/2017;AUTOPISTAS;Gastos_Ocio y transporte;Parking y peaje;7;VARIABLES
13/07/2017;13/07/2017;T/ TUNELS VALLVI S. 10-07-2017;-3,72;19145,91;19142,19;10017;-3,72;19142,19;2017-07-10;10/07/2017;TUNELS;Gastos_Ocio y transporte;Parking y peaje;7;VARIABLES
13/07/2017;13/07/2017;T/ SUPER.BON PREU S16\ 10-07-2017;-17,30;19142,19;19124,89;10018;-17,30;19124,89;2017-07-10;10/07/2017;SUPERBON;Gastos_Compras;Supermercado;7;VARIABLES
13/07/2017;13/07/2017;T/ TUNELS VALLVI S. 07-07-2017;-4,18;19124,89;19120,71;10019;-4,18;19120,71;2017-07-07;07/07/2017;TUNELS;Gastos_Ocio y transporte;Parking y peaje;7;VARIABLES
14/07/2017;14/07/2017;R/ LUZ ENDESA ENERG FACTURA DE ELE;-125,09;19120,71;18995,62;10020;-125,09;18995,62;2017-07-14;14/07/2017;ELE;Gastos_Servicios tipicos;Electricidad;7;FIJO
14/07/2017;12/07/2017;T/ CARREFOUR VALLE;-29,85;18995,62;18965,77;10021;-29,85;18965,77;2017-07-12;12/07/2017;CARREFOUR;Gastos_Compras;Supermercado;7;VARIABLES
14/07/2017;14/07/2017;T/ TUNELS VALLVI S. 11-07-2017;-3,72;18965,77;18962,05;10022;-3,72;18962,05;2017-07-11;11/07/2017;TUNELS;Gastos_Ocio y transporte;Parking y peaje;7;VARIABLES
15/07/2017;15/07/2017;T/ FRANKFURT LES LLET\ 12-07-2017;-6,95;18962,05;18955,10;10023;-6,95;18955,10;2017-07-12;12/07/2017;FRANKFURT;Gastos_Ocio y transporte;Restaurantes;7;VARIABLES
15/07/2017;15/07/2017;T/ FARMACIA TORRAS \ 12-07-2017;-7,24;18955,10;18947,86;10024;-7,24;18947,86;2017-07-12;12/07/2017;FARMACIA;Gastos_Salud, saber y deporte;Farmacia;7;VARIABLES
15/07/2017;15/07/2017;T/ TUNELS VALLVI S. 12-07-2017;-4,18;18947,86;18943,68;10025;-4,18;18943,68;2017-07-12;12/07/2017;TUNELS;Gastos_Ocio y transporte;Parking y peaje;7;VARIABLES
15/07/2017;15/07/2017;T/ AUTOPISTAS TERR 12-07-2017;-1,39;18943,68;18942,29;10026;-1,39;18942,29;2017-07-12;12/07/2017;AUTOPISTAS;Gastos_Ocio y transporte;Parking y peaje;7;VARIABLES
15/07/2017;15/07/2017;T/ AUTOPISTAS TERR 12-07-2017;-1,39;18942,29;18940,90;10027;-1,39;18940,90;2017-07-12;12/07/2017;AUTOPISTAS;Gastos_Ocio y transporte;Parking y peaje;7;VARIABLES
15/07/2017;15/07/2017;T/ PARKING VAPOR GRAN\ 12-07-2017;-3,35;18940,90;18937,55;10028;-3,35;18937,55;2017-07-12;12/07/2017;PARKING;Gastos_Ocio y transporte;Parking y peaje;7;VARIABLES
15/07/2017;15/07/2017;T/ AUTOPISTAS TERR 11-07-2017;-1,39;18937,55;18936,16;10029;-1,39;18936,16;2017-07-11;11/07/2017;AUTOPISTAS;Gastos_Ocio y transporte;Parking y peaje;7;VARIABLES
15/07/2017;15/07/2017;T/ AUTOPISTAS TERR 11-07-2017;-1,39;18936,16;18934,77;10030;-1,39;18934,77;2017-07-11;11/07/2017;AUTOPISTAS;Gastos_Ocio y transporte;Parking y peaje;7;VARIABLES
16/07/2017;16/07/2017;T/ MERCADONA QUATRE C\ 13-07-2017;-10,75;18934,77;18924,02;10031;-10,75;18924,02;2017-07-13;13/07/2017;MERCADONA;Gastos_Compras;Supermercado;7;VARIABLES
16/07/2017;16/07/2017;T/ AUTOPISTAS TERR 13-07-2017;-1,39;18924,02;18922,63;10032;-1,39;18922,63;2017-07-13;13/07/2017;AUTOPISTAS;Gastos_Ocio y transporte;Parking y peaje;7;VARIABLES
16/07/2017;16/07/2017;T/ AUTOPISTAS TERR 13-07-2017;-1,39;18922,63;18921,24;10033;-1,39;18921,24;2017-07-13;13/07/2017;AUTOPISTAS;Gastos_Ocio y transporte;Parking y peaje;7;VARIABLES
16/07/2017;16/07/2017;T/ METRO BARCELONA \B 13-07-2017;-2,15;18921,24;18919,09;10034;-2,15;18919,09;2017-07-13;13/07/2017;METRO;Gastos_Ocio y transporte;Transporte;7;VARIABLES
16/07/2017;16/07/2017;T/ CAFET.C T PRAT\PRAT 13-07-2017;-3,90;18919,09;18915,19;10035;-3,90;18915,19;2017-07-13;13/07/2017;CAFETC;Gastos_Ocio y transporte;Restaurantes;7;VARIABLES
16/07/2017;16/07/2017;T/ FF.CC.GENERALITAT\B 13-07-2017;-4,00;18915,19;18911,19;10036;-4,00;18911,19;2017-07-13;13/07/2017;FFCCGENERALITATB;Gastos_Ocio y transporte;Transporte;7;VARIABLES
17/07/2017;17/07/2017;HAB. INFORMACIO I TECNOLOGIA DE CAT;1777,75;18911,19;20688,94;10037;1777,75;20688,94;2017-07-17;17/07/2017;HAB;Ingresos;Nomina;7;FIJO
17/07/2017;17/07/2017;R/ SEGUROS CCM VIDA Y P Recibo:144;-20,77;20688,94;20668,17;10038;-20,77;20668,17;2017-07-17;17/07/2017;CCM;Gastos_Seguros;Seguro vida;7;FIJO
17/07/2017;17/07/2017;R/ SEGUROS CCM VIDA Y P Recibo:144;-16,49;20668,17;20651,68;10039;-16,49;20651,68;2017-07-17;17/07/2017;CCM;Gastos_Seguros;Seguro vida;7;FIJO
17/07/2017;17/07/2017;T/ CAFET.C T PRAT\PRAT 14-07-2017;-2,20;20651,68;20649,48;10040;-2,20;20649,48;2017-07-14;14/07/2017;CAFETC;Gastos_Ocio y transporte;Restaurantes;7;VARIABLES
17/07/2017;17/07/2017;T/ SUPER.REYPA \TARRA 14-07-2017;-8,20;20649,48;20641,28;10041;-8,20;20641,28;2017-07-14;14/07/2017;SUPERREYPA;Gastos_Compras;Supermercado;7;VARIABLES
17/07/2017;17/07/2017;T/ BON AREA 14-07-2017;-29,24;20641,28;20612,04;10042;-29,24;20612,04;2017-07-14;14/07/2017;BON;Gastos_Compras;Supermercado;7;VARIABLES
18/07/2017;18/07/2017;T/ 0250-CONSUM OLOT 15-07-2017;-11,08;20612,04;20600,96;10043;-11,08;20600,96;2017-07-15;15/07/2017;CONSUM;Gastos_Compras;Supermercado;7;VARIABLES
18/07/2017;18/07/2017;T/ AUTONET & OIL 15-07-2017;-20,00;20600,96;20580,96;10044;-20,00;20580,96;2017-07-15;15/07/2017;AUTONET;Gastos_Ocio y transporte;Gasolina;7;VARIABLES
18/07/2017;18/07/2017;T/ TESI FRESC S.L. 15-07-2017;-140,47;20580,96;20440,49;10045;-140,47;20440,49;2017-07-15;15/07/2017;TESI;Gastos_Compras;Supermercado;7;VARIABLES
19/07/2017;19/07/2017;ABO.TARJETAS 64970028 AMAZON SPAIN RETAIL A;225,00;20440,49;20665,49;10046;225,00;20665,49;2017-07-19;19/07/2017;ABOTARJETAS;Ingresos;Devoluciones;7;VARIABLES
19/07/2017;17/07/2017;T/ CARREFOUR VALLE;-33,96;20665,49;20631,53;10047;-33,96;20631,53;2017-07-17;17/07/2017;CARREFOUR;Gastos_Compras;Supermercado;7;VARIABLES
19/07/2017;19/07/2017;T/ CAMPING DE LA \VAL 16-07-2017;-116,00;20631,53;20515,53;10048;-116,00;20515,53;2017-07-16;16/07/2017;CAMPING;Gastos_Ocio y transporte;Vacaciones;7;VARIABLES
19/07/2017;19/07/2017;T/ AUTOPISTAS TERR 14-07-2017;-1,39;20515,53;20514,14;10049;-1,39;20514,14;2017-07-14;14/07/2017;AUTOPISTAS;Gastos_Ocio y transporte;Parking y peaje;7;VARIABLES
19/07/2017;19/07/2017;T/ AUTOPISTAS TERR 14-07-2017;-1,39;20514,14;20512,75;10050;-1,39;20512,75;2017-07-14;14/07/2017;AUTOPISTAS;Gastos_Ocio y transporte;Parking y peaje;7;VARIABLES
19/07/2017;19/07/2017;T/ TUNELS VALLVI S. 14-07-2017;-4,18;20512,75;20508,57;10051;-4,18;20508,57;2017-07-14;14/07/2017;TUNELS;Gastos_Ocio y transporte;Parking y peaje;7;VARIABLES
20/07/2017;20/07/2017;T/ AUTOPISTAS TERR 17-07-2017;-1,39;20508,57;20507,18;10052;-1,39;20507,18;2017-07-17;17/07/2017;AUTOPISTAS;Gastos_Ocio y transporte;Parking y peaje;7;VARIABLES
21/07/2017;21/07/2017;T/ AUTOPISTAS TERR 18-07-2017;-1,39;20507,18;20505,79;10053;-1,39;20505,79;2017-07-18;18/07/2017;AUTOPISTAS;Gastos_Ocio y transporte;Parking y peaje;7;VARIABLES
21/07/2017;21/07/2017;T/ AUTOPISTAS TERR 18-07-2017;-1,39;20505,79;20504,40;10054;-1,39;20504,40;2017-07-18;18/07/2017;AUTOPISTAS;Gastos_Ocio y transporte;Parking y peaje;7;VARIABLES
21/07/2017;21/07/2017;T/ AP DR. ROBERT TERRA 18-07-2017;-4,45;20504,40;20499,95;10055;-4,45;20499,95;2017-07-18;18/07/2017;ROBERT;Gastos_Ocio y transporte;Parking y peaje;7;VARIABLES
21/07/2017;21/07/2017;T/ TUNELS VALLVI S. 18-07-2017;-3,72;20499,95;20496,23;10056;-3,72;20496,23;2017-07-18;18/07/2017;TUNELS;Gastos_Ocio y transporte;Parking y peaje;7;VARIABLES
21/07/2017;21/07/2017;T/ el cafe d egara \ 18-07-2017;-11,65;20496,23;20484,58;10057;-11,65;20484,58;2017-07-18;18/07/2017;CAFE;Gastos_Ocio y transporte;Restaurantes;7;VARIABLES
21/07/2017;21/07/2017;S/OR. Escola Sala i Badrinas;-30,00;20484,58;20454,58;10058;-30,00;20454,58;2017-07-21;21/07/2017;ESCOLA;Gastos_Salud, saber y deporte;Estudios;7;VARIABLES
22/07/2017;22/07/2017;T/ AUTOPISTAS TERR 19-07-2017;-1,39;20454,58;20453,19;10059;-1,39;20453,19;2017-07-19;19/07/2017;AUTOPISTAS;Gastos_Ocio y transporte;Parking y peaje;7;VARIABLES
22/07/2017;22/07/2017;T/ AUTOPISTAS TERR 19-07-2017;-1,39;20453,19;20451,80;10060;-1,39;20451,80;2017-07-19;19/07/2017;AUTOPISTAS;Gastos_Ocio y transporte;Parking y peaje;7;VARIABLES
22/07/2017;22/07/2017;T/ PANS&COMPANY \BARBE 19-07-2017;-15,90;20451,80;20435,90;10061;-15,90;20435,90;2017-07-19;19/07/2017;PANSCOMPANY;Gastos_Ocio y transporte;Restaurantes;7;VARIABLES
22/07/2017;22/07/2017;T/ CINESA WEB \B 19-07-2017;-9,80;20435,90;20426,10;10062;-9,80;20426,10;2017-07-19;19/07/2017;CINESA;Gastos_Ocio y transporte;Espectáculos;7;VARIABLES
22/07/2017;22/07/2017;T/ LIDL EL PRAT D\PRAT 19-07-2017;-5,34;20426,10;20420,76;10063;-5,34;20420,76;2017-07-19;19/07/2017;LIDL;Gastos_Compras;Supermercado;7;VARIABLES
22/07/2017;22/07/2017;T/ TUNELS VALLVI S. 19-07-2017;-3,72;20420,76;20417,04;10064;-3,72;20417,04;2017-07-19;19/07/2017;TUNELS;Gastos_Ocio y transporte;Parking y peaje;7;VARIABLES
22/07/2017;22/07/2017;T/ KIABI BARICENT\BARB 19-07-2017;-7,00;20417,04;20410,04;10065;-7,00;20410,04;2017-07-19;19/07/2017;KIABI;Gastos_Compras;Ropa;7;VARIABLES
22/07/2017;22/07/2017;T/ TAGLIATELLA PARC V\ 19-07-2017;-37,05;20410,04;20372,99;10066;-37,05;20372,99;2017-07-19;19/07/2017;TAGLIATELLA;Gastos_Ocio y transporte;Restaurantes;7;VARIABLES
22/07/2017;22/07/2017;CAJ. AJENO SERVIRED \TORTOSA;-300,00;20372,99;20072,99;10067;-300,00;20072,99;2017-07-22;22/07/2017;CAJ;Gastos_Gastos varios;Efectivo;7;VARIABLES
22/07/2017;22/07/2017;COM. 64970036 SVRED CAJ OFI;-1,87;20072,99;20071,12;10068;-1,87;20071,12;2017-07-22;22/07/2017;COM;Gastos_Banco y organismos;Cargos banco;7;FIJO
23/07/2017;23/07/2017;T/ SUPER.BON PREU S16\ 20-07-2017;-22,63;20071,12;20048,49;10069;-22,63;20048,49;2017-07-20;20/07/2017;SUPERBON;Gastos_Compras;Supermercado;7;VARIABLES
23/07/2017;23/07/2017;T/ AUTOPISTAS TERR 20-07-2017;-1,39;20048,49;20047,10;10070;-1,39;20047,10;2017-07-20;20/07/2017;AUTOPISTAS;Gastos_Ocio y transporte;Parking y peaje;7;VARIABLES
23/07/2017;23/07/2017;T/ AUTOPISTAS TERR 20-07-2017;-1,39;20047,10;20045,71;10071;-1,39;20045,71;2017-07-20;20/07/2017;AUTOPISTAS;Gastos_Ocio y transporte;Parking y peaje;7;VARIABLES
24/07/2017;24/07/2017;T/ PARKING VAPOR GRAN\ 21-07-2017;-3,55;20045,71;20042,16;10072;-3,55;20042,16;2017-07-21;21/07/2017;PARKING;Gastos_Ocio y transporte;Parking y peaje;7;VARIABLES
24/07/2017;24/07/2017;T/ E.S. RUBI II 21-07-2017;-43,51;20042,16;19998,65;10073;-43,51;19998,65;2017-07-21;21/07/2017;RUBI;Gastos_Ocio y transporte;Gasolina;7;VARIABLES
24/07/2017;24/07/2017;T/ EL SALON THE BARBE\ 21-07-2017;-48,99;19998,65;19949,66;10074;-48,99;19949,66;2017-07-21;21/07/2017;SALON;Gastos_Salud, saber y deporte;Belleza;7;VARIABLES
24/07/2017;24/07/2017;T/ FRANKFURT LES LLET\ 21-07-2017;-10,80;19949,66;19938,86;10075;-10,80;19938,86;2017-07-21;21/07/2017;FRANKFURT;Gastos_Ocio y transporte;Restaurantes;7;VARIABLES
25/07/2017;25/07/2017;T/ VIENA PARC VALLES \ 22-07-2017;-7,70;19938,86;19931,16;10076;-7,70;19931,16;2017-07-22;22/07/2017;VIENA;Gastos_Ocio y transporte;Restaurantes;7;VARIABLES
25/07/2017;25/07/2017;T/ AUTOPISTAS TERR 21-07-2017;-1,39;19931,16;19929,77;10077;-1,39;19929,77;2017-07-21;21/07/2017;AUTOPISTAS;Gastos_Ocio y transporte;Parking y peaje;7;VARIABLES
25/07/2017;25/07/2017;T/ AUTOPISTAS TERR 21-07-2017;-1,39;19929,77;19928,38;10078;-1,39;19928,38;2017-07-21;21/07/2017;AUTOPISTAS;Gastos_Ocio y transporte;Parking y peaje;7;VARIABLES
26/07/2017;26/07/2017;BONIF.COM. 5540556264970036;18,00;19928,38;19946,38;10079;18,00;19946,38;2017-07-26;26/07/2017;BONIFCOM;Ingresos;Devoluciones;7;VARIABLES
26/07/2017;26/07/2017;COMIS.TARJETAS 5540556264970036;-18,00;19946,38;19928,38;10080;-18,00;19928,38;2017-07-26;26/07/2017;COMISTARJETAS;Gastos_Banco y organismos;Cargos banco;7;FIJO
26/07/2017;26/07/2017;T/ TUNELS VALLVI S. 21-07-2017;-4,18;19928,38;19924,20;10081;-4,18;19924,20;2017-07-21;21/07/2017;TUNELS;Gastos_Ocio y transporte;Parking y peaje;7;VARIABLES
27/07/2017;27/07/2017;HAB. INFORMACIO I TECNOLOGIA DE CAT;1624,63;19924,20;21548,83;10082;1624,63;21548,83;2017-07-27;27/07/2017;HAB;Ingresos;Nomina;7;FIJO
27/07/2017;27/07/2017;T/ DECATHLON TORTOSA 24-07-2017;-75,69;21548,83;21473,14;10083;-75,69;21473,14;2017-07-24;24/07/2017;DECATHLON;Gastos_Compras;Deportivo;7;VARIABLES
27/07/2017;27/07/2017;T/ ASIA 24-07-2017;-16,80;21473,14;21456,34;10084;-16,80;21456,34;2017-07-24;24/07/2017;ASIA;Gastos_Compras;Hogar;7;VARIABLES
28/07/2017;28/07/2017;HAB. FOMENT DE TERRASSA S.A. Transf;1789,20;21456,34;23245,54;10085;1789,20;23245,54;2017-07-28;28/07/2017;HAB;Ingresos;Nomina;7;FIJO
28/07/2017;28/07/2017;T/ FARMACIA SEGARRA \ 25-07-2017;-14,76;23245,54;23230,78;10086;-14,76;23230,78;2017-07-25;25/07/2017;FARMACIA;Gastos_Salud, saber y deporte;Farmacia;7;VARIABLES
30/07/2017;30/07/2017;T/ TEMPS DE TERRA 27-07-2017;-70,00;23230,78;23160,78;10087;-70,00;23160,78;2017-07-27;27/07/2017;TEMPS;Gastos_Ocio y transporte;Restaurantes;7;VARIABLES
31/07/2017;31/07/2017;REC. 6061.9600001223;-485,11;23160,78;22675,67;10088;-485,11;22675,67;2017-07-31;31/07/2017;REC;Gastos_Banco y organismos;Hipoteca;7;FIJO
31/07/2017;31/07/2017;R/ . EMTE SERVICE Factura GB17-065;-74,72;22675,67;22600,95;10089;-74,72;22600,95;2017-07-31;31/07/2017;EMTE;Gastos_Servicios tipicos;Otros servicios;7;VARIABLES
31/07/2017;31/07/2017;R/ AYUNTAMIENTO AJUNTAMENT D TAXA;-54,87;22600,95;22546,08;10090;-54,87;22546,08;2017-07-31;31/07/2017;AYUNTAMIENTO;Gastos_Banco y organismos;Ayuntamiento;7;FIJO
31/07/2017;31/07/2017;T/ CINES OSCAR \ 28-07-2017;-19,60;22546,08;22526,48;10091;-19,60;22526,48;2017-07-28;28/07/2017;CINES;Gastos_Ocio y transporte;Espectáculos;7;VARIABLES
01/08/2017;01/08/2017;FACT TARJETAS TARJ.CREDITO 07126017 17-08-01;-615,88;22526,48;21910,60;10092;-615,88;21910,60;2017-08-01;31/07/2017;FACT 07126017;Gastos_Banco y organismos;Credito Bea;7;VARIABLE
01/08/2017;01/08/2017;FACT TARJETAS TARJ.CREDITO 42689013 17-08-01;-277,91;21910,60;21632,69;10093;-277,91;21632,69;2017-08-01;31/07/2017;FACT;No computable;Recibo Tarjeta;7;
01/08/2017;01/08/2017;R/ LUZ ENDESA ENERG FACTURA DE GAS;-85,23;21632,69;21547,46;10094;-85,23;21547,46;2017-08-01;01/08/2017;GAS;Gastos_Servicios tipicos;Gas;8;FIJO
04/08/2017;04/08/2017;T/ ASIA FERRERIES 01-08-2017;-9,80;21547,46;21537,66;10095;-9,80;21537,66;2017-08-01;01/08/2017;ASIA;Gastos_Compras;Hogar;8;VARIABLES
06/08/2017;06/08/2017;T/ CINES OSCAR \ 03-08-2017;-9,80;21537,66;21527,86;10096;-9,80;21527,86;2017-08-03;03/08/2017;CINES;Gastos_Ocio y transporte;Espectáculos;8;VARIABLES
07/08/2017;07/08/2017;R/ . FINQUES GASS Vto 01-08-17 Rec;-72,60;21527,86;21455,26;10097;-72,60;21455,26;2017-08-01;01/08/2017;FINQUES;Gastos_Vivienda y vehiculo;Alquiler Parking;8;FIJO
08/08/2017;08/08/2017;T/ MANGO-EUR \SERRA 05-08-2017;-69,14;21455,26;21386,12;10098;-69,14;21386,12;2017-08-05;05/08/2017;MANGOEUR;Gastos_Compras;Ropa;8;VARIABLES
08/08/2017;08/08/2017;T/ MANGO OUTLET-E\PALA 05-08-2017;-59,94;21386,12;21326,18;10099;-59,94;21326,18;2017-08-05;05/08/2017;MANGO;Gastos_Compras;Ropa;8;VARIABLES
09/08/2017;09/08/2017;CAJ. AJENO SERVIRED \XERTA;-300,00;21326,18;21026,18;10100;-300,00;21026,18;2017-08-09;09/08/2017;CAJ;Gastos_Gastos varios;Efectivo;8;VARIABLES
09/08/2017;09/08/2017;COM. 64970036 SVRED CAJ OFI;-1,87;21026,18;21024,31;10101;-1,87;21024,31;2017-08-09;09/08/2017;COM;Gastos_Banco y organismos;Cargos banco;8;FIJO
10/08/2017;10/08/2017;R/ GAS GAS NATURAL GNS27630480817;-4,60;21024,31;21019,71;10102;-4,60;21019,71;2017-08-10;10/08/2017;GAS;Gastos_Servicios tipicos;Gas;8;FIJO
11/08/2017;11/08/2017;R/ TELECOMUNICACI VODAFONE;-122,43;21019,71;20897,28;10103;-122,43;20897,28;2017-08-11;11/08/2017;TELECOMUNICACI;Gastos_Servicios tipicos;Telecomunicaciones;8;FIJO
11/08/2017;11/08/2017;T/ FRAGADIS 08-08-2017;-14,02;20897,28;20883,26;10104;-14,02;20883,26;2017-08-08;08/08/2017;FRAGADIS;Gastos_Compras;Supermercado;8;VARIABLES
12/08/2017;12/08/2017;T/ FRAGADIS 09-08-2017;-9,98;20883,26;20873,28;10105;-9,98;20873,28;2017-08-09;09/08/2017;FRAGADIS;Gastos_Compras;Supermercado;8;VARIABLES
13/08/2017;13/08/2017;T/ DECATHLON TORTOSA 10-08-2017;-11,90;20873,28;20861,38;10106;-11,90;20861,38;2017-08-10;10/08/2017;DECATHLON;Gastos_Compras;Deportivo;8;VARIABLES
13/08/2017;13/08/2017;T/ LIDL TORTOSA \T 10-08-2017;-40,46;20861,38;20820,92;10107;-40,46;20820,92;2017-08-10;10/08/2017;LIDL;Gastos_Compras;Supermercado;8;VARIABLES
14/08/2017;14/08/2017;R/ SEGUROS ADESLAS CENT MODULAR CO;-144,67;20820,92;20676,25;10108;-144,67;20676,25;2017-08-14;14/08/2017;ADESLAS;Gastos_Salud, saber y deporte;Medico;8;VARIABLES
15/08/2017;15/08/2017;T/ MS MODA TORTOSA 12-08-2017;-28,00;20676,25;20648,25;10109;-28,00;20648,25;2017-08-12;12/08/2017;MODA;Gastos_Compras;Ropa;8;VARIABLES
16/08/2017;16/08/2017;T/ REST.BAR CASTELLS C 13-08-2017;-20,10;20648,25;20628,15;10110;-20,10;20628,15;2017-08-13;13/08/2017;RESTBAR;Gastos_Ocio y transporte;Restaurantes;8;VARIABLES
16/08/2017;16/08/2017;T/ CINES OSCAR \ 13-08-2017;-13,00;20628,15;20615,15;10111;-13,00;20615,15;2017-08-13;13/08/2017;CINES;Gastos_Ocio y transporte;Espectáculos;8;VARIABLES
17/08/2017;17/08/2017;R/ SEGUROS CCM VIDA Y P Recibo:144;-20,69;20615,15;20594,46;10112;-20,69;20594,46;2017-08-17;17/08/2017;CCM;Gastos_Seguros;Seguro vida;8;FIJO
17/08/2017;17/08/2017;T/ VIENA TORTOSA 14-08-2017;-6,80;20594,46;20587,66;10113;-6,80;20587,66;2017-08-14;14/08/2017;VIENA;Gastos_Ocio y transporte;Restaurantes;8;VARIABLES
17/08/2017;17/08/2017;T/ DECATHLON TORTOSA 14-08-2017;-5,97;20587,66;20581,69;10114;-5,97;20581,69;2017-08-14;14/08/2017;DECATHLON;Gastos_Compras;Deportivo;8;VARIABLES
17/08/2017;17/08/2017;T/ SABECO 14-08-2017;-20,47;20581,69;20561,22;10115;-20,47;20561,22;2017-08-14;14/08/2017;SABECO;Gastos_Compras;Supermercado;8;VARIABLES
17/08/2017;17/08/2017;T/ WWW.JUST-EAT.ES 14-08-2017;-23,88;20561,22;20537,34;10116;-23,88;20537,34;2017-08-14;14/08/2017;WWWJUSTEATES;Gastos_Ocio y transporte;Restaurantes;8;VARIABLES
18/08/2017;18/08/2017;R/ SEGUROS CCM VIDA Y P Recibo:144;-16,44;20537,34;20520,90;10117;-16,44;20520,90;2017-08-18;18/08/2017;CCM;Gastos_Seguros;Seguro vida;8;FIJO
18/08/2017;16/08/2017;T/ CARREFOUR VALLE;-35,57;20520,90;20485,33;10118;-35,57;20485,33;2017-08-16;16/08/2017;CARREFOUR;Gastos_Compras;Supermercado;8;VARIABLES
18/08/2017;18/08/2017;T/ WWW.JUST-EAT.ES 15-08-2017;-25,20;20485,33;20460,13;10119;-25,20;20460,13;2017-08-15;15/08/2017;WWWJUSTEATES;Gastos_Ocio y transporte;Restaurantes;8;VARIABLES
18/08/2017;18/08/2017;T/ BON AREA 15-08-2017;-28,88;20460,13;20431,25;10120;-28,88;20431,25;2017-08-15;15/08/2017;BON;Gastos_Compras;Supermercado;8;VARIABLES
19/08/2017;19/08/2017;T/ MCDONALS-CARRE\TARR 16-08-2017;-8,10;20431,25;20423,15;10121;-8,10;20423,15;2017-08-16;16/08/2017;MCDONALSCARRETARR;Gastos_Ocio y transporte;Restaurantes;8;VARIABLES
19/08/2017;19/08/2017;T/ AUTOPISTAS TERR 16-08-2017;-1,39;20423,15;20421,76;10122;-1,39;20421,76;2017-08-16;16/08/2017;AUTOPISTAS;Gastos_Ocio y transporte;Parking y peaje;8;VARIABLES
19/08/2017;19/08/2017;T/ AUTOPISTAS TERR 16-08-2017;-1,39;20421,76;20420,37;10123;-1,39;20420,37;2017-08-16;16/08/2017;AUTOPISTAS;Gastos_Ocio y transporte;Parking y peaje;8;VARIABLES
20/08/2017;20/08/2017;T/ DECATHLON SA TERRA\ 17-08-2017;-28,97;20420,37;20391,40;10124;-28,97;20391,40;2017-08-17;17/08/2017;DECATHLON;Gastos_Compras;Deportivo;8;VARIABLES
20/08/2017;20/08/2017;T/ AUTOPISTAS TERR 17-08-2017;-1,39;20391,40;20390,01;10125;-1,39;20390,01;2017-08-17;17/08/2017;AUTOPISTAS;Gastos_Ocio y transporte;Parking y peaje;8;VARIABLES
20/08/2017;20/08/2017;T/ AUTOPISTAS TERR 17-08-2017;-1,39;20390,01;20388,62;10126;-1,39;20388,62;2017-08-17;17/08/2017;AUTOPISTAS;Gastos_Ocio y transporte;Parking y peaje;8;VARIABLES
20/08/2017;20/08/2017;T/ UDON PARC VALLES \ 17-08-2017;-30,90;20388,62;20357,72;10127;-30,90;20357,72;2017-08-17;17/08/2017;UDON;Gastos_Ocio y transporte;Restaurantes;8;VARIABLES
21/08/2017;21/08/2017;CAJ. AJENO SERVIRED \XERTA;-150,00;20357,72;20207,72;10128;-150,00;20207,72;2017-08-21;21/08/2017;CAJ;Gastos_Gastos varios;Efectivo;8;VARIABLES
21/08/2017;21/08/2017;COM. 76985025 SVRED CAJ OFI;-1,87;20207,72;20205,85;10129;-1,87;20205,85;2017-08-21;21/08/2017;COM;Gastos_Banco y organismos;Cargos banco;8;FIJO
21/08/2017;21/08/2017;T/ E.S. RUBI II 18-08-2017;-40,80;20205,85;20165,05;10130;-40,80;20165,05;2017-08-18;18/08/2017;RUBI;Gastos_Ocio y transporte;Gasolina;8;VARIABLES
22/08/2017;20/08/2017;T/ PlaystationNetwork;-14,99;20165,05;20150,06;10131;-14,99;20150,06;2017-08-20;20/08/2017;PLAYSTATIONNETWORK;Gastos_Servicios tipicos;Servicios online;8;FIJO
22/08/2017;22/08/2017;T/ FORN DE PA CAL PORT 19-08-2017;-11,50;20150,06;20138,56;10132;-11,50;20138,56;2017-08-19;19/08/2017;FORN;Gastos_Compras;Supermercado;8;VARIABLES
22/08/2017;22/08/2017;T/ AUTOPISTAS TERR 18-08-2017;-1,39;20138,56;20137,17;10133;-1,39;20137,17;2017-08-18;18/08/2017;AUTOPISTAS;Gastos_Ocio y transporte;Parking y peaje;8;VARIABLES
22/08/2017;22/08/2017;T/ AUTOPISTAS TERR 18-08-2017;-1,39;20137,17;20135,78;10134;-1,39;20135,78;2017-08-18;18/08/2017;AUTOPISTAS;Gastos_Ocio y transporte;Parking y peaje;8;VARIABLES
22/08/2017;22/08/2017;T/ AUTOPISTAS TERR 18-08-2017;-1,39;20135,78;20134,39;10135;-1,39;20134,39;2017-08-18;18/08/2017;AUTOPISTAS;Gastos_Ocio y transporte;Parking y peaje;8;VARIABLES
23/08/2017;23/08/2017;T/ AUTOPISTAS TERR 20-08-2017;-2,53;20134,39;20131,86;10136;-2,53;20131,86;2017-08-20;20/08/2017;AUTOPISTAS;Gastos_Ocio y transporte;Parking y peaje;8;VARIABLES
23/08/2017;23/08/2017;T/ A.C.E.S.A A REUS-B 20-08-2017;-9,85;20131,86;20122,01;10137;-9,85;20122,01;2017-08-20;20/08/2017;ACESA;Gastos_Ocio y transporte;Parking y peaje;8;VARIABLES
23/08/2017;23/08/2017;T/ FORN DE PA CAL PORT 20-08-2017;-14,30;20122,01;20107,71;10138;-14,30;20107,71;2017-08-20;20/08/2017;FORN;Gastos_Compras;Supermercado;8;VARIABLES
23/08/2017;23/08/2017;T/ AUTOPISTA MARE NOST 18-08-2017;-7,05;20107,71;20100,66;10139;-7,05;20100,66;2017-08-18;18/08/2017;AUTOPISTA;Gastos_Ocio y transporte;Parking y peaje;8;VARIABLES
23/08/2017;23/08/2017;T/ A.C.E.S.A A MART -L 18-08-2017;-8,75;20100,66;20091,91;10140;-8,75;20091,91;2017-08-18;18/08/2017;ACESA;Gastos_Ocio y transporte;Parking y peaje;8;VARIABLES
24/08/2017;24/08/2017;T/ ALDI TERRASSA LES \ 21-08-2017;-25,56;20091,91;20066,35;10141;-25,56;20066,35;2017-08-21;21/08/2017;ALDI;Gastos_Compras;Supermercado;8;VARIABLES
25/08/2017;25/08/2017;T/ AUTOPISTAS TERR 22-08-2017;-1,39;20066,35;20064,96;10142;-1,39;20064,96;2017-08-22;22/08/2017;AUTOPISTAS;Gastos_Ocio y transporte;Parking y peaje;8;VARIABLES
25/08/2017;25/08/2017;T/ AUTOPISTAS TERR 22-08-2017;-1,39;20064,96;20063,57;10143;-1,39;20063,57;2017-08-22;22/08/2017;AUTOPISTAS;Gastos_Ocio y transporte;Parking y peaje;8;VARIABLES
25/08/2017;25/08/2017;T/ RODELAS PERRUQUERS\ 22-08-2017;-16,50;20063,57;20047,07;10144;-16,50;20047,07;2017-08-22;22/08/2017;RODELAS;Gastos_Salud, saber y deporte;Belleza;8;VARIABLES
25/08/2017;25/08/2017;T/ AUTOPISTAS TERR 21-08-2017;-1,39;20047,07;20045,68;10145;-1,39;20045,68;2017-08-21;21/08/2017;AUTOPISTAS;Gastos_Ocio y transporte;Parking y peaje;8;VARIABLES
25/08/2017;25/08/2017;T/ AUTOPISTAS TERR 21-08-2017;-1,39;20045,68;20044,29;10146;-1,39;20044,29;2017-08-21;21/08/2017;AUTOPISTAS;Gastos_Ocio y transporte;Parking y peaje;8;VARIABLES
26/08/2017;26/08/2017;T/ AUTOPISTAS TERR 23-08-2017;-1,39;20044,29;20042,90;10147;-1,39;20042,90;2017-08-23;23/08/2017;AUTOPISTAS;Gastos_Ocio y transporte;Parking y peaje;8;VARIABLES
26/08/2017;26/08/2017;T/ AUTOPISTAS TERR 23-08-2017;-1,39;20042,90;20041,51;10148;-1,39;20041,51;2017-08-23;23/08/2017;AUTOPISTAS;Gastos_Ocio y transporte;Parking y peaje;8;VARIABLES
26/08/2017;26/08/2017;CAJ. AJENO SERVIRED \XERTA;-300,00;20041,51;19741,51;10149;-300,00;19741,51;2017-08-26;26/08/2017;CAJ;Gastos_Gastos varios;Efectivo;8;VARIABLES
26/08/2017;26/08/2017;COM. 76985025 SVRED CAJ OFI;-1,87;19741,51;19739,64;10150;-1,87;19739,64;2017-08-26;26/08/2017;COM;Gastos_Banco y organismos;Cargos banco;8;FIJO
28/08/2017;28/08/2017;HAB. FOMENT DE TERRASSA S.A. Transf;2872,92;19739,64;22612,56;10151;2872,92;22612,56;2017-08-28;28/08/2017;HAB;Ingresos;Nomina;8;FIJO
28/08/2017;28/08/2017;T/ E.S. RUBI II 25-08-2017;-46,82;22612,56;22565,74;10152;-46,82;22565,74;2017-08-25;25/08/2017;RUBI;Gastos_Ocio y transporte;Gasolina;8;VARIABLES
29/08/2017;29/08/2017;HAB. INFORMACIO I TECNOLOGIA DE CAT;1624,63;22565,74;24190,37;10153;1624,63;24190,37;2017-08-29;29/08/2017;HAB;Ingresos;Nomina;8;FIJO
29/08/2017;29/08/2017;T/ AUTOPISTAS TERR 25-08-2017;-1,39;24190,37;24188,98;10154;-1,39;24188,98;2017-08-25;25/08/2017;AUTOPISTAS;Gastos_Ocio y transporte;Parking y peaje;8;VARIABLES
30/08/2017;30/08/2017;T/ TEMPLE 27-08-2017;-8,79;24188,98;24180,19;10155;-8,79;24180,19;2017-08-27;27/08/2017;TEMPLE;Gastos_Ocio y transporte;Gasolina;8;VARIABLES
30/08/2017;30/08/2017;T/ BON AREA 27-08-2017;-19,70;24180,19;24160,49;10156;-19,70;24160,49;2017-08-27;27/08/2017;BON;Gastos_Compras;Supermercado;8;VARIABLES
30/08/2017;30/08/2017;T/ AUTOPISTA MARE NOST 25-08-2017;-7,05;24160,49;24153,44;10157;-7,05;24153,44;2017-08-25;25/08/2017;AUTOPISTA;Gastos_Ocio y transporte;Parking y peaje;8;VARIABLES
30/08/2017;30/08/2017;T/ A.C.E.S.A B MART -L 25-08-2017;-10,50;24153,44;24142,94;10158;-10,50;24142,94;2017-08-25;25/08/2017;ACESA;Gastos_Ocio y transporte;Parking y peaje;8;VARIABLES
31/08/2017;31/08/2017;REC. 6061.9600001223;-485,11;24142,94;23657,83;10159;-485,11;23657,83;2017-08-31;31/08/2017;REC;Gastos_Banco y organismos;Hipoteca;8;FIJO
31/08/2017;31/08/2017;T/ AUTOPISTAS TERR 28-08-2017;-1,39;23657,83;23656,44;10160;-1,39;23656,44;2017-08-28;28/08/2017;AUTOPISTAS;Gastos_Ocio y transporte;Parking y peaje;8;VARIABLES
31/08/2017;31/08/2017;T/ AUTOPISTAS TERR 28-08-2017;-1,39;23656,44;23655,05;10161;-1,39;23655,05;2017-08-28;28/08/2017;AUTOPISTAS;Gastos_Ocio y transporte;Parking y peaje;8;VARIABLES
31/08/2017;31/08/2017;T/ CAFET.C T PRAT\PRAT 28-08-2017;-2,35;23655,05;23652,70;10162;-2,35;23652,70;2017-08-28;28/08/2017;CAFETC;Gastos_Ocio y transporte;Restaurantes;8;VARIABLES
01/09/2017;01/09/2017;FACT TARJETAS TARJ.CREDITO 07126017 17-09-01;-82,57;23652,70;23570,13;10163;-82,57;23570,13;2017-09-01;31/08/2017;FACT 07126017;Gastos_Banco y organismos;Credito Bea;8;VARIABLE
01/09/2017;01/09/2017;FACT TARJETAS TARJ.CREDITO 42689013 17-09-01;-315,87;23570,13;23254,26;10164;-315,87;23254,26;2017-09-01;31/08/2017;FACT;No computable;Recibo Tarjeta;8;
01/09/2017;01/09/2017;T/ PARC VALLES \ 29-08-2017;-13,22;23254,26;23241,04;10165;-13,22;23241,04;2017-08-29;29/08/2017;PARC;Gastos_Compras;Supermercado;8;VARIABLES
01/09/2017;01/09/2017;T/ CINESA WEB \B 29-08-2017;-25,60;23241,04;23215,44;10166;-25,60;23215,44;2017-08-29;29/08/2017;CINESA;Gastos_Ocio y transporte;Espectáculos;8;VARIABLES
01/09/2017;01/09/2017;T/ CINESA PARC VALLES\ 29-08-2017;-12,40;23215,44;23203,04;10167;-12,40;23203,04;2017-08-29;29/08/2017;CINESA;Gastos_Ocio y transporte;Espectáculos;8;VARIABLES
03/09/2017;03/09/2017;T/ NAVAN \ 31-08-2017;-16,82;23203,04;23186,22;10168;-16,82;23186,22;2017-08-31;31/08/2017;NAVAN;Gastos_Salud, saber y deporte;Solidaridad;8;VARIABLES
03/09/2017;03/09/2017;T/ PARC VALLES \ 31-08-2017;-114,97;23186,22;23071,25;10169;-114,97;23071,25;2017-08-31;31/08/2017;PARC;Gastos_Compras;Supermercado;8;VARIABLES
04/09/2017;04/09/2017;R/ SEGUROS ADESLAS CENT MODULAR CO;-144,67;23071,25;22926,58;10170;-144,67;22926,58;2017-09-04;04/09/2017;ADESLAS;Gastos_Salud, saber y deporte;Medico;9;VARIABLES
04/09/2017;04/09/2017;T/ CAPRABO \ 01-09-2017;-8,00;22926,58;22918,58;10171;-8,00;22918,58;2017-09-01;01/09/2017;CAPRABO;Gastos_Compras;Supermercado;9;VARIABLES
07/09/2017;07/09/2017;T/ EL SALON THE BARBE\ 04-09-2017;-24,98;22918,58;22893,60;10172;-24,98;22893,60;2017-09-04;04/09/2017;SALON;Gastos_Salud, saber y deporte;Belleza;9;VARIABLES
07/09/2017;07/09/2017;T/ AUTOPISTAS TERR 04-09-2017;-1,39;22893,60;22892,21;10173;-1,39;22892,21;2017-09-04;04/09/2017;AUTOPISTAS;Gastos_Ocio y transporte;Parking y peaje;9;VARIABLES
07/09/2017;07/09/2017;T/ AUTOPISTAS TERR 04-09-2017;-1,39;22892,21;22890,82;10174;-1,39;22890,82;2017-09-04;04/09/2017;AUTOPISTAS;Gastos_Ocio y transporte;Parking y peaje;9;VARIABLES
07/09/2017;07/09/2017;T/ TUNELS VALLVI S. 04-09-2017;-4,18;22890,82;22886,64;10175;-4,18;22886,64;2017-09-04;04/09/2017;TUNELS;Gastos_Ocio y transporte;Parking y peaje;9;VARIABLES
07/09/2017;07/09/2017;T/ CAPRABO \ 04-09-2017;-20,08;22886,64;22866,56;10176;-20,08;22866,56;2017-09-04;04/09/2017;CAPRABO;Gastos_Compras;Supermercado;9;VARIABLES
08/09/2017;08/09/2017;R/ . FINQUES GASS Vto 01-09-17 Rec;-73,69;22866,56;22792,87;10177;-73,69;22792,87;2017-09-01;01/09/2017;FINQUES;Gastos_Vivienda y vehiculo;Alquiler Parking;9;FIJO
08/09/2017;08/09/2017;T/  AUTOPISTAS TERR 05-09-2017;-1,39;22792,87;22791,48;10178;-1,39;22791,48;2017-09-05;05/09/2017;AUTOPISTAS;Gastos_Ocio y transporte;Parking y peaje;9;VARIABLES
08/09/2017;08/09/2017;T/  TUNELS VALLVI S. 05-09-2017;-4,18;22791,48;22787,30;10179;-4,18;22787,30;2017-09-05;05/09/2017;TUNELS;Gastos_Ocio y transporte;Parking y peaje;9;VARIABLES
09/09/2017;09/09/2017;T/  BON AREA 06-09-2017;-24,86;22787,30;22762,44;10180;-24,86;22762,44;2017-09-06;06/09/2017;BON;Gastos_Compras;Supermercado;9;VARIABLES
09/09/2017;09/09/2017;T/  CAPRABO \ 06-09-2017;-7,69;22762,44;22754,75;10181;-7,69;22754,75;2017-09-06;06/09/2017;CAPRABO;Gastos_Compras;Supermercado;9;VARIABLES
10/09/2017;10/09/2017;CAJ. AJENO  SISTEMA 4B \BARCELONA;-300,00;22754,75;22454,75;10182;-300,00;22454,75;2017-09-10;10/09/2017;CAJ;Gastos_Gastos varios;Efectivo;9;VARIABLES
10/09/2017;10/09/2017;COM.  76985025 4b CAJ5 OFI9052;-1,85;22454,75;22452,90;10183;-1,85;22452,90;2017-09-10;10/09/2017;COM;Gastos_Banco y organismos;Cargos banco;9;FIJO
10/09/2017;10/09/2017;T/  AUTOPISTAS TERR 07-09-2017;-1,39;22452,90;22451,51;10184;-1,39;22451,51;2017-09-07;07/09/2017;AUTOPISTAS;Gastos_Ocio y transporte;Parking y peaje;9;VARIABLES
11/09/2017;11/09/2017;T/  CAFET.C T PRAT\PRAT 08-09-2017;-2,75;22451,51;22448,76;10185;-2,75;22448,76;2017-09-08;08/09/2017;CAFETC;Gastos_Ocio y transporte;Restaurantes;9;VARIABLES
12/09/2017;12/09/2017;R/  GAS GAS NATURAL GNS27630480917;-4,64;22448,76;22444,12;10186;-4,64;22444,12;2017-09-12;12/09/2017;GAS;Gastos_Servicios tipicos;Gas;9;FIJO
12/09/2017;12/09/2017;T/  TIGER STORES SPAIN\ 09-09-2017;-16,10;22444,12;22428,02;10187;-16,10;22428,02;2017-09-09;09/09/2017;TIGER;Gastos_Compras;Otras compras;9;VARIABLES
12/09/2017;12/09/2017;T/  AP. PLAÇA VELLA 09-09-2017;-2,25;22428,02;22425,77;10188;-2,25;22425,77;2017-09-09;09/09/2017;PLAA;Gastos_Ocio y transporte;Parking y peaje;9;VARIABLES
12/09/2017;12/09/2017;T/  NESPRESSO TERRASSA\ 09-09-2017;-40,00;22425,77;22385,77;10189;-40,00;22385,77;2017-09-09;09/09/2017;NESPRESSO;Gastos_Compras;Supermercado;9;VARIABLES
13/09/2017;13/09/2017;R/  TELECOMUNICACI VODAFONE;-132,42;22385,77;22253,35;10190;-132,42;22253,35;2017-09-13;13/09/2017;TELECOMUNICACI;Gastos_Servicios tipicos;Telecomunicaciones;9;FIJO
13/09/2017;13/09/2017;R/  LUZ ENDESA ENERG FACTURA DE ELE;-97,56;22253,35;22155,79;10191;-97,56;22155,79;2017-09-13;13/09/2017;ELE;Gastos_Servicios tipicos;Electricidad;9;FIJO
13/09/2017;13/09/2017;T/  AUTOPISTAS TERR 08-09-2017;-1,39;22155,79;22154,40;10192;-1,39;22154,40;2017-09-08;08/09/2017;AUTOPISTAS;Gastos_Ocio y transporte;Parking y peaje;9;VARIABLES
15/09/2017;15/09/2017;R/  . EDICIO DE PR /INV/5185083145;-60,00;22154,40;22094,40;10193;-60,00;22094,40;2017-09-15;15/09/2017;EDICIO;Gastos_Compras;Libreria;9;VARIABLES
15/09/2017;15/09/2017;T/  AUTOPISTAS TERR 12-09-2017;-1,39;22094,40;22093,01;10194;-1,39;22093,01;2017-09-12;12/09/2017;AUTOPISTAS;Gastos_Ocio y transporte;Parking y peaje;9;VARIABLES
15/09/2017;15/09/2017;T/  AUTOPISTAS TERR 12-09-2017;-1,39;22093,01;22091,62;10195;-1,39;22091,62;2017-09-12;12/09/2017;AUTOPISTAS;Gastos_Ocio y transporte;Parking y peaje;9;VARIABLES
15/09/2017;15/09/2017;T/  TARRASSA CARNES IND 12-09-2017;-47,56;22091,62;22044,06;10196;-47,56;22044,06;2017-09-12;12/09/2017;TARRASSA;Gastos_Compras;Supermercado;9;VARIABLES
15/09/2017;15/09/2017;T/  E.S. RUBI II 12-09-2017;-49,21;22044,06;21994,85;10197;-49,21;21994,85;2017-09-12;12/09/2017;RUBI;Gastos_Ocio y transporte;Gasolina;9;VARIABLES
15/09/2017;15/09/2017;T/  LIDL TERRASSA \ 12-09-2017;-65,20;21994,85;21929,65;10198;-65,20;21929,65;2017-09-12;12/09/2017;LIDL;Gastos_Compras;Supermercado;9;VARIABLES
16/09/2017;16/09/2017;T/  AUTOPISTAS TERR 13-09-2017;-1,39;21929,65;21928,26;10199;-1,39;21928,26;2017-09-13;13/09/2017;AUTOPISTAS;Gastos_Ocio y transporte;Parking y peaje;9;VARIABLES
16/09/2017;16/09/2017;T/  TUNELS VALLVI S. 12-09-2017;-4,18;21928,26;21924,08;10200;-4,18;21924,08;2017-09-12;12/09/2017;TUNELS;Gastos_Ocio y transporte;Parking y peaje;9;VARIABLES
16/09/2017;16/09/2017;T/  TUNELS VALLVI S. 08-09-2017;-3,72;21924,08;21920,36;10201;-3,72;21920,36;2017-09-08;08/09/2017;TUNELS;Gastos_Ocio y transporte;Parking y peaje;9;VARIABLES
17/09/2017;17/09/2017;T/  CAFET.C T PRAT\PRAT 14-09-2017;-1,80;21920,36;21918,56;10202;-1,80;21918,56;2017-09-14;14/09/2017;CAFETC;Gastos_Ocio y transporte;Restaurantes;9;VARIABLES
17/09/2017;17/09/2017;T/  AUTOPISTAS TERR 14-09-2017;-1,39;21918,56;21917,17;10203;-1,39;21917,17;2017-09-14;14/09/2017;AUTOPISTAS;Gastos_Ocio y transporte;Parking y peaje;9;VARIABLES
17/09/2017;17/09/2017;T/  AUTOPISTAS TERR 14-09-2017;-1,39;21917,17;21915,78;10204;-1,39;21915,78;2017-09-14;14/09/2017;AUTOPISTAS;Gastos_Ocio y transporte;Parking y peaje;9;VARIABLES
17/09/2017;17/09/2017;T/  TUNELS VALLVI S. 14-09-2017;-4,18;21915,78;21911,60;10205;-4,18;21911,60;2017-09-14;14/09/2017;TUNELS;Gastos_Ocio y transporte;Parking y peaje;9;VARIABLES
18/09/2017;18/09/2017;R/  SEGUROS CCM VIDA Y P Recibo:145;-20,61;21911,60;21890,99;10206;-20,61;21890,99;2017-09-18;18/09/2017;CCM;Gastos_Seguros;Seguro vida;9;FIJO
18/09/2017;18/09/2017;R/  SEGUROS CCM VIDA Y P Recibo:145;-16,38;21890,99;21874,61;10207;-16,38;21874,61;2017-09-18;18/09/2017;CCM;Gastos_Seguros;Seguro vida;9;FIJO
18/09/2017;18/09/2017;T/  CAFET.C T PRAT\PRAT 15-09-2017;-2,50;21874,61;21872,11;10208;-2,50;21872,11;2017-09-15;15/09/2017;CAFETC;Gastos_Ocio y transporte;Restaurantes;9;VARIABLES
20/09/2017;20/09/2017;R/ MINA PUBLICA AIGUES T.01A75789;-30,48;21872,11;21841,63;10209;-30,48;21841,63;2017-09-20;20/09/2017;MINA;Gastos_Servicios tipicos;Agua;9;FIJO
21/09/2017;21/09/2017;T/  PARKING VAPOR GRAN\ 18-09-2017;-2,65;21841,63;21838,98;10210;-2,65;21838,98;2017-09-18;18/09/2017;PARKING;Gastos_Ocio y transporte;Parking y peaje;9;VARIABLES
21/09/2017;21/09/2017;T/  VIDAL FORNERS \ 18-09-2017;-9,50;21838,98;21829,48;10211;-9,50;21829,48;2017-09-18;18/09/2017;VIDAL;Gastos_Compras;Supermercado;9;VARIABLES
22/09/2017;22/09/2017;T/  AUTOPISTAS TERR 19-09-2017;-1,39;21829,48;21828,09;10212;-1,39;21828,09;2017-09-19;19/09/2017;AUTOPISTAS;Gastos_Ocio y transporte;Parking y peaje;9;VARIABLES
22/09/2017;22/09/2017;T/  SUPER.BON PREU S16\ 19-09-2017;-12,66;21828,09;21815,43;10213;-12,66;21815,43;2017-09-19;19/09/2017;SUPERBON;Gastos_Compras;Supermercado;9;VARIABLES
22/09/2017;22/09/2017;T/  AUTOPISTAS TERR 18-09-2017;-1,39;21815,43;21814,04;10214;-1,39;21814,04;2017-09-18;18/09/2017;AUTOPISTAS;Gastos_Ocio y transporte;Parking y peaje;9;VARIABLES
23/09/2017;23/09/2017;T/  AUTOPISTAS TERR 20-09-2017;-1,39;21814,04;21812,65;10215;-1,39;21812,65;2017-09-20;20/09/2017;AUTOPISTAS;Gastos_Ocio y transporte;Parking y peaje;9;VARIABLES
23/09/2017;23/09/2017;T/  FRANKFURT LES LLET\ 20-09-2017;-7,30;21812,65;21805,35;10216;-7,30;21805,35;2017-09-20;20/09/2017;FRANKFURT;Gastos_Ocio y transporte;Restaurantes;9;VARIABLES
25/09/2017;25/09/2017;T/  CAPRABO - 427 TERR\ 22-09-2017;-19,11;21805,35;21786,24;10217;-19,11;21786,24;2017-09-22;22/09/2017;CAPRABO;Gastos_Compras;Supermercado;9;VARIABLES
25/09/2017;25/09/2017;T/  DRIM PARC VALLES 22-09-2017;-19,99;21786,24;21766,25;10218;-19,99;21766,25;2017-09-22;22/09/2017;DRIM;Gastos_Compras;Niños;9;VARIABLES
26/09/2017;26/09/2017;T/  FRUTAS Y VERDURAS\B 23-09-2017;-16,82;21766,25;21749,43;10219;-16,82;21749,43;2017-09-23;23/09/2017;FRUTAS;Gastos_Compras;Supermercado;9;VARIABLES
26/09/2017;26/09/2017;T/  KM IZQUIERDO E3 \ 23-09-2017;-49,86;21749,43;21699,57;10220;-49,86;21699,57;2017-09-23;23/09/2017;IZQUIERDO;Gastos_Ocio y transporte;Gasolina;9;VARIABLES
27/09/2017;27/09/2017;R/  ALIMENTACION SERHS FOOD A Comed;-83,30;21699,57;21616,27;10221;-83,30;21616,27;2017-09-27;27/09/2017;ALIMENTACION;Gastos_Salud, saber y deporte;Menjador;9;FIJO
27/09/2017;27/09/2017;R/  ALIMENTACION SERHS FOOD A Comed;-24,50;21616,27;21591,77;10222;-24,50;21591,77;2017-09-27;27/09/2017;ALIMENTACION;Gastos_Salud, saber y deporte;Menjador;9;FIJO
27/09/2017;27/09/2017;T/  WWW.JUST-EAT.ES 24-09-2017;-30,50;21591,77;21561,27;10223;-30,50;21561,27;2017-09-24;24/09/2017;WWWJUSTEATES;Gastos_Ocio y transporte;Restaurantes;9;VARIABLES
28/09/2017;28/09/2017;HAB.  INFORMACIO I TECNOLOGIA DE CAT;1624,63;21561,27;23185,90;10224;1624,63;23185,90;2017-09-28;28/09/2017;HAB;Ingresos;Nomina;9;FIJO
28/09/2017;28/09/2017;HAB.  FOMENT DE TERRASSA S.A. Transf;1936,34;23185,90;25122,24;10225;1936,34;25122,24;2017-09-28;28/09/2017;HAB;Ingresos;Nomina;9;FIJO
28/09/2017;28/09/2017;T/  VIENA PARC VALLES \ 25-09-2017;-19,65;25122,24;25102,59;10226;-19,65;25102,59;2017-09-25;25/09/2017;VIENA;Gastos_Ocio y transporte;Restaurantes;9;VARIABLES
28/09/2017;28/09/2017;T/  BON AREA 25-09-2017;-18,87;25102,59;25083,72;10227;-18,87;25083,72;2017-09-25;25/09/2017;BON;Gastos_Compras;Supermercado;9;VARIABLES
29/09/2017;29/09/2017;R/  AYUNTAMIENTO AJUNTAMENT D I.B.I;-45,65;25083,72;25038,07;10228;-45,65;25038,07;2017-09-29;29/09/2017;AYUNTAMIENTO;Gastos_Banco y organismos;Ayuntamiento;9;FIJO
29/09/2017;29/09/2017;T/  AUTOPISTAS TERR 26-09-2017;-1,39;25038,07;25036,68;10229;-1,39;25036,68;2017-09-26;26/09/2017;AUTOPISTAS;Gastos_Ocio y transporte;Parking y peaje;9;VARIABLES
29/09/2017;29/09/2017;T/  AUTOPISTAS TERR 26-09-2017;-1,39;25036,68;25035,29;10230;-1,39;25035,29;2017-09-26;26/09/2017;AUTOPISTAS;Gastos_Ocio y transporte;Parking y peaje;9;VARIABLES
30/09/2017;30/09/2017;REC.  6061.9600001223;-485,11;25035,29;24550,18;10231;-485,11;24550,18;2017-09-30;30/09/2017;REC;Gastos_Banco y organismos;Hipoteca;9;FIJO
30/09/2017;30/09/2017;T/  RODELAS PERRUQUERS\ 27-09-2017;-32,90;24550,18;24517,28;10232;-32,90;24517,28;2017-09-27;27/09/2017;RODELAS;Gastos_Salud, saber y deporte;Belleza;9;VARIABLES
01/10/2017;01/10/2017;FACT TARJETAS  TARJ.CREDITO 07126017 17-10-01;-123,43;24517,28;24393,85;10233;-123,43;24393,85;2017-10-01;30/09/2017;FACT 07126017;Gastos_Banco y organismos;Credito Bea;9;VARIABLE
01/10/2017;01/10/2017;FACT TARJETAS  TARJ.CREDITO 42689013 17-10-01;-509,18;24393,85;23884,67;10234;-509,18;23884,67;2017-10-01;30/09/2017;FACT;No computable;Recibo Tarjeta;9;
01/10/2017;01/10/2017;T/  AUTOPISTAS TERR 28-09-2017;-1,39;23884,67;23883,28;10235;-1,39;23883,28;2017-09-28;28/09/2017;AUTOPISTAS;Gastos_Ocio y transporte;Parking y peaje;9;VARIABLES
01/10/2017;01/10/2017;T/  LIDL TERRASSA \ 28-09-2017;-52,29;23883,28;23830,99;10236;-52,29;23830,99;2017-09-28;28/09/2017;LIDL;Gastos_Compras;Supermercado;9;VARIABLES
01/10/2017;01/10/2017;T/  AUTOPISTAS TERR 27-09-2017;-1,39;23830,99;23829,60;10237;-1,39;23829,60;2017-09-27;27/09/2017;AUTOPISTAS;Gastos_Ocio y transporte;Parking y peaje;9;VARIABLES
01/10/2017;01/10/2017;T/  AUTOPISTAS TERR 27-09-2017;-1,39;23829,60;23828,21;10238;-1,39;23828,21;2017-09-27;27/09/2017;AUTOPISTAS;Gastos_Ocio y transporte;Parking y peaje;9;VARIABLES
02/10/2017;02/10/2017;T/  FRANKFURT LES LLET\ 29-09-2017;-2,90;23828,21;23825,31;10239;-2,90;23825,31;2017-09-29;29/09/2017;FRANKFURT;Gastos_Ocio y transporte;Restaurantes;9;VARIABLES
03/10/2017;03/10/2017;T/  MS MODE CC BAR\BARB 30-09-2017;-28,09;23825,31;23797,22;10240;-28,09;23797,22;2017-09-30;30/09/2017;MODE;Gastos_Compras;Ropa;9;VARIABLES
04/10/2017;04/10/2017;R/  LUZ ENDESA ENERG FACTURA DE GAS;-71,11;23797,22;23726,11;10241;-71,11;23726,11;2017-10-04;04/10/2017;GAS;Gastos_Servicios tipicos;Gas;10;FIJO
04/10/2017;04/10/2017;R/  SEGUROS SEGUROS CATA INCLUIDO S;-327,04;23726,11;23399,07;10242;-327,04;23399,07;2017-10-04;04/10/2017;CATA;Gastos_Seguros;Seguro auto;10;FIJO
04/10/2017;04/10/2017;T/  AUTOPISTAS TERR 29-09-2017;-1,39;23399,07;23397,68;10243;-1,39;23397,68;2017-09-29;29/09/2017;AUTOPISTAS;Gastos_Ocio y transporte;Parking y peaje;9;VARIABLES
04/10/2017;04/10/2017;T/  AUTOPISTAS TERR 29-09-2017;-1,39;23397,68;23396,29;10244;-1,39;23396,29;2017-09-29;29/09/2017;AUTOPISTAS;Gastos_Ocio y transporte;Parking y peaje;9;VARIABLES
05/10/2017;05/10/2017;T/  SUPER.BON PREU S16\ 02-10-2017;-5,73;23396,29;23390,56;10245;-5,73;23390,56;2017-10-02;02/10/2017;SUPERBON;Gastos_Compras;Supermercado;10;VARIABLES
05/10/2017;05/10/2017;T/  FRANKFURT LES LLET\ 02-10-2017;-4,30;23390,56;23386,26;10246;-4,30;23386,26;2017-10-02;02/10/2017;FRANKFURT;Gastos_Ocio y transporte;Restaurantes;10;VARIABLES
06/10/2017;06/10/2017;T/  AUTOPISTAS TERR 02-10-2017;-1,39;23386,26;23384,87;10247;-1,39;23384,87;2017-10-02;02/10/2017;AUTOPISTAS;Gastos_Ocio y transporte;Parking y peaje;10;VARIABLES
07/10/2017;07/10/2017;T/  FRANKFURT LES LLET\ 04-10-2017;-2,90;23384,87;23381,97;10248;-2,90;23381,97;2017-10-04;04/10/2017;FRANKFURT;Gastos_Ocio y transporte;Restaurantes;10;VARIABLES
07/10/2017;07/10/2017;T/  CAFETERIA VINT I U\ 04-10-2017;-30,08;23381,97;23351,89;10249;-30,08;23351,89;2017-10-04;04/10/2017;CAFETERIA;Gastos_Compras;Supermercado;10;VARIABLES
08/10/2017;08/10/2017;T/  CINESA WEB \B 05-10-2017;-38,80;23351,89;23313,09;10250;-38,80;23313,09;2017-10-05;05/10/2017;CINESA;Gastos_Ocio y transporte;Espectáculos;10;VARIABLES
09/10/2017;09/10/2017;'R/  COOPERATIVA L''EINA COOPE Rebut:';-47,60;23313,09;23265,49;10251;-47,60;23265,49;2017-10-09;09/10/2017;COOPERATIVA;Gastos_Salud, saber y deporte;Estudios;10;VARIABLES
09/10/2017;09/10/2017;R/  . FINQUES GASS Vto 01-10-17 Rec;-73,69;23265,49;23191,80;10252;-73,69;23191,80;2017-10-01;01/10/2017;FINQUES;Gastos_Vivienda y vehiculo;Alquiler Parking;10;FIJO
09/10/2017;09/10/2017;T/  FRANKFURT LES LLET\ 06-10-2017;-2,90;23191,80;23188,90;10253;-2,90;23188,90;2017-10-06;06/10/2017;FRANKFURT;Gastos_Ocio y transporte;Restaurantes;10;VARIABLES
10/10/2017;10/10/2017;T/  AUTOPISTAS TERR 06-10-2017;-1,39;23188,90;23187,51;10254;-1,39;23187,51;2017-10-06;06/10/2017;AUTOPISTAS;Gastos_Ocio y transporte;Parking y peaje;10;VARIABLES
11/10/2017;11/10/2017;T/  WWW.JUST-EAT.ES 08-10-2017;-19,50;23187,51;23168,01;10255;-19,50;23168,01;2017-10-08;08/10/2017;WWWJUSTEATES;Gastos_Ocio y transporte;Restaurantes;10;VARIABLES
12/10/2017;12/10/2017;T/  CAFET.C T PRAT\PRAT 09-10-2017;-2,20;23168,01;23165,81;10256;-2,20;23165,81;2017-10-09;09/10/2017;CAFETC;Gastos_Ocio y transporte;Restaurantes;10;VARIABLES
12/10/2017;12/10/2017;T/  FRANKFURT LES LLET\ 09-10-2017;-2,90;23165,81;23162,91;10257;-2,90;23162,91;2017-10-09;09/10/2017;FRANKFURT;Gastos_Ocio y transporte;Restaurantes;10;VARIABLES
13/10/2017;13/10/2017;R/  GAS GAS NATURAL GNS27630481017;-4,64;23162,91;23158,27;10258;-4,64;23158,27;2017-10-13;13/10/2017;GAS;Gastos_Servicios tipicos;Gas;10;FIJO
13/10/2017;13/10/2017;T/  FRANKFURT LES LLET\ 10-10-2017;-2,90;23158,27;23155,37;10259;-2,90;23155,37;2017-10-10;10/10/2017;FRANKFURT;Gastos_Ocio y transporte;Restaurantes;10;VARIABLES
14/10/2017;14/10/2017;T/  REST.PEPERONAT\EL P 11-10-2017;-10,25;23155,37;23145,12;10260;-10,25;23145,12;2017-10-11;11/10/2017;RESTPEPERONATEL;Gastos_Ocio y transporte;Restaurantes;10;VARIABLES
14/10/2017;14/10/2017;T/  FRANKFURT LES LLET\ 11-10-2017;-6,85;23145,12;23138,27;10261;-6,85;23138,27;2017-10-11;11/10/2017;FRANKFURT;Gastos_Ocio y transporte;Restaurantes;10;VARIABLES
14/10/2017;14/10/2017;T/  PARKING VAPOR GRAN\ 11-10-2017;-2,90;23138,27;23135,37;10262;-2,90;23135,37;2017-10-11;11/10/2017;PARKING;Gastos_Ocio y transporte;Parking y peaje;10;VARIABLES
14/10/2017;14/10/2017;T/  EL SALON THE BARBE\ 11-10-2017;-57,97;23135,37;23077,40;10263;-57,97;23077,40;2017-10-11;11/10/2017;SALON;Gastos_Salud, saber y deporte;Belleza;10;VARIABLES
14/10/2017;14/10/2017;T/  FRANKFURT LES LLET\ 11-10-2017;-2,90;23077,40;23074,50;10264;-2,90;23074,50;2017-10-11;11/10/2017;FRANKFURT;Gastos_Ocio y transporte;Restaurantes;10;VARIABLES
15/10/2017;15/10/2017;T/ FARMACIA SEGLE XX \ 12-10-2017;-10,57;23074,50;23063,93;10265;-10,57;23063,93;2017-10-12;12/10/2017;FARMACIA;Gastos_Salud, saber y deporte;Farmacia;10;VARIABLES
15/10/2017;15/10/2017;T/ LA TERRASSETA \ 12-10-2017;-8,10;23063,93;23055,83;10266;-8,10;23055,83;2017-10-12;12/10/2017;TERRASSETA;Gastos_Ocio y transporte;Restaurantes;10;VARIABLES
15/10/2017;15/10/2017;T/ WWW.JUST-EAT.ES 12-10-2017;-51,90;23055,83;23003,93;10267;-51,90;23003,93;2017-10-12;12/10/2017;WWWJUSTEATES;Gastos_Ocio y transporte;Restaurantes;10;VARIABLES
15/10/2017;15/10/2017;T/ TUNELS VALLVI S. 11-10-2017;-3,72;23003,93;23000,21;10268;-3,72;23000,21;2017-10-11;11/10/2017;TUNELS;Gastos_Ocio y transporte;Parking y peaje;10;VARIABLES
16/10/2017;16/10/2017;R/ TELECOMUNICACI VODAFONE;-174,70;23000,21;22825,51;10269;-174,70;22825,51;2017-10-16;16/10/2017;TELECOMUNICACI;Gastos_Servicios tipicos;Telecomunicaciones;10;FIJO
16/10/2017;16/10/2017;R/ Escola d Idi SALT IDIOMES. Ade;-25,00;22825,51;22800,51;10270;-25,00;22800,51;2017-10-16;16/10/2017;ESCOLA;Gastos_Salud, saber y deporte;Estudios;10;VARIABLES
16/10/2017;16/10/2017;T/ CAFET.C T PRAT\PRAT 13-10-2017;-1,35;22800,51;22799,16;10271;-1,35;22799,16;2017-10-13;13/10/2017;CAFETC;Gastos_Ocio y transporte;Restaurantes;10;VARIABLES
16/10/2017;16/10/2017;T/ IKEA REST. SABADEL\ 13-10-2017;-2,50;22799,16;22796,66;10272;-2,50;22796,66;2017-10-13;13/10/2017;IKEA;Gastos_Vivienda y vehiculo;Mnto. hogar;10;VARIABLES
16/10/2017;16/10/2017;T/ EL RACO \ 13-10-2017;-55,50;22796,66;22741,16;10273;-55,50;22741,16;2017-10-13;13/10/2017;RACO;Gastos_Ocio y transporte;Restaurantes;10;VARIABLES
17/10/2017;17/10/2017;R/ SEGUROS CCM VIDA Y P Recibo:146;-16,31;22741,16;22724,85;10274;-16,31;22724,85;2017-10-17;17/10/2017;CCM;Gastos_Seguros;Seguro vida;10;FIJO
17/10/2017;17/10/2017;R/ SEGUROS CCM VIDA Y P Recibo:146;-20,54;22724,85;22704,31;10275;-20,54;22704,31;2017-10-17;17/10/2017;CCM;Gastos_Seguros;Seguro vida;10;FIJO
17/10/2017;14/10/2017;T/ CARREFOUR VALLE;-76,18;22704,31;22628,13;10276;-76,18;22628,13;2017-10-14;14/10/2017;CARREFOUR;Gastos_Compras;Supermercado;10;VARIABLES
17/10/2017;17/10/2017;T/ VIENA PARC VALLES \ 14-10-2017;-17,55;22628,13;22610,58;10277;-17,55;22610,58;2017-10-14;14/10/2017;VIENA;Gastos_Ocio y transporte;Restaurantes;10;VARIABLES
18/10/2017;18/10/2017;R/ SEGUROS ADESLAS CENT MODULAR CO;-144,67;22610,58;22465,91;10278;-144,67;22465,91;2017-10-18;18/10/2017;ADESLAS;Gastos_Salud, saber y deporte;Medico;10;VARIABLES
18/10/2017;18/10/2017;R/ Escola d Idi SALT IDIOMES. Ade;-30,00;22465,91;22435,91;10279;-30,00;22435,91;2017-10-18;18/10/2017;ESCOLA;Gastos_Salud, saber y deporte;Estudios;10;VARIABLES
18/10/2017;18/10/2017;R/ ALIMENTACION SERHS FOOD A Comed;-119,00;22435,91;22316,91;10280;-119,00;22316,91;2017-10-18;18/10/2017;ALIMENTACION;Gastos_Salud, saber y deporte;Menjador;10;FIJO
19/10/2017;19/10/2017;R/ Escola d Idi SALT IDIOMES. Ade;-39,00;22316,91;22277,91;10281;-39,00;22277,91;2017-10-19;19/10/2017;ESCOLA;Gastos_Salud, saber y deporte;Estudios;10;VARIABLES
19/10/2017;19/10/2017;T/ TOCINERIES VENTURA\ 16-10-2017;-13,66;22277,91;22264,25;10282;-13,66;22264,25;2017-10-16;16/10/2017;TOCINERIES;Gastos_Compras;Supermercado;10;VARIABLES
19/10/2017;19/10/2017;T/ CAPRABO \ 16-10-2017;-12,49;22264,25;22251,76;10283;-12,49;22251,76;2017-10-16;16/10/2017;CAPRABO;Gastos_Compras;Supermercado;10;VARIABLES
19/10/2017;19/10/2017;T/ AUTOPISTAS TERR 13-10-2017;-1,39;22251,76;22250,37;10284;-1,39;22250,37;2017-10-13;13/10/2017;AUTOPISTAS;Gastos_Ocio y transporte;Parking y peaje;10;VARIABLES
19/10/2017;19/10/2017;T/ AUTOPISTAS TERR 11-10-2017;-1,39;22250,37;22248,98;10285;-1,39;22248,98;2017-10-11;11/10/2017;AUTOPISTAS;Gastos_Ocio y transporte;Parking y peaje;10;VARIABLES
19/10/2017;19/10/2017;T/ AUTOPISTAS TERR 11-10-2017;-1,39;22248,98;22247,59;10286;-1,39;22247,59;2017-10-11;11/10/2017;AUTOPISTAS;Gastos_Ocio y transporte;Parking y peaje;10;VARIABLES
20/10/2017;20/10/2017;CAJ. AJENO SERVIRED \MADRID;-300,00;22247,59;21947,59;10287;-300,00;21947,59;2017-10-20;20/10/2017;CAJ;Gastos_Gastos varios;Efectivo;10;VARIABLES
20/10/2017;20/10/2017;COM. 64970036 SVRED CAJ OFI;-1,87;21947,59;21945,72;10288;-1,87;21945,72;2017-10-20;20/10/2017;COM;Gastos_Banco y organismos;Cargos banco;10;FIJO
20/10/2017;20/10/2017;T/ CAFET.C T PRAT\PRAT 17-10-2017;-0,90;21945,72;21944,82;10289;-0,90;21944,82;2017-10-17;17/10/2017;CAFETC;Gastos_Ocio y transporte;Restaurantes;10;VARIABLES
20/10/2017;20/10/2017;T/ AUTOPISTAS TERR 17-10-2017;-1,39;21944,82;21943,43;10290;-1,39;21943,43;2017-10-17;17/10/2017;AUTOPISTAS;Gastos_Ocio y transporte;Parking y peaje;10;VARIABLES
20/10/2017;20/10/2017;T/ TUNELS VALLVI S. 17-10-2017;-3,72;21943,43;21939,71;10291;-3,72;21939,71;2017-10-17;17/10/2017;TUNELS;Gastos_Ocio y transporte;Parking y peaje;10;VARIABLES
20/10/2017;20/10/2017;T/ AUTOPISTAS TERR 17-10-2017;-1,39;21939,71;21938,32;10292;-1,39;21938,32;2017-10-17;17/10/2017;AUTOPISTAS;Gastos_Ocio y transporte;Parking y peaje;10;VARIABLES
20/10/2017;20/10/2017;T/ AKI 104 - TERRASSA\ 17-10-2017;-79,00;21938,32;21859,32;10293;-79,00;21859,32;2017-10-17;17/10/2017;AKI;Gastos_Vivienda y vehiculo;Mnto. hogar;10;VARIABLES
20/10/2017;20/10/2017;T/ AUTOPISTAS TERR 16-10-2017;-1,39;21859,32;21857,93;10294;-1,39;21857,93;2017-10-16;16/10/2017;AUTOPISTAS;Gastos_Ocio y transporte;Parking y peaje;10;VARIABLES
20/10/2017;20/10/2017;T/ AUTOPISTAS TERR 16-10-2017;-1,39;21857,93;21856,54;10295;-1,39;21856,54;2017-10-16;16/10/2017;AUTOPISTAS;Gastos_Ocio y transporte;Parking y peaje;10;VARIABLES
21/10/2017;19/10/2017;T/ CARREFOUR VALLE;-117,62;21856,54;21738,92;10296;-117,62;21738,92;2017-10-19;19/10/2017;CARREFOUR;Gastos_Compras;Supermercado;10;VARIABLES
21/10/2017;21/10/2017;T/ AUTOPISTAS TERR 18-10-2017;-1,39;21738,92;21737,53;10297;-1,39;21737,53;2017-10-18;18/10/2017;AUTOPISTAS;Gastos_Ocio y transporte;Parking y peaje;10;VARIABLES
21/10/2017;21/10/2017;T/ AUTOPISTAS TERR 18-10-2017;-1,39;21737,53;21736,14;10298;-1,39;21736,14;2017-10-18;18/10/2017;AUTOPISTAS;Gastos_Ocio y transporte;Parking y peaje;10;VARIABLES
21/10/2017;21/10/2017;T/ CAFET.C T PRAT\PRAT 18-10-2017;-3,65;21736,14;21732,49;10299;-3,65;21732,49;2017-10-18;18/10/2017;CAFETC;Gastos_Ocio y transporte;Restaurantes;10;VARIABLES
21/10/2017;21/10/2017;T/ TUNELS VALLVI S. 18-10-2017;-3,72;21732,49;21728,77;10300;-3,72;21728,77;2017-10-18;18/10/2017;TUNELS;Gastos_Ocio y transporte;Parking y peaje;10;VARIABLES
21/10/2017;21/10/2017;T/ HONG KONG 2 \EL PR 18-10-2017;-10,50;21728,77;21718,27;10301;-10,50;21718,27;2017-10-18;18/10/2017;HONG;Gastos_Ocio y transporte;Restaurantes;10;VARIABLES
22/10/2017;22/10/2017;T/ AUTOPISTAS TERR 19-10-2017;-1,39;21718,27;21716,88;10302;-1,39;21716,88;2017-10-19;19/10/2017;AUTOPISTAS;Gastos_Ocio y transporte;Parking y peaje;10;VARIABLES
22/10/2017;22/10/2017;T/ AUTOPISTAS TERR 19-10-2017;-1,39;21716,88;21715,49;10303;-1,39;21715,49;2017-10-19;19/10/2017;AUTOPISTAS;Gastos_Ocio y transporte;Parking y peaje;10;VARIABLES
22/10/2017;22/10/2017;T/ CAFET.C T PRAT\PRAT 19-10-2017;-2,75;21715,49;21712,74;10304;-2,75;21712,74;2017-10-19;19/10/2017;CAFETC;Gastos_Ocio y transporte;Restaurantes;10;VARIABLES
22/10/2017;22/10/2017;T/ TUNELS VALLVI S. 19-10-2017;-3,72;21712,74;21709,02;10305;-3,72;21709,02;2017-10-19;19/10/2017;TUNELS;Gastos_Ocio y transporte;Parking y peaje;10;VARIABLES
22/10/2017;22/10/2017;T/ E.S. RUBI II 19-10-2017;-47,18;21709,02;21661,84;10306;-47,18;21661,84;2017-10-19;19/10/2017;RUBI;Gastos_Ocio y transporte;Gasolina;10;VARIABLES
24/10/2017;24/10/2017;T/ REDPIZZA \ 21-10-2017;-28,55;21661,84;21633,29;10307;-28,55;21633,29;2017-10-21;21/10/2017;REDPIZZA;Gastos_Ocio y transporte;Restaurantes;10;VARIABLES
24/10/2017;24/10/2017;T/ AUTOPISTAS TERR 20-10-2017;-1,39;21633,29;21631,90;10308;-1,39;21631,90;2017-10-20;20/10/2017;AUTOPISTAS;Gastos_Ocio y transporte;Parking y peaje;10;VARIABLES
24/10/2017;24/10/2017;T/ AUTOPISTAS TERR 20-10-2017;-1,39;21631,90;21630,51;10309;-1,39;21630,51;2017-10-20;20/10/2017;AUTOPISTAS;Gastos_Ocio y transporte;Parking y peaje;10;VARIABLES
25/10/2017;25/10/2017;T/ TUNELS VALLVI S. 20-10-2017;-3,72;21630,51;21626,79;10310;-3,72;21626,79;2017-10-20;20/10/2017;TUNELS;Gastos_Ocio y transporte;Parking y peaje;10;VARIABLES
26/10/2017;26/10/2017;BONIF.COM. 5540550276985025;18,00;21626,79;21644,79;10311;18,00;21644,79;2017-10-26;26/10/2017;BONIFCOM;Ingresos;Devoluciones;10;VARIABLES
26/10/2017;26/10/2017;COMIS.TARJETAS 5540550276985025;-18,00;21644,79;21626,79;10312;-18,00;21626,79;2017-10-26;26/10/2017;COMISTARJETAS;Gastos_Banco y organismos;Cargos banco;10;FIJO
26/10/2017;24/10/2017;T/ CARREFOUR TARRA;-50,02;21626,79;21576,77;10313;-50,02;21576,77;2017-10-24;24/10/2017;CARREFOUR;Gastos_Compras;Supermercado;10;VARIABLES
26/10/2017;26/10/2017;T/ AUTOPISTAS TERR 23-10-2017;-1,39;21576,77;21575,38;10314;-1,39;21575,38;2017-10-23;23/10/2017;AUTOPISTAS;Gastos_Ocio y transporte;Parking y peaje;10;VARIABLES
26/10/2017;26/10/2017;T/ AUTOPISTAS TERR 23-10-2017;-1,39;21575,38;21573,99;10315;-1,39;21573,99;2017-10-23;23/10/2017;AUTOPISTAS;Gastos_Ocio y transporte;Parking y peaje;10;VARIABLES
26/10/2017;26/10/2017;T/ CAPRABO \ 23-10-2017;-11,35;21573,99;21562,64;10316;-11,35;21562,64;2017-10-23;23/10/2017;CAPRABO;Gastos_Compras;Supermercado;10;VARIABLES
26/10/2017;26/10/2017;T/ TUNELS VALLVI S. 23-10-2017;-4,18;21562,64;21558,46;10317;-4,18;21558,46;2017-10-23;23/10/2017;TUNELS;Gastos_Ocio y transporte;Parking y peaje;10;VARIABLES
26/10/2017;26/10/2017;T/ CAFET.C T PRAT\PRAT 23-10-2017;-4,20;21558,46;21554,26;10318;-4,20;21554,26;2017-10-23;23/10/2017;CAFETC;Gastos_Ocio y transporte;Restaurantes;10;VARIABLES
27/10/2017;27/10/2017;HAB. INFORMACIO I TECNOLOGIA DE CAT;1545,33;21554,26;23099,59;10319;1545,33;23099,59;2017-10-27;27/10/2017;HAB;Ingresos;Nomina;10;FIJO
27/10/2017;27/10/2017;HAB. FOMENT DE TERRASSA S.A. Transf;1786,44;23099,59;24886,03;10320;1786,44;24886,03;2017-10-27;27/10/2017;HAB;Ingresos;Nomina;10;FIJO
27/10/2017;25/10/2017;T/ Amazon *Mktplce EU-ES;-276,99;24886,03;24609,04;10321;-276,99;24609,04;2017-10-25;25/10/2017;AMAZON;Gastos_Compras;Hobbys;10;VARIABLES
27/10/2017;27/10/2017;T/ AUTOPISTAS TERR 24-10-2017;-1,39;24609,04;24607,65;10322;-1,39;24607,65;2017-10-24;24/10/2017;AUTOPISTAS;Gastos_Ocio y transporte;Parking y peaje;10;VARIABLES
27/10/2017;27/10/2017;T/ AUTOPISTAS TERR 24-10-2017;-1,39;24607,65;24606,26;10323;-1,39;24606,26;2017-10-24;24/10/2017;AUTOPISTAS;Gastos_Ocio y transporte;Parking y peaje;10;VARIABLES
27/10/2017;27/10/2017;T/ AKI 104 - TERRASSA\ 24-10-2017;-7,95;24606,26;24598,31;10324;-7,95;24598,31;2017-10-24;24/10/2017;AKI;Gastos_Vivienda y vehiculo;Mnto. hogar;10;VARIABLES
27/10/2017;27/10/2017;T/ TUNELS VALLVI S. 24-10-2017;-3,72;24598,31;24594,59;10325;-3,72;24594,59;2017-10-24;24/10/2017;TUNELS;Gastos_Ocio y transporte;Parking y peaje;10;VARIABLES
27/10/2017;27/10/2017;T/ VIENA MONTSERRAT \ 24-10-2017;-21,40;24594,59;24573,19;10326;-21,40;24573,19;2017-10-24;24/10/2017;VIENA;Gastos_Ocio y transporte;Restaurantes;10;VARIABLES
27/10/2017;27/10/2017;T/ SUPER.BON PREU S16\ 24-10-2017;-2,00;24573,19;24571,19;10327;-2,00;24571,19;2017-10-24;24/10/2017;SUPERBON;Gastos_Compras;Supermercado;10;VARIABLES
28/10/2017;28/10/2017;T/ AUTOPISTAS TERR 25-10-2017;-1,39;24571,19;24569,80;10328;-1,39;24569,80;2017-10-25;25/10/2017;AUTOPISTAS;Gastos_Ocio y transporte;Parking y peaje;10;VARIABLES
28/10/2017;28/10/2017;T/ AUTOPISTAS TERR 25-10-2017;-1,39;24569,80;24568,41;10329;-1,39;24568,41;2017-10-25;25/10/2017;AUTOPISTAS;Gastos_Ocio y transporte;Parking y peaje;10;VARIABLES
28/10/2017;28/10/2017;T/ SUPER.BON PREU S16\ 25-10-2017;-3,99;24568,41;24564,42;10330;-3,99;24564,42;2017-10-25;25/10/2017;SUPERBON;Gastos_Compras;Supermercado;10;VARIABLES
28/10/2017;28/10/2017;T/ TUNELS VALLVI S. 25-10-2017;-3,72;24564,42;24560,70;10331;-3,72;24560,70;2017-10-25;25/10/2017;TUNELS;Gastos_Ocio y transporte;Parking y peaje;10;VARIABLES
28/10/2017;28/10/2017;T/ FRANKFURT LES LLET\ 25-10-2017;-2,90;24560,70;24557,80;10332;-2,90;24557,80;2017-10-25;25/10/2017;FRANKFURT;Gastos_Ocio y transporte;Restaurantes;10;VARIABLES
29/10/2017;29/10/2017;T/ AUTOPISTAS TERR 26-10-2017;-1,39;24557,80;24556,41;10333;-1,39;24556,41;2017-10-26;26/10/2017;AUTOPISTAS;Gastos_Ocio y transporte;Parking y peaje;10;VARIABLES
29/10/2017;29/10/2017;T/ FRANKFURT LES LLET\ 26-10-2017;-2,90;24556,41;24553,51;10334;-2,90;24553,51;2017-10-26;26/10/2017;FRANKFURT;Gastos_Ocio y transporte;Restaurantes;10;VARIABLES
29/10/2017;29/10/2017;T/ TUNELS VALLVI S. 26-10-2017;-4,18;24553,51;24549,33;10335;-4,18;24549,33;2017-10-26;26/10/2017;TUNELS;Gastos_Ocio y transporte;Parking y peaje;10;VARIABLES
31/10/2017;31/10/2017;REC. 6061.9600001223;-485,11;24549,33;24064,22;10336;-485,11;24064,22;2017-10-31;31/10/2017;REC;Gastos_Banco y organismos;Hipoteca;10;FIJO
31/10/2017;31/10/2017;T/ AKI 104 - TERRASSA\ 28-10-2017;-69,65;24064,22;23994,57;10337;-69,65;23994,57;2017-10-28;28/10/2017;AKI;Gastos_Vivienda y vehiculo;Mnto. hogar;10;VARIABLES
01/11/2017;01/11/2017;FACT TARJETAS TARJ.CREDITO 07126017 17-11-01;-449,75;23994,57;23544,82;10338;-449,75;23544,82;2017-11-01;31/10/2017;FACT 07126017;Gastos_Banco y organismos;Credito Bea;10;VARIABLE
01/11/2017;01/11/2017;FACT TARJETAS TARJ.CREDITO 42689013 17-11-01;-940,26;23544,82;22604,56;10339;-940,26;22604,56;2017-11-01;31/10/2017;FACT;No computable;Recibo Tarjeta;10;
01/11/2017;01/11/2017;T/ TERRACASA \TERRASSA;-44,56;22604,56;22560,00;10340;-44,56;22560,00;2017-11-01;01/11/2017;TERRACASA;Gastos_Compras;Otras compras;11;VARIABLES
01/11/2017;01/11/2017;T/ E.S.RUBI 9 29-10-2017;-43,16;22560,00;22516,84;10341;-43,16;22516,84;2017-10-29;29/10/2017;ESRUBI;Gastos_Ocio y transporte;Gasolina;10;VARIABLES
01/11/2017;01/11/2017;T/ AUTOPISTAS TERR 29-10-2017;-2,53;22516,84;22514,31;10342;-2,53;22514,31;2017-10-29;29/10/2017;AUTOPISTAS;Gastos_Ocio y transporte;Parking y peaje;10;VARIABLES
01/11/2017;01/11/2017;T/ AUTOPISTAS TERR 28-10-2017;-2,53;22514,31;22511,78;10343;-2,53;22511,78;2017-10-28;28/10/2017;AUTOPISTAS;Gastos_Ocio y transporte;Parking y peaje;10;VARIABLES
01/11/2017;01/11/2017;T/ A.C.E.S.A GELIDA-B 28-10-2017;-2,40;22511,78;22509,38;10344;-2,40;22509,38;2017-10-28;28/10/2017;ACESA;Gastos_Ocio y transporte;Parking y peaje;10;VARIABLES
01/11/2017;01/11/2017;T/ A.C.E.S.A B MARTORE 27-10-2017;-2,40;22509,38;22506,98;10345;-2,40;22506,98;2017-10-27;27/10/2017;ACESA;Gastos_Ocio y transporte;Parking y peaje;10;VARIABLES
01/11/2017;01/11/2017;T/ AUTOPISTAS TERR 27-10-2017;-1,39;22506,98;22505,59;10346;-1,39;22505,59;2017-10-27;27/10/2017;AUTOPISTAS;Gastos_Ocio y transporte;Parking y peaje;10;VARIABLES
01/11/2017;01/11/2017;T/ AUTOPISTAS TERR 27-10-2017;-1,39;22505,59;22504,20;10347;-1,39;22504,20;2017-10-27;27/10/2017;AUTOPISTAS;Gastos_Ocio y transporte;Parking y peaje;10;VARIABLES
02/11/2017;02/11/2017;R/ Escola d Idi Salt Noviembre 17;-39,00;22504,20;22465,20;10348;-39,00;22465,20;2017-11-02;02/11/2017;ESCOLA;Gastos_Salud, saber y deporte;Estudios;11;VARIABLES
02/11/2017;02/11/2017;T/ FRANKFURT LES LLET\ 30-10-2017;-2,90;22465,20;22462,30;10349;-2,90;22462,30;2017-10-30;30/10/2017;FRANKFURT;Gastos_Ocio y transporte;Restaurantes;10;VARIABLES
02/11/2017;02/11/2017;T/ CAPRABO \ 30-10-2017;-9,75;22462,30;22452,55;10350;-9,75;22452,55;2017-10-30;30/10/2017;CAPRABO;Gastos_Compras;Supermercado;10;VARIABLES
02/11/2017;02/11/2017;T/ ORIENT CARS - RECA\TERRASSA;-219,71;22452,55;22232,84;10351;-219,71;22232,84;2017-11-02;02/11/2017;ORIENT;Gastos_Vivienda y vehiculo;Mnto. vehiculo;11;VARIABLE
03/11/2017;03/11/2017;T/ WWW.JUST-EAT.ES 31-10-2017;-30,28;22232,84;22202,56;10352;-30,28;22202,56;2017-10-31;31/10/2017;WWWJUSTEATES;Gastos_Ocio y transporte;Restaurantes;10;VARIABLES
03/11/2017;03/11/2017;T/ AUTOPISTAS TERR 31-10-2017;-1,39;22202,56;22201,17;10353;-1,39;22201,17;2017-10-31;31/10/2017;AUTOPISTAS;Gastos_Ocio y transporte;Parking y peaje;10;VARIABLES
03/11/2017;03/11/2017;T/ FRANKFURT LES LLET\ 31-10-2017;-2,90;22201,17;22198,27;10354;-2,90;22198,27;2017-10-31;31/10/2017;FRANKFURT;Gastos_Ocio y transporte;Restaurantes;10;VARIABLES
03/11/2017;03/11/2017;T/ AUTOPISTAS TERR 30-10-2017;-1,39;22198,27;22196,88;10355;-1,39;22196,88;2017-10-30;30/10/2017;AUTOPISTAS;Gastos_Ocio y transporte;Parking y peaje;10;VARIABLES
03/11/2017;03/11/2017;T/ AUTOPISTAS TERR 30-10-2017;-1,39;22196,88;22195,49;10356;-1,39;22195,49;2017-10-30;30/10/2017;AUTOPISTAS;Gastos_Ocio y transporte;Parking y peaje;10;VARIABLES
04/11/2017;04/11/2017;T/ ESCLATOIL OLOT \OLOT;-24,80;22195,49;22170,69;10357;-24,80;22170,69;2017-11-04;04/11/2017;ESCLATOIL;Gastos_Ocio y transporte;Gasolina;11;VARIABLES
04/11/2017;04/11/2017;'T/ FOSTER''S HOLLYWOOD\ 01-11-2017';-60,05;22170,69;22110,64;10358;-60,05;22110,64;2017-11-01;01/11/2017;FOSTERS;Gastos_Ocio y transporte;Restaurantes;11;VARIABLES
04/11/2017;04/11/2017;T/ CINESA WEB \B 01-11-2017;-27,60;22110,64;22083,04;10359;-27,60;22083,04;2017-11-01;01/11/2017;CINESA;Gastos_Ocio y transporte;Espectáculos;11;VARIABLES
05/11/2017;05/11/2017;T/ CAFET.C T PRAT\PRAT 02-11-2017;-3,65;22083,04;22079,39;10360;-3,65;22079,39;2017-11-02;02/11/2017;CAFETC;Gastos_Ocio y transporte;Restaurantes;11;VARIABLES
05/11/2017;05/11/2017;T/ AUTOPISTAS TERR 02-11-2017;-1,39;22079,39;22078,00;10361;-1,39;22078,00;2017-11-02;02/11/2017;AUTOPISTAS;Gastos_Ocio y transporte;Parking y peaje;11;VARIABLES
05/11/2017;05/11/2017;T/ AUTOPISTAS TERR 02-11-2017;-1,39;22078,00;22076,61;10362;-1,39;22076,61;2017-11-02;02/11/2017;AUTOPISTAS;Gastos_Ocio y transporte;Parking y peaje;11;VARIABLES
05/11/2017;05/11/2017;T/ TUNELS VALLVI S. 02-11-2017;-3,72;22076,61;22072,89;10363;-3,72;22072,89;2017-11-02;02/11/2017;TUNELS;Gastos_Ocio y transporte;Parking y peaje;11;VARIABLES
05/11/2017;05/11/2017;T/ CAPRABO \ 02-11-2017;-4,77;22072,89;22068,12;10364;-4,77;22068,12;2017-11-02;02/11/2017;CAPRABO;Gastos_Compras;Supermercado;11;VARIABLES
05/11/2017;05/11/2017;T/ TUNELS VALLVI S. 31-10-2017;-4,18;22068,12;22063,94;10365;-4,18;22063,94;2017-10-31;31/10/2017;TUNELS;Gastos_Ocio y transporte;Parking y peaje;10;VARIABLES
06/11/2017;06/11/2017;'R/ COOPERATIVA L''EINA COOPE Rebut:';-57,60;22063,94;22006,34;10366;-57,60;22006,34;2017-11-06;06/11/2017;COOPERATIVA;Gastos_Salud, saber y deporte;Estudios;11;VARIABLES
06/11/2017;06/11/2017;T/ CAFET.C T PRAT\PRAT 03-11-2017;-3,85;22006,34;22002,49;10367;-3,85;22002,49;2017-11-03;03/11/2017;CAFETC;Gastos_Ocio y transporte;Restaurantes;11;VARIABLES
06/11/2017;06/11/2017;T/ FF.CC.GENERALITAT\B 03-11-2017;-12,00;22002,49;21990,49;10368;-12,00;21990,49;2017-11-03;03/11/2017;FFCCGENERALITATB;Gastos_Ocio y transporte;Transporte;11;VARIABLES
07/11/2017;07/11/2017;T/ VIENA PARC VALLES \ 04-11-2017;-16,80;21990,49;21973,69;10369;-16,80;21973,69;2017-11-04;04/11/2017;VIENA;Gastos_Ocio y transporte;Restaurantes;11;VARIABLES
07/11/2017;07/11/2017;T/ HIPERMERCAT ESCLAT 04-11-2017;-46,80;21973,69;21926,89;10370;-46,80;21926,89;2017-11-04;04/11/2017;HIPERMERCAT;Gastos_Compras;Supermercado;11;VARIABLES
07/11/2017;07/11/2017;T/ TESI FRESC S.L. 04-11-2017;-32,79;21926,89;21894,10;10371;-32,79;21894,10;2017-11-04;04/11/2017;TESI;Gastos_Compras;Supermercado;11;VARIABLES
07/11/2017;07/11/2017;T/ DECATHLON SA TERRA\ 04-11-2017;-21,98;21894,10;21872,12;10372;-21,98;21872,12;2017-11-04;04/11/2017;DECATHLON;Gastos_Compras;Deportivo;11;VARIABLES
08/11/2017;08/11/2017;R/  SEGUROS ADESLAS CENT MODULAR CO;-144,67;21872,12;21727,45;10373;-144,67;21727,45;2017-11-08;08/11/2017;ADESLAS;Gastos_Salud, saber y deporte;Medico;11;VARIABLES
08/11/2017;08/11/2017;T/  CAMPING DE LA \VALL 05-11-2017;-96,00;21727,45;21631,45;10374;-96,00;21631,45;2017-11-05;05/11/2017;CAMPING;Gastos_Ocio y transporte;Vacaciones;11;VARIABLES
08/11/2017;08/11/2017;T/  AUTOPISTAS TERR 03-11-2017;-1,39;21631,45;21630,06;10375;-1,39;21630,06;2017-11-03;03/11/2017;AUTOPISTAS;Gastos_Ocio y transporte;Parking y peaje;11;VARIABLES
08/11/2017;08/11/2017;T/  TUNELS VALLVI S. 03-11-2017;-3,72;21630,06;21626,34;10376;-3,72;21626,34;2017-11-03;03/11/2017;TUNELS;Gastos_Ocio y transporte;Parking y peaje;11;VARIABLES
09/11/2017;09/11/2017;R/  . FINQUES GASS Vto 01-11-17 Rec;-73,69;21626,34;21552,65;10377;-73,69;21552,65;2017-11-01;01/11/2017;FINQUES;Gastos_Vivienda y vehiculo;Alquiler Parking;11;FIJO
09/11/2017;09/11/2017;T/  CAPRABO \ 06-11-2017;-11,80;21552,65;21540,85;10378;-11,80;21540,85;2017-11-06;06/11/2017;CAPRABO;Gastos_Compras;Supermercado;11;VARIABLES
10/11/2017;10/11/2017;T/  AUTOPISTAS TERR 07-11-2017;-1,39;21540,85;21539,46;10379;-1,39;21539,46;2017-11-07;07/11/2017;AUTOPISTAS;Gastos_Ocio y transporte;Parking y peaje;11;VARIABLES
10/11/2017;10/11/2017;T/  AUTOPISTAS TERR 07-11-2017;-1,39;21539,46;21538,07;10380;-1,39;21538,07;2017-11-07;07/11/2017;AUTOPISTAS;Gastos_Ocio y transporte;Parking y peaje;11;VARIABLES
10/11/2017;10/11/2017;T/  TUNELS VALLVI S. 07-11-2017;-4,18;21538,07;21533,89;10381;-4,18;21533,89;2017-11-07;07/11/2017;TUNELS;Gastos_Ocio y transporte;Parking y peaje;11;VARIABLES
10/11/2017;10/11/2017;T/  AUTOPISTAS TERR 06-11-2017;-1,39;21533,89;21532,50;10382;-1,39;21532,50;2017-11-06;06/11/2017;AUTOPISTAS;Gastos_Ocio y transporte;Parking y peaje;11;VARIABLES
10/11/2017;10/11/2017;T/  TUNELS VALLVI S. 06-11-2017;-4,18;21532,50;21528,32;10383;-4,18;21528,32;2017-11-06;06/11/2017;TUNELS;Gastos_Ocio y transporte;Parking y peaje;11;VARIABLES
11/11/2017;11/11/2017;T/  PRIMARK SPLAU \HOSPITALET;-56,90;21528,32;21471,42;10384;-56,90;21471,42;2017-11-11;11/11/2017;PRIMARK;Gastos_Compras;Ropa;11;VARIABLES
11/11/2017;11/11/2017;T/  C&A MODAS CORN\CORNELLA LLO;-141,90;21471,42;21329,52;10385;-141,90;21329,52;2017-11-11;11/11/2017;MODAS;Gastos_Compras;Ropa;11;VARIABLES
11/11/2017;11/11/2017;T/  MEDIA MARKT E2\PRAT DE LLOB;-59,21;21329,52;21270,31;10386;-59,21;21270,31;2017-11-11;11/11/2017;MEDIA;Gastos_Compras;Hobbys;11;VARIABLES
11/11/2017;11/11/2017;T/  REST.KAORI \BARBERA DEL V;-55,80;21270,31;21214,51;10387;-55,80;21214,51;2017-11-11;11/11/2017;RESTKAORI;Gastos_Ocio y transporte;Restaurantes;11;VARIABLES
11/11/2017;11/11/2017;T/  KIABI BARICENT\BARBERA DEL;-34,00;21214,51;21180,51;10388;-34,00;21180,51;2017-11-11;11/11/2017;KIABI;Gastos_Compras;Ropa;11;VARIABLES
11/11/2017;09/11/2017;T/  AUTOPISTAS TERR;-1,39;21180,51;21179,12;10389;-1,39;21179,12;2017-11-09;09/11/2017;AUTOPISTAS;Gastos_Ocio y transporte;Parking y peaje;11;VARIABLES
11/11/2017;11/11/2017;T/  MEGA ASIA \TERRASSA;-30,18;21179,12;21148,94;10390;-30,18;21148,94;2017-11-11;11/11/2017;MEGA;Gastos_Compras;Hogar;11;VARIABLES
12/11/2017;09/11/2017;T/  TUNELS VALLVI S. C:2T;-3,72;21148,94;21145,22;10391;-3,72;21145,22;2017-11-09;09/11/2017;TUNELS;Gastos_Ocio y transporte;Parking y peaje;11;VARIABLES
12/11/2017;12/11/2017;T/  CAFET.C T PRAT\PRAT 09-11-2017;-3,25;21145,22;21141,97;10392;-3,25;21141,97;2017-11-09;09/11/2017;CAFETC;Gastos_Ocio y transporte;Restaurantes;11;VARIABLES
12/11/2017;12/11/2017;T/  CAPRABO \ 09-11-2017;-9,06;21141,97;21132,91;10393;-9,06;21132,91;2017-11-09;09/11/2017;CAPRABO;Gastos_Compras;Supermercado;11;VARIABLES
13/11/2017;13/11/2017;R/  GAS GAS NATURAL GNS27630481117;-4,64;21132,91;21128,27;10394;-4,64;21128,27;2017-11-13;13/11/2017;GAS;Gastos_Servicios tipicos;Gas;11;FIJO
13/11/2017;13/11/2017;T/  MERCADONA QUATRE C\ 10-11-2017;-146,77;21128,27;20981,50;10395;-146,77;20981,50;2017-11-10;10/11/2017;MERCADONA;Gastos_Compras;Supermercado;11;VARIABLES
13/11/2017;13/11/2017;T/  BON AREA 10-11-2017;-31,60;20981,50;20949,90;10396;-31,60;20949,90;2017-11-10;10/11/2017;BON;Gastos_Compras;Supermercado;11;VARIABLES
14/11/2017;14/11/2017;R/  ALIMENTACION SERHS FOOD A Comed;-122,57;20949,90;20827,33;10397;-122,57;20827,33;2017-11-14;14/11/2017;ALIMENTACION;Gastos_Salud, saber y deporte;Menjador;11;FIJO
14/11/2017;14/11/2017;R/  ALIMENTACION SERHS FOOD A Comed;-36,75;20827,33;20790,58;10398;-36,75;20790,58;2017-11-14;14/11/2017;ALIMENTACION;Gastos_Salud, saber y deporte;Menjador;11;FIJO
14/11/2017;14/11/2017;R/  TELECOMUNICACI VODAFONE;-149,47;20790,58;20641,11;10399;-149,47;20641,11;2017-11-14;14/11/2017;TELECOMUNICACI;Gastos_Servicios tipicos;Telecomunicaciones;11;FIJO
14/11/2017;14/11/2017;R/  LUZ ENDESA ENERG FACTURA DE ELE;-119,45;20641,11;20521,66;10400;-119,45;20521,66;2017-11-14;14/11/2017;ELE;Gastos_Servicios tipicos;Electricidad;11;FIJO
14/11/2017;11/11/2017;T/  Deichmann Cornella de;-60,70;20521,66;20460,96;10401;-60,70;20460,96;2017-11-11;11/11/2017;DEICHMANN;Gastos_Compras;Ropa;11;VARIABLES
14/11/2017;14/11/2017;T/  VIENA SPLAU \EL PR 11-11-2017;-18,25;20460,96;20442,71;10402;-18,25;20442,71;2017-11-11;11/11/2017;VIENA;Gastos_Ocio y transporte;Restaurantes;11;VARIABLES
15/11/2017;15/11/2017;T/  AUTOPISTAS TERR 12-11-2017;-2,53;20442,71;20440,18;10403;-2,53;20440,18;2017-11-12;12/11/2017;AUTOPISTAS;Gastos_Ocio y transporte;Parking y peaje;11;VARIABLES
15/11/2017;15/11/2017;T/  AUTOPISTAS TERR 12-11-2017;-2,53;20440,18;20437,65;10404;-2,53;20437,65;2017-11-12;12/11/2017;AUTOPISTAS;Gastos_Ocio y transporte;Parking y peaje;11;VARIABLES
15/11/2017;15/11/2017;T/  AUTOPISTAS TERR 11-11-2017;-2,53;20437,65;20435,12;10405;-2,53;20435,12;2017-11-11;11/11/2017;AUTOPISTAS;Gastos_Ocio y transporte;Parking y peaje;11;VARIABLES
15/11/2017;15/11/2017;T/  AUTOPISTAS TERR 10-11-2017;-1,39;20435,12;20433,73;10406;-1,39;20433,73;2017-11-10;10/11/2017;AUTOPISTAS;Gastos_Ocio y transporte;Parking y peaje;11;VARIABLES
15/11/2017;15/11/2017;T/  AUTOPISTAS TERR 10-11-2017;-1,39;20433,73;20432,34;10407;-1,39;20432,34;2017-11-10;10/11/2017;AUTOPISTAS;Gastos_Ocio y transporte;Parking y peaje;11;VARIABLES
16/11/2017;16/11/2017;R/  SEGUROS CCM VIDA Y P Recibo:146;-16,24;20432,34;20416,10;10408;-16,24;20416,10;2017-11-16;16/11/2017;CCM;Gastos_Seguros;Seguro vida;11;FIJO
16/11/2017;16/11/2017;R/  SEGUROS CCM VIDA Y P Recibo:146;-20,47;20416,10;20395,63;10409;-20,47;20395,63;2017-11-16;16/11/2017;CCM;Gastos_Seguros;Seguro vida;11;FIJO
16/11/2017;16/11/2017;T/  TUNELS VALLVI S. 10-11-2017;-3,72;20395,63;20391,91;10410;-3,72;20391,91;2017-11-10;10/11/2017;TUNELS;Gastos_Ocio y transporte;Parking y peaje;11;VARIABLES
17/11/2017;17/11/2017;CAJ. AJENO  SERVIRED \MADRID;-150,00;20391,91;20241,91;10411;-150,00;20241,91;2017-11-17;17/11/2017;CAJ;Gastos_Gastos varios;Efectivo;11;VARIABLES
17/11/2017;17/11/2017;COM.  64970036 SVRED CAJ OFI;-1,87;20241,91;20240,04;10412;-1,87;20240,04;2017-11-17;17/11/2017;COM;Gastos_Banco y organismos;Cargos banco;11;FIJO
17/11/2017;17/11/2017;T/  CAFET.C T PRAT\PRAT 14-11-2017;-3,65;20240,04;20236,39;10413;-3,65;20236,39;2017-11-14;14/11/2017;CAFETC;Gastos_Ocio y transporte;Restaurantes;11;VARIABLES
18/11/2017;18/11/2017;T/  AUTOPISTAS TERR 15-11-2017;-1,39;20236,39;20235,00;10414;-1,39;20235,00;2017-11-15;15/11/2017;AUTOPISTAS;Gastos_Ocio y transporte;Parking y peaje;11;VARIABLES
18/11/2017;18/11/2017;T/  AUTOPISTAS TERR 15-11-2017;-1,39;20235,00;20233,61;10415;-1,39;20233,61;2017-11-15;15/11/2017;AUTOPISTAS;Gastos_Ocio y transporte;Parking y peaje;11;VARIABLES
18/11/2017;18/11/2017;T/  TUNELS VALLVI S. 15-11-2017;-4,18;20233,61;20229,43;10416;-4,18;20229,43;2017-11-15;15/11/2017;TUNELS;Gastos_Ocio y transporte;Parking y peaje;11;VARIABLES
18/11/2017;18/11/2017;T/  ES LA RIERA \EL PR 15-11-2017;-30,00;20229,43;20199,43;10417;-30,00;20199,43;2017-11-15;15/11/2017;RIERA;Gastos_Ocio y transporte;Gasolina;11;VARIABLES
18/11/2017;18/11/2017;T/  FRANKFURT LES LLET\ 15-11-2017;-2,90;20199,43;20196,53;10418;-2,90;20196,53;2017-11-15;15/11/2017;FRANKFURT;Gastos_Ocio y transporte;Restaurantes;11;VARIABLES
18/11/2017;18/11/2017;T/  AUTOPISTAS TERR 14-11-2017;-1,39;20196,53;20195,14;10419;-1,39;20195,14;2017-11-14;14/11/2017;AUTOPISTAS;Gastos_Ocio y transporte;Parking y peaje;11;VARIABLES
18/11/2017;18/11/2017;T/  AUTOPISTAS TERR 14-11-2017;-1,39;20195,14;20193,75;10420;-1,39;20193,75;2017-11-14;14/11/2017;AUTOPISTAS;Gastos_Ocio y transporte;Parking y peaje;11;VARIABLES
18/11/2017;18/11/2017;T/  AUTOPISTAS TERR 13-11-2017;-1,39;20193,75;20192,36;10421;-1,39;20192,36;2017-11-13;13/11/2017;AUTOPISTAS;Gastos_Ocio y transporte;Parking y peaje;11;VARIABLES
18/11/2017;18/11/2017;T/  AUTOPISTAS TERR 13-11-2017;-1,39;20192,36;20190,97;10422;-1,39;20190,97;2017-11-13;13/11/2017;AUTOPISTAS;Gastos_Ocio y transporte;Parking y peaje;11;VARIABLES
19/11/2017;19/11/2017;T/  AUTOPISTAS TERR 16-11-2017;-1,39;20190,97;20189,58;10423;-1,39;20189,58;2017-11-16;16/11/2017;AUTOPISTAS;Gastos_Ocio y transporte;Parking y peaje;11;VARIABLES
19/11/2017;19/11/2017;T/  AUTOPISTAS TERR 16-11-2017;-1,39;20189,58;20188,19;10424;-1,39;20188,19;2017-11-16;16/11/2017;AUTOPISTAS;Gastos_Ocio y transporte;Parking y peaje;11;VARIABLES
19/11/2017;19/11/2017;T/  SUPER.REYPA SL \ 16-11-2017;-12,69;20188,19;20175,50;10425;-12,69;20175,50;2017-11-16;16/11/2017;SUPERREYPA;Gastos_Compras;Supermercado;11;VARIABLES
19/11/2017;19/11/2017;T/  FRANKFURT LES LLET\ 16-11-2017;-2,90;20175,50;20172,60;10426;-2,90;20172,60;2017-11-16;16/11/2017;FRANKFURT;Gastos_Ocio y transporte;Restaurantes;11;VARIABLES
20/11/2017;20/11/2017;T/  WWW.JUST-EAT.ES 17-11-2017;-35,45;20172,60;20137,15;10427;-35,45;20137,15;2017-11-17;17/11/2017;WWWJUSTEATES;Gastos_Ocio y transporte;Restaurantes;11;VARIABLES
20/11/2017;20/11/2017;T/  SANTS APARCAMENTS\B 17-11-2017;-9,20;20137,15;20127,95;10428;-9,20;20127,95;2017-11-17;17/11/2017;SANTS;Gastos_Ocio y transporte;Parking y peaje;11;VARIABLES
20/11/2017;20/11/2017;T/  CAFET.C T PRAT\PRAT 17-11-2017;-3,85;20127,95;20124,10;10429;-3,85;20124,10;2017-11-17;17/11/2017;CAFETC;Gastos_Ocio y transporte;Restaurantes;11;VARIABLES
22/11/2017;22/11/2017;T/  WWW.JUST-EAT.ES 19-11-2017;-41,79;20124,10;20082,31;10430;-41,79;20082,31;2017-11-19;19/11/2017;WWWJUSTEATES;Gastos_Ocio y transporte;Restaurantes;11;VARIABLES
22/11/2017;22/11/2017;T/  TUNELS VALLVI N. 17-11-2017;-4,18;20082,31;20078,13;10431;-4,18;20078,13;2017-11-17;17/11/2017;TUNELS;Gastos_Ocio y transporte;Parking y peaje;11;VARIABLES
22/11/2017;22/11/2017;T/  AUTOPISTAS TERR 17-11-2017;-1,39;20078,13;20076,74;10432;-1,39;20076,74;2017-11-17;17/11/2017;AUTOPISTAS;Gastos_Ocio y transporte;Parking y peaje;11;VARIABLES
22/11/2017;22/11/2017;T/  AUTOPISTAS TERR 17-11-2017;-1,39;20076,74;20075,35;10433;-1,39;20075,35;2017-11-17;17/11/2017;AUTOPISTAS;Gastos_Ocio y transporte;Parking y peaje;11;VARIABLES
23/11/2017;23/11/2017;T/  FRANKFURT LES LLET\ 20-11-2017;-9,15;20075,35;20066,20;10434;-9,15;20066,20;2017-11-20;20/11/2017;FRANKFURT;Gastos_Ocio y transporte;Restaurantes;11;VARIABLES
23/11/2017;23/11/2017;T/  FRANKFURT LES LLET\ 20-11-2017;-2,90;20066,20;20063,30;10435;-2,90;20063,30;2017-11-20;20/11/2017;FRANKFURT;Gastos_Ocio y transporte;Restaurantes;11;VARIABLES
24/11/2017;24/11/2017;T/  AUTOPISTAS TERR 21-11-2017;-1,39;20063,30;20061,91;10436;-1,39;20061,91;2017-11-21;21/11/2017;AUTOPISTAS;Gastos_Ocio y transporte;Parking y peaje;11;VARIABLES
24/11/2017;24/11/2017;T/  AUTOPISTAS TERR 21-11-2017;-1,39;20061,91;20060,52;10437;-1,39;20060,52;2017-11-21;21/11/2017;AUTOPISTAS;Gastos_Ocio y transporte;Parking y peaje;11;VARIABLES
24/11/2017;24/11/2017;T/  MERCADONA QUATRE C\ 21-11-2017;-30,68;20060,52;20029,84;10438;-30,68;20029,84;2017-11-21;21/11/2017;MERCADONA;Gastos_Compras;Supermercado;11;VARIABLES
24/11/2017;24/11/2017;T/  AUTOPISTAS TERR 20-11-2017;-1,39;20029,84;20028,45;10439;-1,39;20028,45;2017-11-20;20/11/2017;AUTOPISTAS;Gastos_Ocio y transporte;Parking y peaje;11;VARIABLES
25/11/2017;25/11/2017;CAJ. AJENO  BANCO SABADELL \TERRASSA;-100,00;20028,45;19928,45;10440;-100,00;19928,45;2017-11-25;25/11/2017;CAJ;Gastos_Gastos varios;Efectivo;11;VARIABLES
25/11/2017;25/11/2017;T/  FRANKFURT LES LLET\ 22-11-2017;-2,90;19928,45;19925,55;10441;-2,90;19925,55;2017-11-22;22/11/2017;FRANKFURT;Gastos_Ocio y transporte;Restaurantes;11;VARIABLES
25/11/2017;25/11/2017;T/  TUNELS VALLVI S. 22-11-2017;-4,18;19925,55;19921,37;10442;-4,18;19921,37;2017-11-22;22/11/2017;TUNELS;Gastos_Ocio y transporte;Parking y peaje;11;VARIABLES
25/11/2017;25/11/2017;T/  FRANKFURT LES LLET\ 22-11-2017;-4,85;19921,37;19916,52;10443;-4,85;19916,52;2017-11-22;22/11/2017;FRANKFURT;Gastos_Ocio y transporte;Restaurantes;11;VARIABLES
25/11/2017;25/11/2017;T/  BAR DEL COMPLE\EL P 22-11-2017;-9,00;19916,52;19907,52;10444;-9,00;19907,52;2017-11-22;22/11/2017;BAR;Gastos_Ocio y transporte;Restaurantes;11;VARIABLES
25/11/2017;25/11/2017;T/  CINESA PARC VALLES\TERRASSA;-21,90;19907,52;19885,62;10445;-21,90;19885,62;2017-11-25;25/11/2017;CINESA;Gastos_Ocio y transporte;Espectáculos;11;VARIABLES
26/11/2017;26/11/2017;T/  CON A DE ARTE \RIPOLLET;-57,02;19885,62;19828,60;10446;-57,02;19828,60;2017-11-26;26/11/2017;CON;Gastos_Compras;Hobbys;11;VARIABLES
26/11/2017;26/11/2017;T/  CAPRABO \ 23-11-2017;-12,27;19828,60;19816,33;10447;-12,27;19816,33;2017-11-23;23/11/2017;CAPRABO;Gastos_Compras;Supermercado;11;VARIABLES
26/11/2017;26/11/2017;T/  ORIENT CARS - RECA\ 23-11-2017;-55,97;19816,33;19760,36;10448;-55,97;19760,36;2017-11-23;23/11/2017;ORIENT;Gastos_Vivienda y vehiculo;Mnto. vehiculo;11;VARIABLE
26/11/2017;26/11/2017;T/  TUNELS VALLVI S. 23-11-2017;-4,18;19760,36;19756,18;10449;-4,18;19756,18;2017-11-23;23/11/2017;TUNELS;Gastos_Ocio y transporte;Parking y peaje;11;VARIABLES
26/11/2017;26/11/2017;T/  AUTOPISTAS TERR 23-11-2017;-1,39;19756,18;19754,79;10450;-1,39;19754,79;2017-11-23;23/11/2017;AUTOPISTAS;Gastos_Ocio y transporte;Parking y peaje;11;VARIABLES
26/11/2017;26/11/2017;T/  FRANKFURT LES LLET\ 23-11-2017;-2,90;19754,79;19751,89;10451;-2,90;19751,89;2017-11-23;23/11/2017;FRANKFURT;Gastos_Ocio y transporte;Restaurantes;11;VARIABLES
26/11/2017;26/11/2017;T/  CAFET.C T PRAT\PRAT 23-11-2017;-3,65;19751,89;19748,24;10452;-3,65;19748,24;2017-11-23;23/11/2017;CAFETC;Gastos_Ocio y transporte;Restaurantes;11;VARIABLES
26/11/2017;26/11/2017;T/  AUTOPISTAS TERR 22-11-2017;-1,39;19748,24;19746,85;10453;-1,39;19746,85;2017-11-22;22/11/2017;AUTOPISTAS;Gastos_Ocio y transporte;Parking y peaje;11;VARIABLES
26/11/2017;26/11/2017;T/  AUTOPISTAS TERR 22-11-2017;-1,39;19746,85;19745,46;10454;-1,39;19745,46;2017-11-22;22/11/2017;AUTOPISTAS;Gastos_Ocio y transporte;Parking y peaje;11;VARIABLES
27/11/2017;27/11/2017;T/  REDPIZZA \ 24-11-2017;-23,35;19745,46;19722,11;10455;-23,35;19722,11;2017-11-24;24/11/2017;REDPIZZA;Gastos_Ocio y transporte;Restaurantes;11;VARIABLES
27/11/2017;27/11/2017;T/  FRANKFURT LES LLET\ 24-11-2017;-2,90;19722,11;19719,21;10456;-2,90;19719,21;2017-11-24;24/11/2017;FRANKFURT;Gastos_Ocio y transporte;Restaurantes;11;VARIABLES
27/11/2017;27/11/2017;T/  E.S. RUBI II 24-11-2017;-49,29;19719,21;19669,92;10457;-49,29;19669,92;2017-11-24;24/11/2017;RUBI;Gastos_Ocio y transporte;Gasolina;11;VARIABLES
28/11/2017;28/11/2017;HAB.  INFORMACIO I TECNOLOGIA DE CAT;1550,34;19669,92;21220,26;10458;1550,34;21220,26;2017-11-28;28/11/2017;HAB;Ingresos;Nomina;11;FIJO
28/11/2017;28/11/2017;HAB.  FOMENT DE TERRASSA S.A. Transf;1800,63;21220,26;23020,89;10459;1800,63;23020,89;2017-11-28;28/11/2017;HAB;Ingresos;Nomina;11;FIJO
28/11/2017;28/11/2017;T/ IUNIVERS \ 25-11-2017;-18,10;23020,89;23002,79;10460;-18,10;23002,79;2017-11-25;25/11/2017;IUNIVERS;Gastos_Ocio y transporte;Restaurantes;11;VARIABLES
28/11/2017;28/11/2017;T/ FARMACIA RAGULL \ 25-11-2017;-9,71;23002,79;22993,08;10461;-9,71;22993,08;2017-11-25;25/11/2017;FARMACIA;Gastos_Salud, saber y deporte;Farmacia;11;VARIABLES
28/11/2017;28/11/2017;T/ PASTIS.NOU AMBIENT\ 25-11-2017;-8,50;22993,08;22984,58;10462;-8,50;22984,58;2017-11-25;25/11/2017;PASTISNOU;Gastos_Ocio y transporte;Restaurantes;11;VARIABLES
28/11/2017;28/11/2017;T/ CINESA WEB \B 25-11-2017;-28,40;22984,58;22956,18;10463;-28,40;22956,18;2017-11-25;25/11/2017;CINESA;Gastos_Ocio y transporte;Espectáculos;11;VARIABLES
29/11/2017;26/11/2017;T/ PERLES AND CO;-98,70;22956,18;22857,48;10464;-98,70;22857,48;2017-11-26;26/11/2017;PERLES;Gastos_Compras;Hobbys;11;VARIABLES
29/11/2017;29/11/2017;T/ AUTOPISTAS TERR 24-11-2017;-1,39;22857,48;22856,09;10465;-1,39;22856,09;2017-11-24;24/11/2017;AUTOPISTAS;Gastos_Ocio y transporte;Parking y peaje;11;VARIABLES
30/11/2017;30/11/2017;R/ AYUNTAMIENTO AJUNTAMENT D I.B.I;-45,66;22856,09;22810,43;10466;-45,66;22810,43;2017-11-30;30/11/2017;AYUNTAMIENTO;Gastos_Banco y organismos;Ayuntamiento;11;FIJO
30/11/2017;30/11/2017;REC. 6061.9600001223;-485,11;22810,43;22325,32;10467;-485,11;22325,32;2017-11-30;30/11/2017;REC;Gastos_Banco y organismos;Hipoteca;11;FIJO
30/11/2017;30/11/2017;T/ CAFET.C T PRAT\PRAT 27-11-2017;-7,90;22325,32;22317,42;10468;-7,90;22317,42;2017-11-27;27/11/2017;CAFETC;Gastos_Ocio y transporte;Restaurantes;11;VARIABLES
30/11/2017;30/11/2017;T/ TUNELS VALLVI S. 27-11-2017;-4,18;22317,42;22313,24;10469;-4,18;22313,24;2017-11-27;27/11/2017;TUNELS;Gastos_Ocio y transporte;Parking y peaje;11;VARIABLES
30/11/2017;30/11/2017;T/ SUPER.BON PREU S16\ 27-11-2017;-11,40;22313,24;22301,84;10470;-11,40;22301,84;2017-11-27;27/11/2017;SUPERBON;Gastos_Compras;Supermercado;11;VARIABLES
01/12/2017;01/12/2017;FACT TARJETAS;126,65;22301,84;22428,49;10471;126,65;22428,49;2017-12-01;30/11/2017;FACT;No computable;Recibo Tarjeta;11;
01/12/2017;01/12/2017;FACT TARJETAS TARJ.CREDITO 07126017 17-12-01;-189,79;22428,49;22238,70;10472;-189,79;22238,70;2017-12-01;30/11/2017;FACT 07126017;Gastos_Banco y organismos;Credito Bea;11;VARIABLE
01/12/2017;01/12/2017;R/ Escola d Idi SALT IDIOMES. Ade;-39,00;22238,70;22199,70;10473;-39,00;22199,70;2017-12-01;01/12/2017;ESCOLA;Gastos_Salud, saber y deporte;Estudios;12;VARIABLES
01/12/2017;01/12/2017;T/ AUTOPISTAS TERR 28-11-2017;-1,39;22199,70;22198,31;10474;-1,39;22198,31;2017-11-28;28/11/2017;AUTOPISTAS;Gastos_Ocio y transporte;Parking y peaje;11;VARIABLES
01/12/2017;01/12/2017;T/ TUNELS VALLVI S. 28-11-2017;-4,18;22198,31;22194,13;10475;-4,18;22194,13;2017-11-28;28/11/2017;TUNELS;Gastos_Ocio y transporte;Parking y peaje;11;VARIABLES
01/12/2017;01/12/2017;T/ MEGA ASIA \ 28-11-2017;-9,22;22194,13;22184,91;10476;-9,22;22184,91;2017-11-28;28/11/2017;MEGA;Gastos_Compras;Hogar;11;VARIABLES
01/12/2017;01/12/2017;T/ BON AREA 28-11-2017;-29,12;22184,91;22155,79;10477;-29,12;22155,79;2017-11-28;28/11/2017;BON;Gastos_Compras;Supermercado;11;VARIABLES
01/12/2017;01/12/2017;T/ AUTOPISTAS TERR 27-11-2017;-1,39;22155,79;22154,40;10478;-1,39;22154,40;2017-11-27;27/11/2017;AUTOPISTAS;Gastos_Ocio y transporte;Parking y peaje;11;VARIABLES
01/12/2017;01/12/2017;T/ AUTOPISTAS TERR 27-11-2017;-1,39;22154,40;22153,01;10479;-1,39;22153,01;2017-11-27;27/11/2017;AUTOPISTAS;Gastos_Ocio y transporte;Parking y peaje;11;VARIABLES
01/12/2017;01/12/2017;S/OR. JUANDIK;-42,50;22153,01;22110,51;10480;-42,50;22110,51;2017-12-01;01/12/2017;JUANDIK;Gastos_Ocio y transporte;Loterias;12;
02/12/2017;02/12/2017;T/ DRIM PARC VALLES 29-11-2017;-12,03;22110,51;22098,48;10481;-12,03;22098,48;2017-11-29;29/11/2017;DRIM;Gastos_Compras;Niños;11;VARIABLES
02/12/2017;02/12/2017;T/ AUTOPISTAS TERR 29-11-2017;-1,39;22098,48;22097,09;10482;-1,39;22097,09;2017-11-29;29/11/2017;AUTOPISTAS;Gastos_Ocio y transporte;Parking y peaje;11;VARIABLES
02/12/2017;02/12/2017;T/ Ribs Parc Valles \ 29-11-2017;-23,80;22097,09;22073,29;10483;-23,80;22073,29;2017-11-29;29/11/2017;RIBS;Gastos_Ocio y transporte;Restaurantes;11;VARIABLES
03/12/2017;03/12/2017;CAJ. AJENO SERVIRED \TERRASSA;-300,00;22073,29;21773,29;10484;-300,00;21773,29;2017-12-03;03/12/2017;CAJ;Gastos_Gastos varios;Efectivo;12;VARIABLES
03/12/2017;03/12/2017;COM. 64970036 SVRED CAJ OFI;-1,87;21773,29;21771,42;10485;-1,87;21771,42;2017-12-03;03/12/2017;COM;Gastos_Banco y organismos;Cargos banco;12;FIJO
03/12/2017;03/12/2017;T/ AUTOPISTAS TERR 30-11-2017;-1,39;21771,42;21770,03;10486;-1,39;21770,03;2017-11-30;30/11/2017;AUTOPISTAS;Gastos_Ocio y transporte;Parking y peaje;11;VARIABLES
03/12/2017;03/12/2017;T/ AUTOPISTAS TERR 30-11-2017;-1,39;21770,03;21768,64;10487;-1,39;21768,64;2017-11-30;30/11/2017;AUTOPISTAS;Gastos_Ocio y transporte;Parking y peaje;11;VARIABLES
03/12/2017;03/12/2017;T/ TUNELS VALLVI S. 30-11-2017;-3,72;21768,64;21764,92;10488;-3,72;21764,92;2017-11-30;30/11/2017;TUNELS;Gastos_Ocio y transporte;Parking y peaje;11;VARIABLES
03/12/2017;03/12/2017;T/ TUNELS VALLVI S. 29-11-2017;-3,72;21764,92;21761,20;10489;-3,72;21761,20;2017-11-29;29/11/2017;TUNELS;Gastos_Ocio y transporte;Parking y peaje;11;VARIABLES
04/12/2017;04/12/2017;R/ SEGUROS CAJA DE SEGU POL.953975;-420,70;21761,20;21340,50;10490;-420,70;21340,50;2017-12-04;04/12/2017;CAJA;Gastos_Seguros;Seguro hogar;12;FIJO
04/12/2017;04/12/2017;T/ CAFET.C T PRAT\PRAT 01-12-2017;-3,70;21340,50;21336,80;10491;-3,70;21336,80;2017-12-01;01/12/2017;CAFETC;Gastos_Ocio y transporte;Restaurantes;12;VARIABLES
05/12/2017;01/12/2017;T/ PAYPAL *PANDAHALL;-29,89;21336,80;21306,91;10492;-29,89;21306,91;2017-12-01;01/12/2017;PAYPAL;Gastos_Compras;Hobbys;12;VARIABLES
05/12/2017;05/12/2017;T/ 365 CAFE TERRASSA \ 02-12-2017;-6,15;21306,91;21300,76;10493;-6,15;21300,76;2017-12-02;02/12/2017;CAFE;Gastos_Ocio y transporte;Restaurantes;12;VARIABLES
05/12/2017;05/12/2017;T/ AP. DR. ROBERT - TE 02-12-2017;-11,20;21300,76;21289,56;10494;-11,20;21289,56;2017-12-02;02/12/2017;ROBERT;Gastos_Ocio y transporte;Parking y peaje;12;VARIABLES
05/12/2017;05/12/2017;T/ KIRU \ 02-12-2017;-63,00;21289,56;21226,56;10495;-63,00;21226,56;2017-12-02;02/12/2017;KIRU;Gastos_Ocio y transporte;Restaurantes;12;VARIABLES
05/12/2017;05/12/2017;T/ MOTIVA PRACTIK HOU\ 02-12-2017;-5,98;21226,56;21220,58;10496;-5,98;21220,58;2017-12-02;02/12/2017;MOTIVA;Gastos_Compras;Hobbys;12;VARIABLES
05/12/2017;05/12/2017;T/ AUTOPISTAS TERR 01-12-2017;-1,39;21220,58;21219,19;10497;-1,39;21219,19;2017-12-01;01/12/2017;AUTOPISTAS;Gastos_Ocio y transporte;Parking y peaje;12;VARIABLES
06/12/2017;06/12/2017;R/ LUZ ENDESA ENERG FACTURA DE GAS;-86,54;21219,19;21132,65;10498;-86,54;21132,65;2017-12-06;06/12/2017;GAS;Gastos_Servicios tipicos;Gas;12;FIJO
06/12/2017;06/12/2017;T/ TUNELS VALLVI S. 01-12-2017;-3,72;21132,65;21128,93;10499;-3,72;21128,93;2017-12-01;01/12/2017;TUNELS;Gastos_Ocio y transporte;Parking y peaje;12;VARIABLES
07/12/2017;07/12/2017;R/ . FINQUES GASS Vto 01-12-17 Rec;-73,69;21128,93;21055,24;10500;-73,69;21055,24;2017-12-01;01/12/2017;FINQUES;Gastos_Vivienda y vehiculo;Alquiler Parking;12;FIJO
07/12/2017;07/12/2017;'R/ COOPERATIVA L''EINA COOPE Rebut:';-47,60;21055,24;21007,64;10501;-47,60;21007,64;2017-12-07;07/12/2017;COOPERATIVA;Gastos_Salud, saber y deporte;Estudios;12;VARIABLES
07/12/2017;07/12/2017;T/ CAFET.C T PRAT\PRAT 04-12-2017;-8,20;21007,64;20999,44;10502;-8,20;20999,44;2017-12-04;04/12/2017;CAFETC;Gastos_Ocio y transporte;Restaurantes;12;VARIABLES
07/12/2017;07/12/2017;T/ CAFET.C T PRAT\PRAT 04-12-2017;-3,25;20999,44;20996,19;10503;-3,25;20996,19;2017-12-04;04/12/2017;CAFETC;Gastos_Ocio y transporte;Restaurantes;12;VARIABLES
07/12/2017;07/12/2017;T/ TUNELS VALLVI S. 04-12-2017;-4,18;20996,19;20992,01;10504;-4,18;20992,01;2017-12-04;04/12/2017;TUNELS;Gastos_Ocio y transporte;Parking y peaje;12;VARIABLES
08/12/2017;08/12/2017;T/ CEDIPSA 15838-1 EG\ 05-12-2017;-35,00;20992,01;20957,01;10505;-35,00;20957,01;2017-12-05;05/12/2017;CEDIPSA;Gastos_Ocio y transporte;Gasolina;12;VARIABLES
08/12/2017;08/12/2017;T/ AUTOPISTAS TERR 05-12-2017;-1,39;20957,01;20955,62;10506;-1,39;20955,62;2017-12-05;05/12/2017;AUTOPISTAS;Gastos_Ocio y transporte;Parking y peaje;12;VARIABLES
08/12/2017;08/12/2017;T/ AUTOPISTAS TERR 04-12-2017;-1,39;20955,62;20954,23;10507;-1,39;20954,23;2017-12-04;04/12/2017;AUTOPISTAS;Gastos_Ocio y transporte;Parking y peaje;12;VARIABLES
09/12/2017;09/12/2017;T/ BOSC DE RIBERA 06-12-2017;-34,40;20954,23;20919,83;10508;-34,40;20919,83;2017-12-06;06/12/2017;BOSC;Gastos_Ocio y transporte;Restaurantes;12;VARIABLES
09/12/2017;09/12/2017;T/ AUTOPISTA MARE NOST 06-12-2017;-7,05;20919,83;20912,78;10509;-7,05;20912,78;2017-12-06;06/12/2017;AUTOPISTA;Gastos_Ocio y transporte;Parking y peaje;12;VARIABLES
09/12/2017;09/12/2017;T/ A.C.E.S.A B MART -L 06-12-2017;-10,50;20912,78;20902,28;10510;-10,50;20902,28;2017-12-06;06/12/2017;ACESA;Gastos_Ocio y transporte;Parking y peaje;12;VARIABLES
09/12/2017;09/12/2017;T/ AUTOPISTAS TERR 06-12-2017;-2,53;20902,28;20899,75;10511;-2,53;20899,75;2017-12-06;06/12/2017;AUTOPISTAS;Gastos_Ocio y transporte;Parking y peaje;12;VARIABLES
11/12/2017;11/12/2017;R/ SEGUROS ADESLAS CENT MODULAR CO;-144,67;20899,75;20755,08;10512;-144,67;20755,08;2017-12-11;11/12/2017;ADESLAS;Gastos_Salud, saber y deporte;Medico;12;VARIABLES
12/12/2017;12/12/2017;R/ TELECOMUNICACI VODAFONE;-144,42;20755,08;20610,66;10513;-144,42;20610,66;2017-12-12;12/12/2017;TELECOMUNICACI;Gastos_Servicios tipicos;Telecomunicaciones;12;FIJO
12/12/2017;12/12/2017;T/ VIENA TORTOSA 09-12-2017;-7,60;20610,66;20603,06;10514;-7,60;20603,06;2017-12-09;09/12/2017;VIENA;Gastos_Ocio y transporte;Restaurantes;12;VARIABLES
12/12/2017;12/12/2017;T/ FORN DE PA CAL PORT 09-12-2017;-17,70;20603,06;20585,36;10515;-17,70;20585,36;2017-12-09;09/12/2017;FORN;Gastos_Compras;Supermercado;12;VARIABLES
13/12/2017;13/12/2017;T/ BOLIN SHIJIA, SCP \ 10-12-2017;-48,70;20585,36;20536,66;10516;-48,70;20536,66;2017-12-10;10/12/2017;BOLIN;Gastos_Ocio y transporte;Restaurantes;12;VARIABLES
13/12/2017;13/12/2017;T/ AUTOPISTAS TERR 10-12-2017;-2,53;20536,66;20534,13;10517;-2,53;20534,13;2017-12-10;10/12/2017;AUTOPISTAS;Gastos_Ocio y transporte;Parking y peaje;12;VARIABLES
13/12/2017;13/12/2017;T/ AUTOPISTA MARE NOST 10-12-2017;-7,05;20534,13;20527,08;10518;-7,05;20527,08;2017-12-10;10/12/2017;AUTOPISTA;Gastos_Ocio y transporte;Parking y peaje;12;VARIABLES
13/12/2017;13/12/2017;T/ A.C.E.S.A LIM SCAP7 10-12-2017;-10,50;20527,08;20516,58;10519;-10,50;20516,58;2017-12-10;10/12/2017;ACESA;Gastos_Ocio y transporte;Parking y peaje;12;VARIABLES
13/12/2017;13/12/2017;T/ TEMPLE 10-12-2017;-35,95;20516,58;20480,63;10520;-35,95;20480,63;2017-12-10;10/12/2017;TEMPLE;Gastos_Ocio y transporte;Gasolina;12;VARIABLES
14/12/2017;14/12/2017;R/ GAS GAS NATURAL GNS27630481217;-4,64;20480,63;20475,99;10521;-4,64;20475,99;2017-12-14;14/12/2017;GAS;Gastos_Servicios tipicos;Gas;12;FIJO
14/12/2017;14/12/2017;T/ LIDL TERRASSA \ 11-12-2017;-29,23;20475,99;20446,76;10522;-29,23;20446,76;2017-12-11;11/12/2017;LIDL;Gastos_Compras;Supermercado;12;VARIABLES
14/12/2017;14/12/2017;T/ DRIM PARC VALLES \RUBI;-188,98;20446,76;20257,78;10523;-188,98;20257,78;2017-12-14;14/12/2017;DRIM;Gastos_Compras;Niños;12;VARIABLES
15/12/2017;15/12/2017;R/ ALIMENTACION SERHS FOOD A;-18,62;20257,78;20239,16;10524;-18,62;20239,16;2017-12-15;15/12/2017;ALIMENTACION;Gastos_Salud, saber y deporte;Menjador;12;FIJO
15/12/2017;15/12/2017;R/ ALIMENTACION SERHS FOOD A;-71,40;20239,16;20167,76;10525;-71,40;20167,76;2017-12-15;15/12/2017;ALIMENTACION;Gastos_Salud, saber y deporte;Menjador;12;FIJO
15/12/2017;15/12/2017;T/ SUPERMERCAT DIA \ 12-12-2017;-8,67;20167,76;20159,09;10526;-8,67;20159,09;2017-12-12;12/12/2017;SUPERMERCAT;Gastos_Compras;Supermercado;12;VARIABLES
17/12/2017;17/12/2017;T/ AUTOPISTAS TERR 14-12-2017;-1,39;20159,09;20157,70;10527;-1,39;20157,70;2017-12-14;14/12/2017;AUTOPISTAS;Gastos_Ocio y transporte;Parking y peaje;12;VARIABLES
17/12/2017;17/12/2017;T/ AUTOPISTAS TERR 14-12-2017;-1,39;20157,70;20156,31;10528;-1,39;20156,31;2017-12-14;14/12/2017;AUTOPISTAS;Gastos_Ocio y transporte;Parking y peaje;12;VARIABLES
17/12/2017;17/12/2017;T/ JUGUETILANDIA TERR\ 14-12-2017;-93,50;20156,31;20062,81;10529;-93,50;20062,81;2017-12-14;14/12/2017;JUGUETILANDIA;Gastos_Compras;Niños;12;VARIABLES
17/12/2017;17/12/2017;T/ TUNELS VALLVI S. 14-12-2017;-3,72;20062,81;20059,09;10530;-3,72;20059,09;2017-12-14;14/12/2017;TUNELS;Gastos_Ocio y transporte;Parking y peaje;12;VARIABLES
17/12/2017;17/12/2017;T/ kfc parc valles 14-12-2017;-16,00;20059,09;20043,09;10531;-16,00;20043,09;2017-12-14;14/12/2017;KFC;Gastos_Ocio y transporte;Restaurantes;12;VARIABLES
17/12/2017;17/12/2017;T/ CAFET.C T PRAT\PRAT 14-12-2017;-2,20;20043,09;20040,89;10532;-2,20;20040,89;2017-12-14;14/12/2017;CAFETC;Gastos_Ocio y transporte;Restaurantes;12;VARIABLES
18/12/2017;18/12/2017;R/ SEGUROS CCM VIDA Y P Recibo:147;-17,28;20040,89;20023,61;10533;-17,28;20023,61;2017-12-18;18/12/2017;CCM;Gastos_Seguros;Seguro vida;12;FIJO
18/12/2017;18/12/2017;R/ SEGUROS CCM VIDA Y P Recibo:147;-20,39;20023,61;20003,22;10534;-20,39;20003,22;2017-12-18;18/12/2017;CCM;Gastos_Seguros;Seguro vida;12;FIJO
19/12/2017;19/12/2017;T/ BON AREA 16-12-2017;-31,93;20003,22;19971,29;10535;-31,93;19971,29;2017-12-16;16/12/2017;BON;Gastos_Compras;Supermercado;12;VARIABLES
19/12/2017;19/12/2017;S/OR. ESCOLA SALA I BADRINAS;-286,00;19971,29;19685,29;10536;-286,00;19685,29;2017-12-19;19/12/2017;ESCOLA;Gastos_Salud, saber y deporte;Estudios;12;VARIABLES
19/12/2017;19/12/2017;S/OR. ESCOLA SALA I BADRINAS;-329,00;19685,29;19356,29;10537;-329,00;19356,29;2017-12-19;19/12/2017;ESCOLA;Gastos_Salud, saber y deporte;Estudios;12;VARIABLES
19/12/2017;19/12/2017;COM. TRANSFERENCIAS;-2,00;19356,29;19354,29;10538;-2,00;19354,29;2017-12-19;19/12/2017;COM;Gastos_Banco y organismos;Cargos banco;12;FIJO
19/12/2017;19/12/2017;ENTR.ANT.PTMO 6061.9600001223 U;-6000,00;19354,29;13354,29;10539;-6000,00;13354,29;2017-12-19;19/12/2017;ENTRANTPTMO;Gastos_Banco y organismos;Hipoteca;12;FIJO
20/12/2017;20/12/2017;R/ MINA PUBLICA AIGUES T.01A75789;-47,77;13354,29;13306,52;10540;-47,77;13306,52;2017-12-20;20/12/2017;MINA;Gastos_Servicios tipicos;Agua;12;FIJO
20/12/2017;20/12/2017;HAB.  INFORMACIO I TECNOLOGIA DE CAT;1846,62;13306,52;15153,14;10541;1846,62;15153,14;2017-12-20;20/12/2017;HAB;Ingresos;Nomina;12;FIJO
20/12/2017;20/12/2017;T/  LA BRASA \ 17-12-2017;-31,35;15153,14;15121,79;10542;-31,35;15121,79;2017-12-17;17/12/2017;BRASA;Gastos_Ocio y transporte;Restaurantes;12;VARIABLES
22/12/2017;22/12/2017;HAB.  FOMENT DE TERRASSA S.A. Transf;3805,67;15121,79;18927,46;10543;3805,67;18927,46;2017-12-22;22/12/2017;HAB;Ingresos;Nomina;12;FIJO
22/12/2017;22/12/2017;T/  AUTOPISTAS TERR 19-12-2017;-1,39;18927,46;18926,07;10544;-1,39;18926,07;2017-12-19;19/12/2017;AUTOPISTAS;Gastos_Ocio y transporte;Parking y peaje;12;VARIABLES
22/12/2017;22/12/2017;T/  DECATHLON SA TERRA\ 19-12-2017;-10,97;18926,07;18915,10;10545;-10,97;18915,10;2017-12-19;19/12/2017;DECATHLON;Gastos_Compras;Deportivo;12;VARIABLES
23/12/2017;23/12/2017;T/  YELMO FILMS S.\POZU 20-12-2017;-8,80;18915,10;18906,30;10546;-8,80;18906,30;2017-12-20;20/12/2017;YELMO;Gastos_Ocio y transporte;Espectáculos;12;VARIABLES
24/12/2017;24/12/2017;T/  CAFET.C T PRAT\PRAT 21-12-2017;-2,75;18906,30;18903,55;10547;-2,75;18903,55;2017-12-21;21/12/2017;CAFETC;Gastos_Ocio y transporte;Restaurantes;12;VARIABLES
24/12/2017;24/12/2017;T/  AUTOPISTAS TERR 21-12-2017;-1,39;18903,55;18902,16;10548;-1,39;18902,16;2017-12-21;21/12/2017;AUTOPISTAS;Gastos_Ocio y transporte;Parking y peaje;12;VARIABLES
24/12/2017;24/12/2017;T/  AUTOPISTAS TERR 21-12-2017;-1,39;18902,16;18900,77;10549;-1,39;18900,77;2017-12-21;21/12/2017;AUTOPISTAS;Gastos_Ocio y transporte;Parking y peaje;12;VARIABLES
24/12/2017;24/12/2017;T/  TOCINERIES VENTURA\ 21-12-2017;-13,62;18900,77;18887,15;10550;-13,62;18887,15;2017-12-21;21/12/2017;TOCINERIES;Gastos_Compras;Supermercado;12;VARIABLES
24/12/2017;24/12/2017;T/  CINESA WEB \B 21-12-2017;-25,60;18887,15;18861,55;10551;-25,60;18861,55;2017-12-21;21/12/2017;CINESA;Gastos_Ocio y transporte;Espectáculos;12;VARIABLES
25/12/2017;25/12/2017;T/  WWW.JUST-EAT.ES 22-12-2017;-37,30;18861,55;18824,25;10552;-37,30;18824,25;2017-12-22;22/12/2017;WWWJUSTEATES;Gastos_Ocio y transporte;Restaurantes;12;VARIABLES
25/12/2017;25/12/2017;T/  CAFET.C T PRAT\PRAT 22-12-2017;-2,75;18824,25;18821,50;10553;-2,75;18821,50;2017-12-22;22/12/2017;CAFETC;Gastos_Ocio y transporte;Restaurantes;12;VARIABLES
25/12/2017;25/12/2017;T/  E.S. RUBI II 22-12-2017;-48,29;18821,50;18773,21;10554;-48,29;18773,21;2017-12-22;22/12/2017;RUBI;Gastos_Ocio y transporte;Gasolina;12;VARIABLES
25/12/2017;25/12/2017;T/  RODELAS PERRUQUERS\ 22-12-2017;-36,50;18773,21;18736,71;10555;-36,50;18736,71;2017-12-22;22/12/2017;RODELAS;Gastos_Salud, saber y deporte;Belleza;12;VARIABLES
27/12/2017;27/12/2017;R/  AYUNTAMIENTO AJUNTAMENT D TAXA;-54,87;18736,71;18681,84;10556;-54,87;18681,84;2017-12-27;27/12/2017;AYUNTAMIENTO;Gastos_Banco y organismos;Ayuntamiento;12;FIJO
28/12/2017;28/12/2017;HAB.  INFORMACIO I TECNOLOGIA DE CAT;1794,10;18681,84;20475,94;10557;1794,10;20475,94;2017-12-28;28/12/2017;HAB;Ingresos;Nomina;12;FIJO
28/12/2017;28/12/2017;T/  AUTOPISTAS TERR 22-12-2017;-1,39;20475,94;20474,55;10558;-1,39;20474,55;2017-12-22;22/12/2017;AUTOPISTAS;Gastos_Ocio y transporte;Parking y peaje;12;VARIABLES
28/12/2017;28/12/2017;T/  AUTOPISTAS TERR 22-12-2017;-1,39;20474,55;20473,16;10559;-1,39;20473,16;2017-12-22;22/12/2017;AUTOPISTAS;Gastos_Ocio y transporte;Parking y peaje;12;VARIABLES
29/12/2017;29/12/2017;T/  MEGA ASIA \TERRASSA;-27,00;20473,16;20446,16;10560;-27,00;20446,16;2017-12-29;29/12/2017;MEGA;Gastos_Compras;Hogar;12;VARIABLES
29/12/2017;29/12/2017;T/  TERRACASA \TERRASSA;-33,00;20446,16;20413,16;10561;-33,00;20413,16;2017-12-29;29/12/2017;TERRACASA;Gastos_Compras;Otras compras;12;VARIABLES
29/12/2017;29/12/2017;T/  WWW.JUST-EAT.ES \MADRID;-31,50;20413,16;20381,66;10562;-31,50;20381,66;2017-12-29;29/12/2017;WWWJUSTEATES;Gastos_Ocio y transporte;Restaurantes;12;VARIABLES
30/12/2017;27/12/2017;T/  AUTOPISTAS TERR;-1,39;20381,66;20380,27;10563;-1,39;20380,27;2017-12-27;27/12/2017;AUTOPISTAS;Gastos_Ocio y transporte;Parking y peaje;12;VARIABLES
30/12/2017;28/12/2017;T/  AUTOPISTAS TERR;-1,39;20380,27;20378,88;10564;-1,39;20378,88;2017-12-28;28/12/2017;AUTOPISTAS;Gastos_Ocio y transporte;Parking y peaje;12;VARIABLES
30/12/2017;28/12/2017;T/  AUTOPISTAS TERR;-1,39;20378,88;20377,49;10565;-1,39;20377,49;2017-12-28;28/12/2017;AUTOPISTAS;Gastos_Ocio y transporte;Parking y peaje;12;VARIABLES
30/12/2017;30/12/2017;T/  IKEA REST. SABADEL\ 27-12-2017;-13,40;20377,49;20364,09;10566;-13,40;20364,09;2017-12-27;27/12/2017;IKEA;Gastos_Vivienda y vehiculo;Mnto. hogar;12;VARIABLES
30/12/2017;30/12/2017;T/  AUTOPISTAS TERR 27-12-2017;-1,39;20364,09;20362,70;10567;-1,39;20362,70;2017-12-27;27/12/2017;AUTOPISTAS;Gastos_Ocio y transporte;Parking y peaje;12;VARIABLES
30/12/2017;30/12/2017;T/  IKEA SABADELL \ 27-12-2017;-164,83;20362,70;20197,87;10568;-164,83;20197,87;2017-12-27;27/12/2017;IKEA;Gastos_Vivienda y vehiculo;Mnto. hogar;12;VARIABLES
30/12/2017;30/12/2017;T/  CAFET.C T PRAT\PRAT 27-12-2017;-3,70;20197,87;20194,17;10569;-3,70;20194,17;2017-12-27;27/12/2017;CAFETC;Gastos_Ocio y transporte;Restaurantes;12;VARIABLES
31/12/2017;31/12/2017;REC.  6061.9600001223;-457,13;20194,17;19737,04;10570;-457,13;19737,04;2017-12-31;31/12/2017;REC;Gastos_Banco y organismos;Hipoteca;12;FIJO
31/12/2017;31/12/2017;T/  CAFET.C T PRAT\PRAT 28-12-2017;-3,75;19737,04;19733,29;10571;-3,75;19733,29;2017-12-28;28/12/2017;CAFETC;Gastos_Ocio y transporte;Restaurantes;12;VARIABLES
01/01/2018;01/01/2018;FACT TARJETAS  TARJ.CREDITO 07126017 18-01-01;-873,48;19733,29;18859,81;10572;-873,48;18859,81;2018-01-01;31/12/2017;FACT 07126017;Gastos_Banco y organismos;Credito Bea;12;VARIABLE
01/01/2018;01/01/2018;FACT TARJETAS  TARJ.CREDITO 42689013 18-01-01;-385,30;18859,81;18474,51;10573;-385,30;18474,51;2018-01-01;31/12/2017;FACT;No computable;Recibo Tarjeta;12;
01/01/2018;01/01/2018;T/  TOCINERIES VENTURA\ 29-12-2017;-11,70;18474,51;18462,81;10574;-11,70;18462,81;2017-12-29;29/12/2017;TOCINERIES;Gastos_Compras;Supermercado;12;VARIABLES
02/01/2018;02/01/2018;R/  Escola d Idi SALT IDIOMES. Ade;-39,00;18462,81;18423,81;10575;-39,00;18423,81;2018-01-02;02/01/2018;ESCOLA;Gastos_Salud, saber y deporte;Estudios;1;VARIABLES
02/01/2018;02/01/2018;T/  REDPIZZA \ 30-12-2017;-19,95;18423,81;18403,86;10576;-19,95;18403,86;2017-12-30;30/12/2017;REDPIZZA;Gastos_Ocio y transporte;Restaurantes;12;VARIABLES
03/01/2018;03/01/2018;T/  KAITENSUSHI HE \BARCELONA;-39,12;18403,86;18364,74;10577;-39,12;18364,74;2018-01-03;03/01/2018;KAITENSUSHI;Gastos_Ocio y transporte;Restaurantes;1;VARIABLES
03/01/2018;03/01/2018;T/  HIPERMERCAT ESCLAT 31-12-2017;-19,51;18364,74;18345,23;10578;-19,51;18345,23;2017-12-31;31/12/2017;HIPERMERCAT;Gastos_Compras;Supermercado;12;VARIABLES
03/01/2018;03/01/2018;T/  VIENA PARC VALLES \ 31-12-2017;-14,15;18345,23;18331,08;10579;-14,15;18331,08;2017-12-31;31/12/2017;VIENA;Gastos_Ocio y transporte;Restaurantes;12;VARIABLES
03/01/2018;03/01/2018;T/  AUTOPISTAS TERR 31-12-2017;-2,53;18331,08;18328,55;10580;-2,53;18328,55;2017-12-31;31/12/2017;AUTOPISTAS;Gastos_Ocio y transporte;Parking y peaje;12;VARIABLES
03/01/2018;03/01/2018;T/  E.S. RUBI II 31-12-2017;-31,48;18328,55;18297,07;10581;-31,48;18297,07;2017-12-31;31/12/2017;RUBI;Gastos_Ocio y transporte;Gasolina;12;VARIABLES
03/01/2018;03/01/2018;T/  AUTOPISTAS TERR 29-12-2017;-1,39;18297,07;18295,68;10582;-1,39;18295,68;2017-12-29;29/12/2017;AUTOPISTAS;Gastos_Ocio y transporte;Parking y peaje;12;VARIABLES
03/01/2018;03/01/2018;T/  AUTOPISTAS TERR 29-12-2017;-1,39;18295,68;18294,29;10583;-1,39;18294,29;2017-12-29;29/12/2017;AUTOPISTAS;Gastos_Ocio y transporte;Parking y peaje;12;VARIABLES
04/01/2018;04/01/2018;T/  CINEMES AMPOSTA 11 01-01-2018;-25,00;18294,29;18269,29;10584;-25,00;18269,29;2018-01-01;01/01/2018;CINEMES;Gastos_Ocio y transporte;Espectáculos;1;VARIABLES
04/01/2018;04/01/2018;T/  AUTOPISTA MARE NOST 31-12-2017;-7,05;18269,29;18262,24;10585;-7,05;18262,24;2017-12-31;31/12/2017;AUTOPISTA;Gastos_Ocio y transporte;Parking y peaje;12;VARIABLES
04/01/2018;04/01/2018;T/  A.C.E.S.A B MART -L 31-12-2017;-10,50;18262,24;18251,74;10586;-10,50;18251,74;2017-12-31;31/12/2017;ACESA;Gastos_Ocio y transporte;Parking y peaje;12;VARIABLES
05/01/2018;05/01/2018;'R/  COOPERATIVA L''EINA COOPE Rebut:';-47,60;18251,74;18204,14;10587;-47,60;18204,14;2018-01-05;05/01/2018;COOPERATIVA;Gastos_Salud, saber y deporte;Estudios;1;VARIABLES
05/01/2018;05/01/2018;T/  IKEA SABADELL \SABADELL;-418,91;18204,14;17785,23;10588;-418,91;17785,23;2018-01-05;05/01/2018;IKEA;Gastos_Vivienda y vehiculo;Mnto. hogar;1;VARIABLES
05/01/2018;05/01/2018;T/  MI SUSHI \ 02-01-2018;-46,60;17785,23;17738,63;10589;-46,60;17738,63;2018-01-02;02/01/2018;SUSHI;Gastos_Ocio y transporte;Restaurantes;1;VARIABLES
05/01/2018;05/01/2018;T/  AUTOPISTA MARE NOST 02-01-2018;-7,20;17738,63;17731,43;10590;-7,20;17731,43;2018-01-02;02/01/2018;AUTOPISTA;Gastos_Ocio y transporte;Parking y peaje;1;VARIABLES
05/01/2018;05/01/2018;T/  A.C.E.S.A LIM SCAP7 02-01-2018;-10,70;17731,43;17720,73;10591;-10,70;17720,73;2018-01-02;02/01/2018;ACESA;Gastos_Ocio y transporte;Parking y peaje;1;VARIABLES
05/01/2018;05/01/2018;T/  TEMPLE 02-01-2018;-1,75;17720,73;17718,98;10592;-1,75;17718,98;2018-01-02;02/01/2018;TEMPLE;Gastos_Ocio y transporte;Gasolina;1;VARIABLES
06/01/2018;04/01/2018;T/  CARREFOUR VALLE;-131,26;17718,98;17587,72;10593;-131,26;17587,72;2018-01-04;04/01/2018;CARREFOUR;Gastos_Compras;Supermercado;1;VARIABLES
06/01/2018;06/01/2018;T/  SABA PL. URQUI 03-01-2018;-2,65;17587,72;17585,07;10594;-2,65;17585,07;2018-01-03;03/01/2018;SABA;Gastos_Ocio y transporte;Parking y peaje;1;VARIABLES
06/01/2018;06/01/2018;T/  SABA PL. CAT 03-01-2018;-7,20;17585,07;17577,87;10595;-7,20;17577,87;2018-01-03;03/01/2018;SABA;Gastos_Ocio y transporte;Parking y peaje;1;VARIABLES
06/01/2018;06/01/2018;T/  BCT SAN JAIME \B 03-01-2018;-24,35;17577,87;17553,52;10596;-24,35;17553,52;2018-01-03;03/01/2018;BCT;Gastos_Ocio y transporte;Gasolina;1;VARIABLES
06/01/2018;06/01/2018;T/  AUTOPISTAS TERR 02-01-2018;-1,41;17553,52;17552,11;10597;-1,41;17552,11;2018-01-02;02/01/2018;AUTOPISTAS;Gastos_Ocio y transporte;Parking y peaje;1;VARIABLES
08/01/2018;08/01/2018;T/  BON AREA 05-01-2018;-20,34;17552,11;17531,77;10598;-20,34;17531,77;2018-01-05;05/01/2018;BON;Gastos_Compras;Supermercado;1;VARIABLES
08/01/2018;08/01/2018;T/  VIENA XALET SABADE\ 05-01-2018;-24,40;17531,77;17507,37;10599;-24,40;17507,37;2018-01-05;05/01/2018;VIENA;Gastos_Ocio y transporte;Restaurantes;1;VARIABLES
08/01/2018;08/01/2018;T/  LEROY MERLIN SABAD\ 05-01-2018;-4,55;17507,37;17502,82;10600;-4,55;17502,82;2018-01-05;05/01/2018;LEROY;Gastos_Vivienda y vehiculo;Mnto. hogar;1;VARIABLES
08/01/2018;08/01/2018;T/  IKEA REST. SABADEL\ 05-01-2018;-7,10;17502,82;17495,72;10601;-7,10;17495,72;2018-01-05;05/01/2018;IKEA;Gastos_Vivienda y vehiculo;Mnto. hogar;1;VARIABLES
09/01/2018;05/01/2018;T/ PlaystationNetwork;-64,98;17495,72;17430,74;10602;-64,98;17430,74;2018-01-05;05/01/2018;PLAYSTATIONNETWORK;Gastos_Servicios tipicos;Servicios online;1;FIJO
10/01/2018;10/01/2018;R/ ALIMENTACION SERHS FOOD A Comed;-107,10;17430,74;17323,64;10603;-107,10;17323,64;2018-01-10;10/01/2018;ALIMENTACION;Gastos_Salud, saber y deporte;Menjador;1;FIJO
10/01/2018;10/01/2018;R/ ALIMENTACION SERHS FOOD A Comed;-31,50;17323,64;17292,14;10604;-31,50;17292,14;2018-01-10;10/01/2018;ALIMENTACION;Gastos_Salud, saber y deporte;Menjador;1;FIJO
10/01/2018;10/01/2018;T/ WWW.JUST-EAT.ES 07-01-2018;-38,35;17292,14;17253,79;10605;-38,35;17253,79;2018-01-07;07/01/2018;WWWJUSTEATES;Gastos_Ocio y transporte;Restaurantes;1;VARIABLES
11/01/2018;11/01/2018;R/ GAS GAS NATURAL GNS27630480118;-4,64;17253,79;17249,15;10606;-4,64;17249,15;2018-01-11;11/01/2018;GAS;Gastos_Servicios tipicos;Gas;1;FIJO
11/01/2018;11/01/2018;T/ BON AREA 08-01-2018;-17,87;17249,15;17231,28;10607;-17,87;17231,28;2018-01-08;08/01/2018;BON;Gastos_Compras;Supermercado;1;VARIABLES
12/01/2018;12/01/2018;R/ . FINQUES GASS Vto 01-01-18 Rec;-73,69;17231,28;17157,59;10608;-73,69;17157,59;2018-01-01;01/01/2018;FINQUES;Gastos_Vivienda y vehiculo;Alquiler Parking;1;FIJO
12/01/2018;12/01/2018;R/ TELECOMUNICACI VODAFONE;-168,38;17157,59;16989,21;10609;-168,38;16989,21;2018-01-12;12/01/2018;TELECOMUNICACI;Gastos_Servicios tipicos;Telecomunicaciones;1;FIJO
12/01/2018;12/01/2018;T/ DRIM PARC VALLES \RUBI;-14,99;16989,21;16974,22;10610;-14,99;16974,22;2018-01-12;12/01/2018;DRIM;Gastos_Compras;Niños;1;VARIABLES
12/01/2018;12/01/2018;T/ AUTOPISTAS TERR 09-01-2018;-1,41;16974,22;16972,81;10611;-1,41;16972,81;2018-01-09;09/01/2018;AUTOPISTAS;Gastos_Ocio y transporte;Parking y peaje;1;VARIABLES
12/01/2018;12/01/2018;T/ AUTOPISTAS TERR 09-01-2018;-1,41;16972,81;16971,40;10612;-1,41;16971,40;2018-01-09;09/01/2018;AUTOPISTAS;Gastos_Ocio y transporte;Parking y peaje;1;VARIABLES
12/01/2018;12/01/2018;T/ TUNELS VALLVI S. 09-01-2018;-4,25;16971,40;16967,15;10613;-4,25;16967,15;2018-01-09;09/01/2018;TUNELS;Gastos_Ocio y transporte;Parking y peaje;1;VARIABLES
12/01/2018;12/01/2018;T/ CINESA PARC VALLES\ 09-01-2018;-27,20;16967,15;16939,95;10614;-27,20;16939,95;2018-01-09;09/01/2018;CINESA;Gastos_Ocio y transporte;Espectáculos;1;VARIABLES
12/01/2018;12/01/2018;T/ CINESA PARC VALLES\ 09-01-2018;-14,06;16939,95;16925,89;10615;-14,06;16925,89;2018-01-09;09/01/2018;CINESA;Gastos_Ocio y transporte;Espectáculos;1;VARIABLES
12/01/2018;12/01/2018;T/ E.S.RUBI 9 09-01-2018;-46,42;16925,89;16879,47;10616;-46,42;16879,47;2018-01-09;09/01/2018;ESRUBI;Gastos_Ocio y transporte;Gasolina;1;VARIABLES
12/01/2018;12/01/2018;T/ AUTOPISTAS TERR 08-01-2018;-1,41;16879,47;16878,06;10617;-1,41;16878,06;2018-01-08;08/01/2018;AUTOPISTAS;Gastos_Ocio y transporte;Parking y peaje;1;VARIABLES
12/01/2018;12/01/2018;T/ AUTOPISTAS TERR 08-01-2018;-1,41;16878,06;16876,65;10618;-1,41;16876,65;2018-01-08;08/01/2018;AUTOPISTAS;Gastos_Ocio y transporte;Parking y peaje;1;VARIABLES
12/01/2018;12/01/2018;T/ TUNELS VALLVI S. 08-01-2018;-4,25;16876,65;16872,40;10619;-4,25;16872,40;2018-01-08;08/01/2018;TUNELS;Gastos_Ocio y transporte;Parking y peaje;1;VARIABLES
13/01/2018;10/01/2018;T/ TUNELS VALLVI S. C:2T;-4,25;16872,40;16868,15;10620;-4,25;16868,15;2018-01-10;10/01/2018;TUNELS;Gastos_Ocio y transporte;Parking y peaje;1;VARIABLES
13/01/2018;10/01/2018;T/ AUTOPISTAS TERR;-1,41;16868,15;16866,74;10621;-1,41;16866,74;2018-01-10;10/01/2018;AUTOPISTAS;Gastos_Ocio y transporte;Parking y peaje;1;VARIABLES
13/01/2018;11/01/2018;T/ AUTOPISTAS TERR;-1,41;16866,74;16865,33;10622;-1,41;16865,33;2018-01-11;11/01/2018;AUTOPISTAS;Gastos_Ocio y transporte;Parking y peaje;1;VARIABLES
13/01/2018;11/01/2018;T/ AUTOPISTAS TERR;-1,41;16865,33;16863,92;10623;-1,41;16863,92;2018-01-11;11/01/2018;AUTOPISTAS;Gastos_Ocio y transporte;Parking y peaje;1;VARIABLES
13/01/2018;13/01/2018;T/ CON A DE ARTE \RIPOLLET;-140,57;16863,92;16723,35;10624;-140,57;16723,35;2018-01-13;13/01/2018;CON;Gastos_Compras;Hobbys;1;VARIABLES
13/01/2018;13/01/2018;T/ AUTOPISTAS TERR 10-01-2018;-1,41;16723,35;16721,94;10625;-1,41;16721,94;2018-01-10;10/01/2018;AUTOPISTAS;Gastos_Ocio y transporte;Parking y peaje;1;VARIABLES
13/01/2018;13/01/2018;T/ ALDI TERRASSA LES \ 10-01-2018;-24,57;16721,94;16697,37;10626;-24,57;16697,37;2018-01-10;10/01/2018;ALDI;Gastos_Compras;Supermercado;1;VARIABLES
14/01/2018;11/01/2018;T/ TUNELS VALLVI S. C:2T;-3,78;16697,37;16693,59;10627;-3,78;16693,59;2018-01-11;11/01/2018;TUNELS;Gastos_Ocio y transporte;Parking y peaje;1;VARIABLES
14/01/2018;14/01/2018;T/ AP. PLAÇA VELLA 11-01-2018;-4,25;16693,59;16689,34;10628;-4,25;16689,34;2018-01-11;11/01/2018;PLAA;Gastos_Ocio y transporte;Parking y peaje;1;VARIABLES
14/01/2018;14/01/2018;T/ LIBRERIAS CASA DEL\ 11-01-2018;-32,80;16689,34;16656,54;10629;-32,80;16656,54;2018-01-11;11/01/2018;LIBRERIAS;Gastos_Salud, saber y deporte;Estudios;1;VARIABLES
14/01/2018;14/01/2018;T/ LIBRERIAS CASA DEL\ 11-01-2018;-25,89;16656,54;16630,65;10630;-25,89;16630,65;2018-01-11;11/01/2018;LIBRERIAS;Gastos_Salud, saber y deporte;Estudios;1;VARIABLES
15/01/2018;15/01/2018;R/ LUZ ENDESA ENERG FACTURA DE ELE;-128,45;16630,65;16502,20;10631;-128,45;16502,20;2018-01-15;15/01/2018;ELE;Gastos_Servicios tipicos;Electricidad;1;FIJO
15/01/2018;15/01/2018;T/ CAFET.C T PRAT\PRAT 12-01-2018;-3,80;16502,20;16498,40;10632;-3,80;16498,40;2018-01-12;12/01/2018;CAFETC;Gastos_Ocio y transporte;Restaurantes;1;VARIABLES
16/01/2018;16/01/2018;R/ SEGUROS CCM VIDA Y P Recibo:147;-15,90;16498,40;16482,50;10633;-15,90;16482,50;2018-01-16;16/01/2018;CCM;Gastos_Seguros;Seguro vida;1;FIJO
16/01/2018;16/01/2018;R/ SEGUROS CCM VIDA Y P Recibo:147;-18,76;16482,50;16463,74;10634;-18,76;16463,74;2018-01-16;16/01/2018;CCM;Gastos_Seguros;Seguro vida;1;FIJO
16/01/2018;16/01/2018;T/ IKEA REST. SABADEL\ 13-01-2018;-27,45;16463,74;16436,29;10635;-27,45;16436,29;2018-01-13;13/01/2018;IKEA;Gastos_Vivienda y vehiculo;Mnto. hogar;1;VARIABLES
16/01/2018;16/01/2018;T/ IKEA SABADELL \ 13-01-2018;-80,48;16436,29;16355,81;10636;-80,48;16355,81;2018-01-13;13/01/2018;IKEA;Gastos_Vivienda y vehiculo;Mnto. hogar;1;VARIABLES
17/01/2018;17/01/2018;T/ BON AREA 14-01-2018;-23,14;16355,81;16332,67;10637;-23,14;16332,67;2018-01-14;14/01/2018;BON;Gastos_Compras;Supermercado;1;VARIABLES
17/01/2018;17/01/2018;T/ TUNELS VALLVI S. 12-01-2018;-4,25;16332,67;16328,42;10638;-4,25;16328,42;2018-01-12;12/01/2018;TUNELS;Gastos_Ocio y transporte;Parking y peaje;1;VARIABLES
18/01/2018;18/01/2018;R/ SEGUROS ADESLAS CENT MODULAR CO;-159,81;16328,42;16168,61;10639;-159,81;16168,61;2018-01-18;18/01/2018;ADESLAS;Gastos_Salud, saber y deporte;Medico;1;VARIABLES
18/01/2018;18/01/2018;DEV.COMPRA TJ CON A DE ARTE \RIPOLLET;1,51;16168,61;16170,12;10640;1,51;16170,12;2018-01-18;18/01/2018;DEVCOMPRA;Ingresos;Devoluciones;1;VARIABLES
18/01/2018;18/01/2018;T/ TUNELS VALLVI S. 15-01-2018;-4,25;16170,12;16165,87;10641;-4,25;16165,87;2018-01-15;15/01/2018;TUNELS;Gastos_Ocio y transporte;Parking y peaje;1;VARIABLES
18/01/2018;18/01/2018;T/ CAFET.C T PRAT\PRAT 15-01-2018;-3,65;16165,87;16162,22;10642;-3,65;16162,22;2018-01-15;15/01/2018;CAFETC;Gastos_Ocio y transporte;Restaurantes;1;VARIABLES
18/01/2018;18/01/2018;T/ FARMA.ANGEL MORENO\TERRASSA;-424,60;16162,22;15737,62;10643;-424,60;15737,62;2018-01-18;18/01/2018;FARMAANGEL;Gastos_Salud, saber y deporte;Farmacia;1;VARIABLES
19/01/2018;19/01/2018;T/ AUTOPISTAS TERR 15-01-2018;-1,41;15737,62;15736,21;10644;-1,41;15736,21;2018-01-15;15/01/2018;AUTOPISTAS;Gastos_Ocio y transporte;Parking y peaje;1;VARIABLES
19/01/2018;19/01/2018;T/ AUTOPISTAS TERR 15-01-2018;-1,41;15736,21;15734,80;10645;-1,41;15734,80;2018-01-15;15/01/2018;AUTOPISTAS;Gastos_Ocio y transporte;Parking y peaje;1;VARIABLES
19/01/2018;19/01/2018;T/ AUTOPISTAS TERR 14-01-2018;-2,56;15734,80;15732,24;10646;-2,56;15732,24;2018-01-14;14/01/2018;AUTOPISTAS;Gastos_Ocio y transporte;Parking y peaje;1;VARIABLES
19/01/2018;19/01/2018;T/ AUTOPISTAS TERR 14-01-2018;-2,56;15732,24;15729,68;10647;-2,56;15729,68;2018-01-14;14/01/2018;AUTOPISTAS;Gastos_Ocio y transporte;Parking y peaje;1;VARIABLES
19/01/2018;19/01/2018;T/ AUTOPISTAS TERR 12-01-2018;-1,41;15729,68;15728,27;10648;-1,41;15728,27;2018-01-12;12/01/2018;AUTOPISTAS;Gastos_Ocio y transporte;Parking y peaje;1;VARIABLES
19/01/2018;19/01/2018;T/ AUTOPISTAS TERR 12-01-2018;-1,41;15728,27;15726,86;10649;-1,41;15726,86;2018-01-12;12/01/2018;AUTOPISTAS;Gastos_Ocio y transporte;Parking y peaje;1;VARIABLES
20/01/2018;20/01/2018;T/ MERKAL BARICEN\BARBERA DEL;-136,06;15726,86;15590,80;10650;-136,06;15590,80;2018-01-20;20/01/2018;MERKAL;Gastos_Compras;Ropa;1;VARIABLES
20/01/2018;20/01/2018;T/ BRICOMART TERRASSA\ 17-01-2018;-24,55;15590,80;15566,25;10651;-24,55;15566,25;2018-01-17;17/01/2018;BRICOMART;Gastos_Vivienda y vehiculo;Mnto. hogar;1;VARIABLES
20/01/2018;20/01/2018;T/ AUTOPISTAS TERR 17-01-2018;-1,41;15566,25;15564,84;10652;-1,41;15564,84;2018-01-17;17/01/2018;AUTOPISTAS;Gastos_Ocio y transporte;Parking y peaje;1;VARIABLES
20/01/2018;20/01/2018;T/ TUNELS VALLVI S. 17-01-2018;-4,25;15564,84;15560,59;10653;-4,25;15560,59;2018-01-17;17/01/2018;TUNELS;Gastos_Ocio y transporte;Parking y peaje;1;VARIABLES
21/01/2018;21/01/2018;T/ AUTOPISTAS TERR 18-01-2018;-1,41;15560,59;15559,18;10654;-1,41;15559,18;2018-01-18;18/01/2018;AUTOPISTAS;Gastos_Ocio y transporte;Parking y peaje;1;VARIABLES
21/01/2018;21/01/2018;T/ FARMA.ANGEL MORENO\ 18-01-2018;-16,84;15559,18;15542,34;10655;-16,84;15542,34;2018-01-18;18/01/2018;FARMAANGEL;Gastos_Salud, saber y deporte;Farmacia;1;VARIABLES
22/01/2018;22/01/2018;T/ ES LA RIERA \EL PR 19-01-2018;-30,00;15542,34;15512,34;10656;-30,00;15512,34;2018-01-19;19/01/2018;RIERA;Gastos_Ocio y transporte;Gasolina;1;VARIABLES
23/01/2018;23/01/2018;T/ REST.KAORI \BARBE 20-01-2018;-55,40;15512,34;15456,94;10657;-55,40;15456,94;2018-01-20;20/01/2018;RESTKAORI;Gastos_Ocio y transporte;Restaurantes;1;VARIABLES
23/01/2018;23/01/2018;T/ AUTOPISTAS TERR 19-01-2018;-1,41;15456,94;15455,53;10658;-1,41;15455,53;2018-01-19;19/01/2018;AUTOPISTAS;Gastos_Ocio y transporte;Parking y peaje;1;VARIABLES
24/01/2018;24/01/2018;T/ TUNELS VALLVI S. 19-01-2018;-4,25;15455,53;15451,28;10659;-4,25;15451,28;2018-01-19;19/01/2018;TUNELS;Gastos_Ocio y transporte;Parking y peaje;1;VARIABLES
25/01/2018;25/01/2018;T/ AUTOPISTAS TERR 22-01-2018;-1,41;15451,28;15449,87;10660;-1,41;15449,87;2018-01-22;22/01/2018;AUTOPISTAS;Gastos_Ocio y transporte;Parking y peaje;1;VARIABLES
25/01/2018;25/01/2018;T/ AUTOPISTAS TERR 22-01-2018;-1,41;15449,87;15448,46;10661;-1,41;15448,46;2018-01-22;22/01/2018;AUTOPISTAS;Gastos_Ocio y transporte;Parking y peaje;1;VARIABLES
25/01/2018;25/01/2018;T/ TUNELS VALLVI S. 22-01-2018;-4,25;15448,46;15444,21;10662;-4,25;15444,21;2018-01-22;22/01/2018;TUNELS;Gastos_Ocio y transporte;Parking y peaje;1;VARIABLES
25/01/2018;25/01/2018;T/ CAFET.C T PRAT\PRAT 22-01-2018;-3,30;15444,21;15440,91;10663;-3,30;15440,91;2018-01-22;22/01/2018;CAFETC;Gastos_Ocio y transporte;Restaurantes;1;VARIABLES
26/01/2018;26/01/2018;HAB. FOMENT DE TERRASSA S.A. Transf;1822,90;15440,91;17263,81;10664;1822,90;17263,81;2018-01-26;26/01/2018;HAB;Ingresos;Nomina;1;FIJO
26/01/2018;26/01/2018;T/ AUTOPISTAS TERR 23-01-2018;-1,41;17263,81;17262,40;10665;-1,41;17262,40;2018-01-23;23/01/2018;AUTOPISTAS;Gastos_Ocio y transporte;Parking y peaje;1;VARIABLES
26/01/2018;26/01/2018;T/ AUTOPISTAS TERR 23-01-2018;-1,41;17262,40;17260,99;10666;-1,41;17260,99;2018-01-23;23/01/2018;AUTOPISTAS;Gastos_Ocio y transporte;Parking y peaje;1;VARIABLES
26/01/2018;26/01/2018;T/ TUNELS VALLVI S. 23-01-2018;-4,25;17260,99;17256,74;10667;-4,25;17256,74;2018-01-23;23/01/2018;TUNELS;Gastos_Ocio y transporte;Parking y peaje;1;VARIABLES
26/01/2018;26/01/2018;S/OR. JUANDIK;-40,00;17256,74;17216,74;10668;-40,00;17216,74;2018-01-26;26/01/2018;JUANDIK;Gastos_Ocio y transporte;Loterias;1;
27/01/2018;27/01/2018;T/ AUTOPISTAS TERR 24-01-2018;-1,41;17216,74;17215,33;10669;-1,41;17215,33;2018-01-24;24/01/2018;AUTOPISTAS;Gastos_Ocio y transporte;Parking y peaje;1;VARIABLES
27/01/2018;27/01/2018;T/ AUTOPISTAS TERR 24-01-2018;-1,41;17215,33;17213,92;10670;-1,41;17213,92;2018-01-24;24/01/2018;AUTOPISTAS;Gastos_Ocio y transporte;Parking y peaje;1;VARIABLES
27/01/2018;27/01/2018;T/ TUNELS VALLVI S. 24-01-2018;-4,25;17213,92;17209,67;10671;-4,25;17209,67;2018-01-24;24/01/2018;TUNELS;Gastos_Ocio y transporte;Parking y peaje;1;VARIABLES
28/01/2018;28/01/2018;T/ BAR EL PUNT DE\MONTCADA I R;-15,80;17209,67;17193,87;10672;-15,80;17193,87;2018-01-28;28/01/2018;BAR;Gastos_Ocio y transporte;Restaurantes;1;VARIABLES
29/01/2018;29/01/2018;HAB. INFORMACIO I TECNOLOGIA DE CAT;1659,70;17193,87;18853,57;10673;1659,70;18853,57;2018-01-29;29/01/2018;HAB;Ingresos;Nomina;1;FIJO
29/01/2018;29/01/2018;T/ BON AREA 26-01-2018;-17,25;18853,57;18836,32;10674;-17,25;18836,32;2018-01-26;26/01/2018;BON;Gastos_Compras;Supermercado;1;VARIABLES
30/01/2018;30/01/2018;T/ CON A DE ARTE \ 27-01-2018;-128,14;18836,32;18708,18;10675;-128,14;18708,18;2018-01-27;27/01/2018;CON;Gastos_Compras;Hobbys;1;VARIABLES
31/01/2018;31/01/2018;REC. 6061.9600001223;-448,11;18708,18;18260,07;10676;-448,11;18260,07;2018-01-31;31/01/2018;REC;Gastos_Banco y organismos;Hipoteca;1;FIJO
31/01/2018;31/01/2018;CAJ. AJENO SERVIRED \MADRID;-300,00;18260,07;17960,07;10677;-300,00;17960,07;2018-01-31;31/01/2018;CAJ;Gastos_Gastos varios;Efectivo;1;VARIABLES
31/01/2018;31/01/2018;COM. 64970036 SVRED CAJ OFI;-1,87;17960,07;17958,20;10678;-1,87;17958,20;2018-01-31;31/01/2018;COM;Gastos_Banco y organismos;Cargos banco;1;FIJO
31/01/2018;31/01/2018;T/ E.S. RUBI II 28-01-2018;-44,07;17958,20;17914,13;10679;-44,07;17914,13;2018-01-28;28/01/2018;RUBI;Gastos_Ocio y transporte;Gasolina;1;VARIABLES
31/01/2018;31/01/2018;T/ AUTOPISTAS TERR 28-01-2018;-2,56;17914,13;17911,57;10680;-2,56;17911,57;2018-01-28;28/01/2018;AUTOPISTAS;Gastos_Ocio y transporte;Parking y peaje;1;VARIABLES
31/01/2018;31/01/2018;T/ TUNELS VALLVI S. 26-01-2018;-3,78;17911,57;17907,79;10681;-3,78;17907,79;2018-01-26;26/01/2018;TUNELS;Gastos_Ocio y transporte;Parking y peaje;1;VARIABLES
31/01/2018;31/01/2018;T/ AUTOPISTAS TERR 26-01-2018;-1,41;17907,79;17906,38;10682;-1,41;17906,38;2018-01-26;26/01/2018;AUTOPISTAS;Gastos_Ocio y transporte;Parking y peaje;1;VARIABLES
31/01/2018;31/01/2018;T/ AUTOPISTAS TERR 26-01-2018;-1,41;17906,38;17904,97;10683;-1,41;17904,97;2018-01-26;26/01/2018;AUTOPISTAS;Gastos_Ocio y transporte;Parking y peaje;1;VARIABLES
01/02/2018;01/02/2018;R/ AYUNTAMIENTO AJUNTAMENT D I.B.I;-47,13;17904,97;17857,84;10684;-47,13;17857,84;2018-02-01;01/02/2018;AYUNTAMIENTO;Gastos_Banco y organismos;Ayuntamiento;2;FIJO
01/02/2018;01/02/2018;R/ Escola d Idi SALT IDIOMES. Ade;-39,00;17857,84;17818,84;10685;-39,00;17818,84;2018-02-01;01/02/2018;ESCOLA;Gastos_Salud, saber y deporte;Estudios;2;VARIABLES
01/02/2018;01/02/2018;FACT TARJETAS TARJ.CREDITO 07126017 18-02-01;-413,66;17818,84;17405,18;10686;-413,66;17405,18;2018-02-01;31/01/2018;FACT 07126017;Gastos_Banco y organismos;Credito Bea;1;VARIABLE
01/02/2018;01/02/2018;FACT TARJETAS TARJ.CREDITO 42689013 18-02-01;-224,43;17405,18;17180,75;10687;-224,43;17180,75;2018-02-01;31/01/2018;FACT;No computable;Recibo Tarjeta;1;
02/02/2018;02/02/2018;R/ LUZ ENDESA ENERG FACTURA DE GAS;-89,75;17180,75;17091,00;10688;-89,75;17091,00;2018-02-02;02/02/2018;GAS;Gastos_Servicios tipicos;Gas;2;FIJO
02/02/2018;02/02/2018;T/ TUNELS VALLVI S. 30-01-2018;-4,25;17091,00;17086,75;10689;-4,25;17086,75;2018-01-30;30/01/2018;TUNELS;Gastos_Ocio y transporte;Parking y peaje;1;VARIABLES
03/02/2018;03/02/2018;T/ AUTOPISTAS TERR 31-01-2018;-1,41;17086,75;17085,34;10690;-1,41;17085,34;2018-01-31;31/01/2018;AUTOPISTAS;Gastos_Ocio y transporte;Parking y peaje;1;VARIABLES
03/02/2018;03/02/2018;T/ TUNELS VALLVI S. 31-01-2018;-4,25;17085,34;17081,09;10691;-4,25;17081,09;2018-01-31;31/01/2018;TUNELS;Gastos_Ocio y transporte;Parking y peaje;1;VARIABLES
03/02/2018;03/02/2018;T/ AUTOPISTAS TERR 30-01-2018;-1,41;17081,09;17079,68;10692;-1,41;17079,68;2018-01-30;30/01/2018;AUTOPISTAS;Gastos_Ocio y transporte;Parking y peaje;1;VARIABLES
03/02/2018;03/02/2018;T/ AUTOPISTAS TERR 30-01-2018;-1,41;17079,68;17078,27;10693;-1,41;17078,27;2018-01-30;30/01/2018;AUTOPISTAS;Gastos_Ocio y transporte;Parking y peaje;1;VARIABLES
05/02/2018;05/02/2018;'R/ COOPERATIVA L''EINA COOPE Rebut:';-47,60;17078,27;17030,67;10694;-47,60;17030,67;2018-02-05;05/02/2018;COOPERATIVA;Gastos_Salud, saber y deporte;Estudios;2;VARIABLES
06/02/2018;06/02/2018;R/ ALIMENTACION SERHS FOOD A Comed;-33,25;17030,67;16997,42;10695;-33,25;16997,42;2018-02-06;06/02/2018;ALIMENTACION;Gastos_Salud, saber y deporte;Menjador;2;FIJO
06/02/2018;06/02/2018;R/ ALIMENTACION SERHS FOOD A Comed;-110,67;16997,42;16886,75;10696;-110,67;16886,75;2018-02-06;06/02/2018;ALIMENTACION;Gastos_Salud, saber y deporte;Menjador;2;FIJO
06/02/2018;06/02/2018;R/ SEGUROS ADESLAS CENT MODULAR CO;-159,81;16886,75;16726,94;10697;-159,81;16726,94;2018-02-06;06/02/2018;ADESLAS;Gastos_Salud, saber y deporte;Medico;2;VARIABLES
06/02/2018;06/02/2018;DEV.COMPRA TJ YELMO FILMS S.\POZUELO ALAR;8,80;16726,94;16735,74;10698;8,80;16735,74;2018-02-06;06/02/2018;DEVCOMPRA;Ingresos;Devoluciones;2;VARIABLES
06/02/2018;06/02/2018;T/ WWW.JUST-EAT.ES 03-02-2018;-33,80;16735,74;16701,94;10699;-33,80;16701,94;2018-02-03;03/02/2018;WWWJUSTEATES;Gastos_Ocio y transporte;Restaurantes;2;VARIABLES
07/02/2018;07/02/2018;T/ LUZ DE GAS \B 04-02-2018;-34,00;16701,94;16667,94;10700;-34,00;16667,94;2018-02-04;04/02/2018;LUZ;Gastos_Servicios tipicos;Electricidad;2;FIJO
10/02/2018;10/02/2018;T/ AUTOPISTAS TERR 07-02-2018;-1,41;16667,94;16666,53;10701;-1,41;16666,53;2018-02-07;07/02/2018;AUTOPISTAS;Gastos_Ocio y transporte;Parking y peaje;2;VARIABLES
10/02/2018;10/02/2018;T/ MEGA ASIA \ 07-02-2018;-29,00;16666,53;16637,53;10702;-29,00;16637,53;2018-02-07;07/02/2018;MEGA;Gastos_Compras;Hogar;2;VARIABLES
10/02/2018;10/02/2018;T/ VIENA PARC VALLES \ 07-02-2018;-18,00;16637,53;16619,53;10703;-18,00;16619,53;2018-02-07;07/02/2018;VIENA;Gastos_Ocio y transporte;Restaurantes;2;VARIABLES
11/02/2018;11/02/2018;T/ AUTOPISTAS TERR 08-02-2018;-1,41;16619,53;16618,12;10704;-1,41;16618,12;2018-02-08;08/02/2018;AUTOPISTAS;Gastos_Ocio y transporte;Parking y peaje;2;VARIABLES
11/02/2018;11/02/2018;T/ TUNELS VALLVI S. 07-02-2018;-4,25;16618,12;16613,87;10705;-4,25;16613,87;2018-02-07;07/02/2018;TUNELS;Gastos_Ocio y transporte;Parking y peaje;2;VARIABLES
12/02/2018;12/02/2018;R/ GAS GAS NATURAL GNS27630480218;-4,64;16613,87;16609,23;10706;-4,64;16609,23;2018-02-12;12/02/2018;GAS;Gastos_Servicios tipicos;Gas;2;FIJO
13/02/2018;09/02/2018;T/ CARREFOUR VALLE;-173,18;16609,23;16436,05;10707;-173,18;16436,05;2018-02-09;09/02/2018;CARREFOUR;Gastos_Compras;Supermercado;2;VARIABLES
14/02/2018;14/02/2018;R/ . FINQUES GASS Vto 01-02-18 Rec;-73,69;16436,05;16362,36;10708;-73,69;16362,36;2018-02-01;01/02/2018;FINQUES;Gastos_Vivienda y vehiculo;Alquiler Parking;2;FIJO
14/02/2018;14/02/2018;T/ TUNELS VALLVI S. 09-02-2018;-4,25;16362,36;16358,11;10709;-4,25;16358,11;2018-02-09;09/02/2018;TUNELS;Gastos_Ocio y transporte;Parking y peaje;2;VARIABLES
14/02/2018;14/02/2018;T/ AUTOPISTAS TERR 09-02-2018;-1,41;16358,11;16356,70;10710;-1,41;16356,70;2018-02-09;09/02/2018;AUTOPISTAS;Gastos_Ocio y transporte;Parking y peaje;2;VARIABLES
14/02/2018;14/02/2018;T/ AUTOPISTAS TERR 09-02-2018;-1,41;16356,70;16355,29;10711;-1,41;16355,29;2018-02-09;09/02/2018;AUTOPISTAS;Gastos_Ocio y transporte;Parking y peaje;2;VARIABLES
15/02/2018;15/02/2018;R/ TELECOMUNICACI VODAFONE;-122,03;16355,29;16233,26;10712;-122,03;16233,26;2018-02-15;15/02/2018;TELECOMUNICACI;Gastos_Servicios tipicos;Telecomunicaciones;2;FIJO
15/02/2018;15/02/2018;T/ Ribs Parc Valles \ 12-02-2018;-58,40;16233,26;16174,86;10713;-58,40;16174,86;2018-02-12;12/02/2018;RIBS;Gastos_Ocio y transporte;Restaurantes;2;VARIABLES
15/02/2018;15/02/2018;T/ CINESA WEB \B 12-02-2018;-27,60;16174,86;16147,26;10714;-27,60;16147,26;2018-02-12;12/02/2018;CINESA;Gastos_Ocio y transporte;Espectáculos;2;VARIABLES
16/02/2018;16/02/2018;R/ SEGUROS CCM VIDA Y P Recibo:148;-15,84;16147,26;16131,42;10715;-15,84;16131,42;2018-02-16;16/02/2018;CCM;Gastos_Seguros;Seguro vida;2;FIJO
16/02/2018;16/02/2018;R/ SEGUROS CCM VIDA Y P Recibo:148;-18,68;16131,42;16112,74;10716;-18,68;16112,74;2018-02-16;16/02/2018;CCM;Gastos_Seguros;Seguro vida;2;FIJO
16/02/2018;14/02/2018;T/ everything5pounds.com;-119,50;16112,74;15993,24;10717;-119,50;15993,24;2018-02-14;14/02/2018;EVERYTHINGPOUNDSCOM;Gastos_Compras;Ropa;2;VARIABLES
16/02/2018;16/02/2018;T/ LEROY MERLIN S\SANT 13-02-2018;-45,79;15993,24;15947,45;10718;-45,79;15947,45;2018-02-13;13/02/2018;LEROY;Gastos_Vivienda y vehiculo;Mnto. hogar;2;VARIABLES
16/02/2018;16/02/2018;T/ TUNELS VALLVI S. 13-02-2018;-4,25;15947,45;15943,20;10719;-4,25;15943,20;2018-02-13;13/02/2018;TUNELS;Gastos_Ocio y transporte;Parking y peaje;2;VARIABLES
16/02/2018;16/02/2018;T/ AUTOPISTAS TERR 13-02-2018;-1,41;15943,20;15941,79;10720;-1,41;15941,79;2018-02-13;13/02/2018;AUTOPISTAS;Gastos_Ocio y transporte;Parking y peaje;2;VARIABLES
16/02/2018;16/02/2018;T/ AUTOPISTAS TERR 13-02-2018;-1,41;15941,79;15940,38;10721;-1,41;15940,38;2018-02-13;13/02/2018;AUTOPISTAS;Gastos_Ocio y transporte;Parking y peaje;2;VARIABLES
17/02/2018;17/02/2018;T/ BON AREA 14-02-2018;-28,33;15940,38;15912,05;10722;-28,33;15912,05;2018-02-14;14/02/2018;BON;Gastos_Compras;Supermercado;2;VARIABLES
17/02/2018;17/02/2018;T/ AUTOPISTAS TERR 14-02-2018;-1,41;15912,05;15910,64;10723;-1,41;15910,64;2018-02-14;14/02/2018;AUTOPISTAS;Gastos_Ocio y transporte;Parking y peaje;2;VARIABLES
17/02/2018;17/02/2018;T/ AUTOPISTAS TERR 14-02-2018;-1,41;15910,64;15909,23;10724;-1,41;15909,23;2018-02-14;14/02/2018;AUTOPISTAS;Gastos_Ocio y transporte;Parking y peaje;2;VARIABLES
17/02/2018;17/02/2018;T/ TUNELS VALLVI S. 14-02-2018;-4,25;15909,23;15904,98;10725;-4,25;15904,98;2018-02-14;14/02/2018;TUNELS;Gastos_Ocio y transporte;Parking y peaje;2;VARIABLES
18/02/2018;18/02/2018;T/ AUTOPISTAS TERR 15-02-2018;-1,41;15904,98;15903,57;10726;-1,41;15903,57;2018-02-15;15/02/2018;AUTOPISTAS;Gastos_Ocio y transporte;Parking y peaje;2;VARIABLES
18/02/2018;18/02/2018;T/ AUTOPISTAS TERR 15-02-2018;-1,41;15903,57;15902,16;10727;-1,41;15902,16;2018-02-15;15/02/2018;AUTOPISTAS;Gastos_Ocio y transporte;Parking y peaje;2;VARIABLES
18/02/2018;18/02/2018;T/ TUNELS VALLVI S. 15-02-2018;-4,25;15902,16;15897,91;10728;-4,25;15897,91;2018-02-15;15/02/2018;TUNELS;Gastos_Ocio y transporte;Parking y peaje;2;VARIABLES
19/02/2018;19/02/2018;T/ AP. DR. ROBERT - TE 16-02-2018;-6,25;15897,91;15891,66;10729;-6,25;15891,66;2018-02-16;16/02/2018;ROBERT;Gastos_Ocio y transporte;Parking y peaje;2;VARIABLES
19/02/2018;19/02/2018;T/ CAFET.C T PRAT\PRAT 16-02-2018;-3,80;15891,66;15887,86;10730;-3,80;15887,86;2018-02-16;16/02/2018;CAFETC;Gastos_Ocio y transporte;Restaurantes;2;VARIABLES
20/02/2018;17/02/2018;T/ CARREFOUR VALLE;-33,35;15887,86;15854,51;10731;-33,35;15854,51;2018-02-17;17/02/2018;CARREFOUR;Gastos_Compras;Supermercado;2;VARIABLES
20/02/2018;20/02/2018;T/ AKI 104 - TERRASSA\ 17-02-2018;-3,08;15854,51;15851,43;10732;-3,08;15851,43;2018-02-17;17/02/2018;AKI;Gastos_Vivienda y vehiculo;Mnto. hogar;2;VARIABLES
20/02/2018;20/02/2018;T/ DRIM CAN PARELLADA\ 17-02-2018;-14,99;15851,43;15836,44;10733;-14,99;15836,44;2018-02-17;17/02/2018;DRIM;Gastos_Compras;Niños;2;VARIABLES
20/02/2018;20/02/2018;T/ MEGA ASIA \ 17-02-2018;-30,60;15836,44;15805,84;10734;-30,60;15805,84;2018-02-17;17/02/2018;MEGA;Gastos_Compras;Hogar;2;VARIABLES
20/02/2018;20/02/2018;T/ DECATHLON SA TERRA\ 17-02-2018;-23,96;15805,84;15781,88;10735;-23,96;15781,88;2018-02-17;17/02/2018;DECATHLON;Gastos_Compras;Deportivo;2;VARIABLES
21/02/2018;21/02/2018;T/  BON AREA 18-02-2018;-26,84;15781,88;15755,04;10736;-26,84;15755,04;2018-02-18;18/02/2018;BON;Gastos_Compras;Supermercado;2;VARIABLES
21/02/2018;21/02/2018;T/  TUNELS VALLVI S. 16-02-2018;-4,25;15755,04;15750,79;10737;-4,25;15750,79;2018-02-16;16/02/2018;TUNELS;Gastos_Ocio y transporte;Parking y peaje;2;VARIABLES
21/02/2018;21/02/2018;T/  AUTOPISTAS TERR 16-02-2018;-1,41;15750,79;15749,38;10738;-1,41;15749,38;2018-02-16;16/02/2018;AUTOPISTAS;Gastos_Ocio y transporte;Parking y peaje;2;VARIABLES
21/02/2018;21/02/2018;T/  AUTOPISTAS TERR 16-02-2018;-1,41;15749,38;15747,97;10739;-1,41;15747,97;2018-02-16;16/02/2018;AUTOPISTAS;Gastos_Ocio y transporte;Parking y peaje;2;VARIABLES
22/02/2018;22/02/2018;T/  AUTOPISTAS TERR 19-02-2018;-1,41;15747,97;15746,56;10740;-1,41;15746,56;2018-02-19;19/02/2018;AUTOPISTAS;Gastos_Ocio y transporte;Parking y peaje;2;VARIABLES
22/02/2018;22/02/2018;T/  AUTOPISTAS TERR 19-02-2018;-1,41;15746,56;15745,15;10741;-1,41;15745,15;2018-02-19;19/02/2018;AUTOPISTAS;Gastos_Ocio y transporte;Parking y peaje;2;VARIABLES
23/02/2018;23/02/2018;T/  AUTOPISTAS TERR 20-02-2018;-1,41;15745,15;15743,74;10742;-1,41;15743,74;2018-02-20;20/02/2018;AUTOPISTAS;Gastos_Ocio y transporte;Parking y peaje;2;VARIABLES
23/02/2018;23/02/2018;T/  AUTOPISTAS TERR 20-02-2018;-1,41;15743,74;15742,33;10743;-1,41;15742,33;2018-02-20;20/02/2018;AUTOPISTAS;Gastos_Ocio y transporte;Parking y peaje;2;VARIABLES
23/02/2018;23/02/2018;T/  TUNELS VALLVI S. 20-02-2018;-4,25;15742,33;15738,08;10744;-4,25;15738,08;2018-02-20;20/02/2018;TUNELS;Gastos_Ocio y transporte;Parking y peaje;2;VARIABLES
25/02/2018;25/02/2018;T/  E.S. RUBI II 22-02-2018;-45,79;15738,08;15692,29;10745;-45,79;15692,29;2018-02-22;22/02/2018;RUBI;Gastos_Ocio y transporte;Gasolina;2;VARIABLES
26/02/2018;26/02/2018;HAB.  FOMENT DE TERRASSA S.A. Transf;1832,86;15692,29;17525,15;10746;1832,86;17525,15;2018-02-26;26/02/2018;HAB;Ingresos;Nomina;2;FIJO
27/02/2018;27/02/2018;HAB.  INFORMACIO I TECNOLOGIA DE CAT;1659,70;17525,15;19184,85;10747;1659,70;19184,85;2018-02-27;27/02/2018;HAB;Ingresos;Nomina;2;FIJO
28/02/2018;28/02/2018;REC.  6061.9600001223;-448,11;19184,85;18736,74;10748;-448,11;18736,74;2018-02-28;28/02/2018;REC;Gastos_Banco y organismos;Hipoteca;2;FIJO
28/02/2018;28/02/2018;T/  BON AREA 25-02-2018;-25,93;18736,74;18710,81;10749;-25,93;18710,81;2018-02-25;25/02/2018;BON;Gastos_Compras;Supermercado;2;VARIABLES
01/03/2018;01/03/2018;FACT TARJETAS  TARJ.CREDITO 07126017 18-03-01;-244,52;18710,81;18466,29;10750;-244,52;18466,29;2018-03-01;28/02/2018;FACT 07126017;Gastos_Banco y organismos;Credito Bea;2;VARIABLE
01/03/2018;01/03/2018;FACT TARJETAS  TARJ.CREDITO 42689013 18-03-01;-551,87;18466,29;17914,42;10751;-551,87;17914,42;2018-03-01;28/02/2018;FACT;No computable;Recibo Tarjeta;2;
01/03/2018;01/03/2018;R/  Escola d Idi SALT IDIOMES. Ade;-39,00;17914,42;17875,42;10752;-39,00;17875,42;2018-03-01;01/03/2018;ESCOLA;Gastos_Salud, saber y deporte;Estudios;3;VARIABLES
01/03/2018;01/03/2018;T/ VIENA PARC VALLES \ 26-02-2018;-9,45;17875,42;17865,97;10753;-9,45;17865,97;2018-02-26;26/02/2018;VIENA;Gastos_Ocio y transporte;Restaurantes;2;VARIABLES
02/03/2018;02/03/2018;T/ TUNELS VALLVI S. 27-02-2018;-3,78;17865,97;17862,19;10754;-3,78;17862,19;2018-02-27;27/02/2018;TUNELS;Gastos_Ocio y transporte;Parking y peaje;2;VARIABLES
04/03/2018;04/03/2018;T/ CAFET.C T PRAT\PRAT 01-03-2018;-3,15;17862,19;17859,04;10755;-3,15;17859,04;2018-03-01;01/03/2018;CAFETC;Gastos_Ocio y transporte;Restaurantes;3;VARIABLES
04/03/2018;04/03/2018;T/ BON AREA 01-03-2018;-26,90;17859,04;17832,14;10756;-26,90;17832,14;2018-03-01;01/03/2018;BON;Gastos_Compras;Supermercado;3;VARIABLES
04/03/2018;04/03/2018;T/ REDPIZZA \ 01-03-2018;-19,95;17832,14;17812,19;10757;-19,95;17812,19;2018-03-01;01/03/2018;REDPIZZA;Gastos_Ocio y transporte;Restaurantes;3;VARIABLES
04/03/2018;04/03/2018;T/ AUTOPISTAS TERR 27-02-2018;-1,41;17812,19;17810,78;10758;-1,41;17810,78;2018-02-27;27/02/2018;AUTOPISTAS;Gastos_Ocio y transporte;Parking y peaje;2;VARIABLES
05/03/2018;05/03/2018;'R/ COOPERATIVA L''EINA COOPE Rebut:';-47,60;17810,78;17763,18;10759;-47,60;17763,18;2018-03-05;05/03/2018;COOPERATIVA;Gastos_Salud, saber y deporte;Estudios;3;VARIABLES
05/03/2018;05/03/2018;T/ PARC VALLES \ 02-03-2018;-47,67;17763,18;17715,51;10760;-47,67;17715,51;2018-03-02;02/03/2018;PARC;Gastos_Compras;Supermercado;3;VARIABLES
05/03/2018;05/03/2018;T/ VIENA PARC VALLES \ 02-03-2018;-22,90;17715,51;17692,61;10761;-22,90;17692,61;2018-03-02;02/03/2018;VIENA;Gastos_Ocio y transporte;Restaurantes;3;VARIABLES
06/03/2018;06/03/2018;T/ COSTA COFFEE \B 03-03-2018;-8,55;17692,61;17684,06;10762;-8,55;17684,06;2018-03-03;03/03/2018;COSTA;Gastos_Ocio y transporte;Restaurantes;3;VARIABLES
06/03/2018;06/03/2018;'T/ tommy mel''s \ 03-03-2018';-57,15;17684,06;17626,91;10763;-57,15;17626,91;2018-03-03;03/03/2018;TOMMY;Gastos_Ocio y transporte;Restaurantes;3;VARIABLES
07/03/2018;07/03/2018;T/ AUTOPISTAS TERR 02-03-2018;-1,41;17626,91;17625,50;10764;-1,41;17625,50;2018-03-02;02/03/2018;AUTOPISTAS;Gastos_Ocio y transporte;Parking y peaje;3;VARIABLES
07/03/2018;07/03/2018;T/ AUTOPISTAS TERR 01-03-2018;-1,41;17625,50;17624,09;10765;-1,41;17624,09;2018-03-01;01/03/2018;AUTOPISTAS;Gastos_Ocio y transporte;Parking y peaje;3;VARIABLES
08/03/2018;08/03/2018;R/ ALIMENTACION SERHS FOOD A Comed;-101,15;17624,09;17522,94;10766;-101,15;17522,94;2018-03-08;08/03/2018;ALIMENTACION;Gastos_Salud, saber y deporte;Menjador;3;FIJO
08/03/2018;08/03/2018;R/ ALIMENTACION SERHS FOOD A Comed;-29,75;17522,94;17493,19;10767;-29,75;17493,19;2018-03-08;08/03/2018;ALIMENTACION;Gastos_Salud, saber y deporte;Menjador;3;FIJO
08/03/2018;08/03/2018;T/ CAFET.C T PRAT\PRAT 05-03-2018;-3,80;17493,19;17489,39;10768;-3,80;17489,39;2018-03-05;05/03/2018;CAFETC;Gastos_Ocio y transporte;Restaurantes;3;VARIABLES
08/03/2018;08/03/2018;T/ TERRACASA \ 05-03-2018;-7,17;17489,39;17482,22;10769;-7,17;17482,22;2018-03-05;05/03/2018;TERRACASA;Gastos_Compras;Otras compras;3;VARIABLES
09/03/2018;09/03/2018;T/ AUTOPISTAS TERR 05-03-2018;-1,41;17482,22;17480,81;10770;-1,41;17480,81;2018-03-05;05/03/2018;AUTOPISTAS;Gastos_Ocio y transporte;Parking y peaje;3;VARIABLES
09/03/2018;09/03/2018;T/ AUTOPISTAS TERR 05-03-2018;-1,41;17480,81;17479,40;10771;-1,41;17479,40;2018-03-05;05/03/2018;AUTOPISTAS;Gastos_Ocio y transporte;Parking y peaje;3;VARIABLES
10/03/2018;10/03/2018;T/ AUTOPISTAS TERR 07-03-2018;-1,41;17479,40;17477,99;10772;-1,41;17477,99;2018-03-07;07/03/2018;AUTOPISTAS;Gastos_Ocio y transporte;Parking y peaje;3;VARIABLES
10/03/2018;10/03/2018;T/ TUNELS VALLVI S. 07-03-2018;-3,78;17477,99;17474,21;10773;-3,78;17474,21;2018-03-07;07/03/2018;TUNELS;Gastos_Ocio y transporte;Parking y peaje;3;VARIABLES
10/03/2018;10/03/2018;T/ VIENA PARC VALLES \ 07-03-2018;-10,35;17474,21;17463,86;10774;-10,35;17463,86;2018-03-07;07/03/2018;VIENA;Gastos_Ocio y transporte;Restaurantes;3;VARIABLES
10/03/2018;10/03/2018;T/ WWW.JUST-EAT.ES 07-03-2018;-33,80;17463,86;17430,06;10775;-33,80;17430,06;2018-03-07;07/03/2018;WWWJUSTEATES;Gastos_Ocio y transporte;Restaurantes;3;VARIABLES
12/03/2018;12/03/2018;R/ GAS GAS NATURAL GNS27630480318;-4,64;17430,06;17425,42;10776;-4,64;17425,42;2018-03-12;12/03/2018;GAS;Gastos_Servicios tipicos;Gas;3;FIJO
12/03/2018;12/03/2018;R/ . FINQUES GASS Vto 01-03-18 Rec;-73,69;17425,42;17351,73;10777;-73,69;17351,73;2018-03-01;01/03/2018;FINQUES;Gastos_Vivienda y vehiculo;Alquiler Parking;3;FIJO
12/03/2018;12/03/2018;CAJ. AJENO SERVIRED \MADRID;-300,00;17351,73;17051,73;10778;-300,00;17051,73;2018-03-12;12/03/2018;CAJ;Gastos_Gastos varios;Efectivo;3;VARIABLES
12/03/2018;12/03/2018;COM. 64970036 SVRED CAJ OFI;-1,87;17051,73;17049,86;10779;-1,87;17049,86;2018-03-12;12/03/2018;COM;Gastos_Banco y organismos;Cargos banco;3;FIJO
12/03/2018;12/03/2018;T/ TARRASSA CARNES IND 09-03-2018;-40,13;17049,86;17009,73;10780;-40,13;17009,73;2018-03-09;09/03/2018;TARRASSA;Gastos_Compras;Supermercado;3;VARIABLES
12/03/2018;12/03/2018;T/ LIDL TERRASSA \ 09-03-2018;-25,82;17009,73;16983,91;10781;-25,82;16983,91;2018-03-09;09/03/2018;LIDL;Gastos_Compras;Supermercado;3;VARIABLES
13/03/2018;13/03/2018;R/ TELECOMUNICACI VODAFONE;-144,42;16983,91;16839,49;10782;-144,42;16839,49;2018-03-13;13/03/2018;TELECOMUNICACI;Gastos_Servicios tipicos;Telecomunicaciones;3;FIJO
14/03/2018;14/03/2018;R/ LUZ ENDESA ENERG FACTURA DE ELE;-123,87;16839,49;16715,62;10783;-123,87;16715,62;2018-03-14;14/03/2018;ELE;Gastos_Servicios tipicos;Electricidad;3;FIJO
15/03/2018;15/03/2018;T/ VIENA PARC VALLES \ 12-03-2018;-9,70;16715,62;16705,92;10784;-9,70;16705,92;2018-03-12;12/03/2018;VIENA;Gastos_Ocio y transporte;Restaurantes;3;VARIABLES
15/03/2018;15/03/2018;T/ AUTOPISTAS TERR 12-03-2018;-1,41;16705,92;16704,51;10785;-1,41;16704,51;2018-03-12;12/03/2018;AUTOPISTAS;Gastos_Ocio y transporte;Parking y peaje;3;VARIABLES
16/03/2018;16/03/2018;R/ SEGUROS CCM VIDA Y P Recibo:148;-15,78;16704,51;16688,73;10786;-15,78;16688,73;2018-03-16;16/03/2018;CCM;Gastos_Seguros;Seguro vida;3;FIJO
16/03/2018;16/03/2018;R/ SEGUROS CCM VIDA Y P Recibo:148;-18,60;16688,73;16670,13;10787;-18,60;16670,13;2018-03-16;16/03/2018;CCM;Gastos_Seguros;Seguro vida;3;FIJO
16/03/2018;16/03/2018;T/ AUTOPISTAS TERR 13-03-2018;-1,41;16670,13;16668,72;10788;-1,41;16668,72;2018-03-13;13/03/2018;AUTOPISTAS;Gastos_Ocio y transporte;Parking y peaje;3;VARIABLES
16/03/2018;16/03/2018;T/ TUNELS VALLVI S. 13-03-2018;-4,25;16668,72;16664,47;10789;-4,25;16664,47;2018-03-13;13/03/2018;TUNELS;Gastos_Ocio y transporte;Parking y peaje;3;VARIABLES
18/03/2018;18/03/2018;T/ TUNELS VALLVI S. 15-03-2018;-4,25;16664,47;16660,22;10790;-4,25;16660,22;2018-03-15;15/03/2018;TUNELS;Gastos_Ocio y transporte;Parking y peaje;3;VARIABLES
18/03/2018;18/03/2018;T/ PARC VALLES \ 15-03-2018;-19,95;16660,22;16640,27;10791;-19,95;16640,27;2018-03-15;15/03/2018;PARC;Gastos_Compras;Supermercado;3;VARIABLES
19/03/2018;19/03/2018;R/ SEGUROS ADESLAS CENT MODULAR CO;-159,81;16640,27;16480,46;10792;-159,81;16480,46;2018-03-19;19/03/2018;ADESLAS;Gastos_Salud, saber y deporte;Medico;3;VARIABLES
19/03/2018;19/03/2018;T/ WWW.JUST-EAT.ES 16-03-2018;-17,60;16480,46;16462,86;10793;-17,60;16462,86;2018-03-16;16/03/2018;WWWJUSTEATES;Gastos_Ocio y transporte;Restaurantes;3;VARIABLES
19/03/2018;19/03/2018;T/ AUTOPISTAS TERR 15-03-2018;-1,41;16462,86;16461,45;10794;-1,41;16461,45;2018-03-15;15/03/2018;AUTOPISTAS;Gastos_Ocio y transporte;Parking y peaje;3;VARIABLES
19/03/2018;19/03/2018;T/ AUTOPISTAS TERR 15-03-2018;-1,41;16461,45;16460,04;10795;-1,41;16460,04;2018-03-15;15/03/2018;AUTOPISTAS;Gastos_Ocio y transporte;Parking y peaje;3;VARIABLES
19/03/2018;19/03/2018;T/ LIDL TERRASSA \TERRASSA;-56,60;16460,04;16403,44;10796;-56,60;16403,44;2018-03-19;19/03/2018;LIDL;Gastos_Compras;Supermercado;3;VARIABLES
20/03/2018;20/03/2018;T/ CERTIO ITV VIL\VILADECAVALL;-45,40;16403,44;16358,04;10797;-45,40;16358,04;2018-03-20;20/03/2018;CERTIO;Gastos_Vivienda y vehiculo;Mnto. vehiculo;3;VARIABLE
20/03/2018;17/03/2018;T/ PRIMARK BARCA- DIAGONA;-92,50;16358,04;16265,54;10798;-92,50;16265,54;2018-03-17;17/03/2018;PRIMARK;Gastos_Compras;Ropa;3;VARIABLES
20/03/2018;20/03/2018;T/ D PARKING SOCIEDA\B 17-03-2018;-0,30;16265,54;16265,24;10799;-0,30;16265,24;2018-03-17;17/03/2018;PARKING;Gastos_Ocio y transporte;Parking y peaje;3;VARIABLES
20/03/2018;20/03/2018;T/ LEFTIES \B 17-03-2018;-20,00;16265,24;16245,24;10800;-20,00;16245,24;2018-03-17;17/03/2018;LEFTIES;Gastos_Compras;Ropa;3;VARIABLES
20/03/2018;20/03/2018;T/ KURZ GUT DIAGONAL\B 17-03-2018;-26,10;16245,24;16219,14;10801;-26,10;16219,14;2018-03-17;17/03/2018;KURZ;Gastos_Ocio y transporte;Restaurantes;3;VARIABLES
20/03/2018;20/03/2018;T/ LA GARRIGA - GLOR\B 17-03-2018;-8,00;16219,14;16211,14;10802;-8,00;16211,14;2018-03-17;17/03/2018;GARRIGA;Gastos_Ocio y transporte;Restaurantes;3;VARIABLES
20/03/2018;20/03/2018;T/ KENYAN COFFE \B 17-03-2018;-7,00;16211,14;16204,14;10803;-7,00;16204,14;2018-03-17;17/03/2018;KENYAN;Gastos_Ocio y transporte;Restaurantes;3;VARIABLES
20/03/2018;20/03/2018;T/ QUINLAN DIAGONAL \B 17-03-2018;-6,25;16204,14;16197,89;10804;-6,25;16197,89;2018-03-17;17/03/2018;QUINLAN;Gastos_Ocio y transporte;Restaurantes;3;VARIABLES
20/03/2018;20/03/2018;T/ C&A MODAS GLORIES\B 17-03-2018;-37,50;16197,89;16160,39;10805;-37,50;16160,39;2018-03-17;17/03/2018;MODAS;Gastos_Compras;Ropa;3;VARIABLES
20/03/2018;20/03/2018;T/ AUTOPISTAS TERR 16-03-2018;-1,41;16160,39;16158,98;10806;-1,41;16158,98;2018-03-16;16/03/2018;AUTOPISTAS;Gastos_Ocio y transporte;Parking y peaje;3;VARIABLES
21/03/2018;21/03/2018;R/ MINA PUBLICA AIGUES T.01A75789;-58,07;16158,98;16100,91;10807;-58,07;16100,91;2018-03-21;21/03/2018;MINA;Gastos_Servicios tipicos;Agua;3;FIJO
21/03/2018;21/03/2018;T/ SHIBUYA \ 18-03-2018;-54,25;16100,91;16046,66;10808;-54,25;16046,66;2018-03-18;18/03/2018;SHIBUYA;Gastos_Ocio y transporte;Restaurantes;3;VARIABLES
22/03/2018;22/03/2018;T/ AUTOPISTAS TERR 19-03-2018;-1,41;16046,66;16045,25;10809;-1,41;16045,25;2018-03-19;19/03/2018;AUTOPISTAS;Gastos_Ocio y transporte;Parking y peaje;3;VARIABLES
22/03/2018;22/03/2018;T/ AUTOPISTAS TERR 19-03-2018;-1,41;16045,25;16043,84;10810;-1,41;16043,84;2018-03-19;19/03/2018;AUTOPISTAS;Gastos_Ocio y transporte;Parking y peaje;3;VARIABLES
22/03/2018;22/03/2018;T/ CAFET.C T PRAT\PRAT 19-03-2018;-3,80;16043,84;16040,04;10811;-3,80;16040,04;2018-03-19;19/03/2018;CAFETC;Gastos_Ocio y transporte;Restaurantes;3;VARIABLES
23/03/2018;23/03/2018;T/ AUTOPISTAS TERR 20-03-2018;-1,41;16040,04;16038,63;10812;-1,41;16038,63;2018-03-20;20/03/2018;AUTOPISTAS;Gastos_Ocio y transporte;Parking y peaje;3;VARIABLES
23/03/2018;23/03/2018;T/ BENZINERA VILA\VILA 20-03-2018;-30,00;16038,63;16008,63;10813;-30,00;16008,63;2018-03-20;20/03/2018;BENZINERA;Gastos_Ocio y transporte;Gasolina;3;VARIABLES
23/03/2018;23/03/2018;T/ CAFET.C T PRAT\PRAT 20-03-2018;-3,35;16008,63;16005,28;10814;-3,35;16005,28;2018-03-20;20/03/2018;CAFETC;Gastos_Ocio y transporte;Restaurantes;3;VARIABLES
24/03/2018;24/03/2018;S/OR. JUANDIK;-40,00;16005,28;15965,28;10815;-40,00;15965,28;2018-03-24;24/03/2018;JUANDIK;Gastos_Ocio y transporte;Loterias;3;
24/03/2018;24/03/2018;T/ CAFET.C T PRAT\PRAT 21-03-2018;-1,35;15965,28;15963,93;10816;-1,35;15963,93;2018-03-21;21/03/2018;CAFETC;Gastos_Ocio y transporte;Restaurantes;3;VARIABLES
24/03/2018;24/03/2018;T/ AUTOPISTAS TERR 21-03-2018;-1,41;15963,93;15962,52;10817;-1,41;15962,52;2018-03-21;21/03/2018;AUTOPISTAS;Gastos_Ocio y transporte;Parking y peaje;3;VARIABLES
27/03/2018;27/03/2018;HAB. INFORMACIO I TECNOLOGIA DE CAT;1582,71;15962,52;17545,23;10818;1582,71;17545,23;2018-03-27;27/03/2018;HAB;Ingresos;Nomina;3;FIJO
27/03/2018;27/03/2018;T/ EL RACO \ 24-03-2018;-79,55;17545,23;17465,68;10819;-79,55;17465,68;2018-03-24;24/03/2018;RACO;Gastos_Ocio y transporte;Restaurantes;3;VARIABLES
27/03/2018;27/03/2018;T/ WWW.JUST-EAT.ES 24-03-2018;-39,74;17465,68;17425,94;10820;-39,74;17425,94;2018-03-24;24/03/2018;WWWJUSTEATES;Gastos_Ocio y transporte;Restaurantes;3;VARIABLES
28/03/2018;28/03/2018;R/ AYUNTAMIENTO AJUNTAMENT D I.B.I;-47,13;17425,94;17378,81;10821;-47,13;17378,81;2018-03-28;28/03/2018;AYUNTAMIENTO;Gastos_Banco y organismos;Ayuntamiento;3;FIJO
28/03/2018;28/03/2018;HAB. AJUNTAMENT DE TERRASSA Transfe;1837,84;17378,81;19216,65;10822;1837,84;19216,65;2018-03-28;28/03/2018;HAB;Ingresos;Nomina;3;FIJO
28/03/2018;28/03/2018;T/ E.S. RUBI II 25-03-2018;-40,01;19216,65;19176,64;10823;-40,01;19176,64;2018-03-25;25/03/2018;RUBI;Gastos_Ocio y transporte;Gasolina;3;VARIABLES
28/03/2018;28/03/2018;T/ MCDONALD S TORTOSA 25-03-2018;-22,70;19176,64;19153,94;10824;-22,70;19153,94;2018-03-25;25/03/2018;MCDONALD;Gastos_Ocio y transporte;Restaurantes;3;VARIABLES
28/03/2018;28/03/2018;T/ AUTOPISTAS TERR 25-03-2018;-2,56;19153,94;19151,38;10825;-2,56;19151,38;2018-03-25;25/03/2018;AUTOPISTAS;Gastos_Ocio y transporte;Parking y peaje;3;VARIABLES
28/03/2018;28/03/2018;'T/ MACDONAL''S TORTOSA 25-03-2018';-2,25;19151,38;19149,13;10826;-2,25;19149,13;2018-03-25;25/03/2018;MACDONALS;Gastos_Ocio y transporte;Restaurantes;3;VARIABLES
29/03/2018;29/03/2018;T/ AUTOPISTA MARE NOST 25-03-2018;-7,20;19149,13;19141,93;10827;-7,20;19141,93;2018-03-25;25/03/2018;AUTOPISTA;Gastos_Ocio y transporte;Parking y peaje;3;VARIABLES
29/03/2018;29/03/2018;T/ A.C.E.S.A B MART -L 25-03-2018;-10,70;19141,93;19131,23;10828;-10,70;19131,23;2018-03-25;25/03/2018;ACESA;Gastos_Ocio y transporte;Parking y peaje;3;VARIABLES
30/03/2018;30/03/2018;CAJ. AJENO CAIXABANK \HORTA DE SANT;-300,00;19131,23;18831,23;10829;-300,00;18831,23;2018-03-30;30/03/2018;CAJ;Gastos_Gastos varios;Efectivo;3;VARIABLES
30/03/2018;30/03/2018;COM. 64970036 SVRED CAJ OFI;-2,00;18831,23;18829,23;10830;-2,00;18829,23;2018-03-30;30/03/2018;COM;Gastos_Banco y organismos;Cargos banco;3;FIJO
30/03/2018;30/03/2018;T/ CINES OSCAR \ 27-03-2018;-9,80;18829,23;18819,43;10831;-9,80;18819,43;2018-03-27;27/03/2018;CINES;Gastos_Ocio y transporte;Espectáculos;3;VARIABLES
30/03/2018;30/03/2018;T/ CINES OSCAR \ 27-03-2018;-5,61;18819,43;18813,82;10832;-5,61;18813,82;2018-03-27;27/03/2018;CINES;Gastos_Ocio y transporte;Espectáculos;3;VARIABLES
30/03/2018;30/03/2018;T/ LIZARRAN TORTOSA 27-03-2018;-20,50;18813,82;18793,32;10833;-20,50;18793,32;2018-03-27;27/03/2018;LIZARRAN;Gastos_Ocio y transporte;Restaurantes;3;VARIABLES
31/03/2018;31/03/2018;REC. 6061.9600001223;-448,11;18793,32;18345,21;10834;-448,11;18345,21;2018-03-31;31/03/2018;REC;Gastos_Banco y organismos;Hipoteca;3;FIJO
01/04/2018;01/04/2018;FACT TARJETAS TARJ.CREDITO 07126017 18-04-01;-582,50;18345,21;17762,71;10835;-582,50;17762,71;2018-04-01;31/03/2018;FACT 07126017;Gastos_Banco y organismos;Credito Bea;3;VARIABLE
01/04/2018;01/04/2018;FACT TARJETAS TARJ.CREDITO 42689013 18-04-01;-399,37;17762,71;17363,34;10836;-399,37;17363,34;2018-04-01;31/03/2018;FACT;No computable;Recibo Tarjeta;3;
01/04/2018;01/04/2018;T/ CINES OSCAR \ 29-03-2018;-11,08;17363,34;17352,26;10837;-11,08;17352,26;2018-03-29;29/03/2018;CINES;Gastos_Ocio y transporte;Espectáculos;3;VARIABLES
03/04/2018;03/04/2018;R/ Escola d Idi SALT IDIOMES. Ade;-39,00;17352,26;17313,26;10838;-39,00;17313,26;2018-04-03;03/04/2018;ESCOLA;Gastos_Salud, saber y deporte;Estudios;4;VARIABLES
03/04/2018;03/04/2018;T/ MERCADONA QUATRE C\TERRASSA;-143,91;17313,26;17169,35;10839;-143,91;17169,35;2018-04-03;03/04/2018;MERCADONA;Gastos_Compras;Supermercado;4;VARIABLES
04/04/2018;04/04/2018;R/ LUZ ENDESA ENERG FACTURA DE GAS;-208,85;17169,35;16960,50;10840;-208,85;16960,50;2018-04-04;04/04/2018;GAS;Gastos_Servicios tipicos;Gas;4;FIJO
04/04/2018;04/04/2018;R/ SEGUROS SEGUROS CATA INCLUIDO S;-330,26;16960,50;16630,24;10841;-330,26;16630,24;2018-04-04;04/04/2018;CATA;Gastos_Seguros;Seguro auto;4;FIJO
04/04/2018;04/04/2018;T/ TEMPLE 01-04-2018;-32,44;16630,24;16597,80;10842;-32,44;16597,80;2018-04-01;01/04/2018;TEMPLE;Gastos_Ocio y transporte;Gasolina;4;VARIABLES
05/04/2018;05/04/2018;'R/ COOPERATIVA L''EINA COOPE Rebut:';-47,60;16597,80;16550,20;10843;-47,60;16550,20;2018-04-05;05/04/2018;COOPERATIVA;Gastos_Salud, saber y deporte;Estudios;4;VARIABLES
05/04/2018;05/04/2018;R/ SEGUROS ADESLAS CENT MODULAR CO;-159,81;16550,20;16390,39;10844;-159,81;16390,39;2018-04-05;05/04/2018;ADESLAS;Gastos_Salud, saber y deporte;Medico;4;VARIABLES
05/04/2018;05/04/2018;T/ WWW.JUST-EAT.ES 02-04-2018;-50,25;16390,39;16340,14;10845;-50,25;16340,14;2018-04-02;02/04/2018;WWWJUSTEATES;Gastos_Ocio y transporte;Restaurantes;4;VARIABLES
06/04/2018;06/04/2018;T/ MERCADONA QUATRE C\ 03-04-2018;-10,10;16340,14;16330,04;10846;-10,10;16330,04;2018-04-03;03/04/2018;MERCADONA;Gastos_Compras;Supermercado;4;VARIABLES
06/04/2018;06/04/2018;T/ CAFET.C T PRAT\PRAT 03-04-2018;-3,50;16330,04;16326,54;10847;-3,50;16326,54;2018-04-03;03/04/2018;CAFETC;Gastos_Ocio y transporte;Restaurantes;4;VARIABLES
06/04/2018;06/04/2018;T/ WWW.JUST-EAT.ES 03-04-2018;-30,50;16326,54;16296,04;10848;-30,50;16296,04;2018-04-03;03/04/2018;WWWJUSTEATES;Gastos_Ocio y transporte;Restaurantes;4;VARIABLES
07/04/2018;07/04/2018;T/ AUTOPISTAS TERR 04-04-2018;-1,41;16296,04;16294,63;10849;-1,41;16294,63;2018-04-04;04/04/2018;AUTOPISTAS;Gastos_Ocio y transporte;Parking y peaje;4;VARIABLES
07/04/2018;07/04/2018;T/ CAFET.C T PRAT\PRAT 04-04-2018;-3,50;16294,63;16291,13;10850;-3,50;16291,13;2018-04-04;04/04/2018;CAFETC;Gastos_Ocio y transporte;Restaurantes;4;VARIABLES
07/04/2018;07/04/2018;T/ WWW.JUST-EAT.ES 04-04-2018;-19,75;16291,13;16271,38;10851;-19,75;16271,38;2018-04-04;04/04/2018;WWWJUSTEATES;Gastos_Ocio y transporte;Restaurantes;4;VARIABLES
07/04/2018;07/04/2018;T/ AUTOPISTAS TERR 03-04-2018;-1,41;16271,38;16269,97;10852;-1,41;16269,97;2018-04-03;03/04/2018;AUTOPISTAS;Gastos_Ocio y transporte;Parking y peaje;4;VARIABLES
07/04/2018;07/04/2018;T/ AUTOPISTAS TERR 03-04-2018;-1,41;16269,97;16268,56;10853;-1,41;16268,56;2018-04-03;03/04/2018;AUTOPISTAS;Gastos_Ocio y transporte;Parking y peaje;4;VARIABLES
08/04/2018;08/04/2018;T/ WWW.JUST-EAT.ES 05-04-2018;-18,50;16268,56;16250,06;10854;-18,50;16250,06;2018-04-05;05/04/2018;WWWJUSTEATES;Gastos_Ocio y transporte;Restaurantes;4;VARIABLES
08/04/2018;08/04/2018;T/ AUTOPISTAS TERR 05-04-2018;-1,41;16250,06;16248,65;10855;-1,41;16248,65;2018-04-05;05/04/2018;AUTOPISTAS;Gastos_Ocio y transporte;Parking y peaje;4;VARIABLES
08/04/2018;08/04/2018;T/ AUTOPISTAS TERR 05-04-2018;-1,41;16248,65;16247,24;10856;-1,41;16247,24;2018-04-05;05/04/2018;AUTOPISTAS;Gastos_Ocio y transporte;Parking y peaje;4;VARIABLES
08/04/2018;08/04/2018;T/ BON AREA 05-04-2018;-17,94;16247,24;16229,30;10857;-17,94;16229,30;2018-04-05;05/04/2018;BON;Gastos_Compras;Supermercado;4;VARIABLES
09/04/2018;09/04/2018;R/ ALIMENTACION SERHS FOOD A Comed;-110,67;16229,30;16118,63;10858;-110,67;16118,63;2018-04-09;09/04/2018;ALIMENTACION;Gastos_Salud, saber y deporte;Menjador;4;FIJO
09/04/2018;09/04/2018;R/ ALIMENTACION SERHS FOOD A Comed;-30,87;16118,63;16087,76;10859;-30,87;16087,76;2018-04-09;09/04/2018;ALIMENTACION;Gastos_Salud, saber y deporte;Menjador;4;FIJO
10/04/2018;10/04/2018;R/ . FINQUES GASS Vto 01-04-18 Rec;-73,69;16087,76;16014,07;10860;-73,69;16014,07;2018-04-01;01/04/2018;FINQUES;Gastos_Vivienda y vehiculo;Alquiler Parking;4;FIJO
10/04/2018;10/04/2018;T/ AUTOPISTAS TERR 06-04-2018;-1,41;16014,07;16012,66;10861;-1,41;16012,66;2018-04-06;06/04/2018;AUTOPISTAS;Gastos_Ocio y transporte;Parking y peaje;4;VARIABLES
11/04/2018;11/04/2018;T/ CINESA WEB \B 08-04-2018;-27,60;16012,66;15985,06;10862;-27,60;15985,06;2018-04-08;08/04/2018;CINESA;Gastos_Ocio y transporte;Espectáculos;4;VARIABLES
12/04/2018;12/04/2018;R/ TELECOMUNICACI VODAFONE;-150,42;15985,06;15834,64;10863;-150,42;15834,64;2018-04-12;12/04/2018;TELECOMUNICACI;Gastos_Servicios tipicos;Telecomunicaciones;4;FIJO
12/04/2018;12/04/2018;R/ GAS GAS NATURAL GNS27630480418;-4,64;15834,64;15830,00;10864;-4,64;15830,00;2018-04-12;12/04/2018;GAS;Gastos_Servicios tipicos;Gas;4;FIJO
12/04/2018;12/04/2018;T/ VIENA PARC VALLES \ 09-04-2018;-11,95;15830,00;15818,05;10865;-11,95;15818,05;2018-04-09;09/04/2018;VIENA;Gastos_Ocio y transporte;Restaurantes;4;VARIABLES
12/04/2018;12/04/2018;T/ AUTOPISTAS TERR 09-04-2018;-1,41;15818,05;15816,64;10866;-1,41;15816,64;2018-04-09;09/04/2018;AUTOPISTAS;Gastos_Ocio y transporte;Parking y peaje;4;VARIABLES
12/04/2018;12/04/2018;T/ E.S. CAN CASANOVES\ 09-04-2018;-30,00;15816,64;15786,64;10867;-30,00;15786,64;2018-04-09;09/04/2018;CAN;Gastos_Ocio y transporte;Gasolina;4;VARIABLES
12/04/2018;12/04/2018;T/ TOCINERIES VENTURA\ 09-04-2018;-9,15;15786,64;15777,49;10868;-9,15;15777,49;2018-04-09;09/04/2018;TOCINERIES;Gastos_Compras;Supermercado;4;VARIABLES
13/04/2018;13/04/2018;T/ CAFET.C T PRAT\PRAT 10-04-2018;-6,35;15777,49;15771,14;10869;-6,35;15771,14;2018-04-10;10/04/2018;CAFETC;Gastos_Ocio y transporte;Restaurantes;4;VARIABLES
14/04/2018;14/04/2018;T/ CAFET.C T PRAT\PRAT 11-04-2018;-1,15;15771,14;15769,99;10870;-1,15;15769,99;2018-04-11;11/04/2018;CAFETC;Gastos_Ocio y transporte;Restaurantes;4;VARIABLES
15/04/2018;15/04/2018;T/ AUTOPISTAS TERR 12-04-2018;-1,41;15769,99;15768,58;10871;-1,41;15768,58;2018-04-12;12/04/2018;AUTOPISTAS;Gastos_Ocio y transporte;Parking y peaje;4;VARIABLES
15/04/2018;15/04/2018;T/ AUTOPISTAS TERR 12-04-2018;-1,41;15768,58;15767,17;10872;-1,41;15767,17;2018-04-12;12/04/2018;AUTOPISTAS;Gastos_Ocio y transporte;Parking y peaje;4;VARIABLES
16/04/2018;16/04/2018;T/ BON AREA 13-04-2018;-24,35;15767,17;15742,82;10873;-24,35;15742,82;2018-04-13;13/04/2018;BON;Gastos_Compras;Supermercado;4;VARIABLES
17/04/2018;17/04/2018;R/ SEGUROS CCM VIDA Y P Recibo:149;-15,71;15742,82;15727,11;10874;-15,71;15727,11;2018-04-17;17/04/2018;CCM;Gastos_Seguros;Seguro vida;4;FIJO
17/04/2018;17/04/2018;R/ SEGUROS CCM VIDA Y P Recibo:149;-18,54;15727,11;15708,57;10875;-18,54;15708,57;2018-04-17;17/04/2018;CCM;Gastos_Seguros;Seguro vida;4;FIJO
17/04/2018;17/04/2018;T/ REST.KAORI \BARBE 14-04-2018;-55,80;15708,57;15652,77;10876;-55,80;15652,77;2018-04-14;14/04/2018;RESTKAORI;Gastos_Ocio y transporte;Restaurantes;4;VARIABLES
18/04/2018;18/04/2018;'R/ COOPERATIVA L''EINA COOPE Rebut:';-10,00;15652,77;15642,77;10877;-10,00;15642,77;2018-04-18;18/04/2018;COOPERATIVA;Gastos_Salud, saber y deporte;Estudios;4;VARIABLES
18/04/2018;14/04/2018;T/ PERLES AND CO;-105,25;15642,77;15537,52;10878;-105,25;15537,52;2018-04-14;14/04/2018;PERLES;Gastos_Compras;Hobbys;4;VARIABLES
18/04/2018;18/04/2018;T/ TUNELS VALLVI S. 13-04-2018;-4,25;15537,52;15533,27;10879;-4,25;15533,27;2018-04-13;13/04/2018;TUNELS;Gastos_Ocio y transporte;Parking y peaje;4;VARIABLES
18/04/2018;18/04/2018;T/ AUTOPISTAS TERR 13-04-2018;-1,41;15533,27;15531,86;10880;-1,41;15531,86;2018-04-13;13/04/2018;AUTOPISTAS;Gastos_Ocio y transporte;Parking y peaje;4;VARIABLES
19/04/2018;19/04/2018;T/ CAFET.C T PRAT\PRAT 16-04-2018;-3,80;15531,86;15528,06;10881;-3,80;15528,06;2018-04-16;16/04/2018;CAFETC;Gastos_Ocio y transporte;Restaurantes;4;VARIABLES
20/04/2018;20/04/2018;T/ CAFET.C T PRAT\PRAT 17-04-2018;-2,70;15528,06;15525,36;10882;-2,70;15525,36;2018-04-17;17/04/2018;CAFETC;Gastos_Ocio y transporte;Restaurantes;4;VARIABLES
20/04/2018;20/04/2018;T/ AUTOPISTAS TERR 17-04-2018;-1,41;15525,36;15523,95;10883;-1,41;15523,95;2018-04-17;17/04/2018;AUTOPISTAS;Gastos_Ocio y transporte;Parking y peaje;4;VARIABLES
20/04/2018;20/04/2018;T/ AUTOPISTAS TERR 16-04-2018;-1,41;15523,95;15522,54;10884;-1,41;15522,54;2018-04-16;16/04/2018;AUTOPISTAS;Gastos_Ocio y transporte;Parking y peaje;4;VARIABLES
20/04/2018;20/04/2018;T/ AUTOPISTAS TERR 16-04-2018;-1,41;15522,54;15521,13;10885;-1,41;15521,13;2018-04-16;16/04/2018;AUTOPISTAS;Gastos_Ocio y transporte;Parking y peaje;4;VARIABLES
21/04/2018;21/04/2018;T/ AUTOPISTAS TERR 18-04-2018;-1,41;15521,13;15519,72;10886;-1,41;15519,72;2018-04-18;18/04/2018;AUTOPISTAS;Gastos_Ocio y transporte;Parking y peaje;4;VARIABLES
21/04/2018;21/04/2018;T/ E.S. CAN CASANOVES\ 18-04-2018;-30,00;15519,72;15489,72;10887;-30,00;15489,72;2018-04-18;18/04/2018;CAN;Gastos_Ocio y transporte;Gasolina;4;VARIABLES
22/04/2018;22/04/2018;T/ LA TERRASSETA \ 19-04-2018;-21,50;15489,72;15468,22;10888;-21,50;15468,22;2018-04-19;19/04/2018;TERRASSETA;Gastos_Ocio y transporte;Restaurantes;4;VARIABLES
22/04/2018;22/04/2018;T/ AUTOPISTAS TERR 19-04-2018;-1,41;15468,22;15466,81;10889;-1,41;15466,81;2018-04-19;19/04/2018;AUTOPISTAS;Gastos_Ocio y transporte;Parking y peaje;4;VARIABLES
23/04/2018;23/04/2018;T/ IUNIVERS \ 20-04-2018;-10,40;15466,81;15456,41;10890;-10,40;15456,41;2018-04-20;20/04/2018;IUNIVERS;Gastos_Ocio y transporte;Restaurantes;4;VARIABLES
23/04/2018;23/04/2018;T/ BON AREA 20-04-2018;-26,06;15456,41;15430,35;10891;-26,06;15430,35;2018-04-20;20/04/2018;BON;Gastos_Compras;Supermercado;4;VARIABLES
23/04/2018;23/04/2018;T/ HELADOS DINO \ 20-04-2018;-7,80;15430,35;15422,55;10892;-7,80;15422,55;2018-04-20;20/04/2018;HELADOS;Gastos_Ocio y transporte;Restaurantes;4;VARIABLES
24/04/2018;24/04/2018;T/ VIENA TERRASSA CEN\ 21-04-2018;-11,00;15422,55;15411,55;10893;-11,00;15411,55;2018-04-21;21/04/2018;VIENA;Gastos_Ocio y transporte;Restaurantes;4;VARIABLES
24/04/2018;24/04/2018;T/ BAZAR ORIENTE \ 21-04-2018;-10,27;15411,55;15401,28;10894;-10,27;15401,28;2018-04-21;21/04/2018;BAZAR;Gastos_Compras;Hobbys;4;VARIABLES
25/04/2018;25/04/2018;T/ BON AREA 22-04-2018;-7,91;15401,28;15393,37;10895;-7,91;15393,37;2018-04-22;22/04/2018;BON;Gastos_Compras;Supermercado;4;VARIABLES
27/04/2018;27/04/2018;HAB. INFORMACIO I TECNOLOGIA DE CAT;1661,34;15393,37;17054,71;10896;1661,34;17054,71;2018-04-27;27/04/2018;HAB;Ingresos;Nomina;4;FIJO
27/04/2018;27/04/2018;HAB. AJUNTAMENT DE TERRASSA Transfe;1829,72;17054,71;18884,43;10897;1829,72;18884,43;2018-04-27;27/04/2018;HAB;Ingresos;Nomina;4;FIJO
27/04/2018;27/04/2018;T/ ATRAPALO COM \B 24-04-2018;-38,00;18884,43;18846,43;10898;-38,00;18846,43;2018-04-24;24/04/2018;ATRAPALO;Gastos_Ocio y transporte;Vacaciones;4;VARIABLES
27/04/2018;27/04/2018;T/ AUTOPISTAS TERR 23-04-2018;-1,41;18846,43;18845,02;10899;-1,41;18845,02;2018-04-23;23/04/2018;AUTOPISTAS;Gastos_Ocio y transporte;Parking y peaje;4;VARIABLES
27/04/2018;27/04/2018;T/ AUTOPISTAS TERR 23-04-2018;-1,41;18845,02;18843,61;10900;-1,41;18843,61;2018-04-23;23/04/2018;AUTOPISTAS;Gastos_Ocio y transporte;Parking y peaje;4;VARIABLES
28/04/2018;28/04/2018;T/ AUTOPISTAS TERR 25-04-2018;-1,41;18843,61;18842,20;10901;-1,41;18842,20;2018-04-25;25/04/2018;AUTOPISTAS;Gastos_Ocio y transporte;Parking y peaje;4;VARIABLES
28/04/2018;28/04/2018;T/ TUNELS VALLVI N. 25-04-2018;-3,78;18842,20;18838,42;10902;-3,78;18838,42;2018-04-25;25/04/2018;TUNELS;Gastos_Ocio y transporte;Parking y peaje;4;VARIABLES
28/04/2018;28/04/2018;T/ AUTOPISTAS TERR 25-04-2018;-1,41;18838,42;18837,01;10903;-1,41;18837,01;2018-04-25;25/04/2018;AUTOPISTAS;Gastos_Ocio y transporte;Parking y peaje;4;VARIABLES
28/04/2018;28/04/2018;T/ BON AREA 25-04-2018;-38,46;18837,01;18798,55;10904;-38,46;18798,55;2018-04-25;25/04/2018;BON;Gastos_Compras;Supermercado;4;VARIABLES
28/04/2018;28/04/2018;T/ TUNELS VALLVI S. 25-04-2018;-3,78;18798,55;18794,77;10905;-3,78;18794,77;2018-04-25;25/04/2018;TUNELS;Gastos_Ocio y transporte;Parking y peaje;4;VARIABLES
28/04/2018;28/04/2018;T/ CAFET.C T PRAT\PRAT 25-04-2018;-3,00;18794,77;18791,77;10906;-3,00;18791,77;2018-04-25;25/04/2018;CAFETC;Gastos_Ocio y transporte;Restaurantes;4;VARIABLES
29/04/2018;29/04/2018;T/ AUTOPISTAS TERR 26-04-2018;-1,41;18791,77;18790,36;10907;-1,41;18790,36;2018-04-26;26/04/2018;AUTOPISTAS;Gastos_Ocio y transporte;Parking y peaje;4;VARIABLES
29/04/2018;29/04/2018;T/ AUTOPISTAS TERR 26-04-2018;-1,41;18790,36;18788,95;10908;-1,41;18788,95;2018-04-26;26/04/2018;AUTOPISTAS;Gastos_Ocio y transporte;Parking y peaje;4;VARIABLES
29/04/2018;29/04/2018;T/ TUNELS VALLVI S. 26-04-2018;-3,78;18788,95;18785,17;10909;-3,78;18785,17;2018-04-26;26/04/2018;TUNELS;Gastos_Ocio y transporte;Parking y peaje;4;VARIABLES
29/04/2018;29/04/2018;T/ CAFET.C T PRAT\PRAT 26-04-2018;-3,50;18785,17;18781,67;10910;-3,50;18781,67;2018-04-26;26/04/2018;CAFETC;Gastos_Ocio y transporte;Restaurantes;4;VARIABLES
30/04/2018;30/04/2018;REC. 6061.9600001223;-448,11;18781,67;18333,56;10911;-448,11;18333,56;2018-04-30;30/04/2018;REC;Gastos_Banco y organismos;Hipoteca;4;FIJO
30/04/2018;30/04/2018;R/ AYUNTAMIENTO AJUNTAMENT D I.B.I;-47,13;18333,56;18286,43;10912;-47,13;18286,43;2018-04-30;30/04/2018;AYUNTAMIENTO;Gastos_Banco y organismos;Ayuntamiento;4;FIJO
30/04/2018;30/04/2018;T/  CINESA PARC VALLES\ 27-04-2018;-4,07;18286,43;18282,36;10913;-4,07;18282,36;2018-04-27;27/04/2018;CINESA;Gastos_Ocio y transporte;Espectáculos;4;VARIABLES
30/04/2018;30/04/2018;T/  CAFET.C T PRAT\PRAT 27-04-2018;-3,80;18282,36;18278,56;10914;-3,80;18278,56;2018-04-27;27/04/2018;CAFETC;Gastos_Ocio y transporte;Restaurantes;4;VARIABLES
30/04/2018;30/04/2018;T/  E.S. RUBI II 27-04-2018;-48,22;18278,56;18230,34;10915;-48,22;18230,34;2018-04-27;27/04/2018;RUBI;Gastos_Ocio y transporte;Gasolina;4;VARIABLES
30/04/2018;30/04/2018;T/  KFC PARC VALLES 27-04-2018;-16,00;18230,34;18214,34;10916;-16,00;18214,34;2018-04-27;27/04/2018;KFC;Gastos_Ocio y transporte;Restaurantes;4;VARIABLES
01/05/2018;01/05/2018;FACT TARJETAS  TARJ.CREDITO 07126017 18-05-01;-303,76;18214,34;17910,58;10917;-303,76;17910,58;2018-05-01;30/04/2018;FACT 07126017;Gastos_Banco y organismos;Credito Bea;4;VARIABLE
01/05/2018;01/05/2018;FACT TARJETAS  TARJ.CREDITO 42689013 18-05-01;-200,75;17910,58;17709,83;10918;-200,75;17709,83;2018-05-01;30/04/2018;FACT;No computable;Recibo Tarjeta;4;
01/05/2018;27/04/2018;T/  CARREFOUR VALLE;-62,22;17709,83;17647,61;10919;-62,22;17647,61;2018-04-27;27/04/2018;CARREFOUR;Gastos_Compras;Supermercado;4;VARIABLES
01/05/2018;01/05/2018;T/ WWW.JUST-EAT.ES 28-04-2018;-24,05;17647,61;17623,56;10920;-24,05;17623,56;2018-04-28;28/04/2018;WWWJUSTEATES;Gastos_Ocio y transporte;Restaurantes;4;VARIABLES
01/05/2018;01/05/2018;T/ AP URGELL \B 28-04-2018;-12,25;17623,56;17611,31;10921;-12,25;17611,31;2018-04-28;28/04/2018;URGELL;Gastos_Ocio y transporte;Parking y peaje;4;VARIABLES
02/05/2018;02/05/2018;R/ Escola d Idi SALT IDIOMES. Ade;-39,00;17611,31;17572,31;10922;-39,00;17572,31;2018-05-02;02/05/2018;ESCOLA;Gastos_Salud, saber y deporte;Estudios;5;VARIABLES
03/05/2018;03/05/2018;T/ VIENA MONTSERRAT \ 30-04-2018;-17,80;17572,31;17554,51;10923;-17,80;17554,51;2018-04-30;30/04/2018;VIENA;Gastos_Ocio y transporte;Restaurantes;4;VARIABLES
03/05/2018;03/05/2018;T/ LIDL TERRASSA \ 30-04-2018;-49,67;17554,51;17504,84;10924;-49,67;17504,84;2018-04-30;30/04/2018;LIDL;Gastos_Compras;Supermercado;4;VARIABLES
03/05/2018;03/05/2018;T/ AUTOPISTAS TERR 27-04-2018;-1,41;17504,84;17503,43;10925;-1,41;17503,43;2018-04-27;27/04/2018;AUTOPISTAS;Gastos_Ocio y transporte;Parking y peaje;4;VARIABLES
03/05/2018;03/05/2018;T/ AUTOPISTAS TERR 27-04-2018;-1,41;17503,43;17502,02;10926;-1,41;17502,02;2018-04-27;27/04/2018;AUTOPISTAS;Gastos_Ocio y transporte;Parking y peaje;4;VARIABLES
05/05/2018;05/05/2018;T/ AUTOPISTAS TERR 02-05-2018;-1,41;17502,02;17500,61;10927;-1,41;17500,61;2018-05-02;02/05/2018;AUTOPISTAS;Gastos_Ocio y transporte;Parking y peaje;5;VARIABLES
05/05/2018;05/05/2018;T/ AUTOPISTAS TERR 02-05-2018;-1,41;17500,61;17499,20;10928;-1,41;17499,20;2018-05-02;02/05/2018;AUTOPISTAS;Gastos_Ocio y transporte;Parking y peaje;5;VARIABLES
05/05/2018;05/05/2018;T/ CAFET.C T PRAT\PRAT 02-05-2018;-3,00;17499,20;17496,20;10929;-3,00;17496,20;2018-05-02;02/05/2018;CAFETC;Gastos_Ocio y transporte;Restaurantes;5;VARIABLES
06/05/2018;06/05/2018;T/ AUTOPISTAS TERR 03-05-2018;-1,41;17496,20;17494,79;10930;-1,41;17494,79;2018-05-03;03/05/2018;AUTOPISTAS;Gastos_Ocio y transporte;Parking y peaje;5;VARIABLES
06/05/2018;06/05/2018;T/ AUTOPISTAS TERR 03-05-2018;-1,41;17494,79;17493,38;10931;-1,41;17493,38;2018-05-03;03/05/2018;AUTOPISTAS;Gastos_Ocio y transporte;Parking y peaje;5;VARIABLES
06/05/2018;06/05/2018;T/ TUNELS VALLVI S. 03-05-2018;-3,78;17493,38;17489,60;10932;-3,78;17489,60;2018-05-03;03/05/2018;TUNELS;Gastos_Ocio y transporte;Parking y peaje;5;VARIABLES
06/05/2018;06/05/2018;T/ BON AREA 03-05-2018;-25,81;17489,60;17463,79;10933;-25,81;17463,79;2018-05-03;03/05/2018;BON;Gastos_Compras;Supermercado;5;VARIABLES
07/05/2018;07/05/2018;'R/ COOPERATIVA L''EINA COOPE Rebut:';-51,80;17463,79;17411,99;10934;-51,80;17411,99;2018-05-07;07/05/2018;COOPERATIVA;Gastos_Salud, saber y deporte;Estudios;5;VARIABLES
07/05/2018;07/05/2018;R/ ALIMENTACION SERHS FOOD A Comed;-124,95;17411,99;17287,04;10935;-124,95;17287,04;2018-05-07;07/05/2018;ALIMENTACION;Gastos_Salud, saber y deporte;Menjador;5;FIJO
07/05/2018;07/05/2018;R/ ALIMENTACION SERHS FOOD A Comed;-36,75;17287,04;17250,29;10936;-36,75;17250,29;2018-05-07;07/05/2018;ALIMENTACION;Gastos_Salud, saber y deporte;Menjador;5;FIJO
07/05/2018;07/05/2018;T/ BSM AP PZA JOANIC\B 04-05-2018;-7,45;17250,29;17242,84;10937;-7,45;17242,84;2018-05-04;04/05/2018;BSM;Gastos_Ocio y transporte;Parking y peaje;5;VARIABLES
08/05/2018;08/05/2018;R/ SEGUROS ADESLAS CENT MODULAR CO;-159,81;17242,84;17083,03;10938;-159,81;17083,03;2018-05-08;08/05/2018;ADESLAS;Gastos_Salud, saber y deporte;Medico;5;VARIABLES
09/05/2018;09/05/2018;DEV.COMPRA TJ VIENA PARC VALLES \TERRASSA;6,65;17083,03;17089,68;10939;6,65;17089,68;2018-05-09;09/05/2018;DEVCOMPRA;Ingresos;Devoluciones;5;VARIABLES
09/05/2018;09/05/2018;T/ BON AREA 06-05-2018;-12,53;17089,68;17077,15;10940;-12,53;17077,15;2018-05-06;06/05/2018;BON;Gastos_Compras;Supermercado;5;VARIABLES
09/05/2018;09/05/2018;T/ TUNELS VALLVI S. 04-05-2018;-4,25;17077,15;17072,90;10941;-4,25;17072,90;2018-05-04;04/05/2018;TUNELS;Gastos_Ocio y transporte;Parking y peaje;5;VARIABLES
09/05/2018;09/05/2018;T/ AUTOPISTAS TERR 04-05-2018;-1,41;17072,90;17071,49;10942;-1,41;17071,49;2018-05-04;04/05/2018;AUTOPISTAS;Gastos_Ocio y transporte;Parking y peaje;5;VARIABLES
10/05/2018;10/05/2018;R/ . FINQUES GASS Vto 01-05-18 Rec;-73,69;17071,49;16997,80;10943;-73,69;16997,80;2018-05-01;01/05/2018;FINQUES;Gastos_Vivienda y vehiculo;Alquiler Parking;5;FIJO
10/05/2018;10/05/2018;'R/ COOPERATIVA L''EINA COOPE Rebut:';-10,00;16997,80;16987,80;10944;-10,00;16987,80;2018-05-10;10/05/2018;COOPERATIVA;Gastos_Salud, saber y deporte;Estudios;5;VARIABLES
10/05/2018;10/05/2018;R/ GAS GAS NATURAL GNS27630480518;-4,64;16987,80;16983,16;10945;-4,64;16983,16;2018-05-10;10/05/2018;GAS;Gastos_Servicios tipicos;Gas;5;FIJO
10/05/2018;08/05/2018;T/ WWW.FLORAQUEEN.COM;-81,90;16983,16;16901,26;10946;-81,90;16901,26;2018-05-08;08/05/2018;WWWFLORAQUEENCOM;Gastos_Compras;Regalos;5;VARIABLES
10/05/2018;10/05/2018;T/ CAFET.C T PRAT\PRAT 07-05-2018;-1,15;16901,26;16900,11;10947;-1,15;16900,11;2018-05-07;07/05/2018;CAFETC;Gastos_Ocio y transporte;Restaurantes;5;VARIABLES
11/05/2018;11/05/2018;R/ TELECOMUNICACI VODAFONE;-150,42;16900,11;16749,69;10948;-150,42;16749,69;2018-05-11;11/05/2018;TELECOMUNICACI;Gastos_Servicios tipicos;Telecomunicaciones;5;FIJO
11/05/2018;11/05/2018;T/ KAINIS RITUALS \ 08-05-2018;-39,00;16749,69;16710,69;10949;-39,00;16710,69;2018-05-08;08/05/2018;KAINIS;Gastos_Salud, saber y deporte;Belleza;5;VARIABLES
11/05/2018;11/05/2018;T/ AUTOPISTAS TERR 08-05-2018;-1,41;16710,69;16709,28;10950;-1,41;16709,28;2018-05-08;08/05/2018;AUTOPISTAS;Gastos_Ocio y transporte;Parking y peaje;5;VARIABLES
11/05/2018;11/05/2018;T/ AUTOPISTAS TERR 08-05-2018;-1,41;16709,28;16707,87;10951;-1,41;16707,87;2018-05-08;08/05/2018;AUTOPISTAS;Gastos_Ocio y transporte;Parking y peaje;5;VARIABLES
11/05/2018;11/05/2018;T/ CAFET.C T PRAT\PRAT 08-05-2018;-3,70;16707,87;16704,17;10952;-3,70;16704,17;2018-05-08;08/05/2018;CAFETC;Gastos_Ocio y transporte;Restaurantes;5;VARIABLES
11/05/2018;11/05/2018;T/ AUTOPISTAS TERR 07-05-2018;-1,41;16704,17;16702,76;10953;-1,41;16702,76;2018-05-07;07/05/2018;AUTOPISTAS;Gastos_Ocio y transporte;Parking y peaje;5;VARIABLES
12/05/2018;12/05/2018;T/ VIENA PARC VALLES \ 09-05-2018;-6,65;16702,76;16696,11;10954;-6,65;16696,11;2018-05-09;09/05/2018;VIENA;Gastos_Ocio y transporte;Restaurantes;5;VARIABLES
12/05/2018;12/05/2018;T/ AUTOPISTAS TERR 09-05-2018;-1,41;16696,11;16694,70;10955;-1,41;16694,70;2018-05-09;09/05/2018;AUTOPISTAS;Gastos_Ocio y transporte;Parking y peaje;5;VARIABLES
12/05/2018;12/05/2018;T/ AUTOPISTAS TERR 09-05-2018;-1,41;16694,70;16693,29;10956;-1,41;16693,29;2018-05-09;09/05/2018;AUTOPISTAS;Gastos_Ocio y transporte;Parking y peaje;5;VARIABLES
12/05/2018;12/05/2018;T/ VIENA PARC VALLES \ 09-05-2018;-10,00;16693,29;16683,29;10957;-10,00;16683,29;2018-05-09;09/05/2018;VIENA;Gastos_Ocio y transporte;Restaurantes;5;VARIABLES
13/05/2018;13/05/2018;T/ WWW.JUST-EAT.ES 10-05-2018;-35,09;16683,29;16648,20;10958;-35,09;16648,20;2018-05-10;10/05/2018;WWWJUSTEATES;Gastos_Ocio y transporte;Restaurantes;5;VARIABLES
14/05/2018;14/05/2018;R/ LUZ ENDESA ENERG FACTURA DE ELE;-134,76;16648,20;16513,44;10959;-134,76;16513,44;2018-05-14;14/05/2018;ELE;Gastos_Servicios tipicos;Electricidad;5;FIJO
14/05/2018;14/05/2018;T/ E.S. RUBI II 11-05-2018;-50,76;16513,44;16462,68;10960;-50,76;16462,68;2018-05-11;11/05/2018;RUBI;Gastos_Ocio y transporte;Gasolina;5;VARIABLES
15/05/2018;15/05/2018;T/ VIENA TERRASSA CEN\ 12-05-2018;-5,85;16462,68;16456,83;10961;-5,85;16456,83;2018-05-12;12/05/2018;VIENA;Gastos_Ocio y transporte;Restaurantes;5;VARIABLES
15/05/2018;15/05/2018;T/ FRANKFURT LES LLET\ 12-05-2018;-4,80;16456,83;16452,03;10962;-4,80;16452,03;2018-05-12;12/05/2018;FRANKFURT;Gastos_Ocio y transporte;Restaurantes;5;VARIABLES
15/05/2018;15/05/2018;T/ COFFEE GOLETA \ 12-05-2018;-8,20;16452,03;16443,83;10963;-8,20;16443,83;2018-05-12;12/05/2018;COFFEE;Gastos_Ocio y transporte;Restaurantes;5;VARIABLES
15/05/2018;15/05/2018;T/ HENNES & MAURITZ TERRASA \ 12-05-2018;-24,98;16443,83;16418,85;10964;-24,98;16418,85;2018-05-12;12/05/2018;HENNES;Gastos_Compras;Ropa;5;VARIABLES
16/05/2018;16/05/2018;R/ SEGUROS CCM VIDA Y P Recibo:149;-15,65;16418,85;16403,20;10965;-15,65;16403,20;2018-05-16;16/05/2018;CCM;Gastos_Seguros;Seguro vida;5;FIJO
16/05/2018;16/05/2018;R/ SEGUROS CCM VIDA Y P Recibo:149;-18,47;16403,20;16384,73;10966;-18,47;16384,73;2018-05-16;16/05/2018;CCM;Gastos_Seguros;Seguro vida;5;FIJO
16/05/2018;16/05/2018;T/ BON AREA 13-05-2018;-37,21;16384,73;16347,52;10967;-37,21;16347,52;2018-05-13;13/05/2018;BON;Gastos_Compras;Supermercado;5;VARIABLES
16/05/2018;16/05/2018;T/ AUTOPISTAS TERR 11-05-2018;-1,41;16347,52;16346,11;10968;-1,41;16346,11;2018-05-11;11/05/2018;AUTOPISTAS;Gastos_Ocio y transporte;Parking y peaje;5;VARIABLES
16/05/2018;16/05/2018;T/ TUNELS VALLVI S. 11-05-2018;-4,25;16346,11;16341,86;10969;-4,25;16341,86;2018-05-11;11/05/2018;TUNELS;Gastos_Ocio y transporte;Parking y peaje;5;VARIABLES
18/05/2018;18/05/2018;T/ CAMPING VALL D\LA V 15-05-2018;-47,50;16341,86;16294,36;10970;-47,50;16294,36;2018-05-15;15/05/2018;CAMPING;Gastos_Ocio y transporte;Vacaciones;5;VARIABLES
18/05/2018;18/05/2018;T/ CAFET.C T PRAT\PRAT 15-05-2018;-3,00;16294,36;16291,36;10971;-3,00;16291,36;2018-05-15;15/05/2018;CAFETC;Gastos_Ocio y transporte;Restaurantes;5;VARIABLES
18/05/2018;18/05/2018;T/ AUTOPISTAS TERR 14-05-2018;-1,41;16291,36;16289,95;10972;-1,41;16289,95;2018-05-14;14/05/2018;AUTOPISTAS;Gastos_Ocio y transporte;Parking y peaje;5;VARIABLES
19/05/2018;19/05/2018;T/ AUTOPISTAS TERR 16-05-2018;-1,41;16289,95;16288,54;10973;-1,41;16288,54;2018-05-16;16/05/2018;AUTOPISTAS;Gastos_Ocio y transporte;Parking y peaje;5;VARIABLES
19/05/2018;19/05/2018;T/ VIENA PARC VALLES \ 16-05-2018;-11,70;16288,54;16276,84;10974;-11,70;16276,84;2018-05-16;16/05/2018;VIENA;Gastos_Ocio y transporte;Restaurantes;5;VARIABLES
20/05/2018;20/05/2018;T/ AUTOPISTAS TERR 17-05-2018;-1,41;16276,84;16275,43;10975;-1,41;16275,43;2018-05-17;17/05/2018;AUTOPISTAS;Gastos_Ocio y transporte;Parking y peaje;5;VARIABLES
20/05/2018;20/05/2018;T/ AUTOPISTAS TERR 17-05-2018;-1,41;16275,43;16274,02;10976;-1,41;16274,02;2018-05-17;17/05/2018;AUTOPISTAS;Gastos_Ocio y transporte;Parking y peaje;5;VARIABLES
20/05/2018;20/05/2018;T/ CAFET.C T PRAT\PRAT 17-05-2018;-3,55;16274,02;16270,47;10977;-3,55;16270,47;2018-05-17;17/05/2018;CAFETC;Gastos_Ocio y transporte;Restaurantes;5;VARIABLES
21/05/2018;21/05/2018;'T/ MON GRAN D''OCI \ 18-05-2018';-5,00;16270,47;16265,47;10978;-5,00;16265,47;2018-05-18;18/05/2018;MON;Gastos_Ocio y transporte;Otros ocio;5;VARIABLES
21/05/2018;21/05/2018;T/ DRIM PARC VALLES 18-05-2018;-13,04;16265,47;16252,43;10979;-13,04;16252,43;2018-05-18;18/05/2018;DRIM;Gastos_Compras;Niños;5;VARIABLES
21/05/2018;21/05/2018;T/ REST.KAORI \BARBERA DEL V;-43,70;16252,43;16208,73;10980;-43,70;16208,73;2018-05-21;21/05/2018;RESTKAORI;Gastos_Ocio y transporte;Restaurantes;5;VARIABLES
22/05/2018;18/05/2018;T/ Amazon *Mktplce EU-ES;-172,74;16208,73;16035,99;10981;-172,74;16035,99;2018-05-18;18/05/2018;AMAZON;Gastos_Compras;Hobbys;5;VARIABLES
22/05/2018;22/05/2018;T/ AUTONET & OIL 19-05-2018;-30,00;16035,99;16005,99;10982;-30,00;16005,99;2018-05-19;19/05/2018;AUTONET;Gastos_Ocio y transporte;Gasolina;5;VARIABLES
22/05/2018;22/05/2018;T/ 0250-CONSUM OLOT 19-05-2018;-35,58;16005,99;15970,41;10983;-35,58;15970,41;2018-05-19;19/05/2018;CONSUM;Gastos_Compras;Supermercado;5;VARIABLES
22/05/2018;22/05/2018;T/ TESI FRESC S.L. 19-05-2018;-47,44;15970,41;15922,97;10984;-47,44;15922,97;2018-05-19;19/05/2018;TESI;Gastos_Compras;Supermercado;5;VARIABLES
22/05/2018;22/05/2018;S/OR. CASAL D ESTIU CAN PALET;-662,00;15922,97;15260,97;10985;-662,00;15260,97;2018-05-22;22/05/2018;CASAL;Gastos_Salud, saber y deporte;Estudios;5;VARIABLES
23/05/2018;23/05/2018;T/ CAMPING DE LA \VALL 20-05-2018;-48,50;15260,97;15212,47;10986;-48,50;15212,47;2018-05-20;20/05/2018;CAMPING;Gastos_Ocio y transporte;Vacaciones;5;VARIABLES
23/05/2018;23/05/2018;T/ MOVIL S.A.\SANT JOA 20-05-2018;-3,50;15212,47;15208,97;10987;-3,50;15208,97;2018-05-20;20/05/2018;MOVIL;Gastos_Servicios tipicos;Telecomunicaciones;5;FIJO
24/05/2018;24/05/2018;T/ AUTOPISTAS TERR 20-05-2018;-7,84;15208,97;15201,13;10988;-7,84;15201,13;2018-05-20;20/05/2018;AUTOPISTAS;Gastos_Ocio y transporte;Parking y peaje;5;VARIABLES
24/05/2018;24/05/2018;T/ AUTOPISTAS TERR 19-05-2018;-7,84;15201,13;15193,29;10989;-7,84;15193,29;2018-05-19;19/05/2018;AUTOPISTAS;Gastos_Ocio y transporte;Parking y peaje;5;VARIABLES
24/05/2018;24/05/2018;T/ AUTOPISTAS TERR 18-05-2018;-1,41;15193,29;15191,88;10990;-1,41;15191,88;2018-05-18;18/05/2018;AUTOPISTAS;Gastos_Ocio y transporte;Parking y peaje;5;VARIABLES
24/05/2018;24/05/2018;CAJ. AJENO SERVIRED \TERRASSA;-300,00;15191,88;14891,88;10991;-300,00;14891,88;2018-05-24;24/05/2018;CAJ;Gastos_Gastos varios;Efectivo;5;VARIABLES
24/05/2018;24/05/2018;COM. 64970036 SVRED CAJ OFI;-1,87;14891,88;14890,01;10992;-1,87;14890,01;2018-05-24;24/05/2018;COM;Gastos_Banco y organismos;Cargos banco;5;FIJO
25/05/2018;25/05/2018;T/ CAFET.C T PRAT\PRAT 22-05-2018;-3,50;14890,01;14886,51;10993;-3,50;14886,51;2018-05-22;22/05/2018;CAFETC;Gastos_Ocio y transporte;Restaurantes;5;VARIABLES
25/05/2018;25/05/2018;T/ TUNELS VALLVI S. 22-05-2018;-3,78;14886,51;14882,73;10994;-3,78;14882,73;2018-05-22;22/05/2018;TUNELS;Gastos_Ocio y transporte;Parking y peaje;5;VARIABLES
26/05/2018;26/05/2018;T/ AUTOPISTAS TERR 23-05-2018;-1,41;14882,73;14881,32;10995;-1,41;14881,32;2018-05-23;23/05/2018;AUTOPISTAS;Gastos_Ocio y transporte;Parking y peaje;5;VARIABLES
26/05/2018;26/05/2018;T/ AUTOPISTAS TERR 23-05-2018;-1,41;14881,32;14879,91;10996;-1,41;14879,91;2018-05-23;23/05/2018;AUTOPISTAS;Gastos_Ocio y transporte;Parking y peaje;5;VARIABLES
26/05/2018;26/05/2018;T/ CAFET.C T PRAT\PRAT 23-05-2018;-2,70;14879,91;14877,21;10997;-2,70;14877,21;2018-05-23;23/05/2018;CAFETC;Gastos_Ocio y transporte;Restaurantes;5;VARIABLES
26/05/2018;26/05/2018;T/ VIENA PARC VALLES \ 23-05-2018;-11,05;14877,21;14866,16;10998;-11,05;14866,16;2018-05-23;23/05/2018;VIENA;Gastos_Ocio y transporte;Restaurantes;5;VARIABLES
26/05/2018;26/05/2018;T/ BON AREA 23-05-2018;-14,04;14866,16;14852,12;10999;-14,04;14852,12;2018-05-23;23/05/2018;BON;Gastos_Compras;Supermercado;5;VARIABLES
26/05/2018;26/05/2018;T/ AUTOPISTAS TERR 22-05-2018;-1,41;14852,12;14850,71;11000;-1,41;14850,71;2018-05-22;22/05/2018;AUTOPISTAS;Gastos_Ocio y transporte;Parking y peaje;5;VARIABLES
26/05/2018;26/05/2018;T/ AUTOPISTAS TERR 22-05-2018;-1,41;14850,71;14849,30;11001;-1,41;14849,30;2018-05-22;22/05/2018;AUTOPISTAS;Gastos_Ocio y transporte;Parking y peaje;5;VARIABLES
27/05/2018;27/05/2018;T/ AUTOPISTAS TERR 24-05-2018;-1,41;14849,30;14847,89;11002;-1,41;14847,89;2018-05-24;24/05/2018;AUTOPISTAS;Gastos_Ocio y transporte;Parking y peaje;5;VARIABLES
27/05/2018;27/05/2018;T/ AUTOPISTAS TERR 24-05-2018;-1,41;14847,89;14846,48;11003;-1,41;14846,48;2018-05-24;24/05/2018;AUTOPISTAS;Gastos_Ocio y transporte;Parking y peaje;5;VARIABLES
27/05/2018;27/05/2018;T/ CAFET.C T PRAT\PRAT 24-05-2018;-3,05;14846,48;14843,43;11004;-3,05;14843,43;2018-05-24;24/05/2018;CAFETC;Gastos_Ocio y transporte;Restaurantes;5;VARIABLES
27/05/2018;27/05/2018;T/ TUNELS VALLVI S. 24-05-2018;-3,78;14843,43;14839,65;11005;-3,78;14839,65;2018-05-24;24/05/2018;TUNELS;Gastos_Ocio y transporte;Parking y peaje;5;VARIABLES
27/05/2018;27/05/2018;T/ REST.RUSTIC \PRAT 24-05-2018;-14,90;14839,65;14824,75;11006;-14,90;14824,75;2018-05-24;24/05/2018;RESTRUSTIC;Gastos_Ocio y transporte;Restaurantes;5;VARIABLES
28/05/2018;28/05/2018;HAB. INFORMACIO I TECNOLOGIA DE CAT;1661,34;14824,75;16486,09;11007;1661,34;16486,09;2018-05-28;28/05/2018;HAB;Ingresos;Nomina;5;FIJO
28/05/2018;28/05/2018;HAB. AJUNTAMENT DE TERRASSA Transfe;1809,87;16486,09;18295,96;11008;1809,87;18295,96;2018-05-28;28/05/2018;HAB;Ingresos;Nomina;5;FIJO
29/05/2018;29/05/2018;ABO. A.E.A.T. DEVOLUCIONES TRIBUTAR;289,34;18295,96;18585,30;11009;289,34;18585,30;2018-05-29;29/05/2018;ABO;Ingresos;Devoluciones;5;VARIABLES
30/05/2018;30/05/2018;T/ WWW.JUST-EAT.ES 27-05-2018;-35,20;18585,30;18550,10;11010;-35,20;18550,10;2018-05-27;27/05/2018;WWWJUSTEATES;Gastos_Ocio y transporte;Restaurantes;5;VARIABLES
31/05/2018;31/05/2018;REC. 6061.9600001223;-448,11;18550,10;18101,99;11011;-448,11;18101,99;2018-05-31;31/05/2018;REC;Gastos_Banco y organismos;Hipoteca;5;FIJO
01/06/2018;01/06/2018;FACT TARJETAS TARJ.CREDITO 07126017 18-06-01;-527,16;18101,99;17574,83;11012;-527,16;17574,83;2018-06-01;31/05/2018;FACT 07126017;Gastos_Banco y organismos;Credito Bea;5;VARIABLE
01/06/2018;01/06/2018;FACT TARJETAS TARJ.CREDITO 42689013 18-06-01;-356,16;17574,83;17218,67;11013;-356,16;17218,67;2018-06-01;31/05/2018;FACT;No computable;Recibo Tarjeta;5;
01/06/2018;30/05/2018;T/ PlaystationNetwork;-39,99;17218,67;17178,68;11014;-39,99;17178,68;2018-05-30;30/05/2018;PLAYSTATIONNETWORK;Gastos_Servicios tipicos;Servicios online;5;FIJO
01/06/2018;01/06/2018;CAJ. AJENO SERVIRED \TERRASSA;-200,00;17178,68;16978,68;11015;-200,00;16978,68;2018-06-01;01/06/2018;CAJ;Gastos_Gastos varios;Efectivo;6;VARIABLES
01/06/2018;01/06/2018;COM. 64970036 SVRED CAJ OFI;-1,87;16978,68;16976,81;11016;-1,87;16976,81;2018-06-01;01/06/2018;COM;Gastos_Banco y organismos;Cargos banco;6;FIJO
03/06/2018;03/06/2018;T/ CINESA PARC VALLES\ 31-05-2018;-16,00;16976,81;16960,81;11017;-16,00;16960,81;2018-05-31;31/05/2018;CINESA;Gastos_Ocio y transporte;Espectáculos;5;VARIABLES
04/06/2018;04/06/2018;R/ SEGUROS ADESLAS CENT MODULAR CO;-159,81;16960,81;16801,00;11018;-159,81;16801,00;2018-06-04;04/06/2018;ADESLAS;Gastos_Salud, saber y deporte;Medico;6;VARIABLES
04/06/2018;04/06/2018;S/OR. JUANDIK;-40,00;16801,00;16761,00;11019;-40,00;16761,00;2018-06-04;04/06/2018;JUANDIK;Gastos_Ocio y transporte;Loterias;6;
05/06/2018;05/06/2018;T/ CINESA WEB \B 02-06-2018;-14,20;16761,00;16746,80;11020;-14,20;16746,80;2018-06-02;02/06/2018;CINESA;Gastos_Ocio y transporte;Espectáculos;6;VARIABLES
06/06/2018;06/06/2018;R/ LUZ ENDESA ENERG FACTURA DE GAS;-267,86;16746,80;16478,94;11021;-267,86;16478,94;2018-06-06;06/06/2018;GAS;Gastos_Servicios tipicos;Gas;6;FIJO
06/06/2018;06/06/2018;T/ WWW.JUST-EAT.ES 03-06-2018;-27,49;16478,94;16451,45;11022;-27,49;16451,45;2018-06-03;03/06/2018;WWWJUSTEATES;Gastos_Ocio y transporte;Restaurantes;6;VARIABLES
11/06/2018;11/06/2018;R/ . FINQUES GASS Vto 01-06-18 Rec;-73,69;16451,45;16377,76;11023;-73,69;16377,76;2018-06-01;01/06/2018;FINQUES;Gastos_Vivienda y vehiculo;Alquiler Parking;6;FIJO
11/06/2018;11/06/2018;R/ ALIMENTACION SERHS FOOD A Comed;-92,82;16377,76;16284,94;11024;-92,82;16284,94;2018-06-11;11/06/2018;ALIMENTACION;Gastos_Salud, saber y deporte;Menjador;6;FIJO
11/06/2018;11/06/2018;R/ ALIMENTACION SERHS FOOD A Comed;-23,24;16284,94;16261,70;11025;-23,24;16261,70;2018-06-11;11/06/2018;ALIMENTACION;Gastos_Salud, saber y deporte;Menjador;6;FIJO
11/06/2018;11/06/2018;T/ CINESA WEB \B 08-06-2018;-27,60;16261,70;16234,10;11026;-27,60;16234,10;2018-06-08;08/06/2018;CINESA;Gastos_Ocio y transporte;Espectáculos;6;VARIABLES
11/06/2018;11/06/2018;T/ CINESA PARC VALLES\ 08-06-2018;-22,69;16234,10;16211,41;11027;-22,69;16211,41;2018-06-08;08/06/2018;CINESA;Gastos_Ocio y transporte;Espectáculos;6;VARIABLES
12/06/2018;12/06/2018;R/ GAS GAS NATURAL GNS27630480618;-4,64;16211,41;16206,77;11028;-4,64;16206,77;2018-06-12;12/06/2018;GAS;Gastos_Servicios tipicos;Gas;6;FIJO
13/06/2018;13/06/2018;R/ TELECOMUNICACI VODAFONE;-150,42;16206,77;16056,35;11029;-150,42;16056,35;2018-06-13;13/06/2018;TELECOMUNICACI;Gastos_Servicios tipicos;Telecomunicaciones;6;FIJO
18/06/2018;18/06/2018;R/  SEGUROS CCM VIDA Y P Recibo:150;-15,59;16056,35;16040,76;11030;-15,59;16040,76;2018-06-18;18/06/2018;CCM;Gastos_Seguros;Seguro vida;6;FIJO
18/06/2018;18/06/2018;R/  SEGUROS CCM VIDA Y P Recibo:150;-18,40;16040,76;16022,36;11031;-18,40;16022,36;2018-06-18;18/06/2018;CCM;Gastos_Seguros;Seguro vida;6;FIJO
19/06/2018;19/06/2018;ABO.  A.E.A.T. DEVOLUCIONES TRIBUTAR;1176,82;16022,36;17199,18;11032;1176,82;17199,18;2018-06-19;19/06/2018;ABO;Ingresos;Devoluciones;6;VARIABLES
20/06/2018;20/06/2018;R/ MINA PUBLICA AIGUES T.01A75789;-60,27;17199,18;17138,91;11033;-60,27;17138,91;2018-06-20;20/06/2018;MINA;Gastos_Servicios tipicos;Agua;6;FIJO
21/06/2018;21/06/2018;HAB.  AJUNTAMENT DE TERRASSA Transfe;3783,79;17138,91;20922,70;11034;3783,79;20922,70;2018-06-21;21/06/2018;HAB;Ingresos;Nomina;6;FIJO
21/06/2018;21/06/2018;'R/  COOPERATIVA L''EINA COOPE Rebut:';-10,00;20922,70;20912,70;11035;-10,00;20912,70;2018-06-21;21/06/2018;COOPERATIVA;Gastos_Salud, saber y deporte;Estudios;6;VARIABLES
21/06/2018;21/06/2018;T/  CATALUNYA CAIX\EL P 18-06-2018;-3,50;20912,70;20909,20;11036;-3,50;20909,20;2018-06-18;18/06/2018;CATALUNYA;Gastos_Ocio y transporte;Restaurantes;6;VARIABLES
21/06/2018;21/06/2018;T/  BON AREA 18-06-2018;-24,54;20909,20;20884,66;11037;-24,54;20884,66;2018-06-18;18/06/2018;BON;Gastos_Compras;Supermercado;6;VARIABLES
21/06/2018;21/06/2018;T/  AUTOPISTAS TERR 18-06-2018;-1,41;20884,66;20883,25;11038;-1,41;20883,25;2018-06-18;18/06/2018;AUTOPISTAS;Gastos_Ocio y transporte;Parking y peaje;6;VARIABLES
21/06/2018;21/06/2018;T/  CEDIPSA 15838-1 EG\ 18-06-2018;-30,00;20883,25;20853,25;11039;-30,00;20853,25;2018-06-18;18/06/2018;CEDIPSA;Gastos_Ocio y transporte;Gasolina;6;VARIABLES
21/06/2018;21/06/2018;T/  AKI 104 - TERRASSA\ 18-06-2018;-34,95;20853,25;20818,30;11040;-34,95;20818,30;2018-06-18;18/06/2018;AKI;Gastos_Vivienda y vehiculo;Mnto. hogar;6;VARIABLES
22/06/2018;22/06/2018;T/  CATALUNYA CAIX\EL P 19-06-2018;-4,00;20818,30;20814,30;11041;-4,00;20814,30;2018-06-19;19/06/2018;CATALUNYA;Gastos_Ocio y transporte;Restaurantes;6;VARIABLES
22/06/2018;22/06/2018;T/  AUTOPISTAS TERR 19-06-2018;-1,41;20814,30;20812,89;11042;-1,41;20812,89;2018-06-19;19/06/2018;AUTOPISTAS;Gastos_Ocio y transporte;Parking y peaje;6;VARIABLES
22/06/2018;22/06/2018;T/  AUTOPISTAS TERR 19-06-2018;-1,41;20812,89;20811,48;11043;-1,41;20811,48;2018-06-19;19/06/2018;AUTOPISTAS;Gastos_Ocio y transporte;Parking y peaje;6;VARIABLES
22/06/2018;22/06/2018;T/  TUNELS VALLVI S. 19-06-2018;-3,78;20811,48;20807,70;11044;-3,78;20807,70;2018-06-19;19/06/2018;TUNELS;Gastos_Ocio y transporte;Parking y peaje;6;VARIABLES
23/06/2018;23/06/2018;T/  TIGER \TERRA 20-06-2018;-13,00;20807,70;20794,70;11045;-13,00;20794,70;2018-06-20;20/06/2018;TIGER;Gastos_Compras;Otras compras;6;VARIABLES
24/06/2018;24/06/2018;T/  AUTOPISTAS TERR 21-06-2018;-1,41;20794,70;20793,29;11046;-1,41;20793,29;2018-06-21;21/06/2018;AUTOPISTAS;Gastos_Ocio y transporte;Parking y peaje;6;VARIABLES
24/06/2018;24/06/2018;T/  AUTOPISTAS TERR 21-06-2018;-1,41;20793,29;20791,88;11047;-1,41;20791,88;2018-06-21;21/06/2018;AUTOPISTAS;Gastos_Ocio y transporte;Parking y peaje;6;VARIABLES
24/06/2018;24/06/2018;T/  DECATHLON SA TERRA\ 21-06-2018;-61,93;20791,88;20729,95;11048;-61,93;20729,95;2018-06-21;21/06/2018;DECATHLON;Gastos_Compras;Deportivo;6;VARIABLES
24/06/2018;24/06/2018;T/  TUNELS VALLVI S. 21-06-2018;-3,78;20729,95;20726,17;11049;-3,78;20726,17;2018-06-21;21/06/2018;TUNELS;Gastos_Ocio y transporte;Parking y peaje;6;VARIABLES
24/06/2018;24/06/2018;T/  TERRACASA \ 21-06-2018;-19,30;20726,17;20706,87;11050;-19,30;20706,87;2018-06-21;21/06/2018;TERRACASA;Gastos_Compras;Otras compras;6;VARIABLES
25/06/2018;25/06/2018;T/  WWW.JUST-EAT.ES 22-06-2018;-19,30;20706,87;20687,57;11051;-19,30;20687,57;2018-06-22;22/06/2018;WWWJUSTEATES;Gastos_Ocio y transporte;Restaurantes;6;VARIABLES
26/06/2018;26/06/2018;T/  AUTOPISTAS TERR 22-06-2018;-1,41;20687,57;20686,16;11052;-1,41;20686,16;2018-06-22;22/06/2018;AUTOPISTAS;Gastos_Ocio y transporte;Parking y peaje;6;VARIABLES
27/06/2018;27/06/2018;HAB.  BBVA INFORMATION TECHNOLOGY ES;1661,34;20686,16;22347,50;11053;1661,34;22347,50;2018-06-27;27/06/2018;HAB;Ingresos;Nomina;6;FIJO
27/06/2018;27/06/2018;T/  TUNELS VALLVI S. 22-06-2018;-3,78;22347,50;22343,72;11054;-3,78;22343,72;2018-06-22;22/06/2018;TUNELS;Gastos_Ocio y transporte;Parking y peaje;6;VARIABLES
28/06/2018;28/06/2018;T/  CATALUNYA CAIX\EL P 25-06-2018;-3,50;22343,72;22340,22;11055;-3,50;22340,22;2018-06-25;25/06/2018;CATALUNYA;Gastos_Ocio y transporte;Restaurantes;6;VARIABLES
28/06/2018;28/06/2018;T/  AUTOPISTAS TERR 25-06-2018;-1,41;22340,22;22338,81;11056;-1,41;22338,81;2018-06-25;25/06/2018;AUTOPISTAS;Gastos_Ocio y transporte;Parking y peaje;6;VARIABLES
28/06/2018;28/06/2018;T/  AUTOPISTAS TERR 25-06-2018;-1,41;22338,81;22337,40;11057;-1,41;22337,40;2018-06-25;25/06/2018;AUTOPISTAS;Gastos_Ocio y transporte;Parking y peaje;6;VARIABLES
28/06/2018;28/06/2018;T/  BON AREA 25-06-2018;-29,62;22337,40;22307,78;11058;-29,62;22307,78;2018-06-25;25/06/2018;BON;Gastos_Compras;Supermercado;6;VARIABLES
28/06/2018;28/06/2018;T/  TUNELS VALLVI S. 25-06-2018;-3,78;22307,78;22304,00;11059;-3,78;22304,00;2018-06-25;25/06/2018;TUNELS;Gastos_Ocio y transporte;Parking y peaje;6;VARIABLES
28/06/2018;28/06/2018;T/  PETROCAT DIREC\TARR 25-06-2018;-30,00;22304,00;22274,00;11060;-30,00;22274,00;2018-06-25;25/06/2018;PETROCAT;Gastos_Ocio y transporte;Gasolina;6;VARIABLES
29/06/2018;29/06/2018;R/  AYUNTAMIENTO AJUNTAMENT D I.B.I;-47,13;22274,00;22226,87;11061;-47,13;22226,87;2018-06-29;29/06/2018;AYUNTAMIENTO;Gastos_Banco y organismos;Ayuntamiento;6;FIJO
29/06/2018;29/06/2018;T/  CATALUNYA CAIX\EL P 26-06-2018;-2,50;22226,87;22224,37;11062;-2,50;22224,37;2018-06-26;26/06/2018;CATALUNYA;Gastos_Ocio y transporte;Restaurantes;6;VARIABLES
29/06/2018;29/06/2018;T/  AUTOPISTAS TERR 26-06-2018;-1,41;22224,37;22222,96;11063;-1,41;22222,96;2018-06-26;26/06/2018;AUTOPISTAS;Gastos_Ocio y transporte;Parking y peaje;6;VARIABLES
29/06/2018;29/06/2018;T/  AUTOPISTAS TERR 26-06-2018;-1,41;22222,96;22221,55;11064;-1,41;22221,55;2018-06-26;26/06/2018;AUTOPISTAS;Gastos_Ocio y transporte;Parking y peaje;6;VARIABLES
29/06/2018;29/06/2018;T/  IKEA REST. SABADEL\ 26-06-2018;-17,04;22221,55;22204,51;11065;-17,04;22204,51;2018-06-26;26/06/2018;IKEA;Gastos_Vivienda y vehiculo;Mnto. hogar;6;VARIABLES
29/06/2018;29/06/2018;T/  IKEA SABADELL \ 26-06-2018;-34,99;22204,51;22169,52;11066;-34,99;22169,52;2018-06-26;26/06/2018;IKEA;Gastos_Vivienda y vehiculo;Mnto. hogar;6;VARIABLES
29/06/2018;29/06/2018;T/  TUNELS VALLVI S. 26-06-2018;-4,25;22169,52;22165,27;11067;-4,25;22165,27;2018-06-26;26/06/2018;TUNELS;Gastos_Ocio y transporte;Parking y peaje;6;VARIABLES
30/06/2018;30/06/2018;REC.  6061.9600001223;-448,11;22165,27;21717,16;11068;-448,11;21717,16;2018-06-30;30/06/2018;REC;Gastos_Banco y organismos;Hipoteca;6;FIJO
30/06/2018;28/06/2018;T/  PlaystationNetwork;-59,99;21717,16;21657,17;11069;-59,99;21657,17;2018-06-28;28/06/2018;PLAYSTATIONNETWORK;Gastos_Servicios tipicos;Servicios online;6;FIJO
30/06/2018;30/06/2018;T/  AUTOPISTAS TERR 27-06-2018;-1,41;21657,17;21655,76;11070;-1,41;21655,76;2018-06-27;27/06/2018;AUTOPISTAS;Gastos_Ocio y transporte;Parking y peaje;6;VARIABLES
30/06/2018;30/06/2018;T/  AUTOPISTAS TERR 27-06-2018;-1,41;21655,76;21654,35;11071;-1,41;21654,35;2018-06-27;27/06/2018;AUTOPISTAS;Gastos_Ocio y transporte;Parking y peaje;6;VARIABLES
30/06/2018;30/06/2018;T/  CATALUNYA CAIX\EL P 27-06-2018;-2,50;21654,35;21651,85;11072;-2,50;21651,85;2018-06-27;27/06/2018;CATALUNYA;Gastos_Ocio y transporte;Restaurantes;6;VARIABLES
01/07/2018;01/07/2018;FACT TARJETAS  TARJ.CREDITO 07126017 18-07-01;-1065,51;21651,85;20586,34;11073;-1065,51;20586,34;2018-07-01;30/06/2018;FACT 07126017;Gastos_Banco y organismos;Credito Bea;6;VARIABLE
01/07/2018;01/07/2018;FACT TARJETAS  TARJ.CREDITO 42689013 18-07-01;-811,37;20586,34;19774,97;11074;-811,37;19774,97;2018-07-01;30/06/2018;FACT;No computable;Recibo Tarjeta;6;
01/07/2018;01/07/2018;T/  AUTOPISTAS TERR 28-06-2018;-1,41;19774,97;19773,56;11075;-1,41;19773,56;2018-06-28;28/06/2018;AUTOPISTAS;Gastos_Ocio y transporte;Parking y peaje;6;VARIABLES
01/07/2018;01/07/2018;T/  MCDONALDS \ 28-06-2018;-8,30;19773,56;19765,26;11076;-8,30;19765,26;2018-06-28;28/06/2018;MCDONALDS;Gastos_Ocio y transporte;Restaurantes;6;VARIABLES
01/07/2018;01/07/2018;T/  SUPER.REYPA \TARRA 28-06-2018;-17,94;19765,26;19747,32;11077;-17,94;19747,32;2018-06-28;28/06/2018;SUPERREYPA;Gastos_Compras;Supermercado;6;VARIABLES
01/07/2018;01/07/2018;T/  L ALFABREGA \VA 28-06-2018;-24,45;19747,32;19722,87;11078;-24,45;19722,87;2018-06-28;28/06/2018;ALFABREGA;Gastos_Compras;Supermercado;6;VARIABLES
01/07/2018;01/07/2018;T/  TUNELS VALLVI S. 27-06-2018;-3,78;19722,87;19719,09;11079;-3,78;19719,09;2018-06-27;27/06/2018;TUNELS;Gastos_Ocio y transporte;Parking y peaje;6;VARIABLES
02/07/2018;02/07/2018;T/  TOCINERIES VENTURA\ 29-06-2018;-23,79;19719,09;19695,30;11080;-23,79;19695,30;2018-06-29;29/06/2018;TOCINERIES;Gastos_Compras;Supermercado;6;VARIABLES
02/07/2018;02/07/2018;T/  TUNELS VALLVI S. 28-06-2018;-3,78;19695,30;19691,52;11081;-3,78;19691,52;2018-06-28;28/06/2018;TUNELS;Gastos_Ocio y transporte;Parking y peaje;6;VARIABLES
03/07/2018;03/07/2018;R/  AYUNTAMIENTO AJUNTAMENT D IMPOS;-62,78;19691,52;19628,74;11082;-62,78;19628,74;2018-07-03;03/07/2018;AYUNTAMIENTO;Gastos_Banco y organismos;Ayuntamiento;7;FIJO
03/07/2018;03/07/2018;R/  SEGUROS ADESLAS CENT MODULAR CO;-159,81;19628,74;19468,93;11083;-159,81;19468,93;2018-07-03;03/07/2018;ADESLAS;Gastos_Salud, saber y deporte;Medico;7;VARIABLES
03/07/2018;03/07/2018;T/  AUTOPISTAS TERR 30-06-2018;-2,56;19468,93;19466,37;11084;-2,56;19466,37;2018-06-30;30/06/2018;AUTOPISTAS;Gastos_Ocio y transporte;Parking y peaje;6;VARIABLES
03/07/2018;03/07/2018;T/  AUTOPISTAS TERR 30-06-2018;-2,56;19466,37;19463,81;11085;-2,56;19463,81;2018-06-30;30/06/2018;AUTOPISTAS;Gastos_Ocio y transporte;Parking y peaje;6;VARIABLES
03/07/2018;03/07/2018;T/  E.S. RUBI II 30-06-2018;-42,03;19463,81;19421,78;11086;-42,03;19421,78;2018-06-30;30/06/2018;RUBI;Gastos_Ocio y transporte;Gasolina;6;VARIABLES
03/07/2018;03/07/2018;T/  AUTOPISTAS TERR 29-06-2018;-1,41;19421,78;19420,37;11087;-1,41;19420,37;2018-06-29;29/06/2018;AUTOPISTAS;Gastos_Ocio y transporte;Parking y peaje;6;VARIABLES
05/07/2018;05/07/2018;T/ CATALUNYA CAIX\EL P 02-07-2018;-3,35;19420,37;19417,02;11088;-3,35;19417,02;2018-07-02;02/07/2018;CATALUNYA;Gastos_Ocio y transporte;Restaurantes;7;VARIABLES
05/07/2018;05/07/2018;T/ TUNELS VALLVI S. 29-06-2018;-3,78;19417,02;19413,24;11089;-3,78;19413,24;2018-06-29;29/06/2018;TUNELS;Gastos_Ocio y transporte;Parking y peaje;6;VARIABLES
06/07/2018;06/07/2018;T/ DECATHLON SA TERRA\ 03-07-2018;-3,78;19413,24;19409,46;11090;-3,78;19409,46;2018-07-03;03/07/2018;DECATHLON;Gastos_Compras;Deportivo;7;VARIABLES
06/07/2018;06/07/2018;T/ CATALUNYA CAIX\EL P 03-07-2018;-3,35;19409,46;19406,11;11091;-3,35;19406,11;2018-07-03;03/07/2018;CATALUNYA;Gastos_Ocio y transporte;Restaurantes;7;VARIABLES
06/07/2018;06/07/2018;T/ AUTOPISTAS TERR 03-07-2018;-1,41;19406,11;19404,70;11092;-1,41;19404,70;2018-07-03;03/07/2018;AUTOPISTAS;Gastos_Ocio y transporte;Parking y peaje;7;VARIABLES
06/07/2018;06/07/2018;T/ AUTOPISTAS TERR 03-07-2018;-1,41;19404,70;19403,29;11093;-1,41;19403,29;2018-07-03;03/07/2018;AUTOPISTAS;Gastos_Ocio y transporte;Parking y peaje;7;VARIABLES
06/07/2018;06/07/2018;T/ BON AREA 03-07-2018;-15,80;19403,29;19387,49;11094;-15,80;19387,49;2018-07-03;03/07/2018;BON;Gastos_Compras;Supermercado;7;VARIABLES
06/07/2018;06/07/2018;T/ AUTOPISTAS TERR 02-07-2018;-1,41;19387,49;19386,08;11095;-1,41;19386,08;2018-07-02;02/07/2018;AUTOPISTAS;Gastos_Ocio y transporte;Parking y peaje;7;VARIABLES
06/07/2018;06/07/2018;T/ AUTOPISTAS TERR 02-07-2018;-1,41;19386,08;19384,67;11096;-1,41;19384,67;2018-07-02;02/07/2018;AUTOPISTAS;Gastos_Ocio y transporte;Parking y peaje;7;VARIABLES
07/07/2018;07/07/2018;CAJ. AJENO CAIXABANK \TERRASSA;-300,00;19384,67;19084,67;11097;-300,00;19084,67;2018-07-07;07/07/2018;CAJ;Gastos_Gastos varios;Efectivo;7;VARIABLES
07/07/2018;07/07/2018;COM. 64970036 SVRED CAJ OFI;-2,00;19084,67;19082,67;11098;-2,00;19082,67;2018-07-07;07/07/2018;COM;Gastos_Banco y organismos;Cargos banco;7;FIJO
07/07/2018;07/07/2018;T/ DECATHLON SA TERRA\ 04-07-2018;-4,98;19082,67;19077,69;11099;-4,98;19077,69;2018-07-04;04/07/2018;DECATHLON;Gastos_Compras;Deportivo;7;VARIABLES
07/07/2018;07/07/2018;T/ CINESA WEB \B 04-07-2018;-22,80;19077,69;19054,89;11100;-22,80;19054,89;2018-07-04;04/07/2018;CINESA;Gastos_Ocio y transporte;Espectáculos;7;VARIABLES
08/07/2018;08/07/2018;T/ AUTOPISTAS TERR 05-07-2018;-1,41;19054,89;19053,48;11101;-1,41;19053,48;2018-07-05;05/07/2018;AUTOPISTAS;Gastos_Ocio y transporte;Parking y peaje;7;VARIABLES
08/07/2018;08/07/2018;T/ AUTOPISTAS TERR 05-07-2018;-1,41;19053,48;19052,07;11102;-1,41;19052,07;2018-07-05;05/07/2018;AUTOPISTAS;Gastos_Ocio y transporte;Parking y peaje;7;VARIABLES
08/07/2018;08/07/2018;T/ TUNELS VALLVI S. 05-07-2018;-3,78;19052,07;19048,29;11103;-3,78;19048,29;2018-07-05;05/07/2018;TUNELS;Gastos_Ocio y transporte;Parking y peaje;7;VARIABLES
08/07/2018;08/07/2018;T/ CATALUNYA CAIX\EL P 05-07-2018;-0,95;19048,29;19047,34;11104;-0,95;19047,34;2018-07-05;05/07/2018;CATALUNYA;Gastos_Ocio y transporte;Restaurantes;7;VARIABLES
08/07/2018;08/07/2018;T/ AUTOPISTAS TERR 04-07-2018;-1,41;19047,34;19045,93;11105;-1,41;19045,93;2018-07-04;04/07/2018;AUTOPISTAS;Gastos_Ocio y transporte;Parking y peaje;7;VARIABLES
08/07/2018;08/07/2018;T/ AUTOPISTAS TERR 04-07-2018;-1,41;19045,93;19044,52;11106;-1,41;19044,52;2018-07-04;04/07/2018;AUTOPISTAS;Gastos_Ocio y transporte;Parking y peaje;7;VARIABLES
08/07/2018;08/07/2018;T/ TUNELS VALLVI S. 04-07-2018;-3,78;19044,52;19040,74;11107;-3,78;19040,74;2018-07-04;04/07/2018;TUNELS;Gastos_Ocio y transporte;Parking y peaje;7;VARIABLES
08/07/2018;08/07/2018;T/ TUNELS VALLVI S. 03-07-2018;-3,78;19040,74;19036,96;11108;-3,78;19036,96;2018-07-03;03/07/2018;TUNELS;Gastos_Ocio y transporte;Parking y peaje;7;VARIABLES
08/07/2018;08/07/2018;T/ TUNELS VALLVI S. 02-07-2018;-3,78;19036,96;19033,18;11109;-3,78;19033,18;2018-07-02;02/07/2018;TUNELS;Gastos_Ocio y transporte;Parking y peaje;7;VARIABLES
09/07/2018;09/07/2018;T/ E.S.RUBI 9 \RUBI;-52,26;19033,18;18980,92;11110;-52,26;18980,92;2018-07-09;09/07/2018;ESRUBI;Gastos_Ocio y transporte;Gasolina;7;VARIABLES
09/07/2018;09/07/2018;T/ CATALUNYA CAIX\EL P 06-07-2018;-8,40;18980,92;18972,52;11111;-8,40;18972,52;2018-07-06;06/07/2018;CATALUNYA;Gastos_Ocio y transporte;Restaurantes;7;VARIABLES
09/07/2018;09/07/2018;T/ PAGO TRIBUTOS \B 06-07-2018;-76,54;18972,52;18895,98;11112;-76,54;18895,98;2018-07-06;06/07/2018;PAGO;Gastos_Banco y organismos;Impuestos;7;FIJO
09/07/2018;09/07/2018;T/ DRIM CAN PARELLADA\ 06-07-2018;-20,03;18895,98;18875,95;11113;-20,03;18875,95;2018-07-06;06/07/2018;DRIM;Gastos_Compras;Niños;7;VARIABLES
10/07/2018;06/07/2018;T/ CARREFOUR VALLE;-33,35;18875,95;18842,60;11114;-33,35;18842,60;2018-07-06;06/07/2018;CARREFOUR;Gastos_Compras;Supermercado;7;VARIABLES
10/07/2018;10/07/2018;T/ REST.KAORI \BARBE 07-07-2018;-47,90;18842,60;18794,70;11115;-47,90;18794,70;2018-07-07;07/07/2018;RESTKAORI;Gastos_Ocio y transporte;Restaurantes;7;VARIABLES
10/07/2018;10/07/2018;T/ BARICENTRO L 4\BARB 07-07-2018;-7,95;18794,70;18786,75;11116;-7,95;18786,75;2018-07-07;07/07/2018;BARICENTRO;Gastos_Ocio y transporte;Restaurantes;7;VARIABLES
10/07/2018;10/07/2018;T/ AUTOPISTAS TERR 06-07-2018;-1,41;18786,75;18785,34;11117;-1,41;18785,34;2018-07-06;06/07/2018;AUTOPISTAS;Gastos_Ocio y transporte;Parking y peaje;7;VARIABLES
10/07/2018;10/07/2018;T/ AUTOPISTAS TERR 06-07-2018;-1,41;18785,34;18783,93;11118;-1,41;18783,93;2018-07-06;06/07/2018;AUTOPISTAS;Gastos_Ocio y transporte;Parking y peaje;7;VARIABLES
11/07/2018;11/07/2018;R/ . FINQUES GASS Vto 01-07-18 Rec;-73,69;18783,93;18710,24;11119;-73,69;18710,24;2018-07-01;01/07/2018;FINQUES;Gastos_Vivienda y vehiculo;Alquiler Parking;7;FIJO
11/07/2018;11/07/2018;T/ TUNELS VALLVI S. 06-07-2018;-4,25;18710,24;18705,99;11120;-4,25;18705,99;2018-07-06;06/07/2018;TUNELS;Gastos_Ocio y transporte;Parking y peaje;7;VARIABLES
12/07/2018;12/07/2018;R/ GAS GAS NATURAL GNS27630480718;-4,64;18705,99;18701,35;11121;-4,64;18701,35;2018-07-12;12/07/2018;GAS;Gastos_Servicios tipicos;Gas;7;FIJO
12/07/2018;12/07/2018;T/ AUTOPISTAS TERR 09-07-2018;-1,41;18701,35;18699,94;11122;-1,41;18699,94;2018-07-09;09/07/2018;AUTOPISTAS;Gastos_Ocio y transporte;Parking y peaje;7;VARIABLES
12/07/2018;12/07/2018;T/ AUTOPISTAS TERR 09-07-2018;-1,41;18699,94;18698,53;11123;-1,41;18698,53;2018-07-09;09/07/2018;AUTOPISTAS;Gastos_Ocio y transporte;Parking y peaje;7;VARIABLES
12/07/2018;12/07/2018;T/ TUNELS VALLVI S. 09-07-2018;-3,78;18698,53;18694,75;11124;-3,78;18694,75;2018-07-09;09/07/2018;TUNELS;Gastos_Ocio y transporte;Parking y peaje;7;VARIABLES
12/07/2018;12/07/2018;T/ BON AREA 09-07-2018;-18,32;18694,75;18676,43;11125;-18,32;18676,43;2018-07-09;09/07/2018;BON;Gastos_Compras;Supermercado;7;VARIABLES
12/07/2018;12/07/2018;T/ CATALUNYA CAIX\EL P 09-07-2018;-3,10;18676,43;18673,33;11126;-3,10;18673,33;2018-07-09;09/07/2018;CATALUNYA;Gastos_Ocio y transporte;Restaurantes;7;VARIABLES
13/07/2018;13/07/2018;R/ TELECOMUNICACI VODAFONE;-159,05;18673,33;18514,28;11127;-159,05;18514,28;2018-07-13;13/07/2018;TELECOMUNICACI;Gastos_Servicios tipicos;Telecomunicaciones;7;FIJO
13/07/2018;13/07/2018;R/ LUZ ENDESA ENERG FACTURA DE ELE;-119,50;18514,28;18394,78;11128;-119,50;18394,78;2018-07-13;13/07/2018;ELE;Gastos_Servicios tipicos;Electricidad;7;FIJO
13/07/2018;13/07/2018;S/OR. JUANDIK;-40,00;18394,78;18354,78;11129;-40,00;18354,78;2018-07-13;13/07/2018;JUANDIK;Gastos_Ocio y transporte;Loterias;7;
13/07/2018;13/07/2018;T/ AUTOPISTAS TERR 10-07-2018;-1,41;18354,78;18353,37;11130;-1,41;18353,37;2018-07-10;10/07/2018;AUTOPISTAS;Gastos_Ocio y transporte;Parking y peaje;7;VARIABLES
13/07/2018;13/07/2018;T/ AUTOPISTAS TERR 10-07-2018;-1,41;18353,37;18351,96;11131;-1,41;18351,96;2018-07-10;10/07/2018;AUTOPISTAS;Gastos_Ocio y transporte;Parking y peaje;7;VARIABLES
13/07/2018;13/07/2018;T/ TUNELS VALLVI S. 10-07-2018;-3,78;18351,96;18348,18;11132;-3,78;18348,18;2018-07-10;10/07/2018;TUNELS;Gastos_Ocio y transporte;Parking y peaje;7;VARIABLES
13/07/2018;13/07/2018;T/ CATALUNYA CAIX\EL P 10-07-2018;-2,30;18348,18;18345,88;11133;-2,30;18345,88;2018-07-10;10/07/2018;CATALUNYA;Gastos_Ocio y transporte;Restaurantes;7;VARIABLES
13/07/2018;13/07/2018;T/ SUPER.REYPA \TARRA 10-07-2018;-5,11;18345,88;18340,77;11134;-5,11;18340,77;2018-07-10;10/07/2018;SUPERREYPA;Gastos_Compras;Supermercado;7;VARIABLES
14/07/2018;14/07/2018;T/ CATALUNYA CAIX\EL P 11-07-2018;-3,20;18340,77;18337,57;11135;-3,20;18337,57;2018-07-11;11/07/2018;CATALUNYA;Gastos_Ocio y transporte;Restaurantes;7;VARIABLES
15/07/2018;15/07/2018;T/ AUTOPISTAS TERR 12-07-2018;-1,41;18337,57;18336,16;11136;-1,41;18336,16;2018-07-12;12/07/2018;AUTOPISTAS;Gastos_Ocio y transporte;Parking y peaje;7;VARIABLES
15/07/2018;15/07/2018;T/ AUTOPISTAS TERR 12-07-2018;-1,41;18336,16;18334,75;11137;-1,41;18334,75;2018-07-12;12/07/2018;AUTOPISTAS;Gastos_Ocio y transporte;Parking y peaje;7;VARIABLES
15/07/2018;15/07/2018;T/ TUNELS VALLVI S. 12-07-2018;-3,78;18334,75;18330,97;11138;-3,78;18330,97;2018-07-12;12/07/2018;TUNELS;Gastos_Ocio y transporte;Parking y peaje;7;VARIABLES
15/07/2018;15/07/2018;T/ L ALFABREGA \VA 12-07-2018;-27,30;18330,97;18303,67;11139;-27,30;18303,67;2018-07-12;12/07/2018;ALFABREGA;Gastos_Compras;Supermercado;7;VARIABLES
15/07/2018;15/07/2018;T/ CATALUNYA CAIX\EL P 12-07-2018;-2,30;18303,67;18301,37;11140;-2,30;18301,37;2018-07-12;12/07/2018;CATALUNYA;Gastos_Ocio y transporte;Restaurantes;7;VARIABLES
15/07/2018;15/07/2018;T/ AUTOPISTAS TERR 11-07-2018;-1,41;18301,37;18299,96;11141;-1,41;18299,96;2018-07-11;11/07/2018;AUTOPISTAS;Gastos_Ocio y transporte;Parking y peaje;7;VARIABLES
15/07/2018;15/07/2018;T/ TUNELS VALLVI S. 11-07-2018;-3,78;18299,96;18296,18;11142;-3,78;18296,18;2018-07-11;11/07/2018;TUNELS;Gastos_Ocio y transporte;Parking y peaje;7;VARIABLES
15/07/2018;15/07/2018;T/ AUTOPISTAS TERR 11-07-2018;-1,41;18296,18;18294,77;11143;-1,41;18294,77;2018-07-11;11/07/2018;AUTOPISTAS;Gastos_Ocio y transporte;Parking y peaje;7;VARIABLES
15/07/2018;15/07/2018;T/ PKPRATIS 06-07-2018;-0,60;18294,77;18294,17;11144;-0,60;18294,17;2018-07-06;06/07/2018;PKPRATIS;Gastos_Ocio y transporte;Parking y peaje;7;VARIABLES
16/07/2018;16/07/2018;T/ CATALUNYA CAIX\EL P 13-07-2018;-8,40;18294,17;18285,77;11145;-8,40;18285,77;2018-07-13;13/07/2018;CATALUNYA;Gastos_Ocio y transporte;Restaurantes;7;VARIABLES
17/07/2018;17/07/2018;R/ SEGUROS CCM VIDA Y P Recibo:150;-15,52;18285,77;18270,25;11146;-15,52;18270,25;2018-07-17;17/07/2018;CCM;Gastos_Seguros;Seguro vida;7;FIJO
17/07/2018;17/07/2018;R/ SEGUROS CCM VIDA Y P Recibo:150;-19,23;18270,25;18251,02;11147;-19,23;18251,02;2018-07-17;17/07/2018;CCM;Gastos_Seguros;Seguro vida;7;FIJO
17/07/2018;17/07/2018;HAB. BBVA INFORMATION TECHNOLOGY ES;1803,57;18251,02;20054,59;11148;1803,57;20054,59;2018-07-17;17/07/2018;HAB;Ingresos;Nomina;7;FIJO
17/07/2018;17/07/2018;T/ WWW.JUST-EAT.ES 14-07-2018;-36,70;20054,59;20017,89;11149;-36,70;20017,89;2018-07-14;14/07/2018;WWWJUSTEATES;Gastos_Ocio y transporte;Restaurantes;7;VARIABLES
17/07/2018;17/07/2018;T/ AUTOPISTAS TERR 13-07-2018;-1,41;20017,89;20016,48;11150;-1,41;20016,48;2018-07-13;13/07/2018;AUTOPISTAS;Gastos_Ocio y transporte;Parking y peaje;7;VARIABLES
17/07/2018;17/07/2018;T/ AUTOPISTAS TERR 13-07-2018;-1,41;20016,48;20015,07;11151;-1,41;20015,07;2018-07-13;13/07/2018;AUTOPISTAS;Gastos_Ocio y transporte;Parking y peaje;7;VARIABLES
18/07/2018;18/07/2018;T/ TUNELS VALLVI S. 13-07-2018;-4,25;20015,07;20010,82;11152;-4,25;20010,82;2018-07-13;13/07/2018;TUNELS;Gastos_Ocio y transporte;Parking y peaje;7;VARIABLES
19/07/2018;19/07/2018;T/ AUTOPISTAS TERR 16-07-2018;-1,41;20010,82;20009,41;11153;-1,41;20009,41;2018-07-16;16/07/2018;AUTOPISTAS;Gastos_Ocio y transporte;Parking y peaje;7;VARIABLES
19/07/2018;19/07/2018;T/ CATALUNYA CAIX\EL P 16-07-2018;-2,75;20009,41;20006,66;11154;-2,75;20006,66;2018-07-16;16/07/2018;CATALUNYA;Gastos_Ocio y transporte;Restaurantes;7;VARIABLES
20/07/2018;20/07/2018;T/ AUTOPISTAS TERR 17-07-2018;-1,41;20006,66;20005,25;11155;-1,41;20005,25;2018-07-17;17/07/2018;AUTOPISTAS;Gastos_Ocio y transporte;Parking y peaje;7;VARIABLES
20/07/2018;20/07/2018;T/ AUTOPISTAS TERR 17-07-2018;-1,41;20005,25;20003,84;11156;-1,41;20003,84;2018-07-17;17/07/2018;AUTOPISTAS;Gastos_Ocio y transporte;Parking y peaje;7;VARIABLES
20/07/2018;20/07/2018;T/ TUNELS VALLVI S. 17-07-2018;-3,78;20003,84;20000,06;11157;-3,78;20000,06;2018-07-17;17/07/2018;TUNELS;Gastos_Ocio y transporte;Parking y peaje;7;VARIABLES
20/07/2018;20/07/2018;T/ TUNELS VALLVI S. 16-07-2018;-3,78;20000,06;19996,28;11158;-3,78;19996,28;2018-07-16;16/07/2018;TUNELS;Gastos_Ocio y transporte;Parking y peaje;7;VARIABLES
21/07/2018;21/07/2018;T/ AUTOPISTAS TERR 18-07-2018;-1,41;19996,28;19994,87;11159;-1,41;19994,87;2018-07-18;18/07/2018;AUTOPISTAS;Gastos_Ocio y transporte;Parking y peaje;7;VARIABLES
21/07/2018;21/07/2018;T/ AUTOPISTAS TERR 18-07-2018;-1,41;19994,87;19993,46;11160;-1,41;19993,46;2018-07-18;18/07/2018;AUTOPISTAS;Gastos_Ocio y transporte;Parking y peaje;7;VARIABLES
21/07/2018;21/07/2018;T/ CINESA WEB \B 18-07-2018;-25,60;19993,46;19967,86;11161;-25,60;19967,86;2018-07-18;18/07/2018;CINESA;Gastos_Ocio y transporte;Espectáculos;7;VARIABLES
21/07/2018;21/07/2018;T/ CINESA PARC VALLES\ 18-07-2018;-15,58;19967,86;19952,28;11162;-15,58;19952,28;2018-07-18;18/07/2018;CINESA;Gastos_Ocio y transporte;Espectáculos;7;VARIABLES
22/07/2018;22/07/2018;T/ AUTOPISTAS TERR 19-07-2018;-1,41;19952,28;19950,87;11163;-1,41;19950,87;2018-07-19;19/07/2018;AUTOPISTAS;Gastos_Ocio y transporte;Parking y peaje;7;VARIABLES
22/07/2018;22/07/2018;T/ CATALUNYA CAIX\EL P 19-07-2018;-4,00;19950,87;19946,87;11164;-4,00;19946,87;2018-07-19;19/07/2018;CATALUNYA;Gastos_Ocio y transporte;Restaurantes;7;VARIABLES
22/07/2018;22/07/2018;T/ WWW.JUST-EAT.ES 19-07-2018;-40,00;19946,87;19906,87;11165;-40,00;19906,87;2018-07-19;19/07/2018;WWWJUSTEATES;Gastos_Ocio y transporte;Restaurantes;7;VARIABLES
22/07/2018;22/07/2018;T/ TUNELS VALLVI S. 18-07-2018;-4,25;19906,87;19902,62;11166;-4,25;19902,62;2018-07-18;18/07/2018;TUNELS;Gastos_Ocio y transporte;Parking y peaje;7;VARIABLES
23/07/2018;23/07/2018;T/ TUNELS VALLVI S. 19-07-2018;-3,78;19902,62;19898,84;11167;-3,78;19898,84;2018-07-19;19/07/2018;TUNELS;Gastos_Ocio y transporte;Parking y peaje;7;VARIABLES
24/07/2018;24/07/2018;T/ AUTOPISTAS TERR 20-07-2018;-1,41;19898,84;19897,43;11168;-1,41;19897,43;2018-07-20;20/07/2018;AUTOPISTAS;Gastos_Ocio y transporte;Parking y peaje;7;VARIABLES
26/07/2018;26/07/2018;BONIF.COM. 5540556264970036;24,00;19897,43;19921,43;11169;24,00;19921,43;2018-07-26;26/07/2018;BONIFCOM;Ingresos;Devoluciones;7;VARIABLES
26/07/2018;26/07/2018;COMIS.TARJETAS 5540556264970036;-24,00;19921,43;19897,43;11170;-24,00;19897,43;2018-07-26;26/07/2018;COMISTARJETAS;Gastos_Banco y organismos;Cargos banco;7;FIJO
26/07/2018;26/07/2018;S/OR. AMPA Escola Sala i Badrinas;-30,00;19897,43;19867,43;11171;-30,00;19867,43;2018-07-26;26/07/2018;AMPA;Gastos_Salud, saber y deporte;Estudios;7;VARIABLES
26/07/2018;26/07/2018;T/ CATALUNYA CAIX\EL P 23-07-2018;-3,15;19867,43;19864,28;11172;-3,15;19864,28;2018-07-23;23/07/2018;CATALUNYA;Gastos_Ocio y transporte;Restaurantes;7;VARIABLES
26/07/2018;26/07/2018;'T/ JOHN''S ITALIAN CAF\ 23-07-2018';-23,70;19864,28;19840,58;11173;-23,70;19840,58;2018-07-23;23/07/2018;JOHNS;Gastos_Ocio y transporte;Restaurantes;7;VARIABLES
27/07/2018;27/07/2018;HAB. BBVA INFORMATION TECHNOLOGY ES;1661,34;19840,58;21501,92;11174;1661,34;21501,92;2018-07-27;27/07/2018;HAB;Ingresos;Nomina;7;FIJO
27/07/2018;27/07/2018;HAB. AJUNTAMENT DE TERRASSA Transfe;2781,77;21501,92;24283,69;11175;2781,77;24283,69;2018-07-27;27/07/2018;HAB;Ingresos;Nomina;7;FIJO
27/07/2018;27/07/2018;HAB. FOMENT DE TERRASSA S.A. Transf;55,00;24283,69;24338,69;11176;55,00;24338,69;2018-07-27;27/07/2018;HAB;Ingresos;Nomina;7;FIJO
27/07/2018;27/07/2018;T/ FARMACIA LOSA \ 24-07-2018;-21,69;24338,69;24317,00;11177;-21,69;24317,00;2018-07-24;24/07/2018;FARMACIA;Gastos_Salud, saber y deporte;Farmacia;7;VARIABLES
27/07/2018;27/07/2018;T/ CATALUNYA CAIX\EL P 24-07-2018;-3,85;24317,00;24313,15;11178;-3,85;24313,15;2018-07-24;24/07/2018;CATALUNYA;Gastos_Ocio y transporte;Restaurantes;7;VARIABLES
27/07/2018;27/07/2018;T/ SUPER TAL-DIS, SL.\ 24-07-2018;-19,67;24313,15;24293,48;11179;-19,67;24293,48;2018-07-24;24/07/2018;SUPER;Gastos_Compras;Supermercado;7;VARIABLES
27/07/2018;27/07/2018;T/ FF.CC.GENERALITAT\B 24-07-2018;-27,40;24293,48;24266,08;11180;-27,40;24266,08;2018-07-24;24/07/2018;FFCCGENERALITATB;Gastos_Ocio y transporte;Transporte;7;VARIABLES
28/07/2018;28/07/2018;T/  AUTOPISTAS TERR 25-07-2018;-1,41;24266,08;24264,67;11181;-1,41;24264,67;2018-07-25;25/07/2018;AUTOPISTAS;Gastos_Ocio y transporte;Parking y peaje;7;VARIABLES
28/07/2018;28/07/2018;T/  CINESA PARC VALLES\ 25-07-2018;-11,40;24264,67;24253,27;11182;-11,40;24253,27;2018-07-25;25/07/2018;CINESA;Gastos_Ocio y transporte;Espectáculos;7;VARIABLES
28/07/2018;28/07/2018;T/  CATALUNYA CAIX\EL P 25-07-2018;-5,00;24253,27;24248,27;11183;-5,00;24248,27;2018-07-25;25/07/2018;CATALUNYA;Gastos_Ocio y transporte;Restaurantes;7;VARIABLES
28/07/2018;28/07/2018;T/  CINESA PARC VALLES\ 25-07-2018;-10,80;24248,27;24237,47;11184;-10,80;24237,47;2018-07-25;25/07/2018;CINESA;Gastos_Ocio y transporte;Espectáculos;7;VARIABLES
29/07/2018;29/07/2018;T/  RED ANT. \BARCELONA;-54,20;24237,47;24183,27;11185;-54,20;24183,27;2018-07-29;29/07/2018;RED;Gastos_Ocio y transporte;Restaurantes;7;VARIABLES
29/07/2018;29/07/2018;T/  CATALUNYA CAIX\EL P 26-07-2018;-2,90;24183,27;24180,37;11186;-2,90;24180,37;2018-07-26;26/07/2018;CATALUNYA;Gastos_Ocio y transporte;Restaurantes;7;VARIABLES
29/07/2018;29/07/2018;T/  NOSTRUM 26-07-2018;-9,00;24180,37;24171,37;11187;-9,00;24171,37;2018-07-26;26/07/2018;NOSTRUM;Gastos_Ocio y transporte;Restaurantes;7;VARIABLES
30/07/2018;30/07/2018;T/  WWW.JUST-EAT.ES 27-07-2018;-34,40;24171,37;24136,97;11188;-34,40;24136,97;2018-07-27;27/07/2018;WWWJUSTEATES;Gastos_Ocio y transporte;Restaurantes;7;VARIABLES
30/07/2018;30/07/2018;T/  CATALUNYA CAIX\EL P 27-07-2018;-3,35;24136,97;24133,62;11189;-3,35;24133,62;2018-07-27;27/07/2018;CATALUNYA;Gastos_Ocio y transporte;Restaurantes;7;VARIABLES
30/07/2018;30/07/2018;CAJ. AJENO  SERVIRED \TERRASSA;-200,00;24133,62;23933,62;11190;-200,00;23933,62;2018-07-30;30/07/2018;CAJ;Gastos_Gastos varios;Efectivo;7;VARIABLES
30/07/2018;30/07/2018;COM.  64970036 SVRED CAJ OFI;-1,87;23933,62;23931,75;11191;-1,87;23931,75;2018-07-30;30/07/2018;COM;Gastos_Banco y organismos;Cargos banco;7;FIJO
31/07/2018;31/07/2018;R/  AYUNTAMIENTO AJUNTAMENT D TAXA;-55,08;23931,75;23876,67;11192;-55,08;23876,67;2018-07-31;31/07/2018;AYUNTAMIENTO;Gastos_Banco y organismos;Ayuntamiento;7;FIJO
31/07/2018;31/07/2018;REC.  6061.9600001223;-448,11;23876,67;23428,56;11193;-448,11;23428,56;2018-07-31;31/07/2018;REC;Gastos_Banco y organismos;Hipoteca;7;FIJO
31/07/2018;28/07/2018;T/  WWW.SHEIN.COM;-135,43;23428,56;23293,13;11194;-135,43;23293,13;2018-07-28;28/07/2018;WWWSHEINCOM;Gastos_Compras;Ropa;7;VARIABLES
31/07/2018;31/07/2018;T/  WWW.JUST-EAT.ES 28-07-2018;-55,05;23293,13;23238,08;11195;-55,05;23238,08;2018-07-28;28/07/2018;WWWJUSTEATES;Gastos_Ocio y transporte;Restaurantes;7;VARIABLES
31/07/2018;31/07/2018;T/  SUPER.REYPA \TARRA 28-07-2018;-19,27;23238,08;23218,81;11196;-19,27;23218,81;2018-07-28;28/07/2018;SUPERREYPA;Gastos_Compras;Supermercado;7;VARIABLES
01/08/2018;01/08/2018;FACT TARJETAS  TARJ.CREDITO 07126017 18-08-01;-492,10;23218,81;22726,71;11197;-492,10;22726,71;2018-08-01;31/07/2018;FACT 07126017;Gastos_Banco y organismos;Credito Bea;7;VARIABLE
01/08/2018;01/08/2018;FACT TARJETAS  TARJ.CREDITO 42689013 18-08-01;-586,08;22726,71;22140,63;11198;-586,08;22140,63;2018-08-01;31/07/2018;FACT;No computable;Recibo Tarjeta;7;
01/08/2018;01/08/2018;T/  FF.CC.GENERALITAT\B 29-07-2018;-27,40;22140,63;22113,23;11199;-27,40;22113,23;2018-07-29;29/07/2018;FFCCGENERALITATB;Gastos_Ocio y transporte;Transporte;7;VARIABLES
01/08/2018;01/08/2018;T/  CANDYLU - ESTACIO\B 29-07-2018;-7,50;22113,23;22105,73;11200;-7,50;22105,73;2018-07-29;29/07/2018;CANDYLU;Gastos_Compras;Otras compras;7;VARIABLES
02/08/2018;02/08/2018;R/  SEGUROS ADESLAS CENT MODULAR CO;-159,81;22105,73;21945,92;11201;-159,81;21945,92;2018-08-02;02/08/2018;ADESLAS;Gastos_Salud, saber y deporte;Medico;8;VARIABLES
02/08/2018;02/08/2018;T/  CATALUNYA CAIX\EL P 30-07-2018;-3,35;21945,92;21942,57;11202;-3,35;21942,57;2018-07-30;30/07/2018;CATALUNYA;Gastos_Ocio y transporte;Restaurantes;7;VARIABLES
03/08/2018;03/08/2018;T/ AUTOPISTAS TERR 31-07-2018;-1,41;21942,57;21941,16;11203;-1,41;21941,16;2018-07-31;31/07/2018;AUTOPISTAS;Gastos_Ocio y transporte;Parking y peaje;7;VARIABLES
03/08/2018;03/08/2018;T/ AUTOPISTAS TERR 31-07-2018;-1,41;21941,16;21939,75;11204;-1,41;21939,75;2018-07-31;31/07/2018;AUTOPISTAS;Gastos_Ocio y transporte;Parking y peaje;7;VARIABLES
04/08/2018;04/08/2018;T/ AUTOPISTAS TERR 01-08-2018;-1,41;21939,75;21938,34;11205;-1,41;21938,34;2018-08-01;01/08/2018;AUTOPISTAS;Gastos_Ocio y transporte;Parking y peaje;8;VARIABLES
04/08/2018;04/08/2018;T/ AUTOPISTAS TERR 01-08-2018;-1,41;21938,34;21936,93;11206;-1,41;21936,93;2018-08-01;01/08/2018;AUTOPISTAS;Gastos_Ocio y transporte;Parking y peaje;8;VARIABLES
04/08/2018;04/08/2018;T/ TUNELS VALLVI S. 01-08-2018;-4,25;21936,93;21932,68;11207;-4,25;21932,68;2018-08-01;01/08/2018;TUNELS;Gastos_Ocio y transporte;Parking y peaje;8;VARIABLES
04/08/2018;04/08/2018;T/ CATALUNYA CAIX\EL P 01-08-2018;-5,00;21932,68;21927,68;11208;-5,00;21927,68;2018-08-01;01/08/2018;CATALUNYA;Gastos_Ocio y transporte;Restaurantes;8;VARIABLES
04/08/2018;04/08/2018;T/ SPRINGFIELD \CORNE 01-08-2018;-45,95;21927,68;21881,73;11209;-45,95;21881,73;2018-08-01;01/08/2018;SPRINGFIELD;Gastos_Compras;Ropa;8;VARIABLES
06/08/2018;06/08/2018;R/ . FINQUES GASS Vto 01-08-18 Rec;-73,69;21881,73;21808,04;11210;-73,69;21808,04;2018-08-01;01/08/2018;FINQUES;Gastos_Vivienda y vehiculo;Alquiler Parking;8;FIJO
06/08/2018;06/08/2018;R/ LUZ ENDESA ENERG FACTURA DE GAS;-129,98;21808,04;21678,06;11211;-129,98;21678,06;2018-08-06;06/08/2018;GAS;Gastos_Servicios tipicos;Gas;8;FIJO
06/08/2018;06/08/2018;T/ CATALUNYA CAIX\EL P 03-08-2018;-4,55;21678,06;21673,51;11212;-4,55;21673,51;2018-08-03;03/08/2018;CATALUNYA;Gastos_Ocio y transporte;Restaurantes;8;VARIABLES
09/08/2018;08/08/2018;T/ PlaystationNetwork;-82,97;21673,51;21590,54;11213;-82,97;21590,54;2018-08-08;08/08/2018;PLAYSTATIONNETWORK;Gastos_Servicios tipicos;Servicios online;8;FIJO
09/08/2018;09/08/2018;T/ AUCAT BAR CUBEL 03-08-2018;-4,05;21590,54;21586,49;11214;-4,05;21586,49;2018-08-03;03/08/2018;AUCAT;Gastos_Ocio y transporte;Parking y peaje;8;VARIABLES
09/08/2018;09/08/2018;T/ AUTOPISTA MARE NOST 03-08-2018;-7,20;21586,49;21579,29;11215;-7,20;21579,29;2018-08-03;03/08/2018;AUTOPISTA;Gastos_Ocio y transporte;Parking y peaje;8;VARIABLES
09/08/2018;09/08/2018;T/ A.C.E.S.A A VENDREL 03-08-2018;-5,00;21579,29;21574,29;11216;-5,00;21574,29;2018-08-03;03/08/2018;ACESA;Gastos_Ocio y transporte;Parking y peaje;8;VARIABLES
09/08/2018;09/08/2018;T/ AUCAT BAR VALLC 03-08-2018;-6,78;21574,29;21567,51;11217;-6,78;21567,51;2018-08-03;03/08/2018;AUCAT;Gastos_Ocio y transporte;Parking y peaje;8;VARIABLES
10/08/2018;10/08/2018;T/ ADRIA COFFEE SCP 07-08-2018;-5,30;21567,51;21562,21;11218;-5,30;21562,21;2018-08-07;07/08/2018;ADRIA;Gastos_Ocio y transporte;Restaurantes;8;VARIABLES
10/08/2018;10/08/2018;T/ ASIA 07-08-2018;-19,50;21562,21;21542,71;11219;-19,50;21542,71;2018-08-07;07/08/2018;ASIA;Gastos_Compras;Hogar;8;VARIABLES
13/08/2018;13/08/2018;R/ GAS GAS NATURAL GNS27630480818;-4,72;21542,71;21537,99;11220;-4,72;21537,99;2018-08-13;13/08/2018;GAS;Gastos_Servicios tipicos;Gas;8;FIJO
13/08/2018;13/08/2018;T/ CINES OSCAR \ 10-08-2018;-20,00;21537,99;21517,99;11221;-20,00;21517,99;2018-08-10;10/08/2018;CINES;Gastos_Ocio y transporte;Espectáculos;8;VARIABLES
13/08/2018;13/08/2018;T/ CINES OSCAR \ 10-08-2018;-8,85;21517,99;21509,14;11222;-8,85;21509,14;2018-08-10;10/08/2018;CINES;Gastos_Ocio y transporte;Espectáculos;8;VARIABLES
13/08/2018;13/08/2018;T/ ASIA 10-08-2018;-17,30;21509,14;21491,84;11223;-17,30;21491,84;2018-08-10;10/08/2018;ASIA;Gastos_Compras;Hogar;8;VARIABLES
13/08/2018;13/08/2018;'T/ MACDONAL''S TORTOSA 10-08-2018';-25,80;21491,84;21466,04;11224;-25,80;21466,04;2018-08-10;10/08/2018;MACDONALS;Gastos_Ocio y transporte;Restaurantes;8;VARIABLES
14/08/2018;14/08/2018;R/ TELECOMUNICACI VODAFONE;-157,04;21466,04;21309,00;11225;-157,04;21309,00;2018-08-14;14/08/2018;TELECOMUNICACI;Gastos_Servicios tipicos;Telecomunicaciones;8;FIJO
14/08/2018;14/08/2018;T/ TEMPLE 11-08-2018;-35,45;21309,00;21273,55;11226;-35,45;21273,55;2018-08-11;11/08/2018;TEMPLE;Gastos_Ocio y transporte;Gasolina;8;VARIABLES
14/08/2018;14/08/2018;T/ FORN DE PA CAL PORT 11-08-2018;-9,10;21273,55;21264,45;11227;-9,10;21264,45;2018-08-11;11/08/2018;FORN;Gastos_Compras;Supermercado;8;VARIABLES
14/08/2018;14/08/2018;T/ VIENA TORTOSA 11-08-2018;-9,70;21264,45;21254,75;11228;-9,70;21254,75;2018-08-11;11/08/2018;VIENA;Gastos_Ocio y transporte;Restaurantes;8;VARIABLES
14/08/2018;14/08/2018;T/ MERCADONA TORTOSA 11-08-2018;-6,82;21254,75;21247,93;11229;-6,82;21247,93;2018-08-11;11/08/2018;MERCADONA;Gastos_Compras;Supermercado;8;VARIABLES
17/08/2018;17/08/2018;R/ SEGUROS CCM VIDA Y P Recibo:151;-15,45;21247,93;21232,48;11230;-15,45;21232,48;2018-08-17;17/08/2018;CCM;Gastos_Seguros;Seguro vida;8;FIJO
17/08/2018;17/08/2018;R/ SEGUROS CCM VIDA Y P Recibo:151;-19,14;21232,48;21213,34;11231;-19,14;21213,34;2018-08-17;17/08/2018;CCM;Gastos_Seguros;Seguro vida;8;FIJO
18/08/2018;18/08/2018;CAJ. AJENO CAIXABANK \ROQUETES;-200,00;21213,34;21013,34;11232;-200,00;21013,34;2018-08-18;18/08/2018;CAJ;Gastos_Gastos varios;Efectivo;8;VARIABLES
18/08/2018;18/08/2018;COM. 64970036 SVRED CAJ OFI;-2,00;21013,34;21011,34;11233;-2,00;21011,34;2018-08-18;18/08/2018;COM;Gastos_Banco y organismos;Cargos banco;8;FIJO
19/08/2018;19/08/2018;T/ CINEMES AMPOSTA 11 16-08-2018;-8,14;21011,34;21003,20;11234;-8,14;21003,20;2018-08-16;16/08/2018;CINEMES;Gastos_Ocio y transporte;Espectáculos;8;VARIABLES
19/08/2018;19/08/2018;'T/ MACDONAL''S TORTOSA 16-08-2018';-18,75;21003,20;20984,45;11235;-18,75;20984,45;2018-08-16;16/08/2018;MACDONALS;Gastos_Ocio y transporte;Restaurantes;8;VARIABLES
19/08/2018;19/08/2018;T/ CINEMES AMPOSTA 11 16-08-2018;-10,00;20984,45;20974,45;11236;-10,00;20974,45;2018-08-16;16/08/2018;CINEMES;Gastos_Ocio y transporte;Espectáculos;8;VARIABLES
20/08/2018;20/08/2018;T/ FORN DE PA CAL PORT 17-08-2018;-19,55;20974,45;20954,90;11237;-19,55;20954,90;2018-08-17;17/08/2018;FORN;Gastos_Compras;Supermercado;8;VARIABLES
21/08/2018;21/08/2018;T/ FORN DE PA CAL PORT 18-08-2018;-14,60;20954,90;20940,30;11238;-14,60;20940,30;2018-08-18;18/08/2018;FORN;Gastos_Compras;Supermercado;8;VARIABLES
22/08/2018;22/08/2018;T/ CINES OSCAR \ 19-08-2018;-5,92;20940,30;20934,38;11239;-5,92;20934,38;2018-08-19;19/08/2018;CINES;Gastos_Ocio y transporte;Espectáculos;8;VARIABLES
22/08/2018;22/08/2018;T/ IKEA SABADELL \SABADELL;-170,37;20934,38;20764,01;11240;-170,37;20764,01;2018-08-22;22/08/2018;IKEA;Gastos_Vivienda y vehiculo;Mnto. hogar;8;VARIABLES
23/08/2018;23/08/2018;T/ WWW.JUST-EAT.ES 20-08-2018;-31,24;20764,01;20732,77;11241;-31,24;20732,77;2018-08-20;20/08/2018;WWWJUSTEATES;Gastos_Ocio y transporte;Restaurantes;8;VARIABLES
24/08/2018;24/08/2018;T/ MERCADONA QUATRE C\TERRASSA;-191,31;20732,77;20541,46;11242;-191,31;20541,46;2018-08-24;24/08/2018;MERCADONA;Gastos_Compras;Supermercado;8;VARIABLES
24/08/2018;24/08/2018;T/ MUSEO DE CERA DE \B 21-08-2018;-48,00;20541,46;20493,46;11243;-48,00;20493,46;2018-08-21;21/08/2018;MUSEO;Gastos_Ocio y transporte;Espectáculos;8;VARIABLES
24/08/2018;24/08/2018;T/ FF.CC.GENERALITAT\B 21-08-2018;-27,40;20493,46;20466,06;11244;-27,40;20466,06;2018-08-21;21/08/2018;FFCCGENERALITATB;Gastos_Ocio y transporte;Transporte;8;VARIABLES
24/08/2018;24/08/2018;T/ MOSQUITO FERIAS \B 21-08-2018;-39,65;20466,06;20426,41;11245;-39,65;20426,41;2018-08-21;21/08/2018;MOSQUITO;Gastos_Ocio y transporte;Restaurantes;8;VARIABLES
25/08/2018;25/08/2018;T/ IKEA REST. SABADEL\ 22-08-2018;-8,20;20426,41;20418,21;11246;-8,20;20418,21;2018-08-22;22/08/2018;IKEA;Gastos_Vivienda y vehiculo;Mnto. hogar;8;VARIABLES
25/08/2018;25/08/2018;T/ IKEA REST. SABADEL\ 22-08-2018;-3,60;20418,21;20414,61;11247;-3,60;20414,61;2018-08-22;22/08/2018;IKEA;Gastos_Vivienda y vehiculo;Mnto. hogar;8;VARIABLES
25/08/2018;25/08/2018;T/ IKEA REST. SABADEL\ 22-08-2018;-25,80;20414,61;20388,81;11248;-25,80;20388,81;2018-08-22;22/08/2018;IKEA;Gastos_Vivienda y vehiculo;Mnto. hogar;8;VARIABLES
27/08/2018;27/08/2018;HAB. AJUNTAMENT DE TERRASSA Transfe;2506,72;20388,81;22895,53;11249;2506,72;22895,53;2018-08-27;27/08/2018;HAB;Ingresos;Nomina;8;FIJO
27/08/2018;27/08/2018;T/ WWW.JUST-EAT.ES 24-08-2018;-24,92;22895,53;22870,61;11250;-24,92;22870,61;2018-08-24;24/08/2018;WWWJUSTEATES;Gastos_Ocio y transporte;Restaurantes;8;VARIABLES
27/08/2018;27/08/2018;T/ WWW.JUST-EAT.ES 24-08-2018;-30,20;22870,61;22840,41;11251;-30,20;22840,41;2018-08-24;24/08/2018;WWWJUSTEATES;Gastos_Ocio y transporte;Restaurantes;8;VARIABLES
28/08/2018;28/08/2018;HAB. BBVA INFORMATION TECHNOLOGY ES;2053,38;22840,41;24893,79;11252;2053,38;24893,79;2018-08-28;28/08/2018;HAB;Ingresos;Nomina;8;FIJO
28/08/2018;25/08/2018;T/ AMZN Mktp ES;-61,82;24893,79;24831,97;11253;-61,82;24831,97;2018-08-25;25/08/2018;AMZN;Gastos_Compras;Hobbys;8;VARIABLES
28/08/2018;26/08/2018;T/ AMZN Mktp ES;-30,48;24831,97;24801,49;11254;-30,48;24801,49;2018-08-26;26/08/2018;AMZN;Gastos_Compras;Hobbys;8;VARIABLES
28/08/2018;27/08/2018;T/ AMZN Mktp ES;-15,15;24801,49;24786,34;11255;-15,15;24786,34;2018-08-27;27/08/2018;AMZN;Gastos_Compras;Hobbys;8;VARIABLES
28/08/2018;28/08/2018;T/ VIVE TU ESCAPE \L 25-08-2018;-30,00;24786,34;24756,34;11256;-30,00;24756,34;2018-08-25;25/08/2018;VIVE;Gastos_Ocio y transporte;Espectáculos;8;VARIABLES
29/08/2018;27/08/2018;T/ AMZN Mktp ES;-23,99;24756,34;24732,35;11257;-23,99;24732,35;2018-08-27;27/08/2018;AMZN;Gastos_Compras;Hobbys;8;VARIABLES
29/08/2018;29/08/2018;T/ AUTOPISTAS TERR 24-08-2018;-1,41;24732,35;24730,94;11258;-1,41;24730,94;2018-08-24;24/08/2018;AUTOPISTAS;Gastos_Ocio y transporte;Parking y peaje;8;VARIABLES
30/08/2018;30/08/2018;T/ AUTOPISTAS TERR 27-08-2018;-1,41;24730,94;24729,53;11259;-1,41;24729,53;2018-08-27;27/08/2018;AUTOPISTAS;Gastos_Ocio y transporte;Parking y peaje;8;VARIABLES
30/08/2018;30/08/2018;T/ AUTOPISTAS TERR 27-08-2018;-1,41;24729,53;24728,12;11260;-1,41;24728,12;2018-08-27;27/08/2018;AUTOPISTAS;Gastos_Ocio y transporte;Parking y peaje;8;VARIABLES
30/08/2018;30/08/2018;T/ CECOTEC \QUART DE POBL;-179,00;24728,12;24549,12;11261;-179,00;24549,12;2018-08-30;30/08/2018;CECOTEC;Gastos_Compras;Otras compras;8;VARIABLES
31/08/2018;31/08/2018;REC. 6061.9600001223;-448,11;24549,12;24101,01;11262;-448,11;24101,01;2018-08-31;31/08/2018;REC;Gastos_Banco y organismos;Hipoteca;8;FIJO
31/08/2018;31/08/2018;T/ BON AREA 28-08-2018;-40,07;24101,01;24060,94;11263;-40,07;24060,94;2018-08-28;28/08/2018;BON;Gastos_Compras;Supermercado;8;VARIABLES
01/09/2018;01/09/2018;FACT TARJETAS TARJ.CREDITO 07126017 18-09-01;-489,94;24060,94;23571,00;11264;-489,94;23571,00;2018-09-01;31/08/2018;FACT 07126017;Gastos_Banco y organismos;Credito Bea;8;VARIABLE
01/09/2018;01/09/2018;FACT TARJETAS TARJ.CREDITO 42689013 18-09-01;-520,31;23571,00;23050,69;11265;-520,31;23050,69;2018-09-01;31/08/2018;FACT;No computable;Recibo Tarjeta;8;
01/09/2018;01/09/2018;T/ WWW.JUST-EAT.ES 29-08-2018;-38,92;23050,69;23011,77;11266;-38,92;23011,77;2018-08-29;29/08/2018;WWWJUSTEATES;Gastos_Ocio y transporte;Restaurantes;8;VARIABLES
01/09/2018;01/09/2018;T/ AUTOPISTAS TERR 28-08-2018;-1,41;23011,77;23010,36;11267;-1,41;23010,36;2018-08-28;28/08/2018;AUTOPISTAS;Gastos_Ocio y transporte;Parking y peaje;8;VARIABLES
02/09/2018;02/09/2018;T/ AUTOPISTAS TERR 30-08-2018;-1,41;23010,36;23008,95;11268;-1,41;23008,95;2018-08-30;30/08/2018;AUTOPISTAS;Gastos_Ocio y transporte;Parking y peaje;8;VARIABLES
02/09/2018;02/09/2018;T/ CATALUNYA CAIX\EL P 30-08-2018;-5,40;23008,95;23003,55;11269;-5,40;23003,55;2018-08-30;30/08/2018;CATALUNYA;Gastos_Ocio y transporte;Restaurantes;8;VARIABLES
03/09/2018;03/09/2018;T/ CATALUNYA CAIX\EL P 31-08-2018;-5,40;23003,55;22998,15;11270;-5,40;22998,15;2018-08-31;31/08/2018;CATALUNYA;Gastos_Ocio y transporte;Restaurantes;8;VARIABLES
03/09/2018;03/09/2018;T/ CATALUNYA CAIX\EL P 31-08-2018;-2,50;22998,15;22995,65;11271;-2,50;22995,65;2018-08-31;31/08/2018;CATALUNYA;Gastos_Ocio y transporte;Restaurantes;8;VARIABLES
04/09/2018;04/09/2018;T/ CAFETERIA VINT I U\ 01-09-2018;-9,30;22995,65;22986,35;11272;-9,30;22986,35;2018-09-01;01/09/2018;CAFETERIA;Gastos_Compras;Supermercado;9;VARIABLES
04/09/2018;04/09/2018;T/ AUTOPISTAS TERR 31-08-2018;-1,41;22986,35;22984,94;11273;-1,41;22984,94;2018-08-31;31/08/2018;AUTOPISTAS;Gastos_Ocio y transporte;Parking y peaje;8;VARIABLES
04/09/2018;04/09/2018;T/ AUTOPISTAS TERR 31-08-2018;-1,41;22984,94;22983,53;11274;-1,41;22983,53;2018-08-31;31/08/2018;AUTOPISTAS;Gastos_Ocio y transporte;Parking y peaje;8;VARIABLES
05/09/2018;05/09/2018;R/ SEGUROS ADESLAS CENT MODULAR CO;-159,81;22983,53;22823,72;11275;-159,81;22823,72;2018-09-05;05/09/2018;ADESLAS;Gastos_Salud, saber y deporte;Medico;9;VARIABLES
06/09/2018;06/09/2018;T/ AUTOPISTAS TERR 03-09-2018;-1,41;22823,72;22822,31;11276;-1,41;22822,31;2018-09-03;03/09/2018;AUTOPISTAS;Gastos_Ocio y transporte;Parking y peaje;9;VARIABLES
06/09/2018;06/09/2018;T/ AUTOPISTAS TERR 03-09-2018;-1,41;22822,31;22820,90;11277;-1,41;22820,90;2018-09-03;03/09/2018;AUTOPISTAS;Gastos_Ocio y transporte;Parking y peaje;9;VARIABLES
06/09/2018;06/09/2018;T/ TUNELS VALLVI S. 03-09-2018;-4,25;22820,90;22816,65;11278;-4,25;22816,65;2018-09-03;03/09/2018;TUNELS;Gastos_Ocio y transporte;Parking y peaje;9;VARIABLES
06/09/2018;06/09/2018;T/ CATALUNYA CAIX\EL P 03-09-2018;-3,50;22816,65;22813,15;11279;-3,50;22813,15;2018-09-03;03/09/2018;CATALUNYA;Gastos_Ocio y transporte;Restaurantes;9;VARIABLES
07/09/2018;07/09/2018;R/ . FINQUES GASS Vto 01-09-18 Rec;-75,31;22813,15;22737,84;11280;-75,31;22737,84;2018-09-01;01/09/2018;FINQUES;Gastos_Vivienda y vehiculo;Alquiler Parking;9;FIJO
07/09/2018;07/09/2018;T/ PRMIERE \ 04-09-2018;-12,80;22737,84;22725,04;11281;-12,80;22725,04;2018-09-04;04/09/2018;PRMIERE;Gastos_Ocio y transporte;Restaurantes;9;VARIABLES
08/09/2018;06/09/2018;T/ CARREFOUR VALLE;-26,55;22725,04;22698,49;11282;-26,55;22698,49;2018-09-06;06/09/2018;CARREFOUR;Gastos_Compras;Supermercado;9;VARIABLES
08/09/2018;08/09/2018;T/ AUTOPISTAS TERR 05-09-2018;-1,41;22698,49;22697,08;11283;-1,41;22697,08;2018-09-05;05/09/2018;AUTOPISTAS;Gastos_Ocio y transporte;Parking y peaje;9;VARIABLES
08/09/2018;08/09/2018;T/ AUTOPISTAS TERR 05-09-2018;-1,41;22697,08;22695,67;11284;-1,41;22695,67;2018-09-05;05/09/2018;AUTOPISTAS;Gastos_Ocio y transporte;Parking y peaje;9;VARIABLES
08/09/2018;08/09/2018;T/ CINESA PARC VALLES\ 05-09-2018;-11,00;22695,67;22684,67;11285;-11,00;22684,67;2018-09-05;05/09/2018;CINESA;Gastos_Ocio y transporte;Espectáculos;9;VARIABLES
08/09/2018;08/09/2018;T/ CATALUNYA CAIX\EL P 05-09-2018;-2,30;22684,67;22682,37;11286;-2,30;22682,37;2018-09-05;05/09/2018;CATALUNYA;Gastos_Ocio y transporte;Restaurantes;9;VARIABLES
08/09/2018;08/09/2018;T/ TUNELS VALLVI S. 05-09-2018;-3,78;22682,37;22678,59;11287;-3,78;22678,59;2018-09-05;05/09/2018;TUNELS;Gastos_Ocio y transporte;Parking y peaje;9;VARIABLES
08/09/2018;08/09/2018;T/ CINESA WEB \B 05-09-2018;-11,40;22678,59;22667,19;11288;-11,40;22667,19;2018-09-05;05/09/2018;CINESA;Gastos_Ocio y transporte;Espectáculos;9;VARIABLES
09/09/2018;09/09/2018;T/ CATALUNYA CAIX\EL P 06-09-2018;-2,50;22667,19;22664,69;11289;-2,50;22664,69;2018-09-06;06/09/2018;CATALUNYA;Gastos_Ocio y transporte;Restaurantes;9;VARIABLES
09/09/2018;09/09/2018;T/ AUTOPISTAS TERR 06-09-2018;-1,41;22664,69;22663,28;11290;-1,41;22663,28;2018-09-06;06/09/2018;AUTOPISTAS;Gastos_Ocio y transporte;Parking y peaje;9;VARIABLES
09/09/2018;09/09/2018;T/ AUTOPISTAS TERR 06-09-2018;-1,41;22663,28;22661,87;11291;-1,41;22661,87;2018-09-06;06/09/2018;AUTOPISTAS;Gastos_Ocio y transporte;Parking y peaje;9;VARIABLES
09/09/2018;09/09/2018;T/ TUNELS VALLVI S. 06-09-2018;-4,25;22661,87;22657,62;11292;-4,25;22657,62;2018-09-06;06/09/2018;TUNELS;Gastos_Ocio y transporte;Parking y peaje;9;VARIABLES
09/09/2018;09/09/2018;T/ NOSTRUM \SANT 06-09-2018;-8,50;22657,62;22649,12;11293;-8,50;22649,12;2018-09-06;06/09/2018;NOSTRUM;Gastos_Ocio y transporte;Restaurantes;9;VARIABLES
09/09/2018;09/09/2018;T/ AKI 104 - TERRASSA\ 06-09-2018;-7,45;22649,12;22641,67;11294;-7,45;22641,67;2018-09-06;06/09/2018;AKI;Gastos_Vivienda y vehiculo;Mnto. hogar;9;VARIABLES
10/09/2018;10/09/2018;T/ CATALUNYA CAIX\EL P 07-09-2018;-3,05;22641,67;22638,62;11295;-3,05;22638,62;2018-09-07;07/09/2018;CATALUNYA;Gastos_Ocio y transporte;Restaurantes;9;VARIABLES
10/09/2018;10/09/2018;T/ L ALFABREGA \VA 07-09-2018;-20,00;22638,62;22618,62;11296;-20,00;22618,62;2018-09-07;07/09/2018;ALFABREGA;Gastos_Compras;Supermercado;9;VARIABLES
11/09/2018;11/09/2018;T/ SUPER.REYPA \TARRA 08-09-2018;-33,49;22618,62;22585,13;11297;-33,49;22585,13;2018-09-08;08/09/2018;SUPERREYPA;Gastos_Compras;Supermercado;9;VARIABLES
12/09/2018;12/09/2018;T/ AUTOPISTAS TERR 07-09-2018;-1,41;22585,13;22583,72;11298;-1,41;22583,72;2018-09-07;07/09/2018;AUTOPISTAS;Gastos_Ocio y transporte;Parking y peaje;9;VARIABLES
13/09/2018;13/09/2018;R/ GAS GAS NATURAL GNS27630480918;-4,69;22583,72;22579,03;11299;-4,69;22579,03;2018-09-13;13/09/2018;GAS;Gastos_Servicios tipicos;Gas;9;FIJO
13/09/2018;13/09/2018;R/ LUZ ENDESA ENERG FACTURA DE ELE;-127,78;22579,03;22451,25;11300;-127,78;22451,25;2018-09-13;13/09/2018;ELE;Gastos_Servicios tipicos;Electricidad;9;FIJO
13/09/2018;13/09/2018;T/ CATALUNYA CAIX\EL P 10-09-2018;-3,80;22451,25;22447,45;11301;-3,80;22447,45;2018-09-10;10/09/2018;CATALUNYA;Gastos_Ocio y transporte;Restaurantes;9;VARIABLES
13/09/2018;13/09/2018;T/ E.S.RUBI 9 10-09-2018;-45,82;22447,45;22401,63;11302;-45,82;22401,63;2018-09-10;10/09/2018;ESRUBI;Gastos_Ocio y transporte;Gasolina;9;VARIABLES
13/09/2018;13/09/2018;T/ WWW.JUST-EAT.ES 10-09-2018;-45,75;22401,63;22355,88;11303;-45,75;22355,88;2018-09-10;10/09/2018;WWWJUSTEATES;Gastos_Ocio y transporte;Restaurantes;9;VARIABLES
13/09/2018;13/09/2018;CAJ. AJENO SERVIRED \TERRASSA;-300,00;22355,88;22055,88;11304;-300,00;22055,88;2018-09-13;13/09/2018;CAJ;Gastos_Gastos varios;Efectivo;9;VARIABLES
13/09/2018;13/09/2018;COM. 64970036 SVRED CAJ OFI;-1,87;22055,88;22054,01;11305;-1,87;22054,01;2018-09-13;13/09/2018;COM;Gastos_Banco y organismos;Cargos banco;9;FIJO
14/09/2018;14/09/2018;R/ TELECOMUNICACI VODAFONE;-148,97;22054,01;21905,04;11306;-148,97;21905,04;2018-09-14;14/09/2018;TELECOMUNICACI;Gastos_Servicios tipicos;Telecomunicaciones;9;FIJO
14/09/2018;14/09/2018;T/ AUTOPISTAS TERR 10-09-2018;-1,41;21905,04;21903,63;11307;-1,41;21903,63;2018-09-10;10/09/2018;AUTOPISTAS;Gastos_Ocio y transporte;Parking y peaje;9;VARIABLES
14/09/2018;14/09/2018;T/ AUTOPISTAS TERR 10-09-2018;-1,41;21903,63;21902,22;11308;-1,41;21902,22;2018-09-10;10/09/2018;AUTOPISTAS;Gastos_Ocio y transporte;Parking y peaje;9;VARIABLES
14/09/2018;14/09/2018;T/ TUNELS VALLVI S. 10-09-2018;-4,25;21902,22;21897,97;11309;-4,25;21897,97;2018-09-10;10/09/2018;TUNELS;Gastos_Ocio y transporte;Parking y peaje;9;VARIABLES
14/09/2018;14/09/2018;T/ TUNELS VALLVI S. 07-09-2018;-4,25;21897,97;21893,72;11310;-4,25;21893,72;2018-09-07;07/09/2018;TUNELS;Gastos_Ocio y transporte;Parking y peaje;9;VARIABLES
15/09/2018;15/09/2018;T/ AUTOPISTAS TERR 12-09-2018;-1,41;21893,72;21892,31;11311;-1,41;21892,31;2018-09-12;12/09/2018;AUTOPISTAS;Gastos_Ocio y transporte;Parking y peaje;9;VARIABLES
15/09/2018;15/09/2018;T/ AUTOPISTAS TERR 12-09-2018;-1,41;21892,31;21890,90;11312;-1,41;21890,90;2018-09-12;12/09/2018;AUTOPISTAS;Gastos_Ocio y transporte;Parking y peaje;9;VARIABLES
15/09/2018;15/09/2018;T/ TUNELS VALLVI S. 12-09-2018;-4,25;21890,90;21886,65;11313;-4,25;21886,65;2018-09-12;12/09/2018;TUNELS;Gastos_Ocio y transporte;Parking y peaje;9;VARIABLES
15/09/2018;15/09/2018;T/ BON AREA 12-09-2018;-36,59;21886,65;21850,06;11314;-36,59;21850,06;2018-09-12;12/09/2018;BON;Gastos_Compras;Supermercado;9;VARIABLES
16/09/2018;16/09/2018;T/ AUTOPISTAS TERR 13-09-2018;-1,41;21850,06;21848,65;11315;-1,41;21848,65;2018-09-13;13/09/2018;AUTOPISTAS;Gastos_Ocio y transporte;Parking y peaje;9;VARIABLES
16/09/2018;16/09/2018;T/ AUTOPISTAS TERR 13-09-2018;-1,41;21848,65;21847,24;11316;-1,41;21847,24;2018-09-13;13/09/2018;AUTOPISTAS;Gastos_Ocio y transporte;Parking y peaje;9;VARIABLES
16/09/2018;16/09/2018;T/ L ALFABREGA \VA 13-09-2018;-25,85;21847,24;21821,39;11317;-25,85;21821,39;2018-09-13;13/09/2018;ALFABREGA;Gastos_Compras;Supermercado;9;VARIABLES
17/09/2018;17/09/2018;R/ SEGUROS CCM VIDA Y P Recibo:152;-15,39;21821,39;21806,00;11318;-15,39;21806,00;2018-09-17;17/09/2018;CCM;Gastos_Seguros;Seguro vida;9;FIJO
17/09/2018;17/09/2018;R/ SEGUROS CCM VIDA Y P Recibo:152;-19,07;21806,00;21786,93;11319;-19,07;21786,93;2018-09-17;17/09/2018;CCM;Gastos_Seguros;Seguro vida;9;FIJO
18/09/2018;18/09/2018;R/ . EMTE SERVICE Factura GB18-083;-75,54;21786,93;21711,39;11320;-75,54;21711,39;2018-09-18;18/09/2018;EMTE;Gastos_Servicios tipicos;Otros servicios;9;VARIABLES
18/09/2018;18/09/2018;T/ REST.KAORI \BARBE 15-09-2018;-51,20;21711,39;21660,19;11321;-51,20;21660,19;2018-09-15;15/09/2018;RESTKAORI;Gastos_Ocio y transporte;Restaurantes;9;VARIABLES
18/09/2018;18/09/2018;T/ TERRACASA \ 15-09-2018;-9,30;21660,19;21650,89;11322;-9,30;21650,89;2018-09-15;15/09/2018;TERRACASA;Gastos_Compras;Otras compras;9;VARIABLES
19/09/2018;19/09/2018;R/ MINA PUBLICA AIGUES T.01A75789;-40,37;21650,89;21610,52;11323;-40,37;21610,52;2018-09-19;19/09/2018;MINA;Gastos_Servicios tipicos;Agua;9;FIJO
19/09/2018;19/09/2018;T/ AUTOPISTAS TERR 14-09-2018;-1,41;21610,52;21609,11;11324;-1,41;21609,11;2018-09-14;14/09/2018;AUTOPISTAS;Gastos_Ocio y transporte;Parking y peaje;9;VARIABLES
19/09/2018;19/09/2018;T/ AUTOPISTAS TERR 14-09-2018;-1,41;21609,11;21607,70;11325;-1,41;21607,70;2018-09-14;14/09/2018;AUTOPISTAS;Gastos_Ocio y transporte;Parking y peaje;9;VARIABLES
19/09/2018;19/09/2018;T/ TUNELS VALLVI S. 14-09-2018;-4,25;21607,70;21603,45;11326;-4,25;21603,45;2018-09-14;14/09/2018;TUNELS;Gastos_Ocio y transporte;Parking y peaje;9;VARIABLES
19/09/2018;19/09/2018;T/ ZONA BLAVA-ESTACION 14-09-2018;-1,95;21603,45;21601,50;11327;-1,95;21601,50;2018-09-14;14/09/2018;ZONA;Gastos_Ocio y transporte;Parking y peaje;9;VARIABLES
20/09/2018;20/09/2018;T/ TUNELS VALLVI S. 17-09-2018;-4,25;21601,50;21597,25;11328;-4,25;21597,25;2018-09-17;17/09/2018;TUNELS;Gastos_Ocio y transporte;Parking y peaje;9;VARIABLES
20/09/2018;20/09/2018;T/ DECATHLON SA TERRA\ 17-09-2018;-34,96;21597,25;21562,29;11329;-34,96;21562,29;2018-09-17;17/09/2018;DECATHLON;Gastos_Compras;Deportivo;9;VARIABLES
20/09/2018;20/09/2018;T/ CATALUNYA CAIX\EL P 17-09-2018;-2,45;21562,29;21559,84;11330;-2,45;21559,84;2018-09-17;17/09/2018;CATALUNYA;Gastos_Ocio y transporte;Restaurantes;9;VARIABLES
21/09/2018;21/09/2018;T/ CATALUNYA CAIX\EL P 18-09-2018;-1,95;21559,84;21557,89;11331;-1,95;21557,89;2018-09-18;18/09/2018;CATALUNYA;Gastos_Ocio y transporte;Restaurantes;9;VARIABLES
21/09/2018;21/09/2018;T/ AUTOPISTAS TERR 18-09-2018;-1,41;21557,89;21556,48;11332;-1,41;21556,48;2018-09-18;18/09/2018;AUTOPISTAS;Gastos_Ocio y transporte;Parking y peaje;9;VARIABLES
21/09/2018;21/09/2018;T/ AUTOPISTAS TERR 18-09-2018;-1,41;21556,48;21555,07;11333;-1,41;21555,07;2018-09-18;18/09/2018;AUTOPISTAS;Gastos_Ocio y transporte;Parking y peaje;9;VARIABLES
21/09/2018;21/09/2018;T/ AUTOPISTAS TERR 17-09-2018;-1,41;21555,07;21553,66;11334;-1,41;21553,66;2018-09-17;17/09/2018;AUTOPISTAS;Gastos_Ocio y transporte;Parking y peaje;9;VARIABLES
21/09/2018;21/09/2018;T/ AUTOPISTAS TERR 17-09-2018;-1,41;21553,66;21552,25;11335;-1,41;21552,25;2018-09-17;17/09/2018;AUTOPISTAS;Gastos_Ocio y transporte;Parking y peaje;9;VARIABLES
22/09/2018;22/09/2018;T/ AUTOPISTAS TERR 19-09-2018;-1,41;21552,25;21550,84;11336;-1,41;21550,84;2018-09-19;19/09/2018;AUTOPISTAS;Gastos_Ocio y transporte;Parking y peaje;9;VARIABLES
22/09/2018;22/09/2018;T/ AUTOPISTAS TERR 19-09-2018;-1,41;21550,84;21549,43;11337;-1,41;21549,43;2018-09-19;19/09/2018;AUTOPISTAS;Gastos_Ocio y transporte;Parking y peaje;9;VARIABLES
22/09/2018;22/09/2018;T/ CATALUNYA CAIX\EL P 19-09-2018;-1,95;21549,43;21547,48;11338;-1,95;21547,48;2018-09-19;19/09/2018;CATALUNYA;Gastos_Ocio y transporte;Restaurantes;9;VARIABLES
22/09/2018;22/09/2018;T/ TUNELS VALLVI S. 18-09-2018;-3,78;21547,48;21543,70;11339;-3,78;21543,70;2018-09-18;18/09/2018;TUNELS;Gastos_Ocio y transporte;Parking y peaje;9;VARIABLES
23/09/2018;23/09/2018;T/ AUTOPISTAS TERR 20-09-2018;-1,41;21543,70;21542,29;11340;-1,41;21542,29;2018-09-20;20/09/2018;AUTOPISTAS;Gastos_Ocio y transporte;Parking y peaje;9;VARIABLES
23/09/2018;23/09/2018;T/ AUTOPISTAS TERR 20-09-2018;-1,41;21542,29;21540,88;11341;-1,41;21540,88;2018-09-20;20/09/2018;AUTOPISTAS;Gastos_Ocio y transporte;Parking y peaje;9;VARIABLES
23/09/2018;23/09/2018;T/ L ALFABREGA \VA 20-09-2018;-22,50;21540,88;21518,38;11342;-22,50;21518,38;2018-09-20;20/09/2018;ALFABREGA;Gastos_Compras;Supermercado;9;VARIABLES
24/09/2018;24/09/2018;T/ CATALUNYA CAIX\EL P 21-09-2018;-2,30;21518,38;21516,08;11343;-2,30;21516,08;2018-09-21;21/09/2018;CATALUNYA;Gastos_Ocio y transporte;Restaurantes;9;VARIABLES
24/09/2018;24/09/2018;T/ TUNELS VALLVI S. 20-09-2018;-3,78;21516,08;21512,30;11344;-3,78;21512,30;2018-09-20;20/09/2018;TUNELS;Gastos_Ocio y transporte;Parking y peaje;9;VARIABLES
25/09/2018;25/09/2018;T/ VILANOVA COMELLAS \TERRASSA;-93,35;21512,30;21418,95;11345;-93,35;21418,95;2018-09-25;25/09/2018;VILANOVA;Gastos_Salud, saber y deporte;Belleza;9;VARIABLES
26/09/2018;26/09/2018;T/ AUTOPISTAS TERR 21-09-2018;-1,41;21418,95;21417,54;11346;-1,41;21417,54;2018-09-21;21/09/2018;AUTOPISTAS;Gastos_Ocio y transporte;Parking y peaje;9;VARIABLES
26/09/2018;26/09/2018;T/ AUTOPISTAS TERR 21-09-2018;-1,41;21417,54;21416,13;11347;-1,41;21416,13;2018-09-21;21/09/2018;AUTOPISTAS;Gastos_Ocio y transporte;Parking y peaje;9;VARIABLES
26/09/2018;26/09/2018;T/ SUPER.REYPA \TARRASA/TERRA;-7,21;21416,13;21408,92;11348;-7,21;21408,92;2018-09-26;26/09/2018;SUPERREYPA;Gastos_Compras;Supermercado;9;VARIABLES
27/09/2018;27/09/2018;T/ MERCADONA QUATRE C\ 24-09-2018;-110,55;21408,92;21298,37;11349;-110,55;21298,37;2018-09-24;24/09/2018;MERCADONA;Gastos_Compras;Supermercado;9;VARIABLES
27/09/2018;27/09/2018;T/ GREENVITA HEALTHY \ 24-09-2018;-28,70;21298,37;21269,67;11350;-28,70;21269,67;2018-09-24;24/09/2018;GREENVITA;Gastos_Ocio y transporte;Restaurantes;9;VARIABLES
27/09/2018;27/09/2018;T/ MERCADONA QUATRE C\ 24-09-2018;-5,19;21269,67;21264,48;11351;-5,19;21264,48;2018-09-24;24/09/2018;MERCADONA;Gastos_Compras;Supermercado;9;VARIABLES
27/09/2018;27/09/2018;T/ PARKING VAPOR GRAN\ 24-09-2018;-4,45;21264,48;21260,03;11352;-4,45;21260,03;2018-09-24;24/09/2018;PARKING;Gastos_Ocio y transporte;Parking y peaje;9;VARIABLES
28/09/2018;28/09/2018;R/ AYUNTAMIENTO AJUNTAMENT D I.B.I;-47,13;21260,03;21212,90;11353;-47,13;21212,90;2018-09-28;28/09/2018;AYUNTAMIENTO;Gastos_Banco y organismos;Ayuntamiento;9;FIJO
28/09/2018;28/09/2018;HAB. AJUNTAMENT DE TERRASSA Transfe;1847,19;21212,90;23060,09;11354;1847,19;23060,09;2018-09-28;28/09/2018;HAB;Ingresos;Nomina;9;FIJO
28/09/2018;28/09/2018;R/ ALIMENTACION SERHS FOOD A Comed;-77,35;23060,09;22982,74;11355;-77,35;22982,74;2018-09-28;28/09/2018;ALIMENTACION;Gastos_Salud, saber y deporte;Menjador;9;FIJO
28/09/2018;28/09/2018;R/ ALIMENTACION SERHS FOOD A Comed;-22,75;22982,74;22959,99;11356;-22,75;22959,99;2018-09-28;28/09/2018;ALIMENTACION;Gastos_Salud, saber y deporte;Menjador;9;FIJO
28/09/2018;28/09/2018;T/ PARKING VAPOR GRAN\ 25-09-2018;-4,45;22959,99;22955,54;11357;-4,45;22955,54;2018-09-25;25/09/2018;PARKING;Gastos_Ocio y transporte;Parking y peaje;9;VARIABLES
28/09/2018;28/09/2018;T/ TUNELS VALLVI S. 25-09-2018;-3,78;22955,54;22951,76;11358;-3,78;22951,76;2018-09-25;25/09/2018;TUNELS;Gastos_Ocio y transporte;Parking y peaje;9;VARIABLES
28/09/2018;28/09/2018;T/ EL SALON THE BARBE\ 25-09-2018;-34,95;22951,76;22916,81;11359;-34,95;22916,81;2018-09-25;25/09/2018;SALON;Gastos_Salud, saber y deporte;Belleza;9;VARIABLES
28/09/2018;28/09/2018;T/ FRANKFURT LES LLET\ 25-09-2018;-8,15;22916,81;22908,66;11360;-8,15;22908,66;2018-09-25;25/09/2018;FRANKFURT;Gastos_Ocio y transporte;Restaurantes;9;VARIABLES
28/09/2018;28/09/2018;T/ TUNELS VALLVI S. 21-09-2018;-3,78;22908,66;22904,88;11361;-3,78;22904,88;2018-09-21;21/09/2018;TUNELS;Gastos_Ocio y transporte;Parking y peaje;9;VARIABLES
28/09/2018;28/09/2018;TRANSFBBVABCLM;1200,00;21760,35;22960,35;11374;1200,00;24104,88;2018-09-28;28/09/2018;TRANSFBBVABCLM;No computable;traspasos, transf.;9;
29/09/2018;29/09/2018;T/ AUTOPISTAS TERR 26-09-2018;-1,41;22904,88;22903,47;11362;-1,41;24103,47;2018-09-26;26/09/2018;AUTOPISTAS;Gastos_Ocio y transporte;Parking y peaje;9;VARIABLES
29/09/2018;29/09/2018;T/ AUTOPISTAS TERR 26-09-2018;-1,41;22903,47;22902,06;11363;-1,41;24102,06;2018-09-26;26/09/2018;AUTOPISTAS;Gastos_Ocio y transporte;Parking y peaje;9;VARIABLES
29/09/2018;29/09/2018;T/ AUTOPISTAS TERR 25-09-2018;-1,41;22902,06;22900,65;11364;-1,41;24100,65;2018-09-25;25/09/2018;AUTOPISTAS;Gastos_Ocio y transporte;Parking y peaje;9;VARIABLES
29/09/2018;29/09/2018;T/ AUTOPISTAS TERR 25-09-2018;-1,41;22900,65;22899,24;11365;-1,41;24099,24;2018-09-25;25/09/2018;AUTOPISTAS;Gastos_Ocio y transporte;Parking y peaje;9;VARIABLES
30/09/2018;30/09/2018;REC. 6061.9600001223;-448,11;22899,24;22451,13;11366;-448,11;23651,13;2018-09-30;30/09/2018;REC;Gastos_Banco y organismos;Hipoteca;9;FIJO
30/09/2018;30/09/2018;T/ AUTOPISTAS TERR 27-09-2018;-1,41;22451,13;22449,72;11367;-1,41;23649,72;2018-09-27;27/09/2018;AUTOPISTAS;Gastos_Ocio y transporte;Parking y peaje;9;VARIABLES
30/09/2018;30/09/2018;T/ AUTOPISTAS TERR 27-09-2018;-1,41;22449,72;22448,31;11368;-1,41;23648,31;2018-09-27;27/09/2018;AUTOPISTAS;Gastos_Ocio y transporte;Parking y peaje;9;VARIABLES
30/09/2018;30/09/2018;T/ L ALFABREGA \VA 27-09-2018;-28,55;22448,31;22419,76;11369;-28,55;23619,76;2018-09-27;27/09/2018;ALFABREGA;Gastos_Compras;Supermercado;9;VARIABLES
01/10/2018;01/10/2018;FACT TARJETAS TARJ.CREDITO 07126017 18-10-01;-327,18;22419,76;22092,58;11370;-327,18;23292,58;2018-10-01;30/09/2018;FACT 07126017;Gastos_Banco y organismos;Credito Bea;9;VARIABLE
01/10/2018;01/10/2018;FACT TARJETAS TARJ.CREDITO 42689013 18-10-01;-295,26;22092,58;21797,32;11371;-295,26;22997,32;2018-10-01;30/09/2018;FACT;No computable;Recibo Tarjeta;9;
01/10/2018;01/10/2018;T/ WWW.JUST-EAT.ES 28-09-2018;-32,72;21797,32;21764,60;11372;-32,72;22964,60;2018-09-28;28/09/2018;WWWJUSTEATES;Gastos_Ocio y transporte;Restaurantes;9;VARIABLES
01/10/2018;01/10/2018;T/ TUNELS VALLVI S. 27-09-2018;-4,25;21764,60;21760,35;11373;-4,25;22960,35;2018-09-27;27/09/2018;TUNELS;Gastos_Ocio y transporte;Parking y peaje;9;VARIABLES
02/10/2018;02/10/2018;T/ WWW.JUST-EAT.ES 29-09-2018;-21,95;22960,35;22938,40;11375;-21,95;22938,40;2018-09-29;29/09/2018;WWWJUSTEATES;Gastos_Ocio y transporte;Restaurantes;9;VARIABLES
02/10/2018;02/10/2018;T/ CAMPING VALL D\LA V 29-09-2018;-47,50;22938,40;22890,90;11376;-47,50;22890,90;2018-09-29;29/09/2018;CAMPING;Gastos_Ocio y transporte;Vacaciones;9;VARIABLES
02/10/2018;02/10/2018;T/ AUTOPISTAS TERR 28-09-2018;-1,41;22890,90;22889,49;11377;-1,41;22889,49;2018-09-28;28/09/2018;AUTOPISTAS;Gastos_Ocio y transporte;Parking y peaje;9;VARIABLES
03/10/2018;03/10/2018;R/ SEGUROS SEGUROS CATA INCLUIDO S;-330,26;22889,49;22559,23;11378;-330,26;22559,23;2018-10-03;03/10/2018;CATA;Gastos_Seguros;Seguro auto;10;FIJO
04/10/2018;04/10/2018;T/ SUPER.BON PREU S16\ 01-10-2018;-30,67;22559,23;22528,56;11379;-30,67;22528,56;2018-10-01;01/10/2018;SUPERBON;Gastos_Compras;Supermercado;10;VARIABLES
04/10/2018;04/10/2018;T/ ITACA \ 01-10-2018;-2,90;22528,56;22525,66;11380;-2,90;22525,66;2018-10-01;01/10/2018;ITACA;Gastos_Compras;Otras compras;10;VARIABLES
04/10/2018;04/10/2018;T/ PARKING VAPOR GRAN\ 01-10-2018;-3,80;22525,66;22521,86;11381;-3,80;22521,86;2018-10-01;01/10/2018;PARKING;Gastos_Ocio y transporte;Parking y peaje;10;VARIABLES
05/10/2018;05/10/2018;R/ AYUNTAMIENTO Ajuntament d Abona;-36,00;22521,86;22485,86;11382;-36,00;22485,86;2018-10-05;05/10/2018;AYUNTAMIENTO;Gastos_Banco y organismos;Ayuntamiento;10;FIJO
05/10/2018;04/10/2018;T/ AMZN Mktp ES;-67,11;22485,86;22418,75;11383;-67,11;22418,75;2018-10-04;04/10/2018;AMZN;Gastos_Compras;Hobbys;10;VARIABLES
05/10/2018;05/10/2018;T/ TERRACASA \ 02-10-2018;-7,50;22418,75;22411,25;11384;-7,50;22411,25;2018-10-02;02/10/2018;TERRACASA;Gastos_Compras;Otras compras;10;VARIABLES
05/10/2018;05/10/2018;T/ MAXI CATALUNYA INT\ 02-10-2018;-31,65;22411,25;22379,60;11385;-31,65;22379,60;2018-10-02;02/10/2018;MAXI;Gastos_Compras;Hobbys;10;VARIABLES
05/10/2018;05/10/2018;T/ AUTOPISTAS TERR 02-10-2018;-1,41;22379,60;22378,19;11386;-1,41;22378,19;2018-10-02;02/10/2018;AUTOPISTAS;Gastos_Ocio y transporte;Parking y peaje;10;VARIABLES
05/10/2018;05/10/2018;T/ AUTOPISTAS TERR 02-10-2018;-1,41;22378,19;22376,78;11387;-1,41;22376,78;2018-10-02;02/10/2018;AUTOPISTAS;Gastos_Ocio y transporte;Parking y peaje;10;VARIABLES
05/10/2018;05/10/2018;T/ VIENA PARC VALLES \ 02-10-2018;-21,80;22376,78;22354,98;11388;-21,80;22354,98;2018-10-02;02/10/2018;VIENA;Gastos_Ocio y transporte;Restaurantes;10;VARIABLES
05/10/2018;05/10/2018;T/ CATALUNYA CAIX\EL P 02-10-2018;-1,95;22354,98;22353,03;11389;-1,95;22353,03;2018-10-02;02/10/2018;CATALUNYA;Gastos_Ocio y transporte;Restaurantes;10;VARIABLES
06/10/2018;06/10/2018;T/ TESI FRESC S.L. \OLOT;-33,11;22353,03;22319,92;11390;-33,11;22319,92;2018-10-06;06/10/2018;TESI;Gastos_Compras;Supermercado;10;VARIABLES
06/10/2018;06/10/2018;T/ HIPERMERCAT ESCLAT H55\OLOT;-88,72;22319,92;22231,20;11391;-88,72;22231,20;2018-10-06;06/10/2018;HIPERMERCAT;Gastos_Compras;Supermercado;10;VARIABLES
06/10/2018;06/10/2018;T/ CAMPING DE LA \VALL DE BIAN;-48,50;22231,20;22182,70;11392;-48,50;22182,70;2018-10-06;06/10/2018;CAMPING;Gastos_Ocio y transporte;Vacaciones;10;VARIABLES
06/10/2018;04/10/2018;T/ AMZN Mktp ES;-7,49;22182,70;22175,21;11393;-7,49;22175,21;2018-10-04;04/10/2018;AMZN;Gastos_Compras;Hobbys;10;VARIABLES
06/10/2018;04/10/2018;T/ AMZN Mktp ES;-6,39;22175,21;22168,82;11394;-6,39;22168,82;2018-10-04;04/10/2018;AMZN;Gastos_Compras;Hobbys;10;VARIABLES
06/10/2018;06/10/2018;T/ TUNELS VALLVI S. 03-10-2018;-3,78;22168,82;22165,04;11395;-3,78;22165,04;2018-10-03;03/10/2018;TUNELS;Gastos_Ocio y transporte;Parking y peaje;10;VARIABLES
07/10/2018;07/10/2018;T/ BAR CAMPING VA\VALL DE BIAN;-17,60;22165,04;22147,44;11396;-17,60;22147,44;2018-10-07;07/10/2018;BAR;Gastos_Ocio y transporte;Restaurantes;10;VARIABLES
07/10/2018;07/10/2018;T/ AUTOPISTAS TERR 04-10-2018;-1,41;22147,44;22146,03;11397;-1,41;22146,03;2018-10-04;04/10/2018;AUTOPISTAS;Gastos_Ocio y transporte;Parking y peaje;10;VARIABLES
07/10/2018;07/10/2018;T/ AUTOPISTAS TERR 04-10-2018;-1,41;22146,03;22144,62;11398;-1,41;22144,62;2018-10-04;04/10/2018;AUTOPISTAS;Gastos_Ocio y transporte;Parking y peaje;10;VARIABLES
07/10/2018;07/10/2018;T/ AUTOPISTAS TERR 03-10-2018;-1,41;22144,62;22143,21;11399;-1,41;22143,21;2018-10-03;03/10/2018;AUTOPISTAS;Gastos_Ocio y transporte;Parking y peaje;10;VARIABLES
08/10/2018;08/10/2018;T/ CATALUNYA CAIX\EL P 05-10-2018;-2,35;22143,21;22140,86;11400;-2,35;22140,86;2018-10-05;05/10/2018;CATALUNYA;Gastos_Ocio y transporte;Restaurantes;10;VARIABLES
08/10/2018;08/10/2018;T/ ORIENT CARS - RECA\ 05-10-2018;-177,86;22140,86;21963,00;11401;-177,86;21963,00;2018-10-05;05/10/2018;ORIENT;Gastos_Vivienda y vehiculo;Mnto. vehiculo;10;VARIABLE
09/10/2018;09/10/2018;R/ . FINQUES GASS Vto 01-10-18 Rec;-75,31;21963,00;21887,69;11402;-75,31;21887,69;2018-10-01;01/10/2018;FINQUES;Gastos_Vivienda y vehiculo;Alquiler Parking;10;FIJO
09/10/2018;09/10/2018;R/ LUZ ENDESA ENERG FACTURA DE GAS;-122,63;21887,69;21765,06;11403;-122,63;21765,06;2018-10-09;09/10/2018;GAS;Gastos_Servicios tipicos;Gas;10;FIJO
09/10/2018;05/10/2018;T/ AMZN Mktp ES;-29,19;21765,06;21735,87;11404;-29,19;21735,87;2018-10-05;05/10/2018;AMZN;Gastos_Compras;Hobbys;10;VARIABLES
09/10/2018;05/10/2018;T/ pandahall;-35,07;21735,87;21700,80;11405;-35,07;21700,80;2018-10-05;05/10/2018;PANDAHALL;Gastos_Compras;Hobbys;10;VARIABLES
09/10/2018;07/10/2018;T/ AMZN Mktp ES;-8,99;21700,80;21691,81;11406;-8,99;21691,81;2018-10-07;07/10/2018;AMZN;Gastos_Compras;Hobbys;10;VARIABLES
09/10/2018;09/10/2018;T/ FARMACIA JORNET \ 06-10-2018;-11,88;21691,81;21679,93;11407;-11,88;21679,93;2018-10-06;06/10/2018;FARMACIA;Gastos_Salud, saber y deporte;Farmacia;10;VARIABLES
09/10/2018;09/10/2018;T/ AUTOPISTAS TERR 05-10-2018;-1,41;21679,93;21678,52;11408;-1,41;21678,52;2018-10-05;05/10/2018;AUTOPISTAS;Gastos_Ocio y transporte;Parking y peaje;10;VARIABLES
10/10/2018;10/10/2018;R/ ALIMENTACION SERHS FOOD A Comed;-130,90;21678,52;21547,62;11409;-130,90;21547,62;2018-10-10;10/10/2018;ALIMENTACION;Gastos_Salud, saber y deporte;Menjador;10;FIJO
10/10/2018;10/10/2018;R/ ALIMENTACION SERHS FOOD A Comed;-38,50;21547,62;21509,12;11410;-38,50;21509,12;2018-10-10;10/10/2018;ALIMENTACION;Gastos_Salud, saber y deporte;Menjador;10;FIJO
10/10/2018;10/10/2018;'R/ COOPERATIVA L''EINA COOPE Rebut:';-35,60;21509,12;21473,52;11411;-35,60;21473,52;2018-10-10;10/10/2018;COOPERATIVA;Gastos_Salud, saber y deporte;Estudios;10;VARIABLES
10/10/2018;10/10/2018;T/ AUTOPISTAS TERR 07-10-2018;-7,84;21473,52;21465,68;11412;-7,84;21465,68;2018-10-07;07/10/2018;AUTOPISTAS;Gastos_Ocio y transporte;Parking y peaje;10;VARIABLES
11/10/2018;11/10/2018;R/ TELECOMUNICACI VODAFONE;-150,42;21465,68;21315,26;11413;-150,42;21315,26;2018-10-11;11/10/2018;TELECOMUNICACI;Gastos_Servicios tipicos;Telecomunicaciones;10;FIJO
13/10/2018;13/10/2018;T/ AUTOPISTAS TERR 10-10-2018;-1,41;21315,26;21313,85;11414;-1,41;21313,85;2018-10-10;10/10/2018;AUTOPISTAS;Gastos_Ocio y transporte;Parking y peaje;10;VARIABLES
13/10/2018;13/10/2018;T/ AUTOPISTAS TERR 10-10-2018;-1,41;21313,85;21312,44;11415;-1,41;21312,44;2018-10-10;10/10/2018;AUTOPISTAS;Gastos_Ocio y transporte;Parking y peaje;10;VARIABLES
13/10/2018;13/10/2018;T/ CATALUNYA CAIX\EL P 10-10-2018;-1,95;21312,44;21310,49;11416;-1,95;21310,49;2018-10-10;10/10/2018;CATALUNYA;Gastos_Ocio y transporte;Restaurantes;10;VARIABLES
13/10/2018;13/10/2018;T/ AUTOPISTAS TERR 09-10-2018;-1,41;21310,49;21309,08;11417;-1,41;21309,08;2018-10-09;09/10/2018;AUTOPISTAS;Gastos_Ocio y transporte;Parking y peaje;10;VARIABLES
13/10/2018;13/10/2018;T/ AUTOPISTAS TERR 09-10-2018;-1,41;21309,08;21307,67;11418;-1,41;21307,67;2018-10-09;09/10/2018;AUTOPISTAS;Gastos_Ocio y transporte;Parking y peaje;10;VARIABLES
13/10/2018;13/10/2018;T/ CATALUNYA CAIX\EL P 09-10-2018;-2,85;21307,67;21304,82;11419;-2,85;21304,82;2018-10-09;09/10/2018;CATALUNYA;Gastos_Ocio y transporte;Restaurantes;10;VARIABLES
14/10/2018;14/10/2018;T/ BON AREA 11-10-2018;-12,97;21304,82;21291,85;11420;-12,97;21291,85;2018-10-11;11/10/2018;BON;Gastos_Compras;Supermercado;10;VARIABLES
14/10/2018;14/10/2018;T/ L ALFABREGA \VA 11-10-2018;-29,50;21291,85;21262,35;11421;-29,50;21262,35;2018-10-11;11/10/2018;ALFABREGA;Gastos_Compras;Supermercado;10;VARIABLES
14/10/2018;14/10/2018;T/ WWW.JUST-EAT.ES 11-10-2018;-26,32;21262,35;21236,03;11422;-26,32;21236,03;2018-10-11;11/10/2018;WWWJUSTEATES;Gastos_Ocio y transporte;Restaurantes;10;VARIABLES
15/10/2018;15/10/2018;T/ WWW.JUST-EAT.ES 12-10-2018;-33,60;21236,03;21202,43;11423;-33,60;21202,43;2018-10-12;12/10/2018;WWWJUSTEATES;Gastos_Ocio y transporte;Restaurantes;10;VARIABLES
16/10/2018;16/10/2018;R/ NATURGY IBER 27630481018;-4,69;21202,43;21197,74;11424;-4,69;21197,74;2018-10-16;16/10/2018;NATURGY;Gastos_Servicios tipicos;Gas;10;FIJO
16/10/2018;16/10/2018;T/ VIENA XALET SABADE\ 13-10-2018;-24,00;21197,74;21173,74;11425;-24,00;21173,74;2018-10-13;13/10/2018;VIENA;Gastos_Ocio y transporte;Restaurantes;10;VARIABLES
18/10/2018;18/10/2018;R/SEGUROS CCM VIDA Y P Recibo:152;-15,33;21173,74;21158,41;11426;-15,33;21158,41;2018-10-18;18/10/2018;CCM;Gastos_Seguros;Seguro vida;10;FIJO
18/10/2018;18/10/2018;R/SEGUROS CCM VIDA Y P Recibo:152;-18,99;21158,41;21139,42;11427;-18,99;21139,42;2018-10-18;18/10/2018;CCM;Gastos_Seguros;Seguro vida;10;FIJO
18/10/2018;18/10/2018;T/AUTOPISTAS TERR 15-10-2018;-1,41;21139,42;21138,01;11428;-1,41;21138,01;2018-10-15;15/10/2018;AUTOPISTAS;Gastos_Ocio y transporte;Parking y peaje;10;VARIABLES
18/10/2018;18/10/2018;T/AUTOPISTAS TERR 15-10-2018;-1,41;21138,01;21136,60;11429;-1,41;21136,60;2018-10-15;15/10/2018;AUTOPISTAS;Gastos_Ocio y transporte;Parking y peaje;10;VARIABLES
19/10/2018;19/10/2018;R/SEGUROS ADESLAS CENT MODULAR CO;-159,81;21136,60;20976,79;11430;-159,81;20976,79;2018-10-19;19/10/2018;ADESLAS;Gastos_Salud, saber y deporte;Medico;10;VARIABLES
19/10/2018;19/10/2018;T/AUTOPISTAS TERR 16-10-2018;-1,41;20976,79;20975,38;11431;-1,41;20975,38;2018-10-16;16/10/2018;AUTOPISTAS;Gastos_Ocio y transporte;Parking y peaje;10;VARIABLES
19/10/2018;19/10/2018;T/AUTOPISTAS TERR 16-10-2018;-1,41;20975,38;20973,97;11432;-1,41;20973,97;2018-10-16;16/10/2018;AUTOPISTAS;Gastos_Ocio y transporte;Parking y peaje;10;VARIABLES
19/10/2018;19/10/2018;T/TUNELS VALLVI S. 16-10-2018;-3,78;20973,97;20970,19;11433;-3,78;20970,19;2018-10-16;16/10/2018;TUNELS;Gastos_Ocio y transporte;Parking y peaje;10;VARIABLES
19/10/2018;19/10/2018;T/BON AREA 16-10-2018;-35,35;20970,19;20934,84;11434;-35,35;20934,84;2018-10-16;16/10/2018;BON;Gastos_Compras;Supermercado;10;VARIABLES
19/10/2018;19/10/2018;T/CATALUNYA CAIX/EL P 16-10-2018;-1,80;20934,84;20933,04;11435;-1,80;20933,04;2018-10-16;16/10/2018;CATALUNYA;Gastos_Ocio y transporte;Restaurantes;10;VARIABLES
19/10/2018;19/10/2018;T/TUNELS VALLVI S. 15-10-2018;-4,25;20933,04;20928,79;11436;-4,25;20928,79;2018-10-15;15/10/2018;TUNELS;Gastos_Ocio y transporte;Parking y peaje;10;VARIABLES
20/10/2018;20/10/2018;T/AUTOPISTAS TERR 17-10-2018;-1,41;20928,79;20927,38;11437;-1,41;20927,38;2018-10-17;17/10/2018;AUTOPISTAS;Gastos_Ocio y transporte;Parking y peaje;10;VARIABLES
20/10/2018;20/10/2018;T/CATALUNYA CAIX/EL P 17-10-2018;-1,95;20927,38;20925,43;11438;-1,95;20925,43;2018-10-17;17/10/2018;CATALUNYA;Gastos_Ocio y transporte;Restaurantes;10;VARIABLES
20/10/2018;20/10/2018;S/OR.ESCOLA SALA I BADRINAS;-197,00;20925,43;20728,43;11439;-197,00;20728,43;2018-10-20;20/10/2018;ORESCOLA;Gastos_Salud, saber y deporte;Estudios;10;VARIABLES
20/10/2018;20/10/2018;S/OR.ESCOLA SALA I BADRINAS;-184,00;20728,43;20544,43;11440;-184,00;20544,43;2018-10-20;20/10/2018;ORESCOLA;Gastos_Salud, saber y deporte;Estudios;10;VARIABLES
21/10/2018;21/10/2018;T/WWW.JUST-EAT.ES 18-10-2018;-16,00;20544,43;20528,43;11441;-16,00;20528,43;2018-10-18;18/10/2018;WWWJUSTEATES;Gastos_Ocio y transporte;Restaurantes;10;VARIABLES
21/10/2018;21/10/2018;T/CATALUNYA CAIX/EL P 18-10-2018;-1,95;20528,43;20526,48;11442;-1,95;20526,48;2018-10-18;18/10/2018;CATALUNYA;Gastos_Ocio y transporte;Restaurantes;10;VARIABLES
22/10/2018;22/10/2018;T/CATALUNYA CAIX/EL P 19-10-2018;-8,40;20526,48;20518,08;11443;-8,40;20518,08;2018-10-19;19/10/2018;CATALUNYA;Gastos_Ocio y transporte;Restaurantes;10;VARIABLES
23/10/2018;23/10/2018;T/TERRACASA / 20-10-2018;-35,02;20518,08;20483,06;11444;-35,02;20483,06;2018-10-20;20/10/2018;TERRACASA;Gastos_Compras;Otras compras;10;VARIABLES
23/10/2018;23/10/2018;T/MERKAL BARICEN/BARB 20-10-2018;-60,02;20483,06;20423,04;11445;-60,02;20423,04;2018-10-20;20/10/2018;MERKAL;Gastos_Compras;Ropa;10;VARIABLES
23/10/2018;23/10/2018;T/CINESA WEB /B 20-10-2018;-27,60;20423,04;20395,44;11446;-27,60;20395,44;2018-10-20;20/10/2018;CINESA;Gastos_Ocio y transporte;Espectáculos;10;VARIABLES
23/10/2018;23/10/2018;T/PANS&COMPANY /BARBE 20-10-2018;-10,80;20395,44;20384,64;11447;-10,80;20384,64;2018-10-20;20/10/2018;PANSCOMPANY;Gastos_Ocio y transporte;Restaurantes;10;VARIABLES
24/10/2018;24/10/2018;CAJ. AJENOSERVIRED /PRAT DE LLOBR;-300,00;20384,64;20084,64;11448;-300,00;20084,64;2018-10-24;24/10/2018;CAJ;Gastos_Gastos varios;Efectivo;10;VARIABLES
24/10/2018;24/10/2018;COM.64970036 SVRED CAJ OFI;-1,87;20084,64;20082,77;11449;-1,87;20082,77;2018-10-24;24/10/2018;COM;Gastos_Banco y organismos;Cargos banco;10;FIJO
24/10/2018;24/10/2018;T/BON AREA 21-10-2018;-22,24;20082,77;20060,53;11450;-22,24;20060,53;2018-10-21;21/10/2018;BON;Gastos_Compras;Supermercado;10;VARIABLES
24/10/2018;24/10/2018;T/AUTOPISTAS TERR 19-10-2018;-1,41;20060,53;20059,12;11451;-1,41;20059,12;2018-10-19;19/10/2018;AUTOPISTAS;Gastos_Ocio y transporte;Parking y peaje;10;VARIABLES
25/10/2018;25/10/2018;T/AUTOPISTAS TERR 22-10-2018;-1,41;20059,12;20057,71;11452;-1,41;20057,71;2018-10-22;22/10/2018;AUTOPISTAS;Gastos_Ocio y transporte;Parking y peaje;10;VARIABLES
25/10/2018;25/10/2018;T/AUTOPISTAS TERR 22-10-2018;-1,41;20057,71;20056,30;11453;-1,41;20056,30;2018-10-22;22/10/2018;AUTOPISTAS;Gastos_Ocio y transporte;Parking y peaje;10;VARIABLES
25/10/2018;25/10/2018;T/MERCADONA QUATRE C/ 22-10-2018;-1,32;20056,30;20054,98;11454;-1,32;20054,98;2018-10-22;22/10/2018;MERCADONA;Gastos_Compras;Supermercado;10;VARIABLES
26/10/2018;26/10/2018;BONIF.COM.5540550276985025;24,00;20054,98;20078,98;11455;24,00;20078,98;2018-10-26;26/10/2018;BONIFCOM;Ingresos;Devoluciones;10;VARIABLES
26/10/2018;26/10/2018;COMIS.TARJETAS5540550276985025;-24,00;20078,98;20054,98;11456;-24,00;20054,98;2018-10-26;26/10/2018;COMISTARJETAS;Gastos_Banco y organismos;Cargos banco;10;FIJO
26/10/2018;26/10/2018;HAB. AJUNTAMENT DE TERRASSA Transfe;1829,14;20054,98;21884,12;11457;1829,14;21884,12;2018-10-26;26/10/2018;HAB;Ingresos;Nomina;10;FIJO
26/10/2018;26/10/2018;T/AUTOPISTAS TERR 23-10-2018;-1,41;21884,12;21882,71;11458;-1,41;21882,71;2018-10-23;23/10/2018;AUTOPISTAS;Gastos_Ocio y transporte;Parking y peaje;10;VARIABLES
26/10/2018;26/10/2018;T/AUTOPISTAS TERR 23-10-2018;-1,41;21882,71;21881,30;11459;-1,41;21881,30;2018-10-23;23/10/2018;AUTOPISTAS;Gastos_Ocio y transporte;Parking y peaje;10;VARIABLES
26/10/2018;26/10/2018;T/CATALUNYA CAIX/EL P 23-10-2018;-1,95;21881,30;21879,35;11460;-1,95;21879,35;2018-10-23;23/10/2018;CATALUNYA;Gastos_Ocio y transporte;Restaurantes;10;VARIABLES
27/10/2018;27/10/2018;T/AUTOPISTAS TERR 24-10-2018;-1,41;21879,35;21877,94;11461;-1,41;21877,94;2018-10-24;24/10/2018;AUTOPISTAS;Gastos_Ocio y transporte;Parking y peaje;10;VARIABLES
27/10/2018;27/10/2018;T/AUTOPISTAS TERR 24-10-2018;-1,41;21877,94;21876,53;11462;-1,41;21876,53;2018-10-24;24/10/2018;AUTOPISTAS;Gastos_Ocio y transporte;Parking y peaje;10;VARIABLES
28/10/2018;28/10/2018;T/AUTOPISTAS TERR 25-10-2018;-1,41;21876,53;21875,12;11463;-1,41;21875,12;2018-10-25;25/10/2018;AUTOPISTAS;Gastos_Ocio y transporte;Parking y peaje;10;VARIABLES
28/10/2018;28/10/2018;T/AUTOPISTAS TERR 25-10-2018;-1,41;21875,12;21873,71;11464;-1,41;21873,71;2018-10-25;25/10/2018;AUTOPISTAS;Gastos_Ocio y transporte;Parking y peaje;10;VARIABLES
28/10/2018;28/10/2018;T/TUNELS VALLVI S. 25-10-2018;-3,78;21873,71;21869,93;11465;-3,78;21869,93;2018-10-25;25/10/2018;TUNELS;Gastos_Ocio y transporte;Parking y peaje;10;VARIABLES
28/10/2018;28/10/2018;T/L ALFABREGA /VA 25-10-2018;-24,05;21869,93;21845,88;11466;-24,05;21845,88;2018-10-25;25/10/2018;ALFABREGA;Gastos_Compras;Supermercado;10;VARIABLES
29/10/2018;29/10/2018;T/E.S. CAN CASANOVES/ 26-10-2018;-30,07;21845,88;21815,81;11467;-30,07;21815,81;2018-10-26;26/10/2018;CAN;Gastos_Ocio y transporte;Gasolina;10;VARIABLES
29/10/2018;29/10/2018;T/FET CALENT ESPIRIT/ 26-10-2018;-16,35;21815,81;21799,46;11468;-16,35;21799,46;2018-10-26;26/10/2018;FET;Gastos_Ocio y transporte;Restaurantes;10;VARIABLES
29/10/2018;29/10/2018;T/PK. NN REUS 26-10-2018;-1,15;21799,46;21798,31;11469;-1,15;21798,31;2018-10-26;26/10/2018;REUS;Gastos_Ocio y transporte;Parking y peaje;10;VARIABLES
29/10/2018;29/10/2018;T/APARCAMENTS TGN /T 26-10-2018;-4,80;21798,31;21793,51;11470;-4,80;21793,51;2018-10-26;26/10/2018;APARCAMENTS;Gastos_Ocio y transporte;Parking y peaje;10;VARIABLES
29/10/2018;29/10/2018;T/MCDONALDS PARC CE/T 26-10-2018;-6,35;21793,51;21787,16;11471;-6,35;21787,16;2018-10-26;26/10/2018;MCDONALDS;Gastos_Ocio y transporte;Restaurantes;10;VARIABLES
30/10/2018;30/10/2018;TRANSFBBVABCLM;1200,00;21787,16;22987,16;11472;1200,00;22987,16;2018-10-30;30/10/2018;TRANSFBBVABCLM;No computable;traspasos, transf.;10;
30/10/2018;26/10/2018;T/PRIMARK TARRAGONA;-17,00;22987,16;22970,16;11473;-17,00;22970,16;2018-10-26;26/10/2018;PRIMARK;Gastos_Compras;Ropa;10;VARIABLES
30/10/2018;29/10/2018;T/AMZN Mktp ES*MT3Z68HL4;-26,40;22970,16;22943,76;11474;-26,40;22943,76;2018-10-29;29/10/2018;AMZN;Gastos_Compras;Hobbys;10;VARIABLES
30/10/2018;30/10/2018;T/EL NUCLI 9-08 SL 27-10-2018;-4,00;22943,76;22939,76;11475;-4,00;22939,76;2018-10-27;27/10/2018;NUCLI;Gastos_Ocio y transporte;Espectáculos;10;VARIABLES
30/10/2018;30/10/2018;T/EL NUCLI 9-08 SL 27-10-2018;-4,00;22939,76;22935,76;11476;-4,00;22935,76;2018-10-27;27/10/2018;NUCLI;Gastos_Ocio y transporte;Espectáculos;10;VARIABLES
30/10/2018;30/10/2018;T/VIENA TORTOSA 27-10-2018;-7,15;22935,76;22928,61;11477;-7,15;22928,61;2018-10-27;27/10/2018;VIENA;Gastos_Ocio y transporte;Restaurantes;10;VARIABLES
30/10/2018;30/10/2018;T/SABECO 27-10-2018;-10,46;22928,61;22918,15;11478;-10,46;22918,15;2018-10-27;27/10/2018;SABECO;Gastos_Compras;Supermercado;10;VARIABLES
30/10/2018;30/10/2018;T/EL NUCLI 9-08 SL 27-10-2018;-4,00;22918,15;22914,15;11479;-4,00;22914,15;2018-10-27;27/10/2018;NUCLI;Gastos_Ocio y transporte;Espectáculos;10;VARIABLES
30/10/2018;30/10/2018;T/EL NUCLI 9-08 SL 27-10-2018;-4,00;22914,15;22910,15;11480;-4,00;22910,15;2018-10-27;27/10/2018;NUCLI;Gastos_Ocio y transporte;Espectáculos;10;VARIABLES
31/10/2018;31/10/2018;REC.6061.9600001223;-448,11;22910,15;22462,04;11481;-448,11;22462,04;2018-10-31;31/10/2018;REC;Gastos_Banco y organismos;Hipoteca;10;FIJO
31/10/2018;29/10/2018;T/AMAZON.ES*MT3G04HJ4 AM;-29,62;22462,04;22432,42;11482;-29,62;22432,42;2018-10-29;29/10/2018;AMAZONESMTGHJ;Gastos_Compras;Hobbys;10;VARIABLES
31/10/2018;31/10/2018;T/FORN DE PA CAL PORT 28-10-2018;-17,85;22432,42;22414,57;11483;-17,85;22414,57;2018-10-28;28/10/2018;FORN;Gastos_Compras;Supermercado;10;VARIABLES
01/11/2018;01/11/2018;FACT TARJETASTARJ.CREDITO 07126017 18-11-01;-827,13;22414,57;21587,44;11484;-827,13;21587,44;2018-11-01;31/10/2018;FACT 07126017;Gastos_Banco y organismos;Credito Bea;10;VARIABLE
01/11/2018;01/11/2018;FACT TARJETASTARJ.CREDITO 42689013 18-11-01;-490,45;21587,44;21096,99;11485;-490,45;21096,99;2018-11-01;31/10/2018;FACT;No computable;Recibo Tarjeta;10;
01/11/2018;01/11/2018;T/KAME KAME / 29-10-2018;-20,00;21096,99;21076,99;11486;-20,00;21076,99;2018-10-29;29/10/2018;KAME;Gastos_Compras;Libreria;10;VARIABLES
01/11/2018;01/11/2018;T/FARMA.ANGEL MORENO/ 29-10-2018;-11,18;21076,99;21065,81;11487;-11,18;21065,81;2018-10-29;29/10/2018;FARMAANGEL;Gastos_Salud, saber y deporte;Farmacia;10;VARIABLES
01/11/2018;01/11/2018;T/MC PASTISSERIA / 29-10-2018;-9,60;21065,81;21056,21;11488;-9,60;21056,21;2018-10-29;29/10/2018;PASTISSERIA;Gastos_Ocio y transporte;Restaurantes;10;VARIABLES
01/11/2018;01/11/2018;T/PARKING VAPOR GRAN/ 29-10-2018;-3,60;21056,21;21052,61;11489;-3,60;21052,61;2018-10-29;29/10/2018;PARKING;Gastos_Ocio y transporte;Parking y peaje;10;VARIABLES
01/11/2018;01/11/2018;T/VIENA PARC VALLES / 29-10-2018;-5,80;21052,61;21046,81;11490;-5,80;21046,81;2018-10-29;29/10/2018;VIENA;Gastos_Ocio y transporte;Restaurantes;10;VARIABLES
01/11/2018;01/11/2018;T/AUTOPISTAS TERR 28-10-2018;-2,56;21046,81;21044,25;11491;-2,56;21044,25;2018-10-28;28/10/2018;AUTOPISTAS;Gastos_Ocio y transporte;Parking y peaje;10;VARIABLES
02/11/2018;02/11/2018;T/WWW.JUST-EAT.ES 30-10-2018;-32,05;21044,25;21012,20;11492;-32,05;21012,20;2018-10-30;30/10/2018;WWWJUSTEATES;Gastos_Ocio y transporte;Restaurantes;10;VARIABLES
02/11/2018;02/11/2018;T/AUTOPISTAS TERR 30-10-2018;-1,41;21012,20;21010,79;11493;-1,41;21010,79;2018-10-30;30/10/2018;AUTOPISTAS;Gastos_Ocio y transporte;Parking y peaje;10;VARIABLES
02/11/2018;02/11/2018;T/AUTOPISTAS TERR 30-10-2018;-1,41;21010,79;21009,38;11494;-1,41;21009,38;2018-10-30;30/10/2018;AUTOPISTAS;Gastos_Ocio y transporte;Parking y peaje;10;VARIABLES
02/11/2018;02/11/2018;T/BON AREA 30-10-2018;-3,69;21009,38;21005,69;11495;-3,69;21005,69;2018-10-30;30/10/2018;BON;Gastos_Compras;Supermercado;10;VARIABLES
02/11/2018;02/11/2018;T/AUTOPISTA MARE NOST 28-10-2018;-7,20;21005,69;20998,49;11496;-7,20;20998,49;2018-10-28;28/10/2018;AUTOPISTA;Gastos_Ocio y transporte;Parking y peaje;10;VARIABLES
02/11/2018;02/11/2018;T/A.C.E.S.A LIM SCAP7 28-10-2018;-10,70;20998,49;20987,79;11497;-10,70;20987,79;2018-10-28;28/10/2018;ACESA;Gastos_Ocio y transporte;Parking y peaje;10;VARIABLES
02/11/2018;02/11/2018;T/A.C.E.S.A B MART -A 26-10-2018;-10,05;20987,79;20977,74;11498;-10,05;20977,74;2018-10-26;26/10/2018;ACESA;Gastos_Ocio y transporte;Parking y peaje;10;VARIABLES
02/11/2018;02/11/2018;T/AUTOPISTA MARE NOST 26-10-2018;-7,20;20977,74;20970,54;11499;-7,20;20970,54;2018-10-26;26/10/2018;AUTOPISTA;Gastos_Ocio y transporte;Parking y peaje;10;VARIABLES
02/11/2018;02/11/2018;T/A.C.E.S.A A REUS-LI 26-10-2018;-0,85;20970,54;20969,69;11500;-0,85;20969,69;2018-10-26;26/10/2018;ACESA;Gastos_Ocio y transporte;Parking y peaje;10;VARIABLES
03/11/2018;03/11/2018;T/CATALUNYA CAIX/EL P 31-10-2018;-1,95;20969,69;20967,74;11501;-1,95;20967,74;2018-10-31;31/10/2018;CATALUNYA;Gastos_Ocio y transporte;Restaurantes;10;VARIABLES
03/11/2018;03/11/2018;T/CINESA PARC VALLES/ 31-10-2018;-17,01;20967,74;20950,73;11502;-17,01;20950,73;2018-10-31;31/10/2018;CINESA;Gastos_Ocio y transporte;Espectáculos;10;VARIABLES
03/11/2018;03/11/2018;T/CINESA WEB /B 31-10-2018;-26,00;20950,73;20924,73;11503;-26,00;20924,73;2018-10-31;31/10/2018;CINESA;Gastos_Ocio y transporte;Espectáculos;10;VARIABLES
03/11/2018;03/11/2018;T/TUNELS VALLVI S. 30-10-2018;-3,78;20924,73;20920,95;11504;-3,78;20920,95;2018-10-30;30/10/2018;TUNELS;Gastos_Ocio y transporte;Parking y peaje;10;VARIABLES
04/11/2018;04/11/2018;T/WWW.JUST-EAT.ES 01-11-2018;-32,35;20920,95;20888,60;11505;-32,35;20888,60;2018-11-01;01/11/2018;WWWJUSTEATES;Gastos_Ocio y transporte;Restaurantes;11;VARIABLES
06/11/2018;06/11/2018;T/EL CAFE DE LAULA / 03-11-2018;-16,10;20888,60;20872,50;11506;-16,10;20872,50;2018-11-03;03/11/2018;CAFE;Gastos_Ocio y transporte;Restaurantes;11;VARIABLES
06/11/2018;06/11/2018;T/AUTOPISTAS TERR 31-10-2018;-1,41;20872,50;20871,09;11507;-1,41;20871,09;2018-10-31;31/10/2018;AUTOPISTAS;Gastos_Ocio y transporte;Parking y peaje;10;VARIABLES
06/11/2018;06/11/2018;T/AUTOPISTAS TERR 31-10-2018;-1,41;20871,09;20869,68;11508;-1,41;20869,68;2018-10-31;31/10/2018;AUTOPISTAS;Gastos_Ocio y transporte;Parking y peaje;10;VARIABLES
07/11/2018;07/11/2018;'R/L.EINA COOPERA L''EINA COOPE Reb';-35,60;20869,68;20834,08;11509;-35,60;20834,08;2018-11-07;07/11/2018;LEINA;Gastos_Salud, saber y deporte;Estudios;11;VARIABLES
08/11/2018;08/11/2018;T/WWW.JUST-EAT.ES 05-11-2018;-15,00;20834,08;20819,08;11510;-15,00;20819,08;2018-11-05;05/11/2018;WWWJUSTEATES;Gastos_Ocio y transporte;Restaurantes;11;VARIABLES
08/11/2018;08/11/2018;T/BON AREA 05-11-2018;-17,28;20819,08;20801,80;11511;-17,28;20801,80;2018-11-05;05/11/2018;BON;Gastos_Compras;Supermercado;11;VARIABLES
08/11/2018;08/11/2018;T/CEDIPSA 15838-1 EG/ 05-11-2018;-40,00;20801,80;20761,80;11512;-40,00;20761,80;2018-11-05;05/11/2018;CEDIPSA;Gastos_Ocio y transporte;Gasolina;11;VARIABLES
08/11/2018;08/11/2018;T/AUTOPISTAS TERR 02-11-2018;-1,41;20761,80;20760,39;11513;-1,41;20760,39;2018-11-02;02/11/2018;AUTOPISTAS;Gastos_Ocio y transporte;Parking y peaje;11;VARIABLES
09/11/2018;09/11/2018;R/SERHS FOOD A Comedor Noviembre;-119,00;20760,39;20641,39;11514;-119,00;20641,39;2018-11-09;09/11/2018;SERHS;Gastos_Salud, saber y deporte;Menjador;11;FIJO
09/11/2018;09/11/2018;R/SERHS FOOD A Comedor Noviembre;-35,00;20641,39;20606,39;11515;-35,00;20606,39;2018-11-09;09/11/2018;SERHS;Gastos_Salud, saber y deporte;Menjador;11;FIJO
09/11/2018;09/11/2018;R/. FINQUES GASS Vto 01-11-18 Rec;-75,31;20606,39;20531,08;11516;-75,31;20531,08;2018-11-01;01/11/2018;FINQUES;Gastos_Vivienda y vehiculo;Alquiler Parking;11;FIJO
09/11/2018;09/11/2018;T/TUNELS VALLVI S. 06-11-2018;-4,25;20531,08;20526,83;11517;-4,25;20526,83;2018-11-06;06/11/2018;TUNELS;Gastos_Ocio y transporte;Parking y peaje;11;VARIABLES
09/11/2018;09/11/2018;T/BON AREA 06-11-2018;-13,99;20526,83;20512,84;11518;-13,99;20512,84;2018-11-06;06/11/2018;BON;Gastos_Compras;Supermercado;11;VARIABLES
09/11/2018;09/11/2018;T/CATALUNYA CAIX/EL P 06-11-2018;-1,95;20512,84;20510,89;11519;-1,95;20510,89;2018-11-06;06/11/2018;CATALUNYA;Gastos_Ocio y transporte;Restaurantes;11;VARIABLES
10/11/2018;10/11/2018;T/TUNELS VALLVI S. 07-11-2018;-3,78;20510,89;20507,11;11520;-3,78;20507,11;2018-11-07;07/11/2018;TUNELS;Gastos_Ocio y transporte;Parking y peaje;11;VARIABLES
10/11/2018;10/11/2018;T/CATALUNYA CAIX/EL P 07-11-2018;-2,35;20507,11;20504,76;11521;-2,35;20504,76;2018-11-07;07/11/2018;CATALUNYA;Gastos_Ocio y transporte;Restaurantes;11;VARIABLES
10/11/2018;10/11/2018;T/WWW.JUST-EAT.ES /MADRID;-22,70;20504,76;20482,06;11522;-22,70;20482,06;2018-11-10;10/11/2018;WWWJUSTEATES;Gastos_Ocio y transporte;Restaurantes;11;VARIABLES
11/11/2018;11/11/2018;T/WWW.JUST-EAT.ES /MADRID;-33,35;20482,06;20448,71;11523;-33,35;20448,71;2018-11-11;11/11/2018;WWWJUSTEATES;Gastos_Ocio y transporte;Restaurantes;11;VARIABLES
11/11/2018;11/11/2018;T/CATALUNYA CAIX/EL P 08-11-2018;-0,95;20448,71;20447,76;11524;-0,95;20447,76;2018-11-08;08/11/2018;CATALUNYA;Gastos_Ocio y transporte;Restaurantes;11;VARIABLES
12/11/2018;12/11/2018;T/WWW.JUST-EAT.ES 09-11-2018;-33,45;20447,76;20414,31;11525;-33,45;20414,31;2018-11-09;09/11/2018;WWWJUSTEATES;Gastos_Ocio y transporte;Restaurantes;11;VARIABLES
12/11/2018;12/11/2018;T/LANGLOYS / 09-11-2018;-147,80;20414,31;20266,51;11526;-147,80;20266,51;2018-11-09;09/11/2018;LANGLOYS;Gastos_Compras;Otras compras;11;VARIABLES
12/11/2018;12/11/2018;T/TUNELS VALLVI S. 08-11-2018;-3,78;20266,51;20262,73;11527;-3,78;20262,73;2018-11-08;08/11/2018;TUNELS;Gastos_Ocio y transporte;Parking y peaje;11;VARIABLES
12/11/2018;12/11/2018;T/AUTOPISTAS TERR 07-11-2018;-1,41;20262,73;20261,32;11528;-1,41;20261,32;2018-11-07;07/11/2018;AUTOPISTAS;Gastos_Ocio y transporte;Parking y peaje;11;VARIABLES
12/11/2018;12/11/2018;T/AUTOPISTAS TERR 07-11-2018;-1,41;20261,32;20259,91;11529;-1,41;20259,91;2018-11-07;07/11/2018;AUTOPISTAS;Gastos_Ocio y transporte;Parking y peaje;11;VARIABLES
12/11/2018;12/11/2018;T/AUTOPISTAS TERR 06-11-2018;-1,41;20259,91;20258,50;11530;-1,41;20258,50;2018-11-06;06/11/2018;AUTOPISTAS;Gastos_Ocio y transporte;Parking y peaje;11;VARIABLES
12/11/2018;12/11/2018;T/AUTOPISTAS TERR 06-11-2018;-1,41;20258,50;20257,09;11531;-1,41;20257,09;2018-11-06;06/11/2018;AUTOPISTAS;Gastos_Ocio y transporte;Parking y peaje;11;VARIABLES
13/11/2018;13/11/2018;R/TELEFONO VODAFONE;-150,72;20257,09;20106,37;11532;-150,72;20106,37;2018-11-13;13/11/2018;TELEFONO;Gastos_Servicios tipicos;Telecomunicaciones;11;FIJO
15/11/2018;15/11/2018;R/NATURGY IBER 27630481118;-4,69;20106,37;20101,68;11533;-4,69;20101,68;2018-11-15;15/11/2018;NATURGY;Gastos_Servicios tipicos;Gas;11;FIJO
15/11/2018;15/11/2018;R/LUZ ENDESA ENERG FACTURA DE ELE;-124,97;20101,68;19976,71;11534;-124,97;19976,71;2018-11-15;15/11/2018;ELE;Gastos_Servicios tipicos;Electricidad;11;FIJO
15/11/2018;15/11/2018;T/AUTOPISTAS TERR     09-11-2018;-1,41;19976,71;19975,30;11535;-1,41;19975,30;2018-11-09;09/11/2018;AUTOPISTAS;Gastos_Ocio y transporte;Parking y peaje;11;VARIABLES
15/11/2018;15/11/2018;T/AUTOPISTAS TERR     09-11-2018;-1,41;19975,30;19973,89;11536;-1,41;19973,89;2018-11-09;09/11/2018;AUTOPISTAS;Gastos_Ocio y transporte;Parking y peaje;11;VARIABLES
15/11/2018;15/11/2018;T/AUTOPISTAS TERR     08-11-2018;-1,41;19973,89;19972,48;11537;-1,41;19972,48;2018-11-08;08/11/2018;AUTOPISTAS;Gastos_Ocio y transporte;Parking y peaje;11;VARIABLES
15/11/2018;15/11/2018;T/AUTOPISTAS TERR     08-11-2018;-1,41;19972,48;19971,07;11538;-1,41;19971,07;2018-11-08;08/11/2018;AUTOPISTAS;Gastos_Ocio y transporte;Parking y peaje;11;VARIABLES
16/11/2018;16/11/2018;R/SEGUROS CCM VIDA Y P Recibo:153;-15,28;19971,07;19955,79;11539;-15,28;19955,79;2018-11-16;16/11/2018;CCM;Gastos_Seguros;Seguro vida;11;FIJO
16/11/2018;16/11/2018;R/SEGUROS CCM VIDA Y P Recibo:153;-18,92;19955,79;19936,87;11540;-18,92;19936,87;2018-11-16;16/11/2018;CCM;Gastos_Seguros;Seguro vida;11;FIJO
16/11/2018;16/11/2018;R/SEGUROS ADESLAS CENT MODULAR CO;-159,81;19936,87;19777,06;11541;-159,81;19777,06;2018-11-16;16/11/2018;ADESLAS;Gastos_Salud, saber y deporte;Medico;11;VARIABLES
16/11/2018;16/11/2018;T/CATALUNYA CAIX/EL P 13-11-2018;-2,75;19777,06;19774,31;11542;-2,75;19774,31;2018-11-13;13/11/2018;CATALUNYA;Gastos_Ocio y transporte;Restaurantes;11;VARIABLES
16/11/2018;16/11/2018;T/AUTOPISTAS TERR     13-11-2018;-1,41;19774,31;19772,90;11543;-1,41;19772,90;2018-11-13;13/11/2018;AUTOPISTAS;Gastos_Ocio y transporte;Parking y peaje;11;VARIABLES
16/11/2018;16/11/2018;T/AUTOPISTAS TERR     13-11-2018;-1,41;19772,90;19771,49;11544;-1,41;19771,49;2018-11-13;13/11/2018;AUTOPISTAS;Gastos_Ocio y transporte;Parking y peaje;11;VARIABLES
16/11/2018;16/11/2018;T/TUNELS    VALLVI S. 12-11-2018;-4,25;19771,49;19767,24;11545;-4,25;19767,24;2018-11-12;12/11/2018;TUNELS;Gastos_Ocio y transporte;Parking y peaje;11;VARIABLES
16/11/2018;16/11/2018;T/AUTOPISTAS TERR     12-11-2018;-1,41;19767,24;19765,83;11546;-1,41;19765,83;2018-11-12;12/11/2018;AUTOPISTAS;Gastos_Ocio y transporte;Parking y peaje;11;VARIABLES
16/11/2018;16/11/2018;T/AUTOPISTAS TERR     12-11-2018;-1,41;19765,83;19764,42;11547;-1,41;19764,42;2018-11-12;12/11/2018;AUTOPISTAS;Gastos_Ocio y transporte;Parking y peaje;11;VARIABLES
17/11/2018;17/11/2018;T/AUTOPISTAS TERR     14-11-2018;-1,41;19764,42;19763,01;11548;-1,41;19763,01;2018-11-14;14/11/2018;AUTOPISTAS;Gastos_Ocio y transporte;Parking y peaje;11;VARIABLES
17/11/2018;17/11/2018;T/AUTOPISTAS TERR     14-11-2018;-1,41;19763,01;19761,60;11549;-1,41;19761,60;2018-11-14;14/11/2018;AUTOPISTAS;Gastos_Ocio y transporte;Parking y peaje;11;VARIABLES
17/11/2018;17/11/2018;T/CATALUNYA CAIX/EL P 14-11-2018;-2,30;19761,60;19759,30;11550;-2,30;19759,30;2018-11-14;14/11/2018;CATALUNYA;Gastos_Ocio y transporte;Restaurantes;11;VARIABLES
18/11/2018;18/11/2018;T/AUTOPISTAS TERR     15-11-2018;-1,41;19759,30;19757,89;11551;-1,41;19757,89;2018-11-15;15/11/2018;AUTOPISTAS;Gastos_Ocio y transporte;Parking y peaje;11;VARIABLES
18/11/2018;18/11/2018;T/AUTOPISTAS TERR     15-11-2018;-1,41;19757,89;19756,48;11552;-1,41;19756,48;2018-11-15;15/11/2018;AUTOPISTAS;Gastos_Ocio y transporte;Parking y peaje;11;VARIABLES
18/11/2018;18/11/2018;T/TUNELS    VALLVI S. 15-11-2018;-3,78;19756,48;19752,70;11553;-3,78;19752,70;2018-11-15;15/11/2018;TUNELS;Gastos_Ocio y transporte;Parking y peaje;11;VARIABLES
18/11/2018;18/11/2018;T/TUNELS    VALLVI N. 15-11-2018;-3,78;19752,70;19748,92;11554;-3,78;19748,92;2018-11-15;15/11/2018;TUNELS;Gastos_Ocio y transporte;Parking y peaje;11;VARIABLES
19/11/2018;19/11/2018;T/BON AREA            16-11-2018;-9,57;19748,92;19739,35;11555;-9,57;19739,35;2018-11-16;16/11/2018;BON;Gastos_Compras;Supermercado;11;VARIABLES
20/11/2018;20/11/2018;CAJ. AJENOSERVIRED     /PRAT DE LLOBR;-300,00;19739,35;19439,35;11556;-300,00;19439,35;2018-11-20;20/11/2018;CAJ;Gastos_Gastos varios;Efectivo;11;VARIABLES
20/11/2018;20/11/2018;COM.64970036 SVRED CAJ     OFI;-1,87;19439,35;19437,48;11557;-1,87;19437,48;2018-11-20;20/11/2018;COM;Gastos_Banco y organismos;Cargos banco;11;FIJO
20/11/2018;20/11/2018;T/KIABI BARICENT/BARB 17-11-2018;-53,00;19437,48;19384,48;11558;-53,00;19384,48;2018-11-17;17/11/2018;KIABI;Gastos_Compras;Ropa;11;VARIABLES
20/11/2018;20/11/2018;T/WWW.JUST-EAT.ES     17-11-2018;-21,95;19384,48;19362,53;11559;-21,95;19362,53;2018-11-17;17/11/2018;WWWJUSTEATES;Gastos_Ocio y transporte;Restaurantes;11;VARIABLES
20/11/2018;20/11/2018;T/TERRACASA         / 17-11-2018;-23,63;19362,53;19338,90;11560;-23,63;19338,90;2018-11-17;17/11/2018;TERRACASA;Gastos_Compras;Otras compras;11;VARIABLES
22/11/2018;20/11/2018;T/AMAZON.ES*M89744BI4 AM;-19,90;19338,90;19319,00;11561;-19,90;19319,00;2018-11-20;20/11/2018;AMAZONESMBI;Gastos_Compras;Hobbys;11;VARIABLES
22/11/2018;22/11/2018;T/BON AREA            19-11-2018;-26,73;19319,00;19292,27;11562;-26,73;19292,27;2018-11-19;19/11/2018;BON;Gastos_Compras;Supermercado;11;VARIABLES
23/11/2018;23/11/2018;T/IKEA SABADELL     /SABADELL;-179,97;19292,27;19112,30;11563;-179,97;19112,30;2018-11-23;23/11/2018;IKEA;Gastos_Vivienda y vehiculo;Mnto. hogar;11;VARIABLES
23/11/2018;23/11/2018;T/AUTOPISTAS TERR     20-11-2018;-1,41;19112,30;19110,89;11564;-1,41;19110,89;2018-11-20;20/11/2018;AUTOPISTAS;Gastos_Ocio y transporte;Parking y peaje;11;VARIABLES
23/11/2018;23/11/2018;T/CATALUNYA CAIX/EL P 20-11-2018;-0,95;19110,89;19109,94;11565;-0,95;19109,94;2018-11-20;20/11/2018;CATALUNYA;Gastos_Ocio y transporte;Restaurantes;11;VARIABLES
23/11/2018;23/11/2018;T/AUTOPISTAS TERR     19-11-2018;-1,41;19109,94;19108,53;11566;-1,41;19108,53;2018-11-19;19/11/2018;AUTOPISTAS;Gastos_Ocio y transporte;Parking y peaje;11;VARIABLES
24/11/2018;24/11/2018;T/XIN HUA EXTREMO O/B 21-11-2018;-56,50;19108,53;19052,03;11567;-56,50;19052,03;2018-11-21;21/11/2018;XIN;Gastos_Ocio y transporte;Restaurantes;11;VARIABLES
24/11/2018;24/11/2018;T/AUTOPISTAS TERR     21-11-2018;-1,41;19052,03;19050,62;11568;-1,41;19050,62;2018-11-21;21/11/2018;AUTOPISTAS;Gastos_Ocio y transporte;Parking y peaje;11;VARIABLES
24/11/2018;24/11/2018;T/CATALUNYA CAIX/EL P 21-11-2018;-0,95;19050,62;19049,67;11569;-0,95;19049,67;2018-11-21;21/11/2018;CATALUNYA;Gastos_Ocio y transporte;Restaurantes;11;VARIABLES
24/11/2018;24/11/2018;T/AP. PLACA CATALUN/B 21-11-2018;-4,15;19049,67;19045,52;11570;-4,15;19045,52;2018-11-21;21/11/2018;PLACA;Gastos_Ocio y transporte;Parking y peaje;11;VARIABLES
24/11/2018;24/11/2018;T/TUNELS    VALLVI S. 20-11-2018;-3,78;19045,52;19041,74;11571;-3,78;19041,74;2018-11-20;20/11/2018;TUNELS;Gastos_Ocio y transporte;Parking y peaje;11;VARIABLES
26/11/2018;26/11/2018;T/TAGLIATELLA TERRAS/ 23-11-2018;-48,05;19041,74;18993,69;11572;-48,05;18993,69;2018-11-23;23/11/2018;TAGLIATELLA;Gastos_Ocio y transporte;Restaurantes;11;VARIABLES
26/11/2018;26/11/2018;T/IKEA REST. SABADEL/ 23-11-2018;-5,00;18993,69;18988,69;11573;-5,00;18988,69;2018-11-23;23/11/2018;IKEA;Gastos_Vivienda y vehiculo;Mnto. hogar;11;VARIABLES
27/11/2018;27/11/2018;T/WWW.JUST-EAT.ES     24-11-2018;-39,85;18988,69;18948,84;11574;-39,85;18948,84;2018-11-24;24/11/2018;WWWJUSTEATES;Gastos_Ocio y transporte;Restaurantes;11;VARIABLES
28/11/2018;28/11/2018;HAB. AJUNTAMENT DE TERRASSA Transfe;1843,70;18948,84;20792,54;11575;1843,70;20792,54;2018-11-28;28/11/2018;HAB;Ingresos;Nomina;11;FIJO
28/11/2018;26/11/2018;T/AMZN Mktp ES*M842T3WG4;-89,99;20792,54;20702,55;11576;-89,99;20702,55;2018-11-26;26/11/2018;AMZN;Gastos_Compras;Hobbys;11;VARIABLES
28/11/2018;26/11/2018;T/AMZN Mktp ES*M812E9WS4;-89,99;20702,55;20612,56;11577;-89,99;20612,56;2018-11-26;26/11/2018;AMZN;Gastos_Compras;Hobbys;11;VARIABLES
28/11/2018;28/11/2018;T/BON AREA            25-11-2018;-36,51;20612,56;20576,05;11578;-36,51;20576,05;2018-11-25;25/11/2018;BON;Gastos_Compras;Supermercado;11;VARIABLES
29/11/2018;29/11/2018;T/CATALUNYA CAIX/EL P 26-11-2018;-3,15;20576,05;20572,90;11579;-3,15;20572,90;2018-11-26;26/11/2018;CATALUNYA;Gastos_Ocio y transporte;Restaurantes;11;VARIABLES
29/11/2018;29/11/2018;T/PARKING VAPOR GRAN/ 26-11-2018;-0,50;20572,90;20572,40;11580;-0,50;20572,40;2018-11-26;26/11/2018;PARKING;Gastos_Ocio y transporte;Parking y peaje;11;VARIABLES
29/11/2018;29/11/2018;T/PARKING F. REYES /B 26-11-2018;-0,80;20572,40;20571,60;11581;-0,80;20571,60;2018-11-26;26/11/2018;PARKING;Gastos_Ocio y transporte;Parking y peaje;11;VARIABLES
29/11/2018;29/11/2018;T/WWW.JUST-EAT.ES     26-11-2018;-31,44;20571,60;20540,16;11582;-31,44;20540,16;2018-11-26;26/11/2018;WWWJUSTEATES;Gastos_Ocio y transporte;Restaurantes;11;VARIABLES
30/11/2018;30/11/2018;'R/AJUNTAMENT D I.B.I.  CA D''ALBI';-47,15;20540,16;20493,01;11583;-47,15;20493,01;2018-11-30;30/11/2018;AJUNTAMENT;Gastos_Banco y organismos;Ayuntamiento;11;FIJO
30/11/2018;30/11/2018;REC.6061.9600001223;-448,11;20493,01;20044,90;11584;-448,11;20044,90;2018-11-30;30/11/2018;REC;Gastos_Banco y organismos;Hipoteca;11;FIJO
30/11/2018;30/11/2018;TRANSFBBVABCLM;1200,00;20044,90;21244,90;11585;1200,00;21244,90;2018-11-30;30/11/2018;TRANSFBBVABCLM;No computable;traspasos, transf.;11;
30/11/2018;30/11/2018;T/H&M SPLAU    /CORNELLA DE L;-57,44;21244,90;21187,46;11586;-57,44;21187,46;2018-11-30;30/11/2018;SPLAU;Gastos_Ocio y transporte;Restaurantes;11;VARIABLES
30/11/2018;30/11/2018;T/ESPASA CALPE /CORNELLA DE L;-42,90;21187,46;21144,56;11587;-42,90;21144,56;2018-11-30;30/11/2018;ESPASA;Gastos_Compras;Libreria;11;VARIABLES
30/11/2018;30/11/2018;T/TERRACASA         /TERRASSA;-40,16;21144,56;21104,40;11588;-40,16;21104,40;2018-11-30;30/11/2018;TERRACASA;Gastos_Compras;Otras compras;11;VARIABLES
30/11/2018;30/11/2018;T/AUTOPISTAS TERR     27-11-2018;-1,41;21104,40;21102,99;11589;-1,41;21102,99;2018-11-27;27/11/2018;AUTOPISTAS;Gastos_Ocio y transporte;Parking y peaje;11;VARIABLES
01/12/2018;01/12/2018;FACT TARJETASTARJ.CREDITO 07126017 18-12-01;-480,79;21102,99;20622,20;11590;-480,79;20622,20;2018-12-01;30/11/2018;FACT 07126017;Gastos_Banco y organismos;Credito Bea;11;VARIABLE
01/12/2018;01/12/2018;FACT TARJETASTARJ.CREDITO 42689013 18-12-01;-314,72;20622,20;20307,48;11591;-314,72;20307,48;2018-12-01;30/11/2018;FACT;No computable;Recibo Tarjeta;11;
01/12/2018;01/12/2018;T/CATALUNYA CAIX/EL P 28-11-2018;-3,80;20307,48;20303,68;11592;-3,80;20303,68;2018-11-28;28/11/2018;CATALUNYA;Gastos_Ocio y transporte;Restaurantes;11;VARIABLES
01/12/2018;01/12/2018;T/AUTOPISTAS TERR     28-11-2018;-1,41;20303,68;20302,27;11593;-1,41;20302,27;2018-11-28;28/11/2018;AUTOPISTAS;Gastos_Ocio y transporte;Parking y peaje;11;VARIABLES
01/12/2018;01/12/2018;T/AUTOPISTAS TERR     28-11-2018;-1,41;20302,27;20300,86;11594;-1,41;20300,86;2018-11-28;28/11/2018;AUTOPISTAS;Gastos_Ocio y transporte;Parking y peaje;11;VARIABLES
02/12/2018;28/11/2018;T/TUNELS VALLVI S. C:2T;-3,78;20300,86;20297,08;11595;-3,78;20297,08;2018-11-28;28/11/2018;TUNELS;Gastos_Ocio y transporte;Parking y peaje;11;VARIABLES
02/12/2018;29/11/2018;T/TUNELS VALLVI S. C:2T;-4,25;20297,08;20292,83;11596;-4,25;20292,83;2018-11-29;29/11/2018;TUNELS;Gastos_Ocio y transporte;Parking y peaje;11;VARIABLES
02/12/2018;02/12/2018;T/VIENA PARC VALLES / 29-11-2018;-3,10;20292,83;20289,73;11597;-3,10;20289,73;2018-11-29;29/11/2018;VIENA;Gastos_Ocio y transporte;Restaurantes;11;VARIABLES
02/12/2018;02/12/2018;T/AUTOPISTAS TERR 29-11-2018;-1,41;20289,73;20288,32;11598;-1,41;20288,32;2018-11-29;29/11/2018;AUTOPISTAS;Gastos_Ocio y transporte;Parking y peaje;11;VARIABLES
02/12/2018;02/12/2018;T/AUTOPISTAS TERR 29-11-2018;-1,41;20288,32;20286,91;11599;-1,41;20286,91;2018-11-29;29/11/2018;AUTOPISTAS;Gastos_Ocio y transporte;Parking y peaje;11;VARIABLES
02/12/2018;02/12/2018;T/E.S. CAN CASANOVES/ 29-11-2018;-42,74;20286,91;20244,17;11600;-42,74;20244,17;2018-11-29;29/11/2018;CAN;Gastos_Ocio y transporte;Gasolina;11;VARIABLES
02/12/2018;02/12/2018;T/VIENA PARC VALLES / 29-11-2018;-11,25;20244,17;20232,92;11601;-11,25;20232,92;2018-11-29;29/11/2018;VIENA;Gastos_Ocio y transporte;Restaurantes;11;VARIABLES
02/12/2018;02/12/2018;T/REDONDEO S0LIDARI/B 29-11-2018;-0,25;20232,92;20232,67;11602;-0,25;20232,67;2018-11-29;29/11/2018;REDONDEO;Gastos_Salud, saber y deporte;Solidaridad;11;VARIABLES
03/12/2018;03/12/2018;R/LUZ ENDESA ENERG FACTURA DE GAS;-98,43;20232,67;20134,24;11603;-98,43;20134,24;2018-12-03;03/12/2018;GAS;Gastos_Servicios tipicos;Gas;12;FIJO
03/12/2018;03/12/2018;T/VIENA PARC VALLES / 30-11-2018;-11,50;20134,24;20122,74;11604;-11,50;20122,74;2018-11-30;30/11/2018;VIENA;Gastos_Ocio y transporte;Restaurantes;11;VARIABLES
03/12/2018;03/12/2018;T/REDONDEO S0LIDARI/B 30-11-2018;-0,50;20122,74;20122,24;11605;-0,50;20122,24;2018-11-30;30/11/2018;REDONDEO;Gastos_Salud, saber y deporte;Solidaridad;11;VARIABLES
03/12/2018;03/12/2018;T/DECATHLON SA TERRA/ 30-11-2018;-60,89;20122,24;20061,35;11606;-60,89;20061,35;2018-11-30;30/11/2018;DECATHLON;Gastos_Compras;Deportivo;11;VARIABLES
03/12/2018;03/12/2018;T/SPRINGFIELD /CORNE 30-11-2018;-41,98;20061,35;20019,37;11607;-41,98;20019,37;2018-11-30;30/11/2018;SPRINGFIELD;Gastos_Compras;Ropa;11;VARIABLES
04/12/2018;04/12/2018;R/CASER CAJA DE SEGU POL.95397546;-440,19;20019,37;19579,18;11608;-440,19;19579,18;2018-12-04;04/12/2018;CASER;Ingresos;Transferencias;12;VARIABLES
05/12/2018;05/12/2018;T/CINESA WEB /B 02-12-2018;-21,20;19579,18;19557,98;11609;-21,20;19557,98;2018-12-02;02/12/2018;CINESA;Gastos_Ocio y transporte;Espectáculos;12;VARIABLES
05/12/2018;05/12/2018;T/AUTOPISTAS TERR 30-11-2018;-1,41;19557,98;19556,57;11610;-1,41;19556,57;2018-11-30;30/11/2018;AUTOPISTAS;Gastos_Ocio y transporte;Parking y peaje;11;VARIABLES
05/12/2018;05/12/2018;T/AUTOPISTAS TERR 30-11-2018;-1,41;19556,57;19555,16;11611;-1,41;19555,16;2018-11-30;30/11/2018;AUTOPISTAS;Gastos_Ocio y transporte;Parking y peaje;11;VARIABLES
05/12/2018;05/12/2018;'R/L.EINA COOPERA L''EINA COOPE Reb';-35,60;19555,16;19519,56;11612;-35,60;19519,56;2018-12-05;05/12/2018;LEINA;Gastos_Salud, saber y deporte;Estudios;12;VARIABLES
06/12/2018;06/12/2018;R/. FINQUES GASS Vto 01-12-18 Rec;-75,31;19519,56;19444,25;11613;-75,31;19444,25;2018-12-01;01/12/2018;FINQUES;Gastos_Vivienda y vehiculo;Alquiler Parking;12;FIJO
06/12/2018;06/12/2018;R/SEGUROS ADESLAS CENT MODULAR CO;-159,81;19444,25;19284,44;11614;-159,81;19284,44;2018-12-06;06/12/2018;ADESLAS;Gastos_Salud, saber y deporte;Medico;12;VARIABLES
06/12/2018;06/12/2018;T/BON AREA 03-12-2018;-15,26;19284,44;19269,18;11615;-15,26;19269,18;2018-12-03;03/12/2018;BON;Gastos_Compras;Supermercado;12;VARIABLES
06/12/2018;06/12/2018;T/CATALUNYA CAIX/EL P 03-12-2018;-3,65;19269,18;19265,53;11616;-3,65;19265,53;2018-12-03;03/12/2018;CATALUNYA;Gastos_Ocio y transporte;Restaurantes;12;VARIABLES
07/12/2018;07/12/2018;R/SERHS FOOD A Comedor Diciembre;-22,75;19265,53;19242,78;11617;-22,75;19242,78;2018-12-07;07/12/2018;SERHS;Gastos_Salud, saber y deporte;Menjador;12;FIJO
07/12/2018;07/12/2018;R/SERHS FOOD A Comedor Diciembre;-77,35;19242,78;19165,43;11618;-77,35;19165,43;2018-12-07;07/12/2018;SERHS;Gastos_Salud, saber y deporte;Menjador;12;FIJO
07/12/2018;07/12/2018;T/TUNELS VALLVI S. 04-12-2018;-4,25;19165,43;19161,18;11619;-4,25;19161,18;2018-12-04;04/12/2018;TUNELS;Gastos_Ocio y transporte;Parking y peaje;12;VARIABLES
07/12/2018;07/12/2018;T/AUTOPISTAS TERR 04-12-2018;-1,41;19161,18;19159,77;11620;-1,41;19159,77;2018-12-04;04/12/2018;AUTOPISTAS;Gastos_Ocio y transporte;Parking y peaje;12;VARIABLES
07/12/2018;07/12/2018;T/AUTOPISTAS TERR 04-12-2018;-1,41;19159,77;19158,36;11621;-1,41;19158,36;2018-12-04;04/12/2018;AUTOPISTAS;Gastos_Ocio y transporte;Parking y peaje;12;VARIABLES
07/12/2018;07/12/2018;T/RODELAS CAN PALET / 04-12-2018;-12,90;19158,36;19145,46;11622;-12,90;19145,46;2018-12-04;04/12/2018;RODELAS;Gastos_Salud, saber y deporte;Belleza;12;VARIABLES
07/12/2018;07/12/2018;T/AUTOPISTAS TERR 03-12-2018;-1,41;19145,46;19144,05;11623;-1,41;19144,05;2018-12-03;03/12/2018;AUTOPISTAS;Gastos_Ocio y transporte;Parking y peaje;12;VARIABLES
07/12/2018;07/12/2018;T/AUTOPISTAS TERR 03-12-2018;-1,41;19144,05;19142,64;11624;-1,41;19142,64;2018-12-03;03/12/2018;AUTOPISTAS;Gastos_Ocio y transporte;Parking y peaje;12;VARIABLES
07/12/2018;07/12/2018;T/TUNELS VALLVI S. 03-12-2018;-3,78;19142,64;19138,86;11625;-3,78;19138,86;2018-12-03;03/12/2018;TUNELS;Gastos_Ocio y transporte;Parking y peaje;12;VARIABLES
08/12/2018;08/12/2018;T/WWW.JUST-EAT.ES 05-12-2018;-35,55;19138,86;19103,31;11626;-35,55;19103,31;2018-12-05;05/12/2018;WWWJUSTEATES;Gastos_Ocio y transporte;Restaurantes;12;VARIABLES
08/12/2018;08/12/2018;T/CATALUNYA CAIX/EL P 05-12-2018;-3,80;19103,31;19099,51;11627;-3,80;19099,51;2018-12-05;05/12/2018;CATALUNYA;Gastos_Ocio y transporte;Restaurantes;12;VARIABLES
09/12/2018;09/12/2018;T/CINESA PARC VALLES/ 06-12-2018;-25,37;19099,51;19074,14;11628;-25,37;19074,14;2018-12-06;06/12/2018;CINESA;Gastos_Ocio y transporte;Espectáculos;12;VARIABLES
10/12/2018;10/12/2018;T/OPTICA JORNET / 07-12-2018;-7,95;19074,14;19066,19;11629;-7,95;19066,19;2018-12-07;07/12/2018;OPTICA;Gastos_Salud, saber y deporte;Farmacia;12;VARIABLES
10/12/2018;10/12/2018;T/BON AREA 07-12-2018;-31,10;19066,19;19035,09;11630;-31,10;19035,09;2018-12-07;07/12/2018;BON;Gastos_Compras;Supermercado;12;VARIABLES
10/12/2018;10/12/2018;T/VIENA PARC VALLES / 07-12-2018;-18,70;19035,09;19016,39;11631;-18,70;19016,39;2018-12-07;07/12/2018;VIENA;Gastos_Ocio y transporte;Restaurantes;12;VARIABLES
10/12/2018;10/12/2018;T/REDONDEO S0LIDARI/B 07-12-2018;-0,30;19016,39;19016,09;11632;-0,30;19016,09;2018-12-07;07/12/2018;REDONDEO;Gastos_Salud, saber y deporte;Solidaridad;12;VARIABLES
10/12/2018;10/12/2018;T/KURZ GUT GLORIES /B 07-12-2018;-35,05;19016,09;18981,04;11633;-35,05;18981,04;2018-12-07;07/12/2018;KURZ;Gastos_Ocio y transporte;Restaurantes;12;VARIABLES
10/12/2018;10/12/2018;T/AP. PLACA CATALUN/B 07-12-2018;-6,95;18981,04;18974,09;11634;-6,95;18974,09;2018-12-07;07/12/2018;PLACA;Gastos_Ocio y transporte;Parking y peaje;12;VARIABLES
11/12/2018;11/12/2018;T/WWW.JUST-EAT.ES 08-12-2018;-31,30;18974,09;18942,79;11635;-31,30;18942,79;2018-12-08;08/12/2018;WWWJUSTEATES;Gastos_Ocio y transporte;Restaurantes;12;VARIABLES
12/12/2018;12/12/2018;R/NATURGY IBER NATURGY2763048121;-4,69;18942,79;18938,10;11636;-4,69;18938,10;2018-12-12;12/12/2018;NATURGY;Gastos_Servicios tipicos;Gas;12;FIJO
12/12/2018;10/12/2018;T/Amazon.es*M05T28IO4;-11,40;18938,10;18926,70;11637;-11,40;18926,70;2018-12-10;10/12/2018;AMAZONESMTIO;Gastos_Compras;Hobbys;12;VARIABLES
12/12/2018;12/12/2018;T/AUTOPISTAS TERR 05-12-2018;-1,41;18926,70;18925,29;11638;-1,41;18925,29;2018-12-05;05/12/2018;AUTOPISTAS;Gastos_Ocio y transporte;Parking y peaje;12;VARIABLES
12/12/2018;12/12/2018;T/AUTOPISTAS TERR 05-12-2018;-1,41;18925,29;18923,88;11639;-1,41;18923,88;2018-12-05;05/12/2018;AUTOPISTAS;Gastos_Ocio y transporte;Parking y peaje;12;VARIABLES
13/12/2018;13/12/2018;R/TELEFONO VODAFONE;-150,42;18923,88;18773,46;11640;-150,42;18773,46;2018-12-13;13/12/2018;TELEFONO;Gastos_Servicios tipicos;Telecomunicaciones;12;FIJO
13/12/2018;13/12/2018;T/VIENA PARC VALLES / 10-12-2018;-5,80;18773,46;18767,66;11641;-5,80;18767,66;2018-12-10;10/12/2018;VIENA;Gastos_Ocio y transporte;Restaurantes;12;VARIABLES
13/12/2018;13/12/2018;T/REDONDEO S0LIDARI/B 10-12-2018;-0,20;18767,66;18767,46;11642;-0,20;18767,46;2018-12-10;10/12/2018;REDONDEO;Gastos_Salud, saber y deporte;Solidaridad;12;VARIABLES
13/12/2018;13/12/2018;T/SUPER.REYPA SL / 10-12-2018;-10,99;18767,46;18756,47;11643;-10,99;18756,47;2018-12-10;10/12/2018;SUPERREYPA;Gastos_Compras;Supermercado;12;VARIABLES
13/12/2018;13/12/2018;T/ZONA BLAVA-ESTACION 07-12-2018;-3,80;18756,47;18752,67;11644;-3,80;18752,67;2018-12-07;07/12/2018;ZONA;Gastos_Ocio y transporte;Parking y peaje;12;VARIABLES
13/12/2018;13/12/2018;T/TUNELS VALLVI S. 05-12-2018;-3,78;18752,67;18748,89;11645;-3,78;18748,89;2018-12-05;05/12/2018;TUNELS;Gastos_Ocio y transporte;Parking y peaje;12;VARIABLES
13/12/2018;13/12/2018;T/ORIENT CARS - RECA/TERRASSA;-263,38;18748,89;18485,51;11646;-263,38;18485,51;2018-12-13;13/12/2018;ORIENT;Gastos_Vivienda y vehiculo;Mnto. vehiculo;12;VARIABLE
14/12/2018;12/12/2018;T/AMZN Mktp ES*M29695CC4;-74,98;18485,51;18410,53;11647;-74,98;18410,53;2018-12-12;12/12/2018;AMZN;Gastos_Compras;Hobbys;12;VARIABLES
14/12/2018;14/12/2018;T/CATALUNYA CAIX/EL P 11-12-2018;-3,80;18410,53;18406,73;11648;-3,80;18406,73;2018-12-11;11/12/2018;CATALUNYA;Gastos_Ocio y transporte;Restaurantes;12;VARIABLES
14/12/2018;14/12/2018;T/TUNELS VALLVI S. 11-12-2018;-4,25;18406,73;18402,48;11649;-4,25;18402,48;2018-12-11;11/12/2018;TUNELS;Gastos_Ocio y transporte;Parking y peaje;12;VARIABLES
14/12/2018;14/12/2018;T/AUTOPISTAS TERR 11-12-2018;-1,41;18402,48;18401,07;11650;-1,41;18401,07;2018-12-11;11/12/2018;AUTOPISTAS;Gastos_Ocio y transporte;Parking y peaje;12;VARIABLES
14/12/2018;14/12/2018;T/AUTOPISTAS TERR 11-12-2018;-1,41;18401,07;18399,66;11651;-1,41;18399,66;2018-12-11;11/12/2018;AUTOPISTAS;Gastos_Ocio y transporte;Parking y peaje;12;VARIABLES
14/12/2018;14/12/2018;T/CATALUNYA CAIX/EL P 11-12-2018;-0,95;18399,66;18398,71;11652;-0,95;18398,71;2018-12-11;11/12/2018;CATALUNYA;Gastos_Ocio y transporte;Restaurantes;12;VARIABLES
15/12/2018;15/12/2018;T/AUTOPISTAS TERR 12-12-2018;-1,41;18398,71;18397,30;11653;-1,41;18397,30;2018-12-12;12/12/2018;AUTOPISTAS;Gastos_Ocio y transporte;Parking y peaje;12;VARIABLES
16/12/2018;16/12/2018;T/WWW.JUST-EAT.ES 13-12-2018;-42,45;18397,30;18354,85;11654;-42,45;18354,85;2018-12-13;13/12/2018;WWWJUSTEATES;Gastos_Ocio y transporte;Restaurantes;12;VARIABLES
16/12/2018;16/12/2018;T/AUTOPISTAS TERR 13-12-2018;-1,41;18354,85;18353,44;11655;-1,41;18353,44;2018-12-13;13/12/2018;AUTOPISTAS;Gastos_Ocio y transporte;Parking y peaje;12;VARIABLES
17/12/2018;17/12/2018;R/SEGUROS CCM VIDA Y P Recibo:153;-16,20;18353,44;18337,24;11656;-16,20;18337,24;2018-12-17;17/12/2018;CCM;Gastos_Seguros;Seguro vida;12;FIJO
17/12/2018;17/12/2018;R/SEGUROS CCM VIDA Y P Recibo:153;-18,84;18337,24;18318,40;11657;-18,84;18318,40;2018-12-17;17/12/2018;CCM;Gastos_Seguros;Seguro vida;12;FIJO
17/12/2018;17/12/2018;T/CATALUNYA CAIX/EL P 14-12-2018;-3,15;18318,40;18315,25;11658;-3,15;18315,25;2018-12-14;14/12/2018;CATALUNYA;Gastos_Ocio y transporte;Restaurantes;12;VARIABLES
17/12/2018;17/12/2018;T/E.S. RUBI II 14-12-2018;-44,96;18315,25;18270,29;11659;-44,96;18270,29;2018-12-14;14/12/2018;RUBI;Gastos_Ocio y transporte;Gasolina;12;VARIABLES
17/12/2018;17/12/2018;T/TUNELS VALLVI S. 13-12-2018;-3,78;18270,29;18266,51;11660;-3,78;18266,51;2018-12-13;13/12/2018;TUNELS;Gastos_Ocio y transporte;Parking y peaje;12;VARIABLES
18/12/2018;15/12/2018;T/Amazon.es*M29360324;-226,99;18266,51;18039,52;11661;-226,99;18039,52;2018-12-15;15/12/2018;AMAZONESM;Gastos_Compras;Hobbys;12;VARIABLES
18/12/2018;15/12/2018;T/CARREFOUR VALLE;-173,00;18039,52;17866,52;11662;-173,00;17866,52;2018-12-15;15/12/2018;CARREFOUR;Gastos_Compras;Supermercado;12;VARIABLES
18/12/2018;18/12/2018;T/ITACA / 15-12-2018;-11,10;17866,52;17855,42;11663;-11,10;17855,42;2018-12-15;15/12/2018;ITACA;Gastos_Compras;Otras compras;12;VARIABLES
18/12/2018;18/12/2018;T/WWW.JUST-EAT.ES 15-12-2018;-38,25;17855,42;17817,17;11664;-38,25;17817,17;2018-12-15;15/12/2018;WWWJUSTEATES;Gastos_Ocio y transporte;Restaurantes;12;VARIABLES
19/12/2018;19/12/2018;R/ MINA PUBLICA AIGUES T.01A75789;-49,80;17817,17;17767,37;11665;-49,80;17767,37;2018-12-19;19/12/2018;MINA;Gastos_Servicios tipicos;Agua;12;FIJO
19/12/2018;19/12/2018;'R/L.EINA COOPERA L''EINA COOPE Reb';-20,00;17767,37;17747,37;11666;-20,00;17747,37;2018-12-19;19/12/2018;LEINA;Gastos_Salud, saber y deporte;Estudios;12;VARIABLES
19/12/2018;19/12/2018;T/AUTOPISTAS TERR 14-12-2018;-1,41;17747,37;17745,96;11667;-1,41;17745,96;2018-12-14;14/12/2018;AUTOPISTAS;Gastos_Ocio y transporte;Parking y peaje;12;VARIABLES
19/12/2018;19/12/2018;T/AUTOPISTAS TERR 14-12-2018;-1,41;17745,96;17744,55;11668;-1,41;17744,55;2018-12-14;14/12/2018;AUTOPISTAS;Gastos_Ocio y transporte;Parking y peaje;12;VARIABLES
20/12/2018;20/12/2018;T/CATALUNYA CAIX/EL P 17-12-2018;-2,30;17744,55;17742,25;11669;-2,30;17742,25;2018-12-17;17/12/2018;CATALUNYA;Gastos_Ocio y transporte;Restaurantes;12;VARIABLES
20/12/2018;20/12/2018;T/PARKING VAPOR GRAN/ 17-12-2018;-2,90;17742,25;17739,35;11670;-2,90;17739,35;2018-12-17;17/12/2018;PARKING;Gastos_Ocio y transporte;Parking y peaje;12;VARIABLES
21/12/2018;21/12/2018;HAB.AJUNTAMENT DE TERRASSA Transfe;3847,12;17739,35;21586,47;11671;3847,12;21586,47;2018-12-21;21/12/2018;HABAJUNTAMENT;Ingresos;Nomina;12;FIJO
21/12/2018;21/12/2018;T/KIABI BARICENT/BARB 18-12-2018;-39,00;21586,47;21547,47;11672;-39,00;21547,47;2018-12-18;18/12/2018;KIABI;Gastos_Compras;Ropa;12;VARIABLES
21/12/2018;21/12/2018;T/REST.KAORI /BARBE 18-12-2018;-45,70;21547,47;21501,77;11673;-45,70;21501,77;2018-12-18;18/12/2018;RESTKAORI;Gastos_Ocio y transporte;Restaurantes;12;VARIABLES
21/12/2018;21/12/2018;T/AUTOPISTAS TERR 17-12-2018;-1,41;21501,77;21500,36;11674;-1,41;21500,36;2018-12-17;17/12/2018;AUTOPISTAS;Gastos_Ocio y transporte;Parking y peaje;12;VARIABLES
21/12/2018;21/12/2018;T/TUNELS VALLVI S. 17-12-2018;-4,25;21500,36;21496,11;11675;-4,25;21496,11;2018-12-17;17/12/2018;TUNELS;Gastos_Ocio y transporte;Parking y peaje;12;VARIABLES
22/12/2018;22/12/2018;T/TUNELS VALLVI N. 19-12-2018;-3,78;21496,11;21492,33;11676;-3,78;21492,33;2018-12-19;19/12/2018;TUNELS;Gastos_Ocio y transporte;Parking y peaje;12;VARIABLES
22/12/2018;22/12/2018;T/GRATSA /B 19-12-2018;-8,95;21492,33;21483,38;11677;-8,95;21483,38;2018-12-19;19/12/2018;GRATSA;Gastos_Ocio y transporte;Parking y peaje;12;VARIABLES
22/12/2018;22/12/2018;T/AUTOPISTAS TERR 19-12-2018;-1,41;21483,38;21481,97;11678;-1,41;21481,97;2018-12-19;19/12/2018;AUTOPISTAS;Gastos_Ocio y transporte;Parking y peaje;12;VARIABLES
22/12/2018;22/12/2018;T/AP. DR. ROBERT - TE 18-12-2018;-9,95;21481,97;21472,02;11679;-9,95;21472,02;2018-12-18;18/12/2018;ROBERT;Gastos_Ocio y transporte;Parking y peaje;12;VARIABLES
22/12/2018;22/12/2018;T/ROSA DELS VENTS /BARCELONA;-232,00;21472,02;21240,02;11680;-232,00;21240,02;2018-12-22;22/12/2018;ROSA;Gastos_Ocio y transporte;Vacaciones;12;VARIABLES
23/12/2018;23/12/2018;T/VILAR RURAL DE CARD/CARDONA;-226,45;21240,02;21013,57;11681;-226,45;21013,57;2018-12-23;23/12/2018;VILAR;Gastos_Ocio y transporte;Vacaciones;12;VARIABLES
23/12/2018;23/12/2018;T/VILAR RURAL DE CARD 20-12-2018;-54,00;21013,57;20959,57;11682;-54,00;20959,57;2018-12-20;20/12/2018;VILAR;Gastos_Ocio y transporte;Vacaciones;12;VARIABLES
23/12/2018;23/12/2018;T/AUTOPISTAS TERR 20-12-2018;-1,41;20959,57;20958,16;11683;-1,41;20958,16;2018-12-20;20/12/2018;AUTOPISTAS;Gastos_Ocio y transporte;Parking y peaje;12;VARIABLES
24/12/2018;24/12/2018;T/CINESA WEB /B 21-12-2018;-32,00;20958,16;20926,16;11684;-32,00;20926,16;2018-12-21;21/12/2018;CINESA;Gastos_Ocio y transporte;Espectáculos;12;VARIABLES
24/12/2018;24/12/2018;T/A.C.E.S.A S ACC MAR 20-12-2018;-2,45;20926,16;20923,71;11685;-2,45;20923,71;2018-12-20;20/12/2018;ACESA;Gastos_Ocio y transporte;Parking y peaje;12;VARIABLES
24/12/2018;24/12/2018;T/TUNELS VALLVI S. 20-12-2018;-3,78;20923,71;20919,93;11686;-3,78;20919,93;2018-12-20;20/12/2018;TUNELS;Gastos_Ocio y transporte;Parking y peaje;12;VARIABLES
25/12/2018;25/12/2018;T/AUTOPISTAS TERR 22-12-2018;-7,84;20919,93;20912,09;11687;-7,84;20912,09;2018-12-22;22/12/2018;AUTOPISTAS;Gastos_Ocio y transporte;Parking y peaje;12;VARIABLES
25/12/2018;25/12/2018;T/VIENA PARC VALLES / 22-12-2018;-18,70;20912,09;20893,39;11688;-18,70;20893,39;2018-12-22;22/12/2018;VIENA;Gastos_Ocio y transporte;Restaurantes;12;VARIABLES
25/12/2018;25/12/2018;T/REDONDEO S0LIDARI/B 22-12-2018;-0,30;20893,39;20893,09;11689;-0,30;20893,09;2018-12-22;22/12/2018;REDONDEO;Gastos_Salud, saber y deporte;Solidaridad;12;VARIABLES
25/12/2018;25/12/2018;T/E.S. CAN CASANOVES/ 22-12-2018;-27,39;20893,09;20865,70;11690;-27,39;20865,70;2018-12-22;22/12/2018;CAN;Gastos_Ocio y transporte;Gasolina;12;VARIABLES
26/12/2018;26/12/2018;T/EMBOTITS ARTES/SANT 23-12-2018;-39,85;20865,70;20825,85;11691;-39,85;20825,85;2018-12-23;23/12/2018;EMBOTITS;Gastos_Compras;Supermercado;12;VARIABLES
27/12/2018;27/12/2018;R/AJUNTAMENT D TAXA RESIDUS CA;-55,08;20825,85;20770,77;11692;-55,08;20770,77;2018-12-27;27/12/2018;AJUNTAMENT;Gastos_Banco y organismos;Ayuntamiento;12;FIJO
28/12/2018;28/12/2018;T/HOSTAL CASTELLTE/CASTELLCIR;-44,00;20770,77;20726,77;11693;-44,00;20726,77;2018-12-28;28/12/2018;HOSTAL;Gastos_Ocio y transporte;Restaurantes;12;VARIABLES
28/12/2018;24/12/2018;T/PAYPAL *CREEPYROOMS;-76,00;20726,77;20650,77;11694;-76,00;20650,77;2018-12-24;24/12/2018;PAYPAL;Gastos_Compras;Hobbys;12;VARIABLES
28/12/2018;25/12/2018;T/AUTOPISTAS TERR;-2,56;20650,77;20648,21;11695;-2,56;20648,21;2018-12-25;25/12/2018;AUTOPISTAS;Gastos_Ocio y transporte;Parking y peaje;12;VARIABLES
29/12/2018;29/12/2018;T/WWW.JUST-EAT.ES 26-12-2018;-39,15;20648,21;20609,06;11696;-39,15;20609,06;2018-12-26;26/12/2018;WWWJUSTEATES;Gastos_Ocio y transporte;Restaurantes;12;VARIABLES
30/12/2018;30/12/2018;T/REDPIZZA / 27-12-2018;-27,30;20609,06;20581,76;11697;-27,30;20581,76;2018-12-27;27/12/2018;REDPIZZA;Gastos_Ocio y transporte;Restaurantes;12;VARIABLES
30/12/2018;30/12/2018;T/BON AREA 27-12-2018;-26,29;20581,76;20555,47;11698;-26,29;20555,47;2018-12-27;27/12/2018;BON;Gastos_Compras;Supermercado;12;VARIABLES
30/12/2018;30/12/2018;T/STIKETS / 27-12-2018;-11,95;20555,47;20543,52;11699;-11,95;20543,52;2018-12-27;27/12/2018;STIKETS;Gastos_Compras;Ropa;12;VARIABLES
30/12/2018;30/12/2018;TRANSFBBVABCLM;1200,00;19290,72;20490,72;11709;1200,00;21743,52;2018-12-30;30/12/2018;TRANSFBBVABCLM;No computable;traspasos, transf.;12;
31/12/2018;31/12/2018;REC.6061.9600001223;-448,11;20543,52;20095,41;11700;-448,11;21295,41;2018-12-31;31/12/2018;REC;Gastos_Banco y organismos;Hipoteca;12;FIJO
31/12/2018;31/12/2018;T/SUPER CASTELL/CASTE 28-12-2018;-30,29;20095,41;20065,12;11701;-30,29;21265,12;2018-12-28;28/12/2018;SUPER;Gastos_Compras;Supermercado;12;VARIABLES
31/12/2018;31/12/2018;T/BAR 8668 /CASTE 28-12-2018;-8,70;20065,12;20056,42;11702;-8,70;21256,42;2018-12-28;28/12/2018;BAR;Gastos_Ocio y transporte;Restaurantes;12;VARIABLES
31/12/2018;31/12/2018;T/VIENA PARC VALLES / 28-12-2018;-24,85;20056,42;20031,57;11703;-24,85;21231,57;2018-12-28;28/12/2018;VIENA;Gastos_Ocio y transporte;Restaurantes;12;VARIABLES
31/12/2018;31/12/2018;T/REDONDEO S0LIDARI/B 28-12-2018;-1,15;20031,57;20030,42;11704;-1,15;21230,42;2018-12-28;28/12/2018;REDONDEO;Gastos_Salud, saber y deporte;Solidaridad;12;VARIABLES
31/12/2018;31/12/2018;T/CAPRABO - 427 TERR/ 28-12-2018;-29,58;20030,42;20000,84;11705;-29,58;21200,84;2018-12-28;28/12/2018;CAPRABO;Gastos_Compras;Supermercado;12;VARIABLES
01/01/2019;01/01/2019;FACT TARJETASTARJ.CREDITO 07126017 19-01-01;-474,26;20000,84;19526,58;11706;-474,26;20726,58;2019-01-01;31/12/2018;FACT 07126017;Gastos_Banco y organismos;Credito Bea;12;VARIABLE
01/01/2019;01/01/2019;FACT TARJETASTARJ.CREDITO 42689013 19-01-01;-201,64;19526,58;19324,94;11707;-201,64;20524,94;2019-01-01;31/12/2018;FACT;No computable;Recibo Tarjeta;12;
01/01/2019;30/12/2018;T/CARREFOUR TARRA;-34,22;19324,94;19290,72;11708;-34,22;20490,72;2018-12-30;30/12/2018;CARREFOUR;Gastos_Compras;Supermercado;12;VARIABLES
03/01/2019;01/01/2019;T/PLAYSTATIONNETWORK;-31,49;20490,72;20459,23;11710;-31,49;20459,23;2019-01-01;01/01/2019;PLAYSTATIONNETWORK;Gastos_Servicios tipicos;Servicios online;1;FIJO
03/01/2019;03/01/2019;T/AUTOPISTAS TERR 31-12-2018;-1,41;20459,23;20457,82;11711;-1,41;20457,82;2018-12-31;31/12/2018;AUTOPISTAS;Gastos_Ocio y transporte;Parking y peaje;12;VARIABLES
03/01/2019;03/01/2019;T/CATALUNYA CAIX/EL P 31-12-2018;-3,45;20457,82;20454,37;11712;-3,45;20454,37;2018-12-31;31/12/2018;CATALUNYA;Gastos_Ocio y transporte;Restaurantes;12;VARIABLES
04/01/2019;04/01/2019;R/SERHS FOOD A Comedor Enero/ 20;-107,10;20454,37;20347,27;11713;-107,10;20347,27;2019-01-04;04/01/2019;SERHS;Gastos_Salud, saber y deporte;Menjador;1;FIJO
04/01/2019;04/01/2019;R/SERHS FOOD A Comedor Enero/ 20;-31,50;20347,27;20315,77;11714;-31,50;20315,77;2019-01-04;04/01/2019;SERHS;Gastos_Salud, saber y deporte;Menjador;1;FIJO
04/01/2019;04/01/2019;T/WWW.JUST-EAT.ES 01-01-2019;-29,20;20315,77;20286,57;11715;-29,20;20286,57;2019-01-01;01/01/2019;WWWJUSTEATES;Gastos_Ocio y transporte;Restaurantes;1;VARIABLES
05/01/2019;05/01/2019;T/WWW.JUST-EAT.ES 02-01-2019;-24,08;20286,57;20262,49;11716;-24,08;20262,49;2019-01-02;02/01/2019;WWWJUSTEATES;Gastos_Ocio y transporte;Restaurantes;1;VARIABLES
05/01/2019;05/01/2019;T/POKE SI GLORIES /B 02-01-2019;-23,90;20262,49;20238,59;11717;-23,90;20238,59;2019-01-02;02/01/2019;POKE;Gastos_Ocio y transporte;Restaurantes;1;VARIABLES
05/01/2019;05/01/2019;T/AP. HOSPITAL SANT/B 02-01-2019;-3,85;20238,59;20234,74;11718;-3,85;20234,74;2019-01-02;02/01/2019;HOSPITAL;Gastos_Salud, saber y deporte;Medico;1;VARIABLES
06/01/2019;06/01/2019;T/AUTOPISTAS TERR 03-01-2019;-1,44;20234,74;20233,30;11719;-1,44;20233,30;2019-01-03;03/01/2019;AUTOPISTAS;Gastos_Ocio y transporte;Parking y peaje;1;VARIABLES
06/01/2019;06/01/2019;T/E.S. RUBI II 03-01-2019;-43,99;20233,30;20189,31;11720;-43,99;20189,31;2019-01-03;03/01/2019;RUBI;Gastos_Ocio y transporte;Gasolina;1;VARIABLES
06/01/2019;06/01/2019;T/CINESA WEB /B 03-01-2019;-18,00;20189,31;20171,31;11721;-18,00;20171,31;2019-01-03;03/01/2019;CINESA;Gastos_Ocio y transporte;Espectáculos;1;VARIABLES
06/01/2019;06/01/2019;T/QUINLAN DIAGONAL /B 03-01-2019;-3,50;20171,31;20167,81;11722;-3,50;20167,81;2019-01-03;03/01/2019;QUINLAN;Gastos_Ocio y transporte;Restaurantes;1;VARIABLES
06/01/2019;06/01/2019;T/ALCAMPO DIAGONAL /B 03-01-2019;-6,65;20167,81;20161,16;11723;-6,65;20161,16;2019-01-03;03/01/2019;ALCAMPO;Gastos_Compras;Supermercado;1;VARIABLES
07/01/2019;07/01/2019;T/BON AREA 04-01-2019;-27,52;20161,16;20133,64;11724;-27,52;20133,64;2019-01-04;04/01/2019;BON;Gastos_Compras;Supermercado;1;VARIABLES
07/01/2019;07/01/2019;T/TOYS R US IBER/SANT 04-01-2019;-10,00;20133,64;20123,64;11725;-10,00;20123,64;2019-01-04;04/01/2019;TOYS;Gastos_Compras;Niños;1;VARIABLES
07/01/2019;07/01/2019;T/CATALUNYA CAIX/EL P 04-01-2019;-0,35;20123,64;20123,29;11726;-0,35;20123,29;2019-01-04;04/01/2019;CATALUNYA;Gastos_Ocio y transporte;Restaurantes;1;VARIABLES
09/01/2019;09/01/2019;R/. FINQUES GASS Vto 01-01-19 Rec;-75,31;20123,29;20047,98;11727;-75,31;20047,98;2019-01-01;01/01/2019;FINQUES;Gastos_Vivienda y vehiculo;Alquiler Parking;1;FIJO
09/01/2019;09/01/2019;'R/L.EINA COOPERA L''EINA COOPE Reb';-35,60;20047,98;20012,38;11728;-35,60;20012,38;2019-01-09;09/01/2019;LEINA;Gastos_Salud, saber y deporte;Estudios;1;VARIABLES
09/01/2019;09/01/2019;T/FORN CARNE / 06-01-2019;-32,71;20012,38;19979,67;11729;-32,71;19979,67;2019-01-06;06/01/2019;FORN;Gastos_Compras;Supermercado;1;VARIABLES
09/01/2019;09/01/2019;T/WWW.JUST-EAT.ES 06-01-2019;-24,10;19979,67;19955,57;11730;-24,10;19955,57;2019-01-06;06/01/2019;WWWJUSTEATES;Gastos_Ocio y transporte;Restaurantes;1;VARIABLES
10/01/2019;10/01/2019;T/PC CAN DRAGO 0168/B 07-01-2019;-20,35;19955,57;19935,22;11731;-20,35;19935,22;2019-01-07;07/01/2019;CAN;Gastos_Ocio y transporte;Gasolina;1;VARIABLES
10/01/2019;10/01/2019;T/ZONA BLAVA ESTACI/B 07-01-2019;-1,46;19935,22;19933,76;11732;-1,46;19933,76;2019-01-07;07/01/2019;ZONA;Gastos_Ocio y transporte;Parking y peaje;1;VARIABLES
11/01/2019;11/01/2019;R/Ajuntament d Abonaments IMES g;-36,40;19933,76;19897,36;11733;-36,40;19897,36;2019-01-11;11/01/2019;AJUNTAMENT;Gastos_Banco y organismos;Ayuntamiento;1;FIJO
11/01/2019;11/01/2019;R/TELEFONO VODAFONE;-150,42;19897,36;19746,94;11734;-150,42;19746,94;2019-01-11;11/01/2019;TELEFONO;Gastos_Servicios tipicos;Telecomunicaciones;1;FIJO
11/01/2019;11/01/2019;T/TUNELS VALLVI S. 07-01-2019;-4,34;19746,94;19742,60;11735;-4,34;19742,60;2019-01-07;07/01/2019;TUNELS;Gastos_Ocio y transporte;Parking y peaje;1;VARIABLES
12/01/2019;10/01/2019;T/AMZN Mktp ES*MB0GJ91M4;-61,54;19742,60;19681,06;11736;-61,54;19681,06;2019-01-10;10/01/2019;AMZN;Gastos_Compras;Hobbys;1;VARIABLES
12/01/2019;12/01/2019;T/AUTOPISTAS TERR 09-01-2019;-1,44;19681,06;19679,62;11737;-1,44;19679,62;2019-01-09;09/01/2019;AUTOPISTAS;Gastos_Ocio y transporte;Parking y peaje;1;VARIABLES
12/01/2019;12/01/2019;T/AUTOPISTAS TERR 09-01-2019;-1,44;19679,62;19678,18;11738;-1,44;19678,18;2019-01-09;09/01/2019;AUTOPISTAS;Gastos_Ocio y transporte;Parking y peaje;1;VARIABLES
12/01/2019;12/01/2019;T/AUTOPISTAS TERR 08-01-2019;-1,44;19678,18;19676,74;11739;-1,44;19676,74;2019-01-08;08/01/2019;AUTOPISTAS;Gastos_Ocio y transporte;Parking y peaje;1;VARIABLES
12/01/2019;12/01/2019;T/AUTOPISTAS TERR 07-01-2019;-1,44;19676,74;19675,30;11740;-1,44;19675,30;2019-01-07;07/01/2019;AUTOPISTAS;Gastos_Ocio y transporte;Parking y peaje;1;VARIABLES
12/01/2019;12/01/2019;T/AUTOPISTAS TERR 07-01-2019;-1,44;19675,30;19673,86;11741;-1,44;19673,86;2019-01-07;07/01/2019;AUTOPISTAS;Gastos_Ocio y transporte;Parking y peaje;1;VARIABLES
13/01/2019;13/01/2019;T/AUTOPISTAS TERR 10-01-2019;-1,44;19673,86;19672,42;11742;-1,44;19672,42;2019-01-10;10/01/2019;AUTOPISTAS;Gastos_Ocio y transporte;Parking y peaje;1;VARIABLES
13/01/2019;13/01/2019;T/AUTOPISTAS TERR 10-01-2019;-1,44;19672,42;19670,98;11743;-1,44;19670,98;2019-01-10;10/01/2019;AUTOPISTAS;Gastos_Ocio y transporte;Parking y peaje;1;VARIABLES
13/01/2019;13/01/2019;T/LIDL TERRASSA-LES / 10-01-2019;-39,44;19670,98;19631,54;11744;-39,44;19631,54;2019-01-10;10/01/2019;LIDL;Gastos_Compras;Supermercado;1;VARIABLES
14/01/2019;14/01/2019;'R/L.EINA COOPERA L''EINA COOPE Reb';-10,00;19631,54;19621,54;11745;-10,00;19621,54;2019-01-14;14/01/2019;LEINA;Gastos_Salud, saber y deporte;Estudios;1;VARIABLES
14/01/2019;14/01/2019;R/NATURGY IBER NATURGY2763048011;-4,69;19621,54;19616,85;11746;-4,69;19616,85;2019-01-14;14/01/2019;NATURGY;Gastos_Servicios tipicos;Gas;1;FIJO
15/01/2019;12/01/2019;T/AMZN Mktp ES*MB0P68GH4;-30,99;19616,85;19585,86;11747;-30,99;19585,86;2019-01-12;12/01/2019;AMZN;Gastos_Compras;Hobbys;1;VARIABLES
15/01/2019;12/01/2019;T/AMZN Mktp ES*MB2PX7GR4;-37,99;19585,86;19547,87;11748;-37,99;19547,87;2019-01-12;12/01/2019;AMZN;Gastos_Compras;Hobbys;1;VARIABLES
16/01/2019;16/01/2019;R/SEGUROS CCM VIDA Y P Recibo:154;-18,77;19547,87;19529,10;11749;-18,77;19529,10;2019-01-16;16/01/2019;CCM;Gastos_Seguros;Seguro vida;1;FIJO
16/01/2019;16/01/2019;R/SEGUROS CCM VIDA Y P Recibo:154;-16,12;19529,10;19512,98;11750;-16,12;19512,98;2019-01-16;16/01/2019;CCM;Gastos_Seguros;Seguro vida;1;FIJO
16/01/2019;16/01/2019;T/VIENA PARC VALLES / 13-01-2019;-14,10;19512,98;19498,88;11751;-14,10;19498,88;2019-01-13;13/01/2019;VIENA;Gastos_Ocio y transporte;Restaurantes;1;VARIABLES
16/01/2019;16/01/2019;T/REDONDEO S0LIDARI/B 13-01-2019;-0,40;19498,88;19498,48;11752;-0,40;19498,48;2019-01-13;13/01/2019;REDONDEO;Gastos_Salud, saber y deporte;Solidaridad;1;VARIABLES
16/01/2019;16/01/2019;T/WWW.JUST-EAT.ES 13-01-2019;-32,90;19498,48;19465,58;11753;-32,90;19465,58;2019-01-13;13/01/2019;WWWJUSTEATES;Gastos_Ocio y transporte;Restaurantes;1;VARIABLES
17/01/2019;17/01/2019;R/LUZ ENDESA ENERG FACTURA DE ELE;-127,68;19465,58;19337,90;11754;-127,68;19337,90;2019-01-17;17/01/2019;ELE;Gastos_Servicios tipicos;Electricidad;1;FIJO
17/01/2019;14/01/2019;T/PERLES AND CO;-50,14;19337,90;19287,76;11755;-50,14;19287,76;2019-01-14;14/01/2019;PERLES;Gastos_Compras;Hobbys;1;VARIABLES
17/01/2019;17/01/2019;T/AUTOPISTAS TERR 14-01-2019;-1,44;19287,76;19286,32;11756;-1,44;19286,32;2019-01-14;14/01/2019;AUTOPISTAS;Gastos_Ocio y transporte;Parking y peaje;1;VARIABLES
17/01/2019;17/01/2019;T/AUTOPISTAS TERR 11-01-2019;-1,44;19286,32;19284,88;11757;-1,44;19284,88;2019-01-11;11/01/2019;AUTOPISTAS;Gastos_Ocio y transporte;Parking y peaje;1;VARIABLES
17/01/2019;17/01/2019;T/AUTOPISTAS TERR 11-01-2019;-1,44;19284,88;19283,44;11758;-1,44;19283,44;2019-01-11;11/01/2019;AUTOPISTAS;Gastos_Ocio y transporte;Parking y peaje;1;VARIABLES
18/01/2019;16/01/2019;T/pandahall;-62,93;19283,44;19220,51;11759;-62,93;19220,51;2019-01-16;16/01/2019;PANDAHALL;Gastos_Compras;Hobbys;1;VARIABLES
18/01/2019;18/01/2019;T/AUTOPISTAS TERR 15-01-2019;-1,44;19220,51;19219,07;11760;-1,44;19219,07;2019-01-15;15/01/2019;AUTOPISTAS;Gastos_Ocio y transporte;Parking y peaje;1;VARIABLES
19/01/2019;19/01/2019;T/LIDL TERRASSA-LES /TERRASSA;-86,41;19219,07;19132,66;11761;-86,41;19132,66;2019-01-19;19/01/2019;LIDL;Gastos_Compras;Supermercado;1;VARIABLES
19/01/2019;19/01/2019;T/WWW.JUST-EAT.ES 16-01-2019;-24,00;19132,66;19108,66;11762;-24,00;19108,66;2019-01-16;16/01/2019;WWWJUSTEATES;Gastos_Ocio y transporte;Restaurantes;1;VARIABLES
19/01/2019;19/01/2019;T/AUTOPISTAS TERR 16-01-2019;-1,44;19108,66;19107,22;11763;-1,44;19107,22;2019-01-16;16/01/2019;AUTOPISTAS;Gastos_Ocio y transporte;Parking y peaje;1;VARIABLES
20/01/2019;20/01/2019;T/AUTOPISTAS TERR 17-01-2019;-1,44;19107,22;19105,78;11764;-1,44;19105,78;2019-01-17;17/01/2019;AUTOPISTAS;Gastos_Ocio y transporte;Parking y peaje;1;VARIABLES
20/01/2019;20/01/2019;T/AUTOPISTAS TERR 17-01-2019;-1,44;19105,78;19104,34;11765;-1,44;19104,34;2019-01-17;17/01/2019;AUTOPISTAS;Gastos_Ocio y transporte;Parking y peaje;1;VARIABLES
20/01/2019;20/01/2019;T/RODELAS CAN PALET / 17-01-2019;-20,00;19104,34;19084,34;11766;-20,00;19084,34;2019-01-17;17/01/2019;RODELAS;Gastos_Salud, saber y deporte;Belleza;1;VARIABLES
20/01/2019;20/01/2019;T/CATALUNYA CAIX/EL P 17-01-2019;-1,00;19084,34;19083,34;11767;-1,00;19083,34;2019-01-17;17/01/2019;CATALUNYA;Gastos_Ocio y transporte;Restaurantes;1;VARIABLES
21/01/2019;21/01/2019;T/CATALUNYA CAIX/EL P 18-01-2019;-3,30;19083,34;19080,04;11768;-3,30;19080,04;2019-01-18;18/01/2019;CATALUNYA;Gastos_Ocio y transporte;Restaurantes;1;VARIABLES
21/01/2019;21/01/2019;T/CATALUNYA CAIX/EL P 18-01-2019;-8,60;19080,04;19071,44;11769;-8,60;19071,44;2019-01-18;18/01/2019;CATALUNYA;Gastos_Ocio y transporte;Restaurantes;1;VARIABLES
21/01/2019;21/01/2019;T/WWW.JUST-EAT.ES 18-01-2019;-32,90;19071,44;19038,54;11770;-32,90;19038,54;2019-01-18;18/01/2019;WWWJUSTEATES;Gastos_Ocio y transporte;Restaurantes;1;VARIABLES
22/01/2019;22/01/2019;T/WWW.JUST-EAT.ES 19-01-2019;-21,95;19038,54;19016,59;11771;-21,95;19016,59;2019-01-19;19/01/2019;WWWJUSTEATES;Gastos_Ocio y transporte;Restaurantes;1;VARIABLES
22/01/2019;22/01/2019;T/FET CALENT ESPIRIT/ 19-01-2019;-22,85;19016,59;18993,74;11772;-22,85;18993,74;2019-01-19;19/01/2019;FET;Gastos_Ocio y transporte;Restaurantes;1;VARIABLES
22/01/2019;22/01/2019;T/TARRASSA CARNES IND 19-01-2019;-78,50;18993,74;18915,24;11773;-78,50;18915,24;2019-01-19;19/01/2019;TARRASSA;Gastos_Compras;Supermercado;1;VARIABLES
22/01/2019;22/01/2019;T/AUTOPISTAS TERR 18-01-2019;-1,44;18915,24;18913,80;11774;-1,44;18913,80;2019-01-18;18/01/2019;AUTOPISTAS;Gastos_Ocio y transporte;Parking y peaje;1;VARIABLES
22/01/2019;22/01/2019;T/AUTOPISTAS TERR 18-01-2019;-1,44;18913,80;18912,36;11775;-1,44;18912,36;2019-01-18;18/01/2019;AUTOPISTAS;Gastos_Ocio y transporte;Parking y peaje;1;VARIABLES
23/01/2019;23/01/2019;T/CATALANA DIAG.I CIR 16-01-2019;-4,15;18912,36;18908,21;11776;-4,15;18908,21;2019-01-16;16/01/2019;CATALANA;Gastos_Ocio y transporte;Parking y peaje;1;VARIABLES
24/01/2019;24/01/2019;T/AUTOPISTAS TERR 21-01-2019;-1,44;18908,21;18906,77;11777;-1,44;18906,77;2019-01-21;21/01/2019;AUTOPISTAS;Gastos_Ocio y transporte;Parking y peaje;1;VARIABLES
24/01/2019;24/01/2019;T/AUTOPISTAS TERR 21-01-2019;-1,44;18906,77;18905,33;11778;-1,44;18905,33;2019-01-21;21/01/2019;AUTOPISTAS;Gastos_Ocio y transporte;Parking y peaje;1;VARIABLES
24/01/2019;24/01/2019;T/CATALUNYA CAIX/EL P 21-01-2019;-2,50;18905,33;18902,83;11779;-2,50;18902,83;2019-01-21;21/01/2019;CATALUNYA;Gastos_Ocio y transporte;Restaurantes;1;VARIABLES
25/01/2019;25/01/2019;T/AUTOPISTAS TERR 22-01-2019;-1,44;18902,83;18901,39;11780;-1,44;18901,39;2019-01-22;22/01/2019;AUTOPISTAS;Gastos_Ocio y transporte;Parking y peaje;1;VARIABLES
25/01/2019;25/01/2019;T/AUTOPISTAS TERR 22-01-2019;-1,44;18901,39;18899,95;11781;-1,44;18899,95;2019-01-22;22/01/2019;AUTOPISTAS;Gastos_Ocio y transporte;Parking y peaje;1;VARIABLES
25/01/2019;25/01/2019;T/CATALUNYA CAIX/EL P 22-01-2019;-2,60;18899,95;18897,35;11782;-2,60;18897,35;2019-01-22;22/01/2019;CATALUNYA;Gastos_Ocio y transporte;Restaurantes;1;VARIABLES
26/01/2019;26/01/2019;T/PARKING VAPOR GRAN/ 23-01-2019;-3,00;18897,35;18894,35;11783;-3,00;18894,35;2019-01-23;23/01/2019;PARKING;Gastos_Ocio y transporte;Parking y peaje;1;VARIABLES
26/01/2019;26/01/2019;T/LIFE-FULNES ACADE/B 23-01-2019;-6,50;18894,35;18887,85;11784;-6,50;18887,85;2019-01-23;23/01/2019;LIFEFULNES;Gastos_Ocio y transporte;Restaurantes;1;VARIABLES
26/01/2019;26/01/2019;T/CATALUNYA CAIX/EL P 23-01-2019;-3,50;18887,85;18884,35;11785;-3,50;18884,35;2019-01-23;23/01/2019;CATALUNYA;Gastos_Ocio y transporte;Restaurantes;1;VARIABLES
27/01/2019;27/01/2019;T/AUTOPISTAS TERR 24-01-2019;-1,44;18884,35;18882,91;11786;-1,44;18882,91;2019-01-24;24/01/2019;AUTOPISTAS;Gastos_Ocio y transporte;Parking y peaje;1;VARIABLES
27/01/2019;27/01/2019;T/AUTOPISTAS TERR 24-01-2019;-1,44;18882,91;18881,47;11787;-1,44;18881,47;2019-01-24;24/01/2019;AUTOPISTAS;Gastos_Ocio y transporte;Parking y peaje;1;VARIABLES
27/01/2019;27/01/2019;T/CATALUNYA CAIX/EL P 24-01-2019;-3,00;18881,47;18878,47;11788;-3,00;18878,47;2019-01-24;24/01/2019;CATALUNYA;Gastos_Ocio y transporte;Restaurantes;1;VARIABLES
27/01/2019;27/01/2019;T/WWW.JUST-EAT.ES 24-01-2019;-24,95;18878,47;18853,52;11789;-24,95;18853,52;2019-01-24;24/01/2019;WWWJUSTEATES;Gastos_Ocio y transporte;Restaurantes;1;VARIABLES
27/01/2019;27/01/2019;T/AUTOPISTAS TERR 23-01-2019;-1,44;18853,52;18852,08;11790;-1,44;18852,08;2019-01-23;23/01/2019;AUTOPISTAS;Gastos_Ocio y transporte;Parking y peaje;1;VARIABLES
27/01/2019;27/01/2019;T/AUTOPISTAS TERR 23-01-2019;-1,44;18852,08;18850,64;11791;-1,44;18850,64;2019-01-23;23/01/2019;AUTOPISTAS;Gastos_Ocio y transporte;Parking y peaje;1;VARIABLES
28/01/2019;28/01/2019;HAB.AJUNTAMENT DE TERRASSA Transfe;1883,16;18850,64;20733,80;11792;1883,16;20733,80;2019-01-28;28/01/2019;HABAJUNTAMENT;Ingresos;Nomina;1;FIJO
28/01/2019;28/01/2019;T/WWW.JUST-EAT.ES 25-01-2019;-31,10;20733,80;20702,70;11793;-31,10;20702,70;2019-01-25;25/01/2019;WWWJUSTEATES;Gastos_Ocio y transporte;Restaurantes;1;VARIABLES
29/01/2019;29/01/2019;T/AUTOPISTAS TERRASSA 25-01-2019;-1,44;20702,70;20701,26;11794;-1,44;20701,26;2019-01-25;25/01/2019;AUTOPISTAS;Gastos_Ocio y transporte;Parking y peaje;1;VARIABLES
30/01/2019;30/01/2019;TRANSFBBVABCLM;1200,00;20701,26;21901,26;11795;1200,00;21901,26;2019-01-30;30/01/2019;TRANSFBBVABCLM;No computable;traspasos, transf.;1;
31/01/2019;31/01/2019;REC.6061.9600001223;-448,11;21901,26;21453,15;11796;-448,11;21453,15;2019-01-31;31/01/2019;REC;Gastos_Banco y organismos;Hipoteca;1;FIJO
31/01/2019;31/01/2019;T/AUTOPISTAS TERRASSA 28-01-2019;-1,44;21453,15;21451,71;11797;-1,44;21451,71;2019-01-28;28/01/2019;AUTOPISTAS;Gastos_Ocio y transporte;Parking y peaje;1;VARIABLES
31/01/2019;31/01/2019;T/E.S. RUBI II 28-01-2019;-46,97;21451,71;21404,74;11798;-46,97;21404,74;2019-01-28;28/01/2019;RUBI;Gastos_Ocio y transporte;Gasolina;1;VARIABLES
01/02/2019;01/02/2019;'R/AJUNTAMENT D I.B.I. CA D''ALBI';-48,62;21404,74;21356,12;11799;-48,62;21356,12;2019-02-01;01/02/2019;AJUNTAMENT;Gastos_Banco y organismos;Ayuntamiento;2;FIJO
01/02/2019;01/02/2019;FACT TARJETASTARJ.CREDITO 07126017 19-02-01;-527,88;21356,12;20828,24;11800;-527,88;20828,24;2019-02-01;31/01/2019;FACT 07126017;Gastos_Banco y organismos;Credito Bea;1;VARIABLE
01/02/2019;01/02/2019;FACT TARJETASTARJ.CREDITO 42689013 19-02-01;-122,82;20828,24;20705,42;11801;-122,82;20705,42;2019-02-01;31/01/2019;FACT;No computable;Recibo Tarjeta;1;
02/02/2019;31/01/2019;T/AMZN Mktp ES*MI10U04P4;-17,98;20705,42;20687,44;11802;-17,98;20687,44;2019-01-31;31/01/2019;AMZN;Gastos_Compras;Hobbys;1;VARIABLES
02/02/2019;02/02/2019;T/WWW.JUST-EAT.ES 30-01-2019;-23,70;20687,44;20663,74;11803;-23,70;20663,74;2019-01-30;30/01/2019;WWWJUSTEATES;Gastos_Ocio y transporte;Restaurantes;1;VARIABLES
03/02/2019;03/02/2019;T/AUTOPISTAS TERRASSA 31-01-2019;-1,44;20663,74;20662,30;11804;-1,44;20662,30;2019-01-31;31/01/2019;AUTOPISTAS;Gastos_Ocio y transporte;Parking y peaje;1;VARIABLES
03/02/2019;03/02/2019;T/WWW.JUST-EAT.ES 31-01-2019;-30,60;20662,30;20631,70;11805;-30,60;20631,70;2019-01-31;31/01/2019;WWWJUSTEATES;Gastos_Ocio y transporte;Restaurantes;1;VARIABLES
04/02/2019;04/02/2019;'R/L.EINA COOPERA L''EINA COOPE Reb';-35,60;20631,70;20596,10;11806;-35,60;20596,10;2019-02-04;04/02/2019;LEINA;Gastos_Salud, saber y deporte;Estudios;2;VARIABLES
04/02/2019;04/02/2019;T/CATALUNYA CAIX/EL P 01-02-2019;-4,00;20596,10;20592,10;11807;-4,00;20592,10;2019-02-01;01/02/2019;CATALUNYA;Gastos_Ocio y transporte;Restaurantes;2;VARIABLES
05/02/2019;05/02/2019;R/LUZ ENDESA ENERG FACTURA DE GAS;-405,97;20592,10;20186,13;11808;-405,97;20186,13;2019-02-05;05/02/2019;GAS;Gastos_Servicios tipicos;Gas;2;FIJO
05/02/2019;05/02/2019;T/WWW.JUST-EAT.ES 02-02-2019;-23,95;20186,13;20162,18;11809;-23,95;20162,18;2019-02-02;02/02/2019;WWWJUSTEATES;Gastos_Ocio y transporte;Restaurantes;2;VARIABLES
06/02/2019;06/02/2019;CAJ. AJENOB.B.V.A. /PRAT DE LLOBR;-300,00;20162,18;19862,18;11810;-300,00;19862,18;2019-02-06;06/02/2019;CAJ;Gastos_Gastos varios;Efectivo;2;VARIABLES
06/02/2019;06/02/2019;COM.64970036 SVRED CAJ OFI;-1,87;19862,18;19860,31;11811;-1,87;19860,31;2019-02-06;06/02/2019;COM;Gastos_Banco y organismos;Cargos banco;2;FIJO
06/02/2019;06/02/2019;T/AUTOPISTAS TERRASSA 03-02-2019;-2,62;19860,31;19857,69;11812;-2,62;19857,69;2019-02-03;03/02/2019;AUTOPISTAS;Gastos_Ocio y transporte;Parking y peaje;2;VARIABLES
07/02/2019;07/02/2019;R/SERHS FOOD A Comedor Febrero/;-119,00;19857,69;19738,69;11813;-119,00;19738,69;2019-02-07;07/02/2019;SERHS;Gastos_Salud, saber y deporte;Menjador;2;FIJO
07/02/2019;07/02/2019;R/SERHS FOOD A Comedor Febrero/;-35,00;19738,69;19703,69;11814;-35,00;19703,69;2019-02-07;07/02/2019;SERHS;Gastos_Salud, saber y deporte;Menjador;2;FIJO
07/02/2019;07/02/2019;T/APTIMA / 04-02-2019;-30,00;19703,69;19673,69;11815;-30,00;19673,69;2019-02-04;04/02/2019;APTIMA;Gastos_Salud, saber y deporte;Medico;2;VARIABLES
07/02/2019;07/02/2019;T/AUTOPISTAS TERRASSA 04-02-2019;-1,44;19673,69;19672,25;11816;-1,44;19672,25;2019-02-04;04/02/2019;AUTOPISTAS;Gastos_Ocio y transporte;Parking y peaje;2;VARIABLES
07/02/2019;07/02/2019;T/AUTOPISTAS TERRASSA 04-02-2019;-1,44;19672,25;19670,81;11817;-1,44;19670,81;2019-02-04;04/02/2019;AUTOPISTAS;Gastos_Ocio y transporte;Parking y peaje;2;VARIABLES
08/02/2019;08/02/2019;R/. FINQUES GASS Vto 01-02-19 Rec;-75,31;19670,81;19595,50;11818;-75,31;19595,50;2019-02-01;01/02/2019;FINQUES;Gastos_Vivienda y vehiculo;Alquiler Parking;2;FIJO
08/02/2019;08/02/2019;T/AUTOPISTAS TERRASSA 05-02-2019;-1,44;19595,50;19594,06;11819;-1,44;19594,06;2019-02-05;05/02/2019;AUTOPISTAS;Gastos_Ocio y transporte;Parking y peaje;2;VARIABLES
08/02/2019;08/02/2019;T/AUTOPISTAS TERRASSA 05-02-2019;-1,44;19594,06;19592,62;11820;-1,44;19592,62;2019-02-05;05/02/2019;AUTOPISTAS;Gastos_Ocio y transporte;Parking y peaje;2;VARIABLES
08/02/2019;08/02/2019;T/BON AREA 05-02-2019;-17,72;19592,62;19574,90;11821;-17,72;19574,90;2019-02-05;05/02/2019;BON;Gastos_Compras;Supermercado;2;VARIABLES
08/02/2019;08/02/2019;T/WWW.JUST-EAT.ES 05-02-2019;-26,40;19574,90;19548,50;11822;-26,40;19548,50;2019-02-05;05/02/2019;WWWJUSTEATES;Gastos_Ocio y transporte;Restaurantes;2;VARIABLES
08/02/2019;08/02/2019;T/AP. DR. ROBERT - TE 04-02-2019;-2,90;19548,50;19545,60;11823;-2,90;19545,60;2019-02-04;04/02/2019;ROBERT;Gastos_Ocio y transporte;Parking y peaje;2;VARIABLES
09/02/2019;09/02/2019;T/AUTOPISTAS TERRASSA 06-02-2019;-1,44;19545,60;19544,16;11824;-1,44;19544,16;2019-02-06;06/02/2019;AUTOPISTAS;Gastos_Ocio y transporte;Parking y peaje;2;VARIABLES
09/02/2019;09/02/2019;T/AUTOPISTAS TERRASSA 06-02-2019;-1,44;19544,16;19542,72;11825;-1,44;19542,72;2019-02-06;06/02/2019;AUTOPISTAS;Gastos_Ocio y transporte;Parking y peaje;2;VARIABLES
10/02/2019;10/02/2019;T/AUTOPISTAS TERRASSA 07-02-2019;-1,44;19542,72;19541,28;11826;-1,44;19541,28;2019-02-07;07/02/2019;AUTOPISTAS;Gastos_Ocio y transporte;Parking y peaje;2;VARIABLES
10/02/2019;10/02/2019;T/AUTOPISTAS TERRASSA 07-02-2019;-1,44;19541,28;19539,84;11827;-1,44;19539,84;2019-02-07;07/02/2019;AUTOPISTAS;Gastos_Ocio y transporte;Parking y peaje;2;VARIABLES
11/02/2019;11/02/2019;T/WWW.JUST-EAT.ES 08-02-2019;-32,60;19539,84;19507,24;11828;-32,60;19507,24;2019-02-08;08/02/2019;WWWJUSTEATES;Gastos_Ocio y transporte;Restaurantes;2;VARIABLES
11/02/2019;11/02/2019;T/CATALUNYA CAIX/EL P 08-02-2019;-2,50;19507,24;19504,74;11829;-2,50;19504,74;2019-02-08;08/02/2019;CATALUNYA;Gastos_Ocio y transporte;Restaurantes;2;VARIABLES
12/02/2019;12/02/2019;T/WWW.JUST-EAT.ES 09-02-2019;-29,90;19504,74;19474,84;11830;-29,90;19474,84;2019-02-09;09/02/2019;WWWJUSTEATES;Gastos_Ocio y transporte;Restaurantes;2;VARIABLES
13/02/2019;13/02/2019;R/TELEFONO VODAFONE;-150,42;19474,84;19324,42;11831;-150,42;19324,42;2019-02-13;13/02/2019;TELEFONO;Gastos_Servicios tipicos;Telecomunicaciones;2;FIJO
13/02/2019;09/02/2019;T/PERLES AND CO;-57,67;19324,42;19266,75;11832;-57,67;19266,75;2019-02-09;09/02/2019;PERLES;Gastos_Compras;Hobbys;2;VARIABLES
13/02/2019;13/02/2019;T/WWW.JUST-EAT.ES 10-02-2019;-37,60;19266,75;19229,15;11833;-37,60;19229,15;2019-02-10;10/02/2019;WWWJUSTEATES;Gastos_Ocio y transporte;Restaurantes;2;VARIABLES
13/02/2019;13/02/2019;T/AUTOPISTAS TERRASSA 08-02-2019;-1,44;19229,15;19227,71;11834;-1,44;19227,71;2019-02-08;08/02/2019;AUTOPISTAS;Gastos_Ocio y transporte;Parking y peaje;2;VARIABLES
14/02/2019;14/02/2019;R/NATURGY IBER NATURGY2763048021;-4,69;19227,71;19223,02;11835;-4,69;19223,02;2019-02-14;14/02/2019;NATURGY;Gastos_Servicios tipicos;Gas;2;FIJO
16/02/2019;16/02/2019;T/AUTOPISTAS TERRASSA 13-02-2019;-1,44;19223,02;19221,58;11836;-1,44;19221,58;2019-02-13;13/02/2019;AUTOPISTAS;Gastos_Ocio y transporte;Parking y peaje;2;VARIABLES
16/02/2019;16/02/2019;T/AUTOPISTAS TERRASSA 13-02-2019;-1,44;19221,58;19220,14;11837;-1,44;19220,14;2019-02-13;13/02/2019;AUTOPISTAS;Gastos_Ocio y transporte;Parking y peaje;2;VARIABLES
17/02/2019;17/02/2019;T/CINESA WEB /BARCELONA;-37,60;19220,14;19182,54;11838;-37,60;19182,54;2019-02-17;17/02/2019;CINESA;Gastos_Ocio y transporte;Espectáculos;2;VARIABLES
17/02/2019;17/02/2019;T/CINESA PARC VALLES/TERRASSA;-17,60;19182,54;19164,94;11839;-17,60;19164,94;2019-02-17;17/02/2019;CINESA;Gastos_Ocio y transporte;Espectáculos;2;VARIABLES
17/02/2019;17/02/2019;T/WWW.JUST-EAT.ES 14-02-2019;-25,20;19164,94;19139,74;11840;-25,20;19139,74;2019-02-14;14/02/2019;WWWJUSTEATES;Gastos_Ocio y transporte;Restaurantes;2;VARIABLES
18/02/2019;18/02/2019;R/SEGUROS CCM VIDA Y P Recibo:154;-18,69;19139,74;19121,05;11841;-18,69;19121,05;2019-02-18;18/02/2019;CCM;Gastos_Seguros;Seguro vida;2;FIJO
18/02/2019;18/02/2019;R/SEGUROS CCM VIDA Y P Recibo:154;-16,06;19121,05;19104,99;11842;-16,06;19104,99;2019-02-18;18/02/2019;CCM;Gastos_Seguros;Seguro vida;2;FIJO
18/02/2019;18/02/2019;T/WWW.JUST-EAT.ES 15-02-2019;-29,70;19104,99;19075,29;11843;-29,70;19075,29;2019-02-15;15/02/2019;WWWJUSTEATES;Gastos_Ocio y transporte;Restaurantes;2;VARIABLES
19/02/2019;19/02/2019;T/VIENA PARC VALLES / 16-02-2019;-3,30;19075,29;19071,99;11844;-3,30;19071,99;2019-02-16;16/02/2019;VIENA;Gastos_Ocio y transporte;Restaurantes;2;VARIABLES
19/02/2019;19/02/2019;T/REDONDEO S0LIDARI/B 16-02-2019;-0,20;19071,99;19071,79;11845;-0,20;19071,79;2019-02-16;16/02/2019;REDONDEO;Gastos_Salud, saber y deporte;Solidaridad;2;VARIABLES
19/02/2019;19/02/2019;T/MERKAL BARICEN/BARB 16-02-2019;-115,94;19071,79;18955,85;11846;-115,94;18955,85;2019-02-16;16/02/2019;MERKAL;Gastos_Compras;Ropa;2;VARIABLES
19/02/2019;19/02/2019;T/FET CALENT ESPIRIT/ 16-02-2019;-21,00;18955,85;18934,85;11847;-21,00;18934,85;2019-02-16;16/02/2019;FET;Gastos_Ocio y transporte;Restaurantes;2;VARIABLES
20/02/2019;20/02/2019;T/AUTOPISTAS TERRASSA 15-02-2019;-1,44;18934,85;18933,41;11848;-1,44;18933,41;2019-02-15;15/02/2019;AUTOPISTAS;Gastos_Ocio y transporte;Parking y peaje;2;VARIABLES
20/02/2019;20/02/2019;T/AUTOPISTAS TERRASSA 15-02-2019;-1,44;18933,41;18931,97;11849;-1,44;18931,97;2019-02-15;15/02/2019;AUTOPISTAS;Gastos_Ocio y transporte;Parking y peaje;2;VARIABLES
21/02/2019;21/02/2019;T/CATALUNYA CAIX/EL P 18-02-2019;-3,75;18931,97;18928,22;11850;-3,75;18928,22;2019-02-18;18/02/2019;CATALUNYA;Gastos_Ocio y transporte;Restaurantes;2;VARIABLES
22/02/2019;22/02/2019;T/AUTOPISTAS TERRASSA 18-02-2019;-1,44;18928,22;18926,78;11851;-1,44;18926,78;2019-02-18;18/02/2019;AUTOPISTAS;Gastos_Ocio y transporte;Parking y peaje;2;VARIABLES
22/02/2019;22/02/2019;T/AUTOPISTAS TERRASSA 18-02-2019;-1,44;18926,78;18925,34;11852;-1,44;18925,34;2019-02-18;18/02/2019;AUTOPISTAS;Gastos_Ocio y transporte;Parking y peaje;2;VARIABLES
22/02/2019;22/02/2019;T/TUNELS VALLVI S. 18-02-2019;-3,86;18925,34;18921,48;11853;-3,86;18921,48;2019-02-18;18/02/2019;TUNELS;Gastos_Ocio y transporte;Parking y peaje;2;VARIABLES
23/02/2019;23/02/2019;T/CATALUNYA CAIX/EL P 20-02-2019;-2,50;18921,48;18918,98;11854;-2,50;18918,98;2019-02-20;20/02/2019;CATALUNYA;Gastos_Ocio y transporte;Restaurantes;2;VARIABLES
23/02/2019;23/02/2019;T/AUTOPISTAS TERRASSA 20-02-2019;-1,44;18918,98;18917,54;11855;-1,44;18917,54;2019-02-20;20/02/2019;AUTOPISTAS;Gastos_Ocio y transporte;Parking y peaje;2;VARIABLES
24/02/2019;24/02/2019;T/WWW.JUST-EAT.ES 21-02-2019;-25,80;18917,54;18891,74;11856;-25,80;18891,74;2019-02-21;21/02/2019;WWWJUSTEATES;Gastos_Ocio y transporte;Restaurantes;2;VARIABLES
25/02/2019;25/02/2019;T/BON AREA 22-02-2019;-22,34;18891,74;18869,40;11857;-22,34;18869,40;2019-02-22;22/02/2019;BON;Gastos_Compras;Supermercado;2;VARIABLES
25/02/2019;25/02/2019;T/CATALUNYA CAIX/EL P 22-02-2019;-2,50;18869,40;18866,90;11858;-2,50;18866,90;2019-02-22;22/02/2019;CATALUNYA;Gastos_Ocio y transporte;Restaurantes;2;VARIABLES
26/02/2019;26/02/2019;HAB.AJUNTAMENT DE TERRASSA Transfe;1910,38;18866,90;20777,28;11859;1910,38;20777,28;2019-02-26;26/02/2019;HABAJUNTAMENT;Ingresos;Nomina;2;FIJO
26/02/2019;23/02/2019;T/CARREFOUR VALLE;-19,50;20777,28;20757,78;11860;-19,50;20757,78;2019-02-23;23/02/2019;CARREFOUR;Gastos_Compras;Supermercado;2;VARIABLES
26/02/2019;26/02/2019;T/AUTOPISTAS TERRASSA 22-02-2019;-1,44;20757,78;20756,34;11861;-1,44;20756,34;2019-02-22;22/02/2019;AUTOPISTAS;Gastos_Ocio y transporte;Parking y peaje;2;VARIABLES
26/02/2019;26/02/2019;T/AUTOPISTAS TERRASSA 22-02-2019;-1,44;20756,34;20754,90;11862;-1,44;20754,90;2019-02-22;22/02/2019;AUTOPISTAS;Gastos_Ocio y transporte;Parking y peaje;2;VARIABLES
28/02/2019;28/02/2019;REC.6061.9600001223;-448,11;20754,90;20306,79;11863;-448,11;20306,79;2019-02-28;28/02/2019;REC;Gastos_Banco y organismos;Hipoteca;2;FIJO
28/02/2019;28/02/2019;T/AUTOPISTAS TERRASSA 25-02-2019;-1,44;20306,79;20305,35;11864;-1,44;20305,35;2019-02-25;25/02/2019;AUTOPISTAS;Gastos_Ocio y transporte;Parking y peaje;2;VARIABLES
28/02/2019;28/02/2019;T/AUTOPISTAS TERRASSA 25-02-2019;-1,44;20305,35;20303,91;11865;-1,44;20303,91;2019-02-25;25/02/2019;AUTOPISTAS;Gastos_Ocio y transporte;Parking y peaje;2;VARIABLES
28/02/2019;28/02/2019;T/BON AREA 25-02-2019;-34,37;20303,91;20269,54;11866;-34,37;20269,54;2019-02-25;25/02/2019;BON;Gastos_Compras;Supermercado;2;VARIABLES
01/03/2019;01/03/2019;FACT TARJETASTARJ.CREDITO 07126017 19-03-01;-385,86;20269,54;19883,68;11867;-385,86;19883,68;2019-03-01;28/02/2019;FACT 07126017;Gastos_Banco y organismos;Credito Bea;2;VARIABLE
01/03/2019;01/03/2019;FACT TARJETASTARJ.CREDITO 42689013 19-03-01;-439,23;19883,68;19444,45;11868;-439,23;19444,45;2019-03-01;28/02/2019;FACT;No computable;Recibo Tarjeta;2;
01/03/2019;01/03/2019;TRANSFBBVABCLM;1200,00;19444,45;20644,45;11869;1200,00;20644,45;2019-03-01;01/03/2019;TRANSFBBVABCLM;No computable;traspasos, transf.;3;
01/03/2019;01/03/2019;T/AUTOPISTAS TERRASSA 26-02-2019;-1,44;20644,45;20643,01;11870;-1,44;20643,01;2019-02-26;26/02/2019;AUTOPISTAS;Gastos_Ocio y transporte;Parking y peaje;2;VARIABLES
01/03/2019;01/03/2019;T/AUTOPISTAS TERRASSA 26-02-2019;-1,44;20643,01;20641,57;11871;-1,44;20641,57;2019-02-26;26/02/2019;AUTOPISTAS;Gastos_Ocio y transporte;Parking y peaje;2;VARIABLES
01/03/2019;01/03/2019;T/E.S. RUBI II 26-02-2019;-48,08;20641,57;20593,49;11872;-48,08;20593,49;2019-02-26;26/02/2019;RUBI;Gastos_Ocio y transporte;Gasolina;2;VARIABLES
01/03/2019;01/03/2019;T/TERRACASA / 26-02-2019;-31,59;20593,49;20561,90;11873;-31,59;20561,90;2019-02-26;26/02/2019;TERRACASA;Gastos_Compras;Otras compras;2;VARIABLES
02/03/2019;02/03/2019;T/CATALUNYA CAIX/EL P 27-02-2019;-3,80;20561,90;20558,10;11874;-3,80;20558,10;2019-02-27;27/02/2019;CATALUNYA;Gastos_Ocio y transporte;Restaurantes;2;VARIABLES
02/03/2019;02/03/2019;T/BON AREA 27-02-2019;-6,29;20558,10;20551,81;11875;-6,29;20551,81;2019-02-27;27/02/2019;BON;Gastos_Compras;Supermercado;2;VARIABLES
02/03/2019;02/03/2019;T/AUTOPISTAS TERRASSA 27-02-2019;-1,44;20551,81;20550,37;11876;-1,44;20550,37;2019-02-27;27/02/2019;AUTOPISTAS;Gastos_Ocio y transporte;Parking y peaje;2;VARIABLES
02/03/2019;02/03/2019;T/AUTOPISTAS TERRASSA 27-02-2019;-1,44;20550,37;20548,93;11877;-1,44;20548,93;2019-02-27;27/02/2019;AUTOPISTAS;Gastos_Ocio y transporte;Parking y peaje;2;VARIABLES
02/03/2019;02/03/2019;T/TUNELS VALLVI S. 27-02-2019;-3,86;20548,93;20545,07;11878;-3,86;20545,07;2019-02-27;27/02/2019;TUNELS;Gastos_Ocio y transporte;Parking y peaje;2;VARIABLES
03/03/2019;03/03/2019;T/AUTOPISTAS TERRASSA 28-02-2019;-1,44;20545,07;20543,63;11879;-1,44;20543,63;2019-02-28;28/02/2019;AUTOPISTAS;Gastos_Ocio y transporte;Parking y peaje;2;VARIABLES
03/03/2019;03/03/2019;T/AUTOPISTAS TERRASSA 28-02-2019;-1,44;20543,63;20542,19;11880;-1,44;20542,19;2019-02-28;28/02/2019;AUTOPISTAS;Gastos_Ocio y transporte;Parking y peaje;2;VARIABLES
03/03/2019;03/03/2019;T/VIENA PARC VALLES / 28-02-2019;-8,75;20542,19;20533,44;11881;-8,75;20533,44;2019-02-28;28/02/2019;VIENA;Gastos_Ocio y transporte;Restaurantes;2;VARIABLES
03/03/2019;03/03/2019;T/REDONDEO S0LIDARI/B 28-02-2019;-0,25;20533,44;20533,19;11882;-0,25;20533,19;2019-02-28;28/02/2019;REDONDEO;Gastos_Salud, saber y deporte;Solidaridad;2;VARIABLES
03/03/2019;03/03/2019;T/TUNELS VALLVI S. 28-02-2019;-3,86;20533,19;20529,33;11883;-3,86;20529,33;2019-02-28;28/02/2019;TUNELS;Gastos_Ocio y transporte;Parking y peaje;2;VARIABLES
03/03/2019;03/03/2019;T/BON AREA 28-02-2019;-5,23;20529,33;20524,10;11884;-5,23;20524,10;2019-02-28;28/02/2019;BON;Gastos_Compras;Supermercado;2;VARIABLES
04/03/2019;04/03/2019;T/CATALUNYA CAIX/EL P 01-03-2019;-3,80;20524,10;20520,30;11885;-3,80;20520,30;2019-03-01;01/03/2019;CATALUNYA;Gastos_Ocio y transporte;Restaurantes;3;VARIABLES
06/03/2019;06/03/2019;R/SERHS FOOD A Comedor Marzo/ 20;-33,25;20520,30;20487,05;11886;-33,25;20487,05;2019-03-06;06/03/2019;SERHS;Gastos_Salud, saber y deporte;Menjador;3;FIJO
06/03/2019;06/03/2019;R/SERHS FOOD A Comedor Marzo/ 20;-113,05;20487,05;20374,00;11887;-113,05;20374,00;2019-03-06;06/03/2019;SERHS;Gastos_Salud, saber y deporte;Menjador;3;FIJO
06/03/2019;06/03/2019;T/AUTOPISTAS TERRASSA 01-03-2019;-1,44;20374,00;20372,56;11888;-1,44;20372,56;2019-03-01;01/03/2019;AUTOPISTAS;Gastos_Ocio y transporte;Parking y peaje;3;VARIABLES
06/03/2019;06/03/2019;T/AUTOPISTAS TERRASSA 01-03-2019;-1,44;20372,56;20371,12;11889;-1,44;20371,12;2019-03-01;01/03/2019;AUTOPISTAS;Gastos_Ocio y transporte;Parking y peaje;3;VARIABLES
07/03/2019;07/03/2019;'R/L.EINA COOPERA L''EINA COOPE Reb';-35,60;20371,12;20335,52;11890;-35,60;20335,52;2019-03-07;07/03/2019;LEINA;Gastos_Salud, saber y deporte;Estudios;3;VARIABLES
09/03/2019;09/03/2019;T/CINESA WEB /BARCELONA;-28,80;20335,52;20306,72;11891;-28,80;20306,72;2019-03-09;09/03/2019;CINESA;Gastos_Ocio y transporte;Espectáculos;3;VARIABLES
09/03/2019;09/03/2019;T/PARC VALLES /TERRASSA;-171,16;20306,72;20135,56;11892;-171,16;20135,56;2019-03-09;09/03/2019;PARC;Gastos_Compras;Supermercado;3;VARIABLES
10/03/2019;10/03/2019;T/CATALUNYA CAIX/EL P 07-03-2019;-2,00;20135,56;20133,56;11893;-2,00;20133,56;2019-03-07;07/03/2019;CATALUNYA;Gastos_Ocio y transporte;Restaurantes;3;VARIABLES
11/03/2019;11/03/2019;T/AP. DR. ROBERT - TE 08-03-2019;-1,00;20133,56;20132,56;11894;-1,00;20132,56;2019-03-08;08/03/2019;ROBERT;Gastos_Ocio y transporte;Parking y peaje;3;VARIABLES
11/03/2019;11/03/2019;T/BON AREA 08-03-2019;-44,49;20132,56;20088,07;11895;-44,49;20088,07;2019-03-08;08/03/2019;BON;Gastos_Compras;Supermercado;3;VARIABLES
12/03/2019;12/03/2019;R/TELEFONO VODAFONE;-139,43;20088,07;19948,64;11896;-139,43;19948,64;2019-03-12;12/03/2019;TELEFONO;Gastos_Servicios tipicos;Telecomunicaciones;3;FIJO
12/03/2019;12/03/2019;T/HELADOS DINO / 09-03-2019;-8,20;19948,64;19940,44;11897;-8,20;19940,44;2019-03-09;09/03/2019;HELADOS;Gastos_Ocio y transporte;Restaurantes;3;VARIABLES
12/03/2019;12/03/2019;T/AJUNT.DE BARCELON/B 09-03-2019;-50,00;19940,44;19890,44;11898;-50,00;19890,44;2019-03-09;09/03/2019;AJUNTDE;Gastos_Banco y organismos;Multas;3;
12/03/2019;12/03/2019;T/PARC VALLES / 09-03-2019;-3,07;19890,44;19887,37;11899;-3,07;19887,37;2019-03-09;09/03/2019;PARC;Gastos_Compras;Supermercado;3;VARIABLES
12/03/2019;12/03/2019;T/TAGLIATELLA PARC V/ 09-03-2019;-63,65;19887,37;19823,72;11900;-63,65;19823,72;2019-03-09;09/03/2019;TAGLIATELLA;Gastos_Ocio y transporte;Restaurantes;3;VARIABLES
12/03/2019;12/03/2019;T/CINESA PARC VALLES/ 09-03-2019;-2,90;19823,72;19820,82;11901;-2,90;19820,82;2019-03-09;09/03/2019;CINESA;Gastos_Ocio y transporte;Espectáculos;3;VARIABLES
12/03/2019;12/03/2019;T/BON AREA /LLEIDA;-7,81;19820,82;19813,01;11902;-7,81;19813,01;2019-03-12;12/03/2019;BON;Gastos_Compras;Supermercado;3;VARIABLES
13/03/2019;13/03/2019;R/. FINQUES GASS Vto 01-03-19 Rec;-75,31;19813,01;19737,70;11903;-75,31;19737,70;2019-03-01;01/03/2019;FINQUES;Gastos_Vivienda y vehiculo;Alquiler Parking;3;FIJO
13/03/2019;13/03/2019;T/E.S. RUBI II /RUBI;-49,74;19737,70;19687,96;11904;-49,74;19687,96;2019-03-13;13/03/2019;RUBI;Gastos_Ocio y transporte;Gasolina;3;VARIABLES
13/03/2019;11/03/2019;T/AMAZON.ES*MW9ZX5M74 AM;-229,99;19687,96;19457,97;11905;-229,99;19457,97;2019-03-11;11/03/2019;AMAZONESMWZXM;Gastos_Compras;Hobbys;3;VARIABLES
13/03/2019;13/03/2019;T/AUTOPISTAS TERRASSA 08-03-2019;-1,44;19457,97;19456,53;11906;-1,44;19456,53;2019-03-08;08/03/2019;AUTOPISTAS;Gastos_Ocio y transporte;Parking y peaje;3;VARIABLES
14/03/2019;14/03/2019;R/NATURGY IBER NATURGY2763048031;-4,69;19456,53;19451,84;11907;-4,69;19451,84;2019-03-14;14/03/2019;NATURGY;Gastos_Servicios tipicos;Gas;3;FIJO
14/03/2019;11/03/2019;T/AUTOPISTAS TERRASSA MANRE;-1,44;19451,84;19450,40;11908;-1,44;19450,40;2019-03-11;11/03/2019;AUTOPISTAS;Gastos_Ocio y transporte;Parking y peaje;3;VARIABLES
14/03/2019;12/03/2019;T/AUTOPISTAS TERRASSA MANRE;-1,44;19450,40;19448,96;11909;-1,44;19448,96;2019-03-12;12/03/2019;AUTOPISTAS;Gastos_Ocio y transporte;Parking y peaje;3;VARIABLES
14/03/2019;12/03/2019;T/AUTOPISTAS TERRASSA MANRE;-1,44;19448,96;19447,52;11910;-1,44;19447,52;2019-03-12;12/03/2019;AUTOPISTAS;Gastos_Ocio y transporte;Parking y peaje;3;VARIABLES
14/03/2019;14/03/2019;T/AUTOPISTAS TERRASSA 11-03-2019;-1,44;19447,52;19446,08;11911;-1,44;19446,08;2019-03-11;11/03/2019;AUTOPISTAS;Gastos_Ocio y transporte;Parking y peaje;3;VARIABLES
14/03/2019;14/03/2019;T/BON AREA /LLEIDA;-16,39;19446,08;19429,69;11912;-16,39;19429,69;2019-03-14;14/03/2019;BON;Gastos_Compras;Supermercado;3;VARIABLES
15/03/2019;15/03/2019;'R/L.EINA COOPERA L''EINA COOPE Reb';-15,00;19429,69;19414,69;11913;-15,00;19414,69;2019-03-15;15/03/2019;LEINA;Gastos_Salud, saber y deporte;Estudios;3;VARIABLES
15/03/2019;15/03/2019;R/LUZ ENDESA ENERG FACTURA DE ELE;-133,69;19414,69;19281,00;11914;-133,69;19281,00;2019-03-15;15/03/2019;ELE;Gastos_Servicios tipicos;Electricidad;3;FIJO
15/03/2019;15/03/2019;T/FRANKFURT REITER / 12-03-2019;-5,35;19281,00;19275,65;11915;-5,35;19275,65;2019-03-12;12/03/2019;FRANKFURT;Gastos_Ocio y transporte;Restaurantes;3;VARIABLES
15/03/2019;15/03/2019;T/ORIENT CARS - RECA/ 12-03-2019;-192,03;19275,65;19083,62;11916;-192,03;19083,62;2019-03-12;12/03/2019;ORIENT;Gastos_Vivienda y vehiculo;Mnto. vehiculo;3;VARIABLE
16/03/2019;16/03/2019;T/AUTOPISTAS TERRASSA 13-03-2019;-1,44;19083,62;19082,18;11917;-1,44;19082,18;2019-03-13;13/03/2019;AUTOPISTAS;Gastos_Ocio y transporte;Parking y peaje;3;VARIABLES
16/03/2019;16/03/2019;T/AUTOPISTAS TERRASSA 13-03-2019;-1,44;19082,18;19080,74;11918;-1,44;19080,74;2019-03-13;13/03/2019;AUTOPISTAS;Gastos_Ocio y transporte;Parking y peaje;3;VARIABLES
16/03/2019;16/03/2019;T/TUNELS VALLVI S. 13-03-2019;-3,86;19080,74;19076,88;11919;-3,86;19076,88;2019-03-13;13/03/2019;TUNELS;Gastos_Ocio y transporte;Parking y peaje;3;VARIABLES
16/03/2019;16/03/2019;T/TUNELS VALLVI S. 12-03-2019;-3,86;19076,88;19073,02;11920;-3,86;19073,02;2019-03-12;12/03/2019;TUNELS;Gastos_Ocio y transporte;Parking y peaje;3;VARIABLES
17/03/2019;17/03/2019;CAJ. AJENOB.B.V.A. /TERRASSA;-80,00;19073,02;18993,02;11921;-80,00;18993,02;2019-03-17;17/03/2019;CAJ;Gastos_Gastos varios;Efectivo;3;VARIABLES
17/03/2019;17/03/2019;COM.64970036 SVRED CAJ OFI;-1,87;18993,02;18991,15;11922;-1,87;18991,15;2019-03-17;17/03/2019;COM;Gastos_Banco y organismos;Cargos banco;3;FIJO
17/03/2019;17/03/2019;T/AUTOPISTAS TERRASSA 14-03-2019;-1,44;18991,15;18989,71;11923;-1,44;18989,71;2019-03-14;14/03/2019;AUTOPISTAS;Gastos_Ocio y transporte;Parking y peaje;3;VARIABLES
17/03/2019;17/03/2019;T/AUTOPISTAS TERRASSA 14-03-2019;-1,44;18989,71;18988,27;11924;-1,44;18988,27;2019-03-14;14/03/2019;AUTOPISTAS;Gastos_Ocio y transporte;Parking y peaje;3;VARIABLES
18/03/2019;18/03/2019;R/SEGUROS CCM VIDA Y P Recibo:155;-18,61;18988,27;18969,66;11925;-18,61;18969,66;2019-03-18;18/03/2019;CCM;Gastos_Seguros;Seguro vida;3;FIJO
18/03/2019;18/03/2019;R/SEGUROS CCM VIDA Y P Recibo:155;-15,99;18969,66;18953,67;11926;-15,99;18953,67;2019-03-18;18/03/2019;CCM;Gastos_Seguros;Seguro vida;3;FIJO
18/03/2019;18/03/2019;T/CATALUNYA CAIX/EL P 15-03-2019;-2,60;18953,67;18951,07;11927;-2,60;18951,07;2019-03-15;15/03/2019;CATALUNYA;Gastos_Ocio y transporte;Restaurantes;3;VARIABLES
20/03/2019;18/03/2019;T/AMZN Mktp ES*MW11W52T4;-35,74;18951,07;18915,33;11928;-35,74;18915,33;2019-03-18;18/03/2019;AMZN;Gastos_Compras;Hobbys;3;VARIABLES
20/03/2019;20/03/2019;T/AUTOPISTAS TERRASSA 15-03-2019;-1,44;18915,33;18913,89;11929;-1,44;18913,89;2019-03-15;15/03/2019;AUTOPISTAS;Gastos_Ocio y transporte;Parking y peaje;3;VARIABLES
20/03/2019;20/03/2019;T/AUTOPISTAS TERRASSA 15-03-2019;-1,44;18913,89;18912,45;11930;-1,44;18912,45;2019-03-15;15/03/2019;AUTOPISTAS;Gastos_Ocio y transporte;Parking y peaje;3;VARIABLES
21/03/2019;21/03/2019;T/CATALUNYA CAIX/EL P 18-03-2019;-2,00;18912,45;18910,45;11931;-2,00;18910,45;2019-03-18;18/03/2019;CATALUNYA;Gastos_Ocio y transporte;Restaurantes;3;VARIABLES
21/03/2019;21/03/2019;T/AUTOPISTAS TERRASSA 18-03-2019;-1,44;18910,45;18909,01;11932;-1,44;18909,01;2019-03-18;18/03/2019;AUTOPISTAS;Gastos_Ocio y transporte;Parking y peaje;3;VARIABLES
21/03/2019;21/03/2019;T/AUTOPISTAS TERRASSA 18-03-2019;-1,44;18909,01;18907,57;11933;-1,44;18907,57;2019-03-18;18/03/2019;AUTOPISTAS;Gastos_Ocio y transporte;Parking y peaje;3;VARIABLES
21/03/2019;21/03/2019;T/CERTIO ITV VIL/VILA 18-03-2019;-45,50;18907,57;18862,07;11934;-45,50;18862,07;2019-03-18;18/03/2019;CERTIO;Gastos_Vivienda y vehiculo;Mnto. vehiculo;3;VARIABLE
21/03/2019;21/03/2019;T/BON AREA            18-03-2019;-22,74;18862,07;18839,33;11935;-22,74;18839,33;2019-03-18;18/03/2019;BON;Gastos_Compras;Supermercado;3;VARIABLES
21/03/2019;21/03/2019;T/TUNELS    VALLVI N. 15-03-2019;-3,86;18839,33;18835,47;11936;-3,86;18835,47;2019-03-15;15/03/2019;TUNELS;Gastos_Ocio y transporte;Parking y peaje;3;VARIABLES
22/03/2019;22/03/2019;T/AUTOPISTAS TERRASSA 19-03-2019;-1,44;18835,47;18834,03;11937;-1,44;18834,03;2019-03-19;19/03/2019;AUTOPISTAS;Gastos_Ocio y transporte;Parking y peaje;3;VARIABLES
22/03/2019;22/03/2019;T/AUTOPISTAS TERRASSA 19-03-2019;-1,44;18834,03;18832,59;11938;-1,44;18832,59;2019-03-19;19/03/2019;AUTOPISTAS;Gastos_Ocio y transporte;Parking y peaje;3;VARIABLES
22/03/2019;22/03/2019;T/CATALUNYA CAIX/EL P 19-03-2019;-3,00;18832,59;18829,59;11939;-3,00;18829,59;2019-03-19;19/03/2019;CATALUNYA;Gastos_Ocio y transporte;Restaurantes;3;VARIABLES
23/03/2019;23/03/2019;T/CATALUNYA CAIX/EL P 20-03-2019;-3,00;18829,59;18826,59;11940;-3,00;18826,59;2019-03-20;20/03/2019;CATALUNYA;Gastos_Ocio y transporte;Restaurantes;3;VARIABLES
23/03/2019;23/03/2019;T/HIPERMERCAT ESCLAT/ 20-03-2019;-1,39;18826,59;18825,20;11941;-1,39;18825,20;2019-03-20;20/03/2019;HIPERMERCAT;Gastos_Compras;Supermercado;3;VARIABLES
23/03/2019;23/03/2019;T/AUTOPISTAS TERRASSA 20-03-2019;-1,44;18825,20;18823,76;11942;-1,44;18823,76;2019-03-20;20/03/2019;AUTOPISTAS;Gastos_Ocio y transporte;Parking y peaje;3;VARIABLES
23/03/2019;23/03/2019;T/AUTOPISTAS TERRASSA 20-03-2019;-1,44;18823,76;18822,32;11943;-1,44;18822,32;2019-03-20;20/03/2019;AUTOPISTAS;Gastos_Ocio y transporte;Parking y peaje;3;VARIABLES
24/03/2019;24/03/2019;T/AUTOPISTAS TERRASSA 21-03-2019;-1,44;18822,32;18820,88;11944;-1,44;18820,88;2019-03-21;21/03/2019;AUTOPISTAS;Gastos_Ocio y transporte;Parking y peaje;3;VARIABLES
24/03/2019;24/03/2019;T/AUTOPISTAS TERRASSA 21-03-2019;-1,44;18820,88;18819,44;11945;-1,44;18819,44;2019-03-21;21/03/2019;AUTOPISTAS;Gastos_Ocio y transporte;Parking y peaje;3;VARIABLES
24/03/2019;24/03/2019;T/CATALUNYA CAIX/EL P 21-03-2019;-3,30;18819,44;18816,14;11946;-3,30;18816,14;2019-03-21;21/03/2019;CATALUNYA;Gastos_Ocio y transporte;Restaurantes;3;VARIABLES
24/03/2019;24/03/2019;T/BON AREA            21-03-2019;-17,16;18816,14;18798,98;11947;-17,16;18798,98;2019-03-21;21/03/2019;BON;Gastos_Compras;Supermercado;3;VARIABLES
25/03/2019;25/03/2019;R/ MINA PUBLICA AIGUES T.01A75789;-57,64;18798,98;18741,34;11948;-57,64;18741,34;2019-03-25;25/03/2019;MINA;Gastos_Servicios tipicos;Agua;3;FIJO
25/03/2019;25/03/2019;T/CATALUNYA CAIX/EL P 22-03-2019;-2,50;18741,34;18738,84;11949;-2,50;18738,84;2019-03-22;22/03/2019;CATALUNYA;Gastos_Ocio y transporte;Restaurantes;3;VARIABLES
25/03/2019;25/03/2019;T/WWW.JUST-EAT.ES     22-03-2019;-44,90;18738,84;18693,94;11950;-44,90;18693,94;2019-03-22;22/03/2019;WWWJUSTEATES;Gastos_Ocio y transporte;Restaurantes;3;VARIABLES
27/03/2019;23/03/2019;T/PERLES AND CO;-52,21;18693,94;18641,73;11951;-52,21;18641,73;2019-03-23;23/03/2019;PERLES;Gastos_Compras;Hobbys;3;VARIABLES
27/03/2019;27/03/2019;T/CINESA PARC VALLES/ 24-03-2019;-10,26;18641,73;18631,47;11952;-10,26;18631,47;2019-03-24;24/03/2019;CINESA;Gastos_Ocio y transporte;Espectáculos;3;VARIABLES
27/03/2019;27/03/2019;T/CINESA WEB       /B 24-03-2019;-32,40;18631,47;18599,07;11953;-32,40;18599,07;2019-03-24;24/03/2019;CINESA;Gastos_Ocio y transporte;Espectáculos;3;VARIABLES
27/03/2019;27/03/2019;T/AUTOPISTAS TERRASSA 22-03-2019;-1,44;18599,07;18597,63;11954;-1,44;18597,63;2019-03-22;22/03/2019;AUTOPISTAS;Gastos_Ocio y transporte;Parking y peaje;3;VARIABLES
27/03/2019;27/03/2019;T/AUTOPISTAS TERRASSA 22-03-2019;-1,44;18597,63;18596,19;11955;-1,44;18596,19;2019-03-22;22/03/2019;AUTOPISTAS;Gastos_Ocio y transporte;Parking y peaje;3;VARIABLES
28/03/2019;28/03/2019;HAB.AJUNTAMENT DE TERRASSA Transfe;1900,01;18596,19;20496,20;11956;1900,01;20496,20;2019-03-28;28/03/2019;HABAJUNTAMENT;Ingresos;Nomina;3;FIJO
28/03/2019;28/03/2019;CAJ. AJENOB.B.V.A.     /PRAT DE LLOBR;-300,00;20496,20;20196,20;11957;-300,00;20196,20;2019-03-28;28/03/2019;CAJ;Gastos_Gastos varios;Efectivo;3;VARIABLES
28/03/2019;28/03/2019;COM.64970036 SVRED CAJ     OFI;-1,87;20196,20;20194,33;11958;-1,87;20194,33;2019-03-28;28/03/2019;COM;Gastos_Banco y organismos;Cargos banco;3;FIJO
28/03/2019;28/03/2019;T/CATALUNYA CAIX/EL P 25-03-2019;-3,50;20194,33;20190,83;11959;-3,50;20190,83;2019-03-25;25/03/2019;CATALUNYA;Gastos_Ocio y transporte;Restaurantes;3;VARIABLES
28/03/2019;28/03/2019;T/BON AREA            25-03-2019;-29,76;20190,83;20161,07;11960;-29,76;20161,07;2019-03-25;25/03/2019;BON;Gastos_Compras;Supermercado;3;VARIABLES
29/03/2019;29/03/2019;'R/AJUNTAMENT D I.B.I.  CA D''ALBI';-48,62;20161,07;20112,45;11961;-48,62;20112,45;2019-03-29;29/03/2019;AJUNTAMENT;Gastos_Banco y organismos;Ayuntamiento;3;FIJO
29/03/2019;29/03/2019;TRANSFBBVABCLM;1200,00;20112,45;21312,45;11962;1200,00;21312,45;2019-03-29;29/03/2019;TRANSFBBVABCLM;No computable;traspasos, transf.;3;
29/03/2019;29/03/2019;T/E.S.RUBI 9          26-03-2019;-48,10;21312,45;21264,35;11963;-48,10;21264,35;2019-03-26;26/03/2019;ESRUBI;Gastos_Ocio y transporte;Gasolina;3;VARIABLES
29/03/2019;29/03/2019;T/AUTOPISTAS TERRASSA 26-03-2019;-1,44;21264,35;21262,91;11964;-1,44;21262,91;2019-03-26;26/03/2019;AUTOPISTAS;Gastos_Ocio y transporte;Parking y peaje;3;VARIABLES
29/03/2019;29/03/2019;T/AUTOPISTAS TERRASSA 26-03-2019;-1,44;21262,91;21261,47;11965;-1,44;21261,47;2019-03-26;26/03/2019;AUTOPISTAS;Gastos_Ocio y transporte;Parking y peaje;3;VARIABLES
29/03/2019;29/03/2019;T/AUTOPISTAS TERRASSA 25-03-2019;-1,44;21261,47;21260,03;11966;-1,44;21260,03;2019-03-25;25/03/2019;AUTOPISTAS;Gastos_Ocio y transporte;Parking y peaje;3;VARIABLES
29/03/2019;29/03/2019;T/AUTOPISTAS TERRASSA 25-03-2019;-1,44;21260,03;21258,59;11967;-1,44;21258,59;2019-03-25;25/03/2019;AUTOPISTAS;Gastos_Ocio y transporte;Parking y peaje;3;VARIABLES
30/03/2019;30/03/2019;T/LIDL TERRASSA-LES / 27-03-2019;-48,37;21258,59;21210,22;11968;-48,37;21210,22;2019-03-27;27/03/2019;LIDL;Gastos_Compras;Supermercado;3;VARIABLES
30/03/2019;30/03/2019;T/AUTOPISTAS TERRASSA 27-03-2019;-1,44;21210,22;21208,78;11969;-1,44;21208,78;2019-03-27;27/03/2019;AUTOPISTAS;Gastos_Ocio y transporte;Parking y peaje;3;VARIABLES
30/03/2019;30/03/2019;T/AUTOPISTAS TERRASSA 27-03-2019;-1,44;21208,78;21207,34;11970;-1,44;21207,34;2019-03-27;27/03/2019;AUTOPISTAS;Gastos_Ocio y transporte;Parking y peaje;3;VARIABLES
30/03/2019;30/03/2019;T/CATALUNYA CAIX/EL P 27-03-2019;-2,00;21207,34;21205,34;11971;-2,00;21205,34;2019-03-27;27/03/2019;CATALUNYA;Gastos_Ocio y transporte;Restaurantes;3;VARIABLES
31/03/2019;31/03/2019;REC.6061.9600001223;-448,11;21205,34;20757,23;11972;-448,11;20757,23;2019-03-31;31/03/2019;REC;Gastos_Banco y organismos;Hipoteca;3;FIJO
31/03/2019;31/03/2019;T/AUTOPISTAS TERRASSA 28-03-2019;-1,44;20757,23;20755,79;11973;-1,44;20755,79;2019-03-28;28/03/2019;AUTOPISTAS;Gastos_Ocio y transporte;Parking y peaje;3;VARIABLES
31/03/2019;31/03/2019;T/AUTOPISTAS TERRASSA 28-03-2019;-1,44;20755,79;20754,35;11974;-1,44;20754,35;2019-03-28;28/03/2019;AUTOPISTAS;Gastos_Ocio y transporte;Parking y peaje;3;VARIABLES
31/03/2019;31/03/2019;T/AP. PLAÇA VELLA     28-03-2019;-2,60;20754,35;20751,75;11975;-2,60;20751,75;2019-03-28;28/03/2019;PLAA;Gastos_Ocio y transporte;Parking y peaje;3;VARIABLES
01/04/2019;01/04/2019;FACT TARJETASTARJ.CREDITO 07126017 19-04-01;-374,03;20751,75;20377,72;11976;-374,03;20377,72;2019-04-01;31/03/2019;FACT 07126017;Gastos_Banco y organismos;Credito Bea;3;VARIABLE
01/04/2019;01/04/2019;FACT TARJETASTARJ.CREDITO 42689013 19-04-01;-393,58;20377,72;19984,14;11977;-393,58;19984,14;2019-04-01;31/03/2019;FACT;No computable;Recibo Tarjeta;3;
01/04/2019;01/04/2019;T/WWW.JUST-EAT.ES     29-03-2019;-44,90;19984,14;19939,24;11978;-44,90;19939,24;2019-03-29;29/03/2019;WWWJUSTEATES;Gastos_Ocio y transporte;Restaurantes;3;VARIABLES
02/04/2019;02/04/2019;T/E143 JYSK TERRASSA/ 30-03-2019;-41,69;19939,24;19897,55;11979;-41,69;19897,55;2019-03-30;30/03/2019;JYSK;Gastos_Vivienda y vehiculo;Mnto. hogar;3;VARIABLES
02/04/2019;02/04/2019;T/DRIM CAN PARELLADA/ 30-03-2019;-1,99;19897,55;19895,56;11980;-1,99;19895,56;2019-03-30;30/03/2019;DRIM;Gastos_Compras;Niños;3;VARIABLES
02/04/2019;02/04/2019;T/DRIM CAN PARELLADA/ 30-03-2019;-37,04;19895,56;19858,52;11981;-37,04;19858,52;2019-03-30;30/03/2019;DRIM;Gastos_Compras;Niños;3;VARIABLES
02/04/2019;02/04/2019;T/VIENA PARC VALLES / 30-03-2019;-17,60;19858,52;19840,92;11982;-17,60;19840,92;2019-03-30;30/03/2019;VIENA;Gastos_Ocio y transporte;Restaurantes;3;VARIABLES
02/04/2019;02/04/2019;T/REDONDEO S0LIDARI/B 30-03-2019;-0,40;19840,92;19840,52;11983;-0,40;19840,52;2019-03-30;30/03/2019;REDONDEO;Gastos_Salud, saber y deporte;Solidaridad;3;VARIABLES
03/04/2019;03/04/2019;'R/L.EINA COOPERA L''EINA COOPE Reb';-35,60;19840,52;19804,92;11984;-35,60;19804,92;2019-04-03;03/04/2019;LEINA;Gastos_Salud, saber y deporte;Estudios;4;VARIABLES
03/04/2019;03/04/2019;R/SEGUROS SEGUROS CATA INCLUIDO S;-357,35;19804,92;19447,57;11985;-357,35;19447,57;2019-04-03;03/04/2019;CATA;Gastos_Seguros;Seguro auto;4;FIJO
04/04/2019;04/04/2019;R/LUZ ENDESA ENERG FACTURA DE GAS;-130,17;19447,57;19317,40;11986;-130,17;19317,40;2019-04-04;04/04/2019;GAS;Gastos_Servicios tipicos;Gas;4;FIJO
04/04/2019;04/04/2019;T/WWW.JUST-EAT.ES     01-04-2019;-29,55;19317,40;19287,85;11987;-29,55;19287,85;2019-04-01;01/04/2019;WWWJUSTEATES;Gastos_Ocio y transporte;Restaurantes;4;VARIABLES
04/04/2019;04/04/2019;T/BON AREA            01-04-2019;-24,26;19287,85;19263,59;11988;-24,26;19263,59;2019-04-01;01/04/2019;BON;Gastos_Compras;Supermercado;4;VARIABLES
04/04/2019;04/04/2019;T/CATALUNYA CAIX/EL P 01-04-2019;-2,85;19263,59;19260,74;11989;-2,85;19260,74;2019-04-01;01/04/2019;CATALUNYA;Gastos_Ocio y transporte;Restaurantes;4;VARIABLES
04/04/2019;04/04/2019;T/AUTOPISTAS TERRASSA 01-04-2019;-1,44;19260,74;19259,30;11990;-1,44;19259,30;2019-04-01;01/04/2019;AUTOPISTAS;Gastos_Ocio y transporte;Parking y peaje;4;VARIABLES
05/04/2019;05/04/2019;R/Ajuntament d Abonaments IMES a;-36,40;19259,30;19222,90;11991;-36,40;19222,90;2019-04-05;05/04/2019;AJUNTAMENT;Gastos_Banco y organismos;Ayuntamiento;4;FIJO
05/04/2019;05/04/2019;T/AUTOPISTAS TERRASSA 02-04-2019;-1,44;19222,90;19221,46;11992;-1,44;19221,46;2019-04-02;02/04/2019;AUTOPISTAS;Gastos_Ocio y transporte;Parking y peaje;4;VARIABLES
05/04/2019;05/04/2019;T/AUTOPISTAS TERRASSA 02-04-2019;-1,44;19221,46;19220,02;11993;-1,44;19220,02;2019-04-02;02/04/2019;AUTOPISTAS;Gastos_Ocio y transporte;Parking y peaje;4;VARIABLES
05/04/2019;05/04/2019;T/PARKING VAPOR GRAN/ 02-04-2019;-5,20;19220,02;19214,82;11994;-5,20;19214,82;2019-04-02;02/04/2019;PARKING;Gastos_Ocio y transporte;Parking y peaje;4;VARIABLES
05/04/2019;05/04/2019;T/FRANKFURT LES LLET/ 02-04-2019;-6,45;19214,82;19208,37;11995;-6,45;19208,37;2019-04-02;02/04/2019;FRANKFURT;Gastos_Ocio y transporte;Restaurantes;4;VARIABLES
06/04/2019;06/04/2019;T/AUTOPISTAS TERRASSA 03-04-2019;-1,44;19208,37;19206,93;11996;-1,44;19206,93;2019-04-03;03/04/2019;AUTOPISTAS;Gastos_Ocio y transporte;Parking y peaje;4;VARIABLES
06/04/2019;06/04/2019;T/AUTOPISTAS TERRASSA 03-04-2019;-1,44;19206,93;19205,49;11997;-1,44;19205,49;2019-04-03;03/04/2019;AUTOPISTAS;Gastos_Ocio y transporte;Parking y peaje;4;VARIABLES
06/04/2019;06/04/2019;T/CATALUNYA CAIX/EL P 03-04-2019;-2,00;19205,49;19203,49;11998;-2,00;19203,49;2019-04-03;03/04/2019;CATALUNYA;Gastos_Ocio y transporte;Restaurantes;4;VARIABLES
06/04/2019;06/04/2019;T/CATALUNYA CAIX/EL P 03-04-2019;-2,00;19203,49;19201,49;11999;-2,00;19201,49;2019-04-03;03/04/2019;CATALUNYA;Gastos_Ocio y transporte;Restaurantes;4;VARIABLES
07/04/2019;07/04/2019;T/AUTOPISTAS TERRASSA 04-04-2019;-1,44;19201,49;19200,05;12000;-1,44;19200,05;2019-04-04;04/04/2019;AUTOPISTAS;Gastos_Ocio y transporte;Parking y peaje;4;VARIABLES
07/04/2019;07/04/2019;T/AUTOPISTAS TERRASSA 04-04-2019;-1,44;19200,05;19198,61;12001;-1,44;19198,61;2019-04-04;04/04/2019;AUTOPISTAS;Gastos_Ocio y transporte;Parking y peaje;4;VARIABLES
07/04/2019;07/04/2019;T/CATALUNYA CAIX/EL P 04-04-2019;-2,95;19198,61;19195,66;12002;-2,95;19195,66;2019-04-04;04/04/2019;CATALUNYA;Gastos_Ocio y transporte;Restaurantes;4;VARIABLES
08/04/2019;08/04/2019;R/SERHS FOOD A Comedor Abril/ 20;-95,20;19195,66;19100,46;12003;-95,20;19100,46;2019-04-08;08/04/2019;SERHS;Gastos_Salud, saber y deporte;Menjador;4;FIJO
08/04/2019;08/04/2019;R/SERHS FOOD A Comedor Abril/ 20;-28,00;19100,46;19072,46;12004;-28,00;19072,46;2019-04-08;08/04/2019;SERHS;Gastos_Salud, saber y deporte;Menjador;4;FIJO
08/04/2019;08/04/2019;T/WWW.JUST-EAT.ES     05-04-2019;-32,55;19072,46;19039,91;12005;-32,55;19039,91;2019-04-05;05/04/2019;WWWJUSTEATES;Gastos_Ocio y transporte;Restaurantes;4;VARIABLES
09/04/2019;09/04/2019;R/. FINQUES GASS Vto 01-04-19 Rec;-75,31;19039,91;18964,60;12006;-75,31;18964,60;2019-04-01;01/04/2019;FINQUES;Gastos_Vivienda y vehiculo;Alquiler Parking;4;FIJO
09/04/2019;09/04/2019;T/E.S. RUBI II          /RUBI;-49,17;18964,60;18915,43;12007;-49,17;18915,43;2019-04-09;09/04/2019;RUBI;Gastos_Ocio y transporte;Gasolina;4;VARIABLES
09/04/2019;09/04/2019;T/SPACIO DECOTERRAS/L 06-04-2019;-10,55;18915,43;18904,88;12008;-10,55;18904,88;2019-04-06;06/04/2019;SPACIO;Gastos_Compras;Hobbys;4;VARIABLES
09/04/2019;09/04/2019;T/MEGA ASIA         / 06-04-2019;-35,57;18904,88;18869,31;12009;-35,57;18869,31;2019-04-06;06/04/2019;MEGA;Gastos_Compras;Hogar;4;VARIABLES
09/04/2019;09/04/2019;T/BON AREA            06-04-2019;-24,21;18869,31;18845,10;12010;-24,21;18845,10;2019-04-06;06/04/2019;BON;Gastos_Compras;Supermercado;4;VARIABLES
10/04/2019;10/04/2019;T/WWW.JUST-EAT.ES 07-04-2019;-41,30;18845,10;18803,80;12011;-41,30;18803,80;2019-04-07;07/04/2019;WWWJUSTEATES;Gastos_Ocio y transporte;Restaurantes;4;VARIABLES
11/04/2019;11/04/2019;T/BON AREA 08-04-2019;-24,08;18803,80;18779,72;12012;-24,08;18779,72;2019-04-08;08/04/2019;BON;Gastos_Compras;Supermercado;4;VARIABLES
11/04/2019;11/04/2019;T/AUTOPISTAS TERRASSA 05-04-2019;-1,44;18779,72;18778,28;12013;-1,44;18778,28;2019-04-05;05/04/2019;AUTOPISTAS;Gastos_Ocio y transporte;Parking y peaje;4;VARIABLES
12/04/2019;12/04/2019;R/TELEFONO VODAFONE;-80,89;18778,28;18697,39;12014;-80,89;18697,39;2019-04-12;12/04/2019;TELEFONO;Gastos_Servicios tipicos;Telecomunicaciones;4;FIJO
12/04/2019;12/04/2019;T/AUTOPISTAS TERRASSA 09-04-2019;-1,44;18697,39;18695,95;12015;-1,44;18695,95;2019-04-09;09/04/2019;AUTOPISTAS;Gastos_Ocio y transporte;Parking y peaje;4;VARIABLES
12/04/2019;12/04/2019;T/E.S. RUBI II 09-04-2019;-62,66;18695,95;18633,29;12016;-62,66;18633,29;2019-04-09;09/04/2019;RUBI;Gastos_Ocio y transporte;Gasolina;4;VARIABLES
12/04/2019;12/04/2019;T/AUTOPISTAS TERRASSA 08-04-2019;-1,44;18633,29;18631,85;12017;-1,44;18631,85;2019-04-08;08/04/2019;AUTOPISTAS;Gastos_Ocio y transporte;Parking y peaje;4;VARIABLES
12/04/2019;12/04/2019;T/AUTOPISTAS TERRASSA 08-04-2019;-1,44;18631,85;18630,41;12018;-1,44;18630,41;2019-04-08;08/04/2019;AUTOPISTAS;Gastos_Ocio y transporte;Parking y peaje;4;VARIABLES
14/04/2019;14/04/2019;T/BON AREA 11-04-2019;-11,27;18630,41;18619,14;12019;-11,27;18619,14;2019-04-11;11/04/2019;BON;Gastos_Compras;Supermercado;4;VARIABLES
14/04/2019;14/04/2019;T/CATALUNYA CAIX/EL P 11-04-2019;-2,00;18619,14;18617,14;12020;-2,00;18617,14;2019-04-11;11/04/2019;CATALUNYA;Gastos_Ocio y transporte;Restaurantes;4;VARIABLES
15/04/2019;15/04/2019;R/NATURGY IBER NATURGY2763048041;-4,69;18617,14;18612,45;12021;-4,69;18612,45;2019-04-15;15/04/2019;NATURGY;Gastos_Servicios tipicos;Gas;4;FIJO
15/04/2019;15/04/2019;T/WWW.JUST-EAT.ES 12-04-2019;-22,40;18612,45;18590,05;12022;-22,40;18590,05;2019-04-12;12/04/2019;WWWJUSTEATES;Gastos_Ocio y transporte;Restaurantes;4;VARIABLES
15/04/2019;15/04/2019;T/CAN TORRECA /TERRASSA;-96,00;18590,05;18494,05;12023;-96,00;18494,05;2019-04-15;15/04/2019;CAN;Gastos_Ocio y transporte;Gasolina;4;VARIABLES
16/04/2019;16/04/2019;R/SEGUROS CCM VIDA Y P Recibo:155;-15,93;18494,05;18478,12;12024;-15,93;18478,12;2019-04-16;16/04/2019;CCM;Gastos_Seguros;Seguro vida;4;FIJO
16/04/2019;16/04/2019;R/SEGUROS CCM VIDA Y P Recibo:155;-18,53;18478,12;18459,59;12025;-18,53;18459,59;2019-04-16;16/04/2019;CCM;Gastos_Seguros;Seguro vida;4;FIJO
16/04/2019;16/04/2019;T/WWW.JUST-EAT.ES 13-04-2019;-19,60;18459,59;18439,99;12026;-19,60;18439,99;2019-04-13;13/04/2019;WWWJUSTEATES;Gastos_Ocio y transporte;Restaurantes;4;VARIABLES
16/04/2019;16/04/2019;T/REST.MEXTERRA / 13-04-2019;-43,00;18439,99;18396,99;12027;-43,00;18396,99;2019-04-13;13/04/2019;RESTMEXTERRA;Gastos_Ocio y transporte;Restaurantes;4;VARIABLES
16/04/2019;16/04/2019;T/ITACA / 13-04-2019;-9,05;18396,99;18387,94;12028;-9,05;18387,94;2019-04-13;13/04/2019;ITACA;Gastos_Compras;Otras compras;4;VARIABLES
17/04/2019;17/04/2019;T/WWW.JUST-EAT.ES 14-04-2019;-36,84;18387,94;18351,10;12029;-36,84;18351,10;2019-04-14;14/04/2019;WWWJUSTEATES;Gastos_Ocio y transporte;Restaurantes;4;VARIABLES
17/04/2019;17/04/2019;T/AUTOPISTAS TERRASSA 12-04-2019;-1,44;18351,10;18349,66;12030;-1,44;18349,66;2019-04-12;12/04/2019;AUTOPISTAS;Gastos_Ocio y transporte;Parking y peaje;4;VARIABLES
17/04/2019;17/04/2019;T/ORIENT CARS - RECA/TERRASSA;-436,88;18349,66;17912,78;12031;-436,88;17912,78;2019-04-17;17/04/2019;ORIENT;Gastos_Vivienda y vehiculo;Mnto. vehiculo;4;VARIABLE
18/04/2019;18/04/2019;T/PARKING VAPOR GRAN/ 15-04-2019;-3,70;17912,78;17909,08;12032;-3,70;17909,08;2019-04-15;15/04/2019;PARKING;Gastos_Ocio y transporte;Parking y peaje;4;VARIABLES
18/04/2019;18/04/2019;T/EL SALON THE BARBE/ 15-04-2019;-51,49;17909,08;17857,59;12033;-51,49;17857,59;2019-04-15;15/04/2019;SALON;Gastos_Salud, saber y deporte;Belleza;4;VARIABLES
18/04/2019;18/04/2019;T/CATALUNYA CAIX/EL P 15-04-2019;-2,50;17857,59;17855,09;12034;-2,50;17855,09;2019-04-15;15/04/2019;CATALUNYA;Gastos_Ocio y transporte;Restaurantes;4;VARIABLES
20/04/2019;20/04/2019;T/CATALUNYA CAIX/EL P 17-04-2019;-2,50;17855,09;17852,59;12035;-2,50;17852,59;2019-04-17;17/04/2019;CATALUNYA;Gastos_Ocio y transporte;Restaurantes;4;VARIABLES
20/04/2019;20/04/2019;T/BON AREA            17-04-2019;-11,54;17852,59;17841,05;12036;-11,54;17841,05;2019-04-17;17/04/2019;BON;Gastos_Compras;Supermercado;4;VARIABLES
21/04/2019;21/04/2019;T/ES LA RIERA  /EL PR 18-04-2019;-28,00;17841,05;17813,05;12037;-28,00;17813,05;2019-04-18;18/04/2019;RIERA;Gastos_Ocio y transporte;Gasolina;4;VARIABLES
21/04/2019;21/04/2019;T/AUTOPISTA MARE NOST 18-04-2019;-7,35;17813,05;17805,70;12038;-7,35;17805,70;2019-04-18;18/04/2019;AUTOPISTA;Gastos_Ocio y transporte;Parking y peaje;4;VARIABLES
21/04/2019;21/04/2019;T/A.C.E.S.A A VENDREL 18-04-2019;-5,10;17805,70;17800,60;12039;-5,10;17800,60;2019-04-18;18/04/2019;ACESA;Gastos_Ocio y transporte;Parking y peaje;4;VARIABLES
21/04/2019;21/04/2019;T/AUCAT     BAR VALLC 18-04-2019;-6,93;17800,60;17793,67;12040;-6,93;17793,67;2019-04-18;18/04/2019;AUCAT;Gastos_Ocio y transporte;Parking y peaje;4;VARIABLES
21/04/2019;21/04/2019;T/VIENA PARC VALLES / 18-04-2019;-17,35;17793,67;17776,32;12041;-17,35;17776,32;2019-04-18;18/04/2019;VIENA;Gastos_Ocio y transporte;Restaurantes;4;VARIABLES
21/04/2019;21/04/2019;T/REDONDEO S0LIDARI/B 18-04-2019;-0,15;17776,32;17776,17;12042;-0,15;17776,17;2019-04-18;18/04/2019;REDONDEO;Gastos_Salud, saber y deporte;Solidaridad;4;VARIABLES
23/04/2019;23/04/2019;S/OR. COMUNIDAD PROPIETARRIOS DR.ALB;-240,00;17776,17;17536,17;12043;-240,00;17536,17;2019-04-23;23/04/2019;COMUNIDAD;Gastos_Vivienda y vehiculo;Comunidad;4;FIJO
24/04/2019;24/04/2019;ABO.A.E.A.T. DEVOLUCIONES TRIBUTAR;744,21;17536,17;18280,38;12044;744,21;18280,38;2019-04-24;24/04/2019;ABOAEAT;Ingresos;Devoluciones;4;VARIABLES
25/04/2019;25/04/2019;T/WWW.JUST-EAT.ES 22-04-2019;-42,39;18280,38;18237,99;12045;-42,39;18237,99;2019-04-22;22/04/2019;WWWJUSTEATES;Gastos_Ocio y transporte;Restaurantes;4;VARIABLES
25/04/2019;25/04/2019;T/WWW.JUST-EAT.ES 22-04-2019;-28,55;18237,99;18209,44;12046;-28,55;18209,44;2019-04-22;22/04/2019;WWWJUSTEATES;Gastos_Ocio y transporte;Restaurantes;4;VARIABLES
25/04/2019;25/04/2019;T/AUTOPISTAS TERRASSA 18-04-2019;-1,44;18209,44;18208,00;12047;-1,44;18208,00;2019-04-18;18/04/2019;AUTOPISTAS;Gastos_Ocio y transporte;Parking y peaje;4;VARIABLES
25/04/2019;25/04/2019;T/AUCAT BAR CUBEL 18-04-2019;-4,14;18208,00;18203,86;12048;-4,14;18203,86;2019-04-18;18/04/2019;AUCAT;Gastos_Ocio y transporte;Parking y peaje;4;VARIABLES
25/04/2019;25/04/2019;T/AUTOPISTAS TERRASSA 17-04-2019;-1,44;18203,86;18202,42;12049;-1,44;18202,42;2019-04-17;17/04/2019;AUTOPISTAS;Gastos_Ocio y transporte;Parking y peaje;4;VARIABLES
25/04/2019;25/04/2019;T/AUTOPISTAS TERRASSA 16-04-2019;-1,44;18202,42;18200,98;12050;-1,44;18200,98;2019-04-16;16/04/2019;AUTOPISTAS;Gastos_Ocio y transporte;Parking y peaje;4;VARIABLES
25/04/2019;25/04/2019;T/AUTOPISTAS TERRASSA 16-04-2019;-1,44;18200,98;18199,54;12051;-1,44;18199,54;2019-04-16;16/04/2019;AUTOPISTAS;Gastos_Ocio y transporte;Parking y peaje;4;VARIABLES
25/04/2019;25/04/2019;T/AUTOPISTAS TERRASSA 15-04-2019;-1,44;18199,54;18198,10;12052;-1,44;18198,10;2019-04-15;15/04/2019;AUTOPISTAS;Gastos_Ocio y transporte;Parking y peaje;4;VARIABLES
25/04/2019;25/04/2019;T/AUTOPISTAS TERRASSA 15-04-2019;-1,44;18198,10;18196,66;12053;-1,44;18196,66;2019-04-15;15/04/2019;AUTOPISTAS;Gastos_Ocio y transporte;Parking y peaje;4;VARIABLES
26/04/2019;26/04/2019;HAB.AJUNTAMENT DE TERRASSA Transfe;1900,01;18196,66;20096,67;12054;1900,01;20096,67;2019-04-26;26/04/2019;HABAJUNTAMENT;Ingresos;Nomina;4;FIJO
26/04/2019;26/04/2019;T/BON AREA 23-04-2019;-24,71;20096,67;20071,96;12055;-24,71;20071,96;2019-04-23;23/04/2019;BON;Gastos_Compras;Supermercado;4;VARIABLES
27/04/2019;27/04/2019;T/CATALUNYA CAIX/EL P 24-04-2019;-2,00;20071,96;20069,96;12056;-2,00;20069,96;2019-04-24;24/04/2019;CATALUNYA;Gastos_Ocio y transporte;Restaurantes;4;VARIABLES
27/04/2019;27/04/2019;T/E.S.RUBI 9 24-04-2019;-49,91;20069,96;20020,05;12057;-49,91;20020,05;2019-04-24;24/04/2019;ESRUBI;Gastos_Ocio y transporte;Gasolina;4;VARIABLES
27/04/2019;27/04/2019;T/AUTOPISTAS TERRASSA 24-04-2019;-1,44;20020,05;20018,61;12058;-1,44;20018,61;2019-04-24;24/04/2019;AUTOPISTAS;Gastos_Ocio y transporte;Parking y peaje;4;VARIABLES
27/04/2019;27/04/2019;T/AUTOPISTAS TERRASSA 24-04-2019;-1,44;20018,61;20017,17;12059;-1,44;20017,17;2019-04-24;24/04/2019;AUTOPISTAS;Gastos_Ocio y transporte;Parking y peaje;4;VARIABLES
27/04/2019;27/04/2019;T/BON AREA 24-04-2019;-11,13;20017,17;20006,04;12060;-11,13;20006,04;2019-04-24;24/04/2019;BON;Gastos_Compras;Supermercado;4;VARIABLES
27/04/2019;27/04/2019;T/MERCADONA QUATRE C/TERRASSA;-140,40;20006,04;19865,64;12061;-140,40;19865,64;2019-04-27;27/04/2019;MERCADONA;Gastos_Compras;Supermercado;4;VARIABLES
28/04/2019;28/04/2019;T/CATALUNYA CAIX/EL P 25-04-2019;-2,00;19865,64;19863,64;12062;-2,00;19863,64;2019-04-25;25/04/2019;CATALUNYA;Gastos_Ocio y transporte;Restaurantes;4;VARIABLES
28/04/2019;28/04/2019;T/AUTOPISTAS TERRASSA 25-04-2019;-1,44;19863,64;19862,20;12063;-1,44;19862,20;2019-04-25;25/04/2019;AUTOPISTAS;Gastos_Ocio y transporte;Parking y peaje;4;VARIABLES
28/04/2019;28/04/2019;T/AUTOPISTAS TERRASSA 25-04-2019;-1,44;19862,20;19860,76;12064;-1,44;19860,76;2019-04-25;25/04/2019;AUTOPISTAS;Gastos_Ocio y transporte;Parking y peaje;4;VARIABLES
29/04/2019;29/04/2019;T/PARKING VAPOR GRAN/ 26-04-2019;-6,10;19860,76;19854,66;12065;-6,10;19854,66;2019-04-26;26/04/2019;PARKING;Gastos_Ocio y transporte;Parking y peaje;4;VARIABLES
29/04/2019;29/04/2019;T/AP. DR. ROBERT TER/ 26-04-2019;-2,20;19854,66;19852,46;12066;-2,20;19852,46;2019-04-26;26/04/2019;ROBERT;Gastos_Ocio y transporte;Parking y peaje;4;VARIABLES
29/04/2019;29/04/2019;T/FRUTAS Y VERDURAS / 26-04-2019;-10,00;19852,46;19842,46;12067;-10,00;19842,46;2019-04-26;26/04/2019;FRUTAS;Gastos_Compras;Supermercado;4;VARIABLES
29/04/2019;29/04/2019;T/BON AREA 26-04-2019;-22,78;19842,46;19819,68;12068;-22,78;19819,68;2019-04-26;26/04/2019;BON;Gastos_Compras;Supermercado;4;VARIABLES
29/04/2019;29/04/2019;T/EL RACO / 26-04-2019;-41,75;19819,68;19777,93;12069;-41,75;19777,93;2019-04-26;26/04/2019;RACO;Gastos_Ocio y transporte;Restaurantes;4;VARIABLES
29/04/2019;29/04/2019;T/CATALUNYA CAIX/EL P 26-04-2019;-3,00;19777,93;19774,93;12070;-3,00;19774,93;2019-04-26;26/04/2019;CATALUNYA;Gastos_Ocio y transporte;Restaurantes;4;VARIABLES
30/04/2019;30/04/2019;REC.6061.9600001223;-448,11;19774,93;19326,82;12071;-448,11;19326,82;2019-04-30;30/04/2019;REC;Gastos_Banco y organismos;Hipoteca;4;FIJO
30/04/2019;30/04/2019;TRANSFBBVABCLM;1200,00;19326,82;20526,82;12072;1200,00;20526,82;2019-04-30;30/04/2019;TRANSFBBVABCLM;No computable;traspasos, transf.;4;
30/04/2019;30/04/2019;T/MERCADONA QUATRE C/ 27-04-2019;-14,03;20526,82;20512,79;12073;-14,03;20512,79;2019-04-27;27/04/2019;MERCADONA;Gastos_Compras;Supermercado;4;VARIABLES
30/04/2019;30/04/2019;T/BON AREA 27-04-2019;-6,38;20512,79;20506,41;12074;-6,38;20506,41;2019-04-27;27/04/2019;BON;Gastos_Compras;Supermercado;4;VARIABLES
30/04/2019;30/04/2019;T/AUTOPISTAS TERRASSA 26-04-2019;-1,44;20506,41;20504,97;12075;-1,44;20504,97;2019-04-26;26/04/2019;AUTOPISTAS;Gastos_Ocio y transporte;Parking y peaje;4;VARIABLES
30/04/2019;30/04/2019;T/AUTOPISTAS TERRASSA 26-04-2019;-1,44;20504,97;20503,53;12076;-1,44;20503,53;2019-04-26;26/04/2019;AUTOPISTAS;Gastos_Ocio y transporte;Parking y peaje;4;VARIABLES
01/05/2019;01/05/2019;FACT TARJETASTARJ.CREDITO 07126017 19-05-01;-269,49;20503,53;20234,04;12077;-269,49;20234,04;2019-05-01;30/04/2019;FACT;No computable;Recibo Tarjeta;4;
01/05/2019;01/05/2019;FACT TARJETASTARJ.CREDITO 42689013 19-05-01;-104,19;20234,04;20129,85;12078;-104,19;20129,85;2019-05-01;30/04/2019;FACT;No computable;Recibo Tarjeta;4;
01/05/2019;01/05/2019;CAJ. AJENOB.B.V.A. /TERRASSA;-300,00;20129,85;19829,85;12079;-300,00;19829,85;2019-05-01;01/05/2019;CAJ;Gastos_Gastos varios;Efectivo;5;VARIABLES
01/05/2019;01/05/2019;COM.64970036 SVRED CAJ OFI;-1,87;19829,85;19827,98;12080;-1,87;19827,98;2019-05-01;01/05/2019;COM;Gastos_Banco y organismos;Cargos banco;5;FIJO
01/05/2019;01/05/2019;T/AUTOPISTAS TERRASSA 28-04-2019;-2,62;19827,98;19825,36;12081;-2,62;19825,36;2019-04-28;28/04/2019;AUTOPISTAS;Gastos_Ocio y transporte;Parking y peaje;4;VARIABLES
01/05/2019;01/05/2019;T/AUTOPISTAS TERRASSA 28-04-2019;-2,62;19825,36;19822,74;12082;-2,62;19822,74;2019-04-28;28/04/2019;AUTOPISTAS;Gastos_Ocio y transporte;Parking y peaje;4;VARIABLES
01/05/2019;01/05/2019;T/CAFET.QUIRON GENE/B 28-04-2019;-8,50;19822,74;19814,24;12083;-8,50;19814,24;2019-04-28;28/04/2019;CAFETQUIRON;Gastos_Ocio y transporte;Restaurantes;4;VARIABLES
01/05/2019;01/05/2019;T/FARMACIA SEGLE XX / 28-04-2019;-3,75;19814,24;19810,49;12084;-3,75;19810,49;2019-04-28;28/04/2019;FARMACIA;Gastos_Salud, saber y deporte;Farmacia;4;VARIABLES
02/05/2019;02/05/2019;'R/AJUNTAMENT D I.B.I. CA D''ALBI';-48,62;19810,49;19761,87;12085;-48,62;19761,87;2019-05-02;02/05/2019;AJUNTAMENT;Gastos_Banco y organismos;Ayuntamiento;5;FIJO
02/05/2019;02/05/2019;'R/L.EINA COOPERA L''EINA COOPE Reb';-43,88;19761,87;19717,99;12086;-43,88;19717,99;2019-05-02;02/05/2019;LEINA;Gastos_Salud, saber y deporte;Estudios;5;VARIABLES
02/05/2019;02/05/2019;T/BON AREA 29-04-2019;-14,00;19717,99;19703,99;12087;-14,00;19703,99;2019-04-29;29/04/2019;BON;Gastos_Compras;Supermercado;4;VARIABLES
02/05/2019;02/05/2019;T/CATALUNYA CAIX/EL P 29-04-2019;-2,50;19703,99;19701,49;12088;-2,50;19701,49;2019-04-29;29/04/2019;CATALUNYA;Gastos_Ocio y transporte;Restaurantes;4;VARIABLES
03/05/2019;03/05/2019;T/CINESA WEB /B 30-04-2019;-24,80;19701,49;19676,69;12089;-24,80;19676,69;2019-04-30;30/04/2019;CINESA;Gastos_Ocio y transporte;Espectáculos;4;VARIABLES
03/05/2019;03/05/2019;T/VIENA PARC VALLES / 30-04-2019;-26,60;19676,69;19650,09;12090;-26,60;19650,09;2019-04-30;30/04/2019;VIENA;Gastos_Ocio y transporte;Restaurantes;4;VARIABLES
03/05/2019;03/05/2019;T/REDONDEO S0LIDARI/B 30-04-2019;-0,40;19650,09;19649,69;12091;-0,40;19649,69;2019-04-30;30/04/2019;REDONDEO;Gastos_Salud, saber y deporte;Solidaridad;4;VARIABLES
03/05/2019;03/05/2019;T/CINESA PARC VALLES/ 30-04-2019;-4,00;19649,69;19645,69;12092;-4,00;19645,69;2019-04-30;30/04/2019;CINESA;Gastos_Ocio y transporte;Espectáculos;4;VARIABLES
03/05/2019;03/05/2019;T/HELADOS DINO / 30-04-2019;-9,60;19645,69;19636,09;12093;-9,60;19636,09;2019-04-30;30/04/2019;HELADOS;Gastos_Ocio y transporte;Restaurantes;4;VARIABLES
04/05/2019;04/05/2019;T/IKEA SABADELL /SABADELL;-152,31;19636,09;19483,78;12094;-152,31;19483,78;2019-05-04;04/05/2019;IKEA;Gastos_Vivienda y vehiculo;Mnto. hogar;5;VARIABLES
04/05/2019;01/05/2019;T/PERLES AND CO;-108,99;19483,78;19374,79;12095;-108,99;19374,79;2019-05-01;01/05/2019;PERLES;Gastos_Compras;Hobbys;5;VARIABLES
04/05/2019;04/05/2019;T/WWW.JUST-EAT.ES 01-05-2019;-33,90;19374,79;19340,89;12096;-33,90;19340,89;2019-05-01;01/05/2019;WWWJUSTEATES;Gastos_Ocio y transporte;Restaurantes;5;VARIABLES
04/05/2019;04/05/2019;T/WWW.JUST-EAT.ES 01-05-2019;-27,20;19340,89;19313,69;12097;-27,20;19313,69;2019-05-01;01/05/2019;WWWJUSTEATES;Gastos_Ocio y transporte;Restaurantes;5;VARIABLES
04/05/2019;04/05/2019;T/AUTOPISTAS TERRASSA 29-04-2019;-1,44;19313,69;19312,25;12098;-1,44;19312,25;2019-04-29;29/04/2019;AUTOPISTAS;Gastos_Ocio y transporte;Parking y peaje;4;VARIABLES
04/05/2019;04/05/2019;T/AUTOPISTAS TERRASSA 29-04-2019;-1,44;19312,25;19310,81;12099;-1,44;19310,81;2019-04-29;29/04/2019;AUTOPISTAS;Gastos_Ocio y transporte;Parking y peaje;4;VARIABLES
05/05/2019;05/05/2019;T/AUTOPISTAS TERRASSA 02-05-2019;-1,44;19310,81;19309,37;12100;-1,44;19309,37;2019-05-02;02/05/2019;AUTOPISTAS;Gastos_Ocio y transporte;Parking y peaje;5;VARIABLES
05/05/2019;05/05/2019;T/AUTOPISTAS TERRASSA 02-05-2019;-1,44;19309,37;19307,93;12101;-1,44;19307,93;2019-05-02;02/05/2019;AUTOPISTAS;Gastos_Ocio y transporte;Parking y peaje;5;VARIABLES
05/05/2019;05/05/2019;T/CATALUNYA CAIX/EL P 02-05-2019;-2,00;19307,93;19305,93;12102;-2,00;19305,93;2019-05-02;02/05/2019;CATALUNYA;Gastos_Ocio y transporte;Restaurantes;5;VARIABLES
06/05/2019;06/05/2019;T/CATALUNYA CAIX/EL P 03-05-2019;-8,70;19305,93;19297,23;12103;-8,70;19297,23;2019-05-03;03/05/2019;CATALUNYA;Gastos_Ocio y transporte;Restaurantes;5;VARIABLES
07/05/2019;07/05/2019;T/WWW.JUST-EAT.ES     04-05-2019;-32,55;19297,23;19264,68;12104;-32,55;19264,68;2019-05-04;04/05/2019;WWWJUSTEATES;Gastos_Ocio y transporte;Restaurantes;5;VARIABLES
07/05/2019;07/05/2019;T/BON AREA            04-05-2019;-22,08;19264,68;19242,60;12105;-22,08;19242,60;2019-05-04;04/05/2019;BON;Gastos_Compras;Supermercado;5;VARIABLES
07/05/2019;07/05/2019;T/IKEA REST. SABADEL/ 04-05-2019;-13,20;19242,60;19229,40;12106;-13,20;19229,40;2019-05-04;04/05/2019;IKEA;Gastos_Vivienda y vehiculo;Mnto. hogar;5;VARIABLES
08/05/2019;08/05/2019;T/WWW.JUST-EAT.ES     05-05-2019;-23,90;19229,40;19205,50;12107;-23,90;19205,50;2019-05-05;05/05/2019;WWWJUSTEATES;Gastos_Ocio y transporte;Restaurantes;5;VARIABLES
08/05/2019;08/05/2019;T/AUTOPISTAS TERRASSA 03-05-2019;-1,44;19205,50;19204,06;12108;-1,44;19204,06;2019-05-03;03/05/2019;AUTOPISTAS;Gastos_Ocio y transporte;Parking y peaje;5;VARIABLES
08/05/2019;08/05/2019;T/AUTOPISTAS TERRASSA 03-05-2019;-1,44;19204,06;19202,62;12109;-1,44;19202,62;2019-05-03;03/05/2019;AUTOPISTAS;Gastos_Ocio y transporte;Parking y peaje;5;VARIABLES
09/05/2019;09/05/2019;R/SERHS FOOD A Comedor Mayo/ 201;-130,90;19202,62;19071,72;12110;-130,90;19071,72;2019-05-09;09/05/2019;SERHS;Gastos_Salud, saber y deporte;Menjador;5;FIJO
09/05/2019;09/05/2019;R/SERHS FOOD A Comedor Mayo/ 201;-38,50;19071,72;19033,22;12111;-38,50;19033,22;2019-05-09;09/05/2019;SERHS;Gastos_Salud, saber y deporte;Menjador;5;FIJO
09/05/2019;09/05/2019;T/E.S. RUBI II          /RUBI;-48,56;19033,22;18984,66;12112;-48,56;18984,66;2019-05-09;09/05/2019;RUBI;Gastos_Ocio y transporte;Gasolina;5;VARIABLES
09/05/2019;09/05/2019;T/AUTOPISTAS TERRASSA 06-05-2019;-1,44;18984,66;18983,22;12113;-1,44;18983,22;2019-05-06;06/05/2019;AUTOPISTAS;Gastos_Ocio y transporte;Parking y peaje;5;VARIABLES
09/05/2019;09/05/2019;T/AUTOPISTAS TERRASSA 06-05-2019;-1,44;18983,22;18981,78;12114;-1,44;18981,78;2019-05-06;06/05/2019;AUTOPISTAS;Gastos_Ocio y transporte;Parking y peaje;5;VARIABLES
09/05/2019;09/05/2019;T/TERRACASA         / 06-05-2019;-18,97;18981,78;18962,81;12115;-18,97;18962,81;2019-05-06;06/05/2019;TERRACASA;Gastos_Compras;Otras compras;5;VARIABLES
10/05/2019;10/05/2019;T/AUTOPISTAS TERRASSA 07-05-2019;-1,44;18962,81;18961,37;12116;-1,44;18961,37;2019-05-07;07/05/2019;AUTOPISTAS;Gastos_Ocio y transporte;Parking y peaje;5;VARIABLES
10/05/2019;10/05/2019;T/AUTOPISTAS TERRASSA 07-05-2019;-1,44;18961,37;18959,93;12117;-1,44;18959,93;2019-05-07;07/05/2019;AUTOPISTAS;Gastos_Ocio y transporte;Parking y peaje;5;VARIABLES
10/05/2019;10/05/2019;T/CATALUNYA CAIX/EL P 07-05-2019;-2,00;18959,93;18957,93;12118;-2,00;18957,93;2019-05-07;07/05/2019;CATALUNYA;Gastos_Ocio y transporte;Restaurantes;5;VARIABLES
10/05/2019;10/05/2019;T/BON AREA            07-05-2019;-32,17;18957,93;18925,76;12119;-32,17;18925,76;2019-05-07;07/05/2019;BON;Gastos_Compras;Supermercado;5;VARIABLES
11/05/2019;11/05/2019;T/BUENAS MIGAS TRIA/B 08-05-2019;-17,50;18925,76;18908,26;12120;-17,50;18908,26;2019-05-08;08/05/2019;BUENAS;Gastos_Ocio y transporte;Restaurantes;5;VARIABLES
11/05/2019;11/05/2019;T/EXTREMO ORIENTE  /B 08-05-2019;-78,30;18908,26;18829,96;12121;-78,30;18829,96;2019-05-08;08/05/2019;EXTREMO;Gastos_Compras;Hobbys;5;VARIABLES
11/05/2019;11/05/2019;T/AP. PLACA CATALUN/B 08-05-2019;-3,70;18829,96;18826,26;12122;-3,70;18826,26;2019-05-08;08/05/2019;PLACA;Gastos_Ocio y transporte;Parking y peaje;5;VARIABLES
11/05/2019;11/05/2019;T/AUTOPISTAS TERRASSA 08-05-2019;-1,44;18826,26;18824,82;12123;-1,44;18824,82;2019-05-08;08/05/2019;AUTOPISTAS;Gastos_Ocio y transporte;Parking y peaje;5;VARIABLES
11/05/2019;11/05/2019;T/CATALUNYA CAIX/EL P 08-05-2019;-2,00;18824,82;18822,82;12124;-2,00;18822,82;2019-05-08;08/05/2019;CATALUNYA;Gastos_Ocio y transporte;Restaurantes;5;VARIABLES
12/05/2019;12/05/2019;T/AUTOPISTAS TERRASSA 09-05-2019;-1,44;18822,82;18821,38;12125;-1,44;18821,38;2019-05-09;09/05/2019;AUTOPISTAS;Gastos_Ocio y transporte;Parking y peaje;5;VARIABLES
12/05/2019;12/05/2019;T/AUTOPISTAS TERRASSA 09-05-2019;-1,44;18821,38;18819,94;12126;-1,44;18819,94;2019-05-09;09/05/2019;AUTOPISTAS;Gastos_Ocio y transporte;Parking y peaje;5;VARIABLES
12/05/2019;12/05/2019;T/CATALUNYA CAIX/EL P 09-05-2019;-3,00;18819,94;18816,94;12127;-3,00;18816,94;2019-05-09;09/05/2019;CATALUNYA;Gastos_Ocio y transporte;Restaurantes;5;VARIABLES
13/05/2019;13/05/2019;'R/L.EINA COOPERA L''EINA COOPE Reb';-10,00;18816,94;18806,94;12128;-10,00;18806,94;2019-05-13;13/05/2019;LEINA;Gastos_Salud, saber y deporte;Estudios;5;VARIABLES
13/05/2019;13/05/2019;T/FARMACIA LOSA     / 10-05-2019;-9,20;18806,94;18797,74;12129;-9,20;18797,74;2019-05-10;10/05/2019;FARMACIA;Gastos_Salud, saber y deporte;Farmacia;5;VARIABLES
14/05/2019;14/05/2019;R/NATURGY IBER NATURGY2763048051;-4,69;18797,74;18793,05;12130;-4,69;18793,05;2019-05-14;14/05/2019;NATURGY;Gastos_Servicios tipicos;Gas;5;FIJO
14/05/2019;14/05/2019;R/. FINQUES GASS Vto 01-05-19 Rec;-75,31;18793,05;18717,74;12131;-75,31;18717,74;2019-05-01;01/05/2019;FINQUES;Gastos_Vivienda y vehiculo;Alquiler Parking;5;FIJO
14/05/2019;14/05/2019;R/TELEFONO VODAFONE;-97,92;18717,74;18619,82;12132;-97,92;18619,82;2019-05-14;14/05/2019;TELEFONO;Gastos_Servicios tipicos;Telecomunicaciones;5;FIJO
15/05/2019;15/05/2019;T/AUTOPISTAS TERRASSA 10-05-2019;-1,44;18619,82;18618,38;12133;-1,44;18618,38;2019-05-10;10/05/2019;AUTOPISTAS;Gastos_Ocio y transporte;Parking y peaje;5;VARIABLES
16/05/2019;16/05/2019;R/SEGUROS CCM VIDA Y P Recibo:156;-18,45;18618,38;18599,93;12134;-18,45;18599,93;2019-05-16;16/05/2019;CCM;Gastos_Seguros;Seguro vida;5;FIJO
16/05/2019;16/05/2019;R/SEGUROS CCM VIDA Y P Recibo:156;-15,87;18599,93;18584,06;12135;-15,87;18584,06;2019-05-16;16/05/2019;CCM;Gastos_Seguros;Seguro vida;5;FIJO
16/05/2019;16/05/2019;R/LUZ ENDESA ENERG FACTURA DE ELE;-127,61;18584,06;18456,45;12136;-127,61;18456,45;2019-05-16;16/05/2019;ELE;Gastos_Servicios tipicos;Electricidad;5;FIJO
16/05/2019;16/05/2019;T/AUTOPISTAS TERRASSA 13-05-2019;-1,44;18456,45;18455,01;12137;-1,44;18455,01;2019-05-13;13/05/2019;AUTOPISTAS;Gastos_Ocio y transporte;Parking y peaje;5;VARIABLES
16/05/2019;16/05/2019;T/CATALUNYA CAIX/EL P 13-05-2019;-8,65;18455,01;18446,36;12138;-8,65;18446,36;2019-05-13;13/05/2019;CATALUNYA;Gastos_Ocio y transporte;Restaurantes;5;VARIABLES
16/05/2019;16/05/2019;T/MERCADONA QUATRE C/ 13-05-2019;-32,26;18446,36;18414,10;12139;-32,26;18414,10;2019-05-13;13/05/2019;MERCADONA;Gastos_Compras;Supermercado;5;VARIABLES
17/05/2019;17/05/2019;T/CATALUNYA CAIX/EL P 14-05-2019;-7,25;18414,10;18406,85;12140;-7,25;18406,85;2019-05-14;14/05/2019;CATALUNYA;Gastos_Ocio y transporte;Restaurantes;5;VARIABLES
17/05/2019;17/05/2019;T/CATALUNYA CAIX/EL P 14-05-2019;-3,00;18406,85;18403,85;12141;-3,00;18403,85;2019-05-14;14/05/2019;CATALUNYA;Gastos_Ocio y transporte;Restaurantes;5;VARIABLES
18/05/2019;16/05/2019;T/UDEMY: ONLINE COURSES;-19,99;18403,85;18383,86;12142;-19,99;18383,86;2019-05-16;16/05/2019;UDEMY;Gastos_Salud, saber y deporte;Estudios;5;VARIABLES
18/05/2019;18/05/2019;T/CATALUNYA CAIX/EL P 15-05-2019;-5,40;18383,86;18378,46;12143;-5,40;18378,46;2019-05-15;15/05/2019;CATALUNYA;Gastos_Ocio y transporte;Restaurantes;5;VARIABLES
18/05/2019;18/05/2019;T/AUTOPISTAS TERRASSA 15-05-2019;-1,44;18378,46;18377,02;12144;-1,44;18377,02;2019-05-15;15/05/2019;AUTOPISTAS;Gastos_Ocio y transporte;Parking y peaje;5;VARIABLES
18/05/2019;18/05/2019;T/AUTOPISTAS TERRASSA 15-05-2019;-1,44;18377,02;18375,58;12145;-1,44;18375,58;2019-05-15;15/05/2019;AUTOPISTAS;Gastos_Ocio y transporte;Parking y peaje;5;VARIABLES
18/05/2019;18/05/2019;T/CATALUNYA CAIX/EL P 15-05-2019;-2,00;18375,58;18373,58;12146;-2,00;18373,58;2019-05-15;15/05/2019;CATALUNYA;Gastos_Ocio y transporte;Restaurantes;5;VARIABLES
19/05/2019;19/05/2019;T/REST.PEPERONAT/EL P 16-05-2019;-11,00;18373,58;18362,58;12147;-11,00;18362,58;2019-05-16;16/05/2019;RESTPEPERONATEL;Gastos_Ocio y transporte;Restaurantes;5;VARIABLES
19/05/2019;19/05/2019;T/CATALUNYA CAIX/EL P 16-05-2019;-3,00;18362,58;18359,58;12148;-3,00;18359,58;2019-05-16;16/05/2019;CATALUNYA;Gastos_Ocio y transporte;Restaurantes;5;VARIABLES
19/05/2019;19/05/2019;T/AUTOPISTAS TERRASSA 16-05-2019;-1,44;18359,58;18358,14;12149;-1,44;18358,14;2019-05-16;16/05/2019;AUTOPISTAS;Gastos_Ocio y transporte;Parking y peaje;5;VARIABLES
19/05/2019;19/05/2019;T/AUTOPISTAS TERRASSA 16-05-2019;-1,44;18358,14;18356,70;12150;-1,44;18356,70;2019-05-16;16/05/2019;AUTOPISTAS;Gastos_Ocio y transporte;Parking y peaje;5;VARIABLES
19/05/2019;19/05/2019;T/CATALUNYA CAIX/EL P 16-05-2019;-2,00;18356,70;18354,70;12151;-2,00;18354,70;2019-05-16;16/05/2019;CATALUNYA;Gastos_Ocio y transporte;Restaurantes;5;VARIABLES
20/05/2019;20/05/2019;T/CINESA PARC VALLES/ 17-05-2019;-13,11;18354,70;18341,59;12152;-13,11;18341,59;2019-05-17;17/05/2019;CINESA;Gastos_Ocio y transporte;Espectáculos;5;VARIABLES
20/05/2019;20/05/2019;T/CINESA WEB       /B 17-05-2019;-23,60;18341,59;18317,99;12153;-23,60;18317,99;2019-05-17;17/05/2019;CINESA;Gastos_Ocio y transporte;Espectáculos;5;VARIABLES
21/05/2019;21/05/2019;T/SUPER.REYPA  /TARRA 18-05-2019;-23,28;18317,99;18294,71;12154;-23,28;18294,71;2019-05-18;18/05/2019;SUPERREYPA;Gastos_Compras;Supermercado;5;VARIABLES
21/05/2019;21/05/2019;T/BON AREA            18-05-2019;-46,22;18294,71;18248,49;12155;-46,22;18248,49;2019-05-18;18/05/2019;BON;Gastos_Compras;Supermercado;5;VARIABLES
22/05/2019;22/05/2019;T/AUTOPISTAS TERRASSA 17-05-2019;-1,44;18248,49;18247,05;12156;-1,44;18247,05;2019-05-17;17/05/2019;AUTOPISTAS;Gastos_Ocio y transporte;Parking y peaje;5;VARIABLES
22/05/2019;22/05/2019;T/LATERAL THINKING C/TERRASSA;-524,00;18247,05;17723,05;12157;-524,00;17723,05;2019-05-22;22/05/2019;LATERAL;Gastos_Salud, saber y deporte;Estudios;5;VARIABLES
23/05/2019;23/05/2019;T/CATALUNYA CAIX/EL P 20-05-2019;-3,00;17723,05;17720,05;12158;-3,00;17720,05;2019-05-20;20/05/2019;CATALUNYA;Gastos_Ocio y transporte;Restaurantes;5;VARIABLES
23/05/2019;23/05/2019;T/AUTOPISTAS TERRASSA 20-05-2019;-1,44;17720,05;17718,61;12159;-1,44;17718,61;2019-05-20;20/05/2019;AUTOPISTAS;Gastos_Ocio y transporte;Parking y peaje;5;VARIABLES
24/05/2019;24/05/2019;T/CATALUNYA CAIX/EL P 21-05-2019;-2,00;17718,61;17716,61;12160;-2,00;17716,61;2019-05-21;21/05/2019;CATALUNYA;Gastos_Ocio y transporte;Restaurantes;5;VARIABLES
24/05/2019;24/05/2019;T/PARKING VAPOR GRAN/ 21-05-2019;-3,00;17716,61;17713,61;12161;-3,00;17713,61;2019-05-21;21/05/2019;PARKING;Gastos_Ocio y transporte;Parking y peaje;5;VARIABLES
24/05/2019;24/05/2019;T/AUTOPISTAS TERRASSA 21-05-2019;-1,44;17713,61;17712,17;12162;-1,44;17712,17;2019-05-21;21/05/2019;AUTOPISTAS;Gastos_Ocio y transporte;Parking y peaje;5;VARIABLES
24/05/2019;24/05/2019;T/AUTOPISTAS TERRASSA 21-05-2019;-1,44;17712,17;17710,73;12163;-1,44;17710,73;2019-05-21;21/05/2019;AUTOPISTAS;Gastos_Ocio y transporte;Parking y peaje;5;VARIABLES
24/05/2019;24/05/2019;T/DECATHLON SA TERRA/ 21-05-2019;-20,97;17710,73;17689,76;12164;-20,97;17689,76;2019-05-21;21/05/2019;DECATHLON;Gastos_Compras;Deportivo;5;VARIABLES
24/05/2019;24/05/2019;T/FRANKFURT LES LLET/ 21-05-2019;-15,45;17689,76;17674,31;12165;-15,45;17674,31;2019-05-21;21/05/2019;FRANKFURT;Gastos_Ocio y transporte;Restaurantes;5;VARIABLES
25/05/2019;25/05/2019;T/WWW.JUST-EAT.ES 22-05-2019;-25,20;17674,31;17649,11;12166;-25,20;17649,11;2019-05-22;22/05/2019;WWWJUSTEATES;Gastos_Ocio y transporte;Restaurantes;5;VARIABLES
25/05/2019;25/05/2019;T/VIENA PARC VALLES / 22-05-2019;-5,80;17649,11;17643,31;12167;-5,80;17643,31;2019-05-22;22/05/2019;VIENA;Gastos_Ocio y transporte;Restaurantes;5;VARIABLES
25/05/2019;25/05/2019;T/REDONDEO S0LIDARI/B 22-05-2019;-0,20;17643,31;17643,11;12168;-0,20;17643,11;2019-05-22;22/05/2019;REDONDEO;Gastos_Salud, saber y deporte;Solidaridad;5;VARIABLES
25/05/2019;25/05/2019;T/TIGER /TERRA 22-05-2019;-11,00;17643,11;17632,11;12169;-11,00;17632,11;2019-05-22;22/05/2019;TIGER;Gastos_Compras;Otras compras;5;VARIABLES
26/05/2019;26/05/2019;T/BON AREA 23-05-2019;-34,30;17632,11;17597,81;12170;-34,30;17597,81;2019-05-23;23/05/2019;BON;Gastos_Compras;Supermercado;5;VARIABLES
26/05/2019;26/05/2019;T/CATALUNYA CAIX/EL P 23-05-2019;-3,25;17597,81;17594,56;12171;-3,25;17594,56;2019-05-23;23/05/2019;CATALUNYA;Gastos_Ocio y transporte;Restaurantes;5;VARIABLES
26/05/2019;26/05/2019;T/AUTOPISTAS TERRASSA 23-05-2019;-1,44;17594,56;17593,12;12172;-1,44;17593,12;2019-05-23;23/05/2019;AUTOPISTAS;Gastos_Ocio y transporte;Parking y peaje;5;VARIABLES
26/05/2019;26/05/2019;T/AUTOPISTAS TERRASSA 23-05-2019;-1,44;17593,12;17591,68;12173;-1,44;17591,68;2019-05-23;23/05/2019;AUTOPISTAS;Gastos_Ocio y transporte;Parking y peaje;5;VARIABLES
27/05/2019;27/05/2019;T/E.S. CAN CASANOVES/ 24-05-2019;-30,00;17591,68;17561,68;12174;-30,00;17561,68;2019-05-24;24/05/2019;CAN;Gastos_Ocio y transporte;Gasolina;5;VARIABLES
27/05/2019;27/05/2019;T/SUPER.REYPA /TARRA 24-05-2019;-8,40;17561,68;17553,28;12175;-8,40;17553,28;2019-05-24;24/05/2019;SUPERREYPA;Gastos_Compras;Supermercado;5;VARIABLES
28/05/2019;28/05/2019;HAB.AJUNTAMENT DE TERRASSA Transfe;1853,60;17553,28;19406,88;12176;1853,60;19406,88;2019-05-28;28/05/2019;HABAJUNTAMENT;Ingresos;Nomina;5;FIJO
28/05/2019;28/05/2019;T/BON AREA 25-05-2019;-17,34;19406,88;19389,54;12177;-17,34;19389,54;2019-05-25;25/05/2019;BON;Gastos_Compras;Supermercado;5;VARIABLES
28/05/2019;28/05/2019;T/WWW.JUST-EAT.ES 25-05-2019;-31,35;19389,54;19358,19;12178;-31,35;19358,19;2019-05-25;25/05/2019;WWWJUSTEATES;Gastos_Ocio y transporte;Restaurantes;5;VARIABLES
28/05/2019;28/05/2019;T/AUTOPISTAS TERRASSA 24-05-2019;-1,44;19358,19;19356,75;12179;-1,44;19356,75;2019-05-24;24/05/2019;AUTOPISTAS;Gastos_Ocio y transporte;Parking y peaje;5;VARIABLES
29/05/2019;29/05/2019;TRANSFBBVABCLM;1200,00;19356,75;20556,75;12180;1200,00;20556,75;2019-05-29;29/05/2019;TRANSFBBVABCLM;No computable;traspasos, transf.;5;
29/05/2019;29/05/2019;T/WWW.JUST-EAT.ES 26-05-2019;-33,50;20556,75;20523,25;12181;-33,50;20523,25;2019-05-26;26/05/2019;WWWJUSTEATES;Gastos_Ocio y transporte;Restaurantes;5;VARIABLES
29/05/2019;29/05/2019;'T/MON GRAN D''OCI / 26-05-2019';-6,60;20523,25;20516,65;12182;-6,60;20516,65;2019-05-26;26/05/2019;MON;Gastos_Ocio y transporte;Otros ocio;5;VARIABLES
30/05/2019;30/05/2019;T/FRUTAS Y VERDURAS / 27-05-2019;-9,36;20516,65;20507,29;12183;-9,36;20507,29;2019-05-27;27/05/2019;FRUTAS;Gastos_Compras;Supermercado;5;VARIABLES
30/05/2019;30/05/2019;T/CATALUNYA CAIX/EL P 27-05-2019;-3,00;20507,29;20504,29;12184;-3,00;20504,29;2019-05-27;27/05/2019;CATALUNYA;Gastos_Ocio y transporte;Restaurantes;5;VARIABLES
30/05/2019;30/05/2019;CAJ. AJENOB.B.V.A. /TERRASSA;-300,00;20504,29;20204,29;12185;-300,00;20204,29;2019-05-30;30/05/2019;CAJ;Gastos_Gastos varios;Efectivo;5;VARIABLES
30/05/2019;30/05/2019;COM.64970036 SVRED CAJ OFI;-1,87;20204,29;20202,42;12186;-1,87;20202,42;2019-05-30;30/05/2019;COM;Gastos_Banco y organismos;Cargos banco;5;FIJO
31/05/2019;31/05/2019;REC.6061.9600001223;-448,11;20202,42;19754,31;12187;-448,11;19754,31;2019-05-31;31/05/2019;REC;Gastos_Banco y organismos;Hipoteca;5;FIJO
31/05/2019;31/05/2019;T/CATALUNYA CAIX/EL PRAT DE L;-3,40;19754,31;19750,91;12188;-3,40;19750,91;2019-05-31;31/05/2019;CATALUNYA;Gastos_Ocio y transporte;Restaurantes;5;VARIABLES
31/05/2019;27/05/2019;T/AUTOPISTAS TERRASSA MANRE;-1,44;19750,91;19749,47;12189;-1,44;19749,47;2019-05-27;27/05/2019;AUTOPISTAS;Gastos_Ocio y transporte;Parking y peaje;5;VARIABLES
31/05/2019;27/05/2019;T/AUTOPISTAS TERRASSA MANRE;-1,44;19749,47;19748,03;12190;-1,44;19748,03;2019-05-27;27/05/2019;AUTOPISTAS;Gastos_Ocio y transporte;Parking y peaje;5;VARIABLES
31/05/2019;28/05/2019;T/AUTOPISTAS TERRASSA MANRE;-1,44;19748,03;19746,59;12191;-1,44;19746,59;2019-05-28;28/05/2019;AUTOPISTAS;Gastos_Ocio y transporte;Parking y peaje;5;VARIABLES
31/05/2019;28/05/2019;T/AUTOPISTAS TERRASSA MANRE;-1,44;19746,59;19745,15;12192;-1,44;19745,15;2019-05-28;28/05/2019;AUTOPISTAS;Gastos_Ocio y transporte;Parking y peaje;5;VARIABLES
31/05/2019;31/05/2019;T/CATALUNYA CAIX/EL P 28-05-2019;-2,80;19745,15;19742,35;12193;-2,80;19742,35;2019-05-28;28/05/2019;CATALUNYA;Gastos_Ocio y transporte;Restaurantes;5;VARIABLES
01/06/2019;01/06/2019;FACT TARJETASTARJ.CREDITO 07126017 19-06-01;-307,98;19742,35;19434,37;12194;-307,98;19434,37;2019-06-01;31/05/2019;FACT;No computable;Recibo Tarjeta;5;
01/06/2019;01/06/2019;FACT TARJETASTARJ.CREDITO 42689013 19-06-01;-50,44;19434,37;19383,93;12195;-50,44;19383,93;2019-06-01;31/05/2019;FACT;No computable;Recibo Tarjeta;5;
01/06/2019;01/06/2019;T/SUPER.REYPA /TARRASA/TERRA;-9,91;19383,93;19374,02;12196;-9,91;19374,02;2019-06-01;01/06/2019;SUPERREYPA;Gastos_Compras;Supermercado;6;VARIABLES
01/06/2019;01/06/2019;T/BAR AMORES /VACARISSES;-20,00;19374,02;19354,02;12197;-20,00;19354,02;2019-06-01;01/06/2019;BAR;Gastos_Ocio y transporte;Restaurantes;6;VARIABLES
01/06/2019;30/05/2019;T/AMZN Mktp ES*MN7B59IR4;-12,99;19354,02;19341,03;12198;-12,99;19341,03;2019-05-30;30/05/2019;AMZN;Gastos_Compras;Hobbys;5;VARIABLES
01/06/2019;30/05/2019;T/AUTOPISTAS TERRASSA MANRE;-1,44;19341,03;19339,59;12199;-1,44;19339,59;2019-05-30;30/05/2019;AUTOPISTAS;Gastos_Ocio y transporte;Parking y peaje;5;VARIABLES
01/06/2019;30/05/2019;T/AUTOPISTAS TERRASSA MANRE;-1,44;19339,59;19338,15;12200;-1,44;19338,15;2019-05-30;30/05/2019;AUTOPISTAS;Gastos_Ocio y transporte;Parking y peaje;5;VARIABLES
01/06/2019;30/05/2019;T/CARREFOUR VALLE;-6,77;19338,15;19331,38;12201;-6,77;19331,38;2019-05-30;30/05/2019;CARREFOUR;Gastos_Compras;Supermercado;5;VARIABLES
01/06/2019;01/06/2019;T/CATALUNYA CAIX/EL P 29-05-2019;-3,00;19331,38;19328,38;12202;-3,00;19328,38;2019-05-29;29/05/2019;CATALUNYA;Gastos_Ocio y transporte;Restaurantes;5;VARIABLES
01/06/2019;01/06/2019;T/AUTOPISTAS TERRASSA 29-05-2019;-1,44;19328,38;19326,94;12203;-1,44;19326,94;2019-05-29;29/05/2019;AUTOPISTAS;Gastos_Ocio y transporte;Parking y peaje;5;VARIABLES
01/06/2019;01/06/2019;T/AUTOPISTAS TERRASSA 29-05-2019;-1,44;19326,94;19325,50;12204;-1,44;19325,50;2019-05-29;29/05/2019;AUTOPISTAS;Gastos_Ocio y transporte;Parking y peaje;5;VARIABLES
01/06/2019;01/06/2019;T/BON AREA 29-05-2019;-24,95;19325,50;19300,55;12205;-24,95;19300,55;2019-05-29;29/05/2019;BON;Gastos_Compras;Supermercado;5;VARIABLES
02/06/2019;02/06/2019;T/SATURN E515 EL/PRAT 30-05-2019;-121,03;19300,55;19179,52;12206;-121,03;19179,52;2019-05-30;30/05/2019;SATURN;Gastos_Compras;Hobbys;5;VARIABLES
02/06/2019;02/06/2019;T/FORN CARNE / 30-05-2019;-13,13;19179,52;19166,39;12207;-13,13;19166,39;2019-05-30;30/05/2019;FORN;Gastos_Compras;Supermercado;5;VARIABLES
02/06/2019;02/06/2019;T/CATALUNYA CAIX/EL P 30-05-2019;-2,00;19166,39;19164,39;12208;-2,00;19164,39;2019-05-30;30/05/2019;CATALUNYA;Gastos_Ocio y transporte;Restaurantes;5;VARIABLES
02/06/2019;02/06/2019;T/WWW.JUST-EAT.ES 30-05-2019;-32,55;19164,39;19131,84;12209;-32,55;19131,84;2019-05-30;30/05/2019;WWWJUSTEATES;Gastos_Ocio y transporte;Restaurantes;5;VARIABLES
04/06/2019;31/05/2019;T/AMZN Mktp ES*MN02A9I74;-19,90;19131,84;19111,94;12210;-19,90;19111,94;2019-05-31;31/05/2019;AMZN;Gastos_Compras;Hobbys;5;VARIABLES
04/06/2019;04/06/2019;T/BON AREA 01-06-2019;-2,15;19111,94;19109,79;12211;-2,15;19109,79;2019-06-01;01/06/2019;BON;Gastos_Compras;Supermercado;6;VARIABLES
04/06/2019;04/06/2019;T/AUTOPISTAS TERRASSA 31-05-2019;-1,44;19109,79;19108,35;12212;-1,44;19108,35;2019-05-31;31/05/2019;AUTOPISTAS;Gastos_Ocio y transporte;Parking y peaje;5;VARIABLES
05/06/2019;05/06/2019;T/WWW.JUST-EAT.ES 02-06-2019;-19,99;19108,35;19088,36;12213;-19,99;19088,36;2019-06-02;02/06/2019;WWWJUSTEATES;Gastos_Ocio y transporte;Restaurantes;6;VARIABLES
06/06/2019;06/06/2019;R/LUZ ENDESA ENERG FACTURA DE GAS;-123,99;19088,36;18964,37;12214;-123,99;18964,37;2019-06-06;06/06/2019;GAS;Gastos_Servicios tipicos;Gas;6;FIJO
06/06/2019;04/06/2019;T/AMZN Mktp ES*M65WB6CQ4;-34,95;18964,37;18929,42;12215;-34,95;18929,42;2019-06-04;04/06/2019;AMZN;Gastos_Compras;Hobbys;6;VARIABLES
07/06/2019;07/06/2019;R/SERHS FOOD A Comedor Junio/ 20;-83,30;18929,42;18846,12;12216;-83,30;18846,12;2019-06-07;07/06/2019;SERHS;Gastos_Salud, saber y deporte;Menjador;6;FIJO
07/06/2019;07/06/2019;R/SERHS FOOD A Comedor Junio/ 20;-24,50;18846,12;18821,62;12217;-24,50;18821,62;2019-06-07;07/06/2019;SERHS;Gastos_Salud, saber y deporte;Menjador;6;FIJO
07/06/2019;07/06/2019;T/WWW.JUST-EAT.ES 04-06-2019;-31,25;18821,62;18790,37;12218;-31,25;18790,37;2019-06-04;04/06/2019;WWWJUSTEATES;Gastos_Ocio y transporte;Restaurantes;6;VARIABLES
09/06/2019;09/06/2019;T/GLORIAS / 06-06-2019;-3,98;18790,37;18786,39;12219;-3,98;18786,39;2019-06-06;06/06/2019;GLORIAS;Gastos_Ocio y transporte;Espectáculos;6;VARIABLES
09/06/2019;09/06/2019;T/LIDL TERRASSA-LES / 06-06-2019;-73,64;18786,39;18712,75;12220;-73,64;18712,75;2019-06-06;06/06/2019;LIDL;Gastos_Compras;Supermercado;6;VARIABLES
10/06/2019;10/06/2019;T/FRUTAS Y VERDURAS / 07-06-2019;-7,60;18712,75;18705,15;12221;-7,60;18705,15;2019-06-07;07/06/2019;FRUTAS;Gastos_Compras;Supermercado;6;VARIABLES
10/06/2019;10/06/2019;T/BON AREA 07-06-2019;-17,85;18705,15;18687,30;12222;-17,85;18687,30;2019-06-07;07/06/2019;BON;Gastos_Compras;Supermercado;6;VARIABLES
10/06/2019;10/06/2019;T/WWW.JUST-EAT.ES 07-06-2019;-49,90;18687,30;18637,40;12223;-49,90;18637,40;2019-06-07;07/06/2019;WWWJUSTEATES;Gastos_Ocio y transporte;Restaurantes;6;VARIABLES
11/06/2019;11/06/2019;T/WWW.JUST-EAT.ES 08-06-2019;-35,75;18637,40;18601,65;12224;-35,75;18601,65;2019-06-08;08/06/2019;WWWJUSTEATES;Gastos_Ocio y transporte;Restaurantes;6;VARIABLES
12/06/2019;12/06/2019;R/. FINQUES GASS Vto 01-06-19 Rec;-75,31;18601,65;18526,34;12225;-75,31;18526,34;2019-06-01;01/06/2019;FINQUES;Gastos_Vivienda y vehiculo;Alquiler Parking;6;FIJO
13/06/2019;13/06/2019;'R/L.EINA COOPERA L''EINA COOPE Reb';-48,75;18526,34;18477,59;12226;-48,75;18477,59;2019-06-13;13/06/2019;LEINA;Gastos_Salud, saber y deporte;Estudios;6;VARIABLES
13/06/2019;13/06/2019;R/NATURGY IBER NATURGY2763048061;-4,69;18477,59;18472,90;12227;-4,69;18472,90;2019-06-13;13/06/2019;NATURGY;Gastos_Servicios tipicos;Gas;6;FIJO
13/06/2019;13/06/2019;T/KIABI BARICENT/BARB 10-06-2019;-63,00;18472,90;18409,90;12228;-63,00;18409,90;2019-06-10;10/06/2019;KIABI;Gastos_Compras;Ropa;6;VARIABLES
13/06/2019;13/06/2019;T/BARICENTRO L 4/BARB 10-06-2019;-5,65;18409,90;18404,25;12229;-5,65;18404,25;2019-06-10;10/06/2019;BARICENTRO;Gastos_Ocio y transporte;Restaurantes;6;VARIABLES
13/06/2019;13/06/2019;T/AUTOPISTAS TERRASSA 07-06-2019;-1,44;18404,25;18402,81;12230;-1,44;18402,81;2019-06-07;07/06/2019;AUTOPISTAS;Gastos_Ocio y transporte;Parking y peaje;6;VARIABLES
14/06/2019;14/06/2019;R/TELEFONO VODAFONE;-97,92;18402,81;18304,89;12231;-97,92;18304,89;2019-06-14;14/06/2019;TELEFONO;Gastos_Servicios tipicos;Telecomunicaciones;6;FIJO
14/06/2019;14/06/2019;T/PARKING VAPOR GRAN/ 11-06-2019;-5,55;18304,89;18299,34;12232;-5,55;18299,34;2019-06-11;11/06/2019;PARKING;Gastos_Ocio y transporte;Parking y peaje;6;VARIABLES
14/06/2019;14/06/2019;T/FRANKFURT LES LLET/ 11-06-2019;-13,85;18299,34;18285,49;12233;-13,85;18285,49;2019-06-11;11/06/2019;FRANKFURT;Gastos_Ocio y transporte;Restaurantes;6;VARIABLES
14/06/2019;14/06/2019;T/EL SALON THE BARBE/ 11-06-2019;-61,41;18285,49;18224,08;12234;-61,41;18224,08;2019-06-11;11/06/2019;SALON;Gastos_Salud, saber y deporte;Belleza;6;VARIABLES
15/06/2019;15/06/2019;T/SUPER.REYPA /TARRASA/TERRA;-9,15;18224,08;18214,93;12235;-9,15;18214,93;2019-06-15;15/06/2019;SUPERREYPA;Gastos_Compras;Supermercado;6;VARIABLES
15/06/2019;15/06/2019;T/E.S. CAN CASANOVES/TERRASSA;-31,85;18214,93;18183,08;12236;-31,85;18183,08;2019-06-15;15/06/2019;CAN;Gastos_Ocio y transporte;Gasolina;6;VARIABLES
15/06/2019;12/06/2019;T/AUTOPISTAS TERRASSA MANRE;-1,44;18183,08;18181,64;12237;-1,44;18181,64;2019-06-12;12/06/2019;AUTOPISTAS;Gastos_Ocio y transporte;Parking y peaje;6;VARIABLES
15/06/2019;13/06/2019;T/AUTOPISTAS TERRASSA MANRE;-1,44;18181,64;18180,20;12238;-1,44;18180,20;2019-06-13;13/06/2019;AUTOPISTAS;Gastos_Ocio y transporte;Parking y peaje;6;VARIABLES
15/06/2019;13/06/2019;T/AUTOPISTAS TERRASSA MANRE;-1,44;18180,20;18178,76;12239;-1,44;18178,76;2019-06-13;13/06/2019;AUTOPISTAS;Gastos_Ocio y transporte;Parking y peaje;6;VARIABLES
15/06/2019;15/06/2019;T/CATALUNYA CAIX/EL P 12-06-2019;-1,95;18178,76;18176,81;12240;-1,95;18176,81;2019-06-12;12/06/2019;CATALUNYA;Gastos_Ocio y transporte;Restaurantes;6;VARIABLES
15/06/2019;15/06/2019;T/CINESA WEB /B 12-06-2019;-13,80;18176,81;18163,01;12241;-13,80;18163,01;2019-06-12;12/06/2019;CINESA;Gastos_Ocio y transporte;Espectáculos;6;VARIABLES
15/06/2019;15/06/2019;T/CINESA PARC VALLES/ 12-06-2019;-13,50;18163,01;18149,51;12242;-13,50;18149,51;2019-06-12;12/06/2019;CINESA;Gastos_Ocio y transporte;Espectáculos;6;VARIABLES
16/06/2019;16/06/2019;T/BON AREA 13-06-2019;-26,67;18149,51;18122,84;12243;-26,67;18122,84;2019-06-13;13/06/2019;BON;Gastos_Compras;Supermercado;6;VARIABLES
16/06/2019;16/06/2019;T/CATALUNYA CAIX/EL P 13-06-2019;-3,20;18122,84;18119,64;12244;-3,20;18119,64;2019-06-13;13/06/2019;CATALUNYA;Gastos_Ocio y transporte;Restaurantes;6;VARIABLES
17/06/2019;17/06/2019;R/SEGUROS CCM VIDA Y P Recibo:156;-15,80;18119,64;18103,84;12245;-15,80;18103,84;2019-06-17;17/06/2019;CCM;Gastos_Seguros;Seguro vida;6;FIJO
17/06/2019;17/06/2019;R/SEGUROS CCM VIDA Y P Recibo:156;-18,38;18103,84;18085,46;12246;-18,38;18085,46;2019-06-17;17/06/2019;CCM;Gastos_Seguros;Seguro vida;6;FIJO
17/06/2019;17/06/2019;T/WWW.JUST-EAT.ES 14-06-2019;-32,55;18085,46;18052,91;12247;-32,55;18052,91;2019-06-14;14/06/2019;WWWJUSTEATES;Gastos_Ocio y transporte;Restaurantes;6;VARIABLES
17/06/2019;17/06/2019;T/TOCINERIES VENTURA/ 14-06-2019;-9,08;18052,91;18043,83;12248;-9,08;18043,83;2019-06-14;14/06/2019;TOCINERIES;Gastos_Compras;Supermercado;6;VARIABLES
17/06/2019;17/06/2019;T/CATALUNYA CAIX/EL P 14-06-2019;-2,90;18043,83;18040,93;12249;-2,90;18040,93;2019-06-14;14/06/2019;CATALUNYA;Gastos_Ocio y transporte;Restaurantes;6;VARIABLES
17/06/2019;17/06/2019;T/TARRASSA CARNES IND 14-06-2019;-96,22;18040,93;17944,71;12250;-96,22;17944,71;2019-06-14;14/06/2019;TARRASSA;Gastos_Compras;Supermercado;6;VARIABLES
19/06/2019;19/06/2019;T/AUTOPISTAS TERRASSA 15-06-2019;-2,62;17944,71;17942,09;12251;-2,62;17942,09;2019-06-15;15/06/2019;AUTOPISTAS;Gastos_Ocio y transporte;Parking y peaje;6;VARIABLES
19/06/2019;19/06/2019;T/AUTOPISTAS TERRASSA 14-06-2019;-1,44;17942,09;17940,65;12252;-1,44;17940,65;2019-06-14;14/06/2019;AUTOPISTAS;Gastos_Ocio y transporte;Parking y peaje;6;VARIABLES
19/06/2019;19/06/2019;T/AUTOPISTAS TERRASSA 14-06-2019;-1,44;17940,65;17939,21;12253;-1,44;17939,21;2019-06-14;14/06/2019;AUTOPISTAS;Gastos_Ocio y transporte;Parking y peaje;6;VARIABLES
20/06/2019;20/06/2019;R/ MINA PUBLICA AIGUES T.01A75789;-55,87;17939,21;17883,34;12254;-55,87;17883,34;2019-06-20;20/06/2019;MINA;Gastos_Servicios tipicos;Agua;6;FIJO
20/06/2019;20/06/2019;T/CATALUNYA CAIX/EL P 17-06-2019;-3,70;17883,34;17879,64;12255;-3,70;17879,64;2019-06-17;17/06/2019;CATALUNYA;Gastos_Ocio y transporte;Restaurantes;6;VARIABLES
20/06/2019;20/06/2019;T/A.C.E.S.A S CELON-L 15-06-2019;-2,20;17879,64;17877,44;12256;-2,20;17877,44;2019-06-15;15/06/2019;ACESA;Gastos_Ocio y transporte;Parking y peaje;6;VARIABLES
20/06/2019;20/06/2019;T/A.C.E.S.A LA ROCA-S 15-06-2019;-2,20;17877,44;17875,24;12257;-2,20;17875,24;2019-06-15;15/06/2019;ACESA;Gastos_Ocio y transporte;Parking y peaje;6;VARIABLES
21/06/2019;21/06/2019;HAB.AJUNTAMENT DE TERRASSA Transfe;3939,09;17875,24;21814,33;12258;3939,09;21814,33;2019-06-21;21/06/2019;HABAJUNTAMENT;Ingresos;Nomina;6;FIJO
21/06/2019;21/06/2019;T/AUTOPISTAS TERRASSA 18-06-2019;-1,44;21814,33;21812,89;12259;-1,44;21812,89;2019-06-18;18/06/2019;AUTOPISTAS;Gastos_Ocio y transporte;Parking y peaje;6;VARIABLES
21/06/2019;21/06/2019;T/AUTOPISTAS TERRASSA 18-06-2019;-1,44;21812,89;21811,45;12260;-1,44;21811,45;2019-06-18;18/06/2019;AUTOPISTAS;Gastos_Ocio y transporte;Parking y peaje;6;VARIABLES
21/06/2019;21/06/2019;T/DECATHLON SA TERRA/ 18-06-2019;-65,94;21811,45;21745,51;12261;-65,94;21745,51;2019-06-18;18/06/2019;DECATHLON;Gastos_Compras;Deportivo;6;VARIABLES
21/06/2019;21/06/2019;T/BON AREA 18-06-2019;-14,42;21745,51;21731,09;12262;-14,42;21731,09;2019-06-18;18/06/2019;BON;Gastos_Compras;Supermercado;6;VARIABLES
21/06/2019;21/06/2019;T/FRUTAS Y VERDURAS / 18-06-2019;-13,88;21731,09;21717,21;12263;-13,88;21717,21;2019-06-18;18/06/2019;FRUTAS;Gastos_Compras;Supermercado;6;VARIABLES
21/06/2019;21/06/2019;T/AUTOPISTAS TERRASSA 17-06-2019;-1,44;21717,21;21715,77;12264;-1,44;21715,77;2019-06-17;17/06/2019;AUTOPISTAS;Gastos_Ocio y transporte;Parking y peaje;6;VARIABLES
22/06/2019;22/06/2019;T/CATALUNYA CAIX/EL P 19-06-2019;-2,90;21715,77;21712,87;12265;-2,90;21712,87;2019-06-19;19/06/2019;CATALUNYA;Gastos_Ocio y transporte;Restaurantes;6;VARIABLES
23/06/2019;20/06/2019;T/AUTOPISTAS TERRASSA MANRE;-1,44;21712,87;21711,43;12266;-1,44;21711,43;2019-06-20;20/06/2019;AUTOPISTAS;Gastos_Ocio y transporte;Parking y peaje;6;VARIABLES
23/06/2019;23/06/2019;T/AUTOPISTAS TERRASSA 20-06-2019;-1,44;21711,43;21709,99;12267;-1,44;21709,99;2019-06-20;20/06/2019;AUTOPISTAS;Gastos_Ocio y transporte;Parking y peaje;6;VARIABLES
23/06/2019;23/06/2019;T/BON AREA 20-06-2019;-15,32;21709,99;21694,67;12268;-15,32;21694,67;2019-06-20;20/06/2019;BON;Gastos_Compras;Supermercado;6;VARIABLES
23/06/2019;23/06/2019;T/CATALUNYA CAIX/EL P 20-06-2019;-3,00;21694,67;21691,67;12269;-3,00;21691,67;2019-06-20;20/06/2019;CATALUNYA;Gastos_Ocio y transporte;Restaurantes;6;VARIABLES
23/06/2019;23/06/2019;T/AUTOPISTAS TERRASSA 19-06-2019;-1,44;21691,67;21690,23;12270;-1,44;21690,23;2019-06-19;19/06/2019;AUTOPISTAS;Gastos_Ocio y transporte;Parking y peaje;6;VARIABLES
24/06/2019;24/06/2019;T/FRANKFURT VALLES / 21-06-2019;-25,60;21690,23;21664,63;12271;-25,60;21664,63;2019-06-21;21/06/2019;FRANKFURT;Gastos_Ocio y transporte;Restaurantes;6;VARIABLES
25/06/2019;25/06/2019;T/PARC VALLES /TERRASSA;-109,62;21664,63;21555,01;12272;-109,62;21555,01;2019-06-25;25/06/2019;PARC;Gastos_Compras;Supermercado;6;VARIABLES
25/06/2019;25/06/2019;T/PARC VALLES / 22-06-2019;-69,08;21555,01;21485,93;12273;-69,08;21485,93;2019-06-22;22/06/2019;PARC;Gastos_Compras;Supermercado;6;VARIABLES
25/06/2019;25/06/2019;T/REST.KAORI /BARBE 22-06-2019;-57,80;21485,93;21428,13;12274;-57,80;21428,13;2019-06-22;22/06/2019;RESTKAORI;Gastos_Ocio y transporte;Restaurantes;6;VARIABLES
26/06/2019;26/06/2019;T/WWW.JUST-EAT.ES 23-06-2019;-25,10;21428,13;21403,03;12275;-25,10;21403,03;2019-06-23;23/06/2019;WWWJUSTEATES;Gastos_Ocio y transporte;Restaurantes;6;VARIABLES
26/06/2019;26/06/2019;T/AUTOPISTAS TERRASSA 21-06-2019;-1,44;21403,03;21401,59;12276;-1,44;21401,59;2019-06-21;21/06/2019;AUTOPISTAS;Gastos_Ocio y transporte;Parking y peaje;6;VARIABLES
28/06/2019;28/06/2019;'R/AJUNTAMENT D I.B.I. CA D''ALBI';-48,62;21401,59;21352,97;12277;-48,62;21352,97;2019-06-28;28/06/2019;AJUNTAMENT;Gastos_Banco y organismos;Ayuntamiento;6;FIJO
28/06/2019;28/06/2019;T/PARKING VAPOR GRAN/ 25-06-2019;-2,60;21352,97;21350,37;12278;-2,60;21350,37;2019-06-25;25/06/2019;PARKING;Gastos_Ocio y transporte;Parking y peaje;6;VARIABLES
29/06/2019;29/06/2019;T/AUTOPISTAS TERRASSA 26-06-2019;-1,44;21350,37;21348,93;12279;-1,44;21348,93;2019-06-26;26/06/2019;AUTOPISTAS;Gastos_Ocio y transporte;Parking y peaje;6;VARIABLES
29/06/2019;29/06/2019;T/CATALUNYA CAIX/EL P 26-06-2019;-1,95;21348,93;21346,98;12280;-1,95;21346,98;2019-06-26;26/06/2019;CATALUNYA;Gastos_Ocio y transporte;Restaurantes;6;VARIABLES
29/06/2019;29/06/2019;T/CINESA WEB /B 26-06-2019;-19,60;21346,98;21327,38;12281;-19,60;21327,38;2019-06-26;26/06/2019;CINESA;Gastos_Ocio y transporte;Espectáculos;6;VARIABLES
29/06/2019;29/06/2019;T/AUTOPISTAS TERRASSA 25-06-2019;-1,44;21327,38;21325,94;12282;-1,44;21325,94;2019-06-25;25/06/2019;AUTOPISTAS;Gastos_Ocio y transporte;Parking y peaje;6;VARIABLES
30/06/2019;30/06/2019;REC.6061.9600001223;-448,11;21325,94;20877,83;12283;-448,11;20877,83;2019-06-30;30/06/2019;REC;Gastos_Banco y organismos;Hipoteca;6;FIJO
30/06/2019;30/06/2019;T/AUTOPISTAS TERRASSA 27-06-2019;-1,44;20877,83;20876,39;12284;-1,44;20876,39;2019-06-27;27/06/2019;AUTOPISTAS;Gastos_Ocio y transporte;Parking y peaje;6;VARIABLES
30/06/2019;30/06/2019;T/CATALUNYA CAIX/EL P 27-06-2019;-1,95;20876,39;20874,44;12285;-1,95;20874,44;2019-06-27;27/06/2019;CATALUNYA;Gastos_Ocio y transporte;Restaurantes;6;VARIABLES
30/06/2019;30/06/2019;T/FUND.RUBRICAT /PRAT 27-06-2019;-9,50;20874,44;20864,94;12286;-9,50;20864,94;2019-06-27;27/06/2019;FUNDRUBRICAT;Gastos_Ocio y transporte;Restaurantes;6;VARIABLES
30/06/2019;30/06/2019;T/CATALUNYA CAIX/EL P 27-06-2019;-1,50;20864,94;20863,44;12287;-1,50;20863,44;2019-06-27;27/06/2019;CATALUNYA;Gastos_Ocio y transporte;Restaurantes;6;VARIABLES
01/07/2019;01/07/2019;FACT TARJETASTARJ.CREDITO 07126017 19-07-01;-255,81;20863,44;20607,63;12288;-255,81;20607,63;2019-07-01;30/06/2019;FACT;No computable;Recibo Tarjeta;6;
01/07/2019;01/07/2019;FACT TARJETASTARJ.CREDITO 42689013 19-07-01;-560,89;20607,63;20046,74;12289;-560,89;20046,74;2019-07-01;30/06/2019;FACT;No computable;Recibo Tarjeta;6;
01/07/2019;01/07/2019;TRANSFBBVABCLM;1200,00;20046,74;21246,74;12290;1200,00;21246,74;2019-07-01;01/07/2019;TRANSFBBVABCLM;No computable;traspasos, transf.;7;
01/07/2019;01/07/2019;'R/L.EINA COOPERA L''EINA COOPE Reb';-10,00;21246,74;21236,74;12291;-10,00;21236,74;2019-07-01;01/07/2019;LEINA;Gastos_Salud, saber y deporte;Estudios;7;VARIABLES
01/07/2019;01/07/2019;T/CATALUNYA CAIX/EL P 28-06-2019;-1,60;21236,74;21235,14;12292;-1,60;21235,14;2019-06-28;28/06/2019;CATALUNYA;Gastos_Ocio y transporte;Restaurantes;6;VARIABLES
02/07/2019;02/07/2019;TESORO PUBLICOI R P F (IMPTO;-162,10;21235,14;21073,04;12293;-162,10;21073,04;2019-07-02;02/07/2019;TESORO;Gastos_Banco y organismos;Impuestos;7;FIJO
02/07/2019;28/06/2019;T/PlaystationNetwork;-59,99;21073,04;21013,05;12294;-59,99;21013,05;2019-06-28;28/06/2019;PLAYSTATIONNETWORK;Gastos_Servicios tipicos;Servicios online;6;FIJO
02/07/2019;30/06/2019;T/PlaystationNetwork;-18,99;21013,05;20994,06;12295;-18,99;20994,06;2019-06-30;30/06/2019;PLAYSTATIONNETWORK;Gastos_Servicios tipicos;Servicios online;6;FIJO
02/07/2019;02/07/2019;T/WWW.JUST-EAT.ES 29-06-2019;-24,95;20994,06;20969,11;12296;-24,95;20969,11;2019-06-29;29/06/2019;WWWJUSTEATES;Gastos_Ocio y transporte;Restaurantes;6;VARIABLES
03/07/2019;03/07/2019;R/AJUNTAMENT D IMPOST VEHICLES T;-62,78;20969,11;20906,33;12297;-62,78;20906,33;2019-07-03;03/07/2019;AJUNTAMENT;Gastos_Banco y organismos;Ayuntamiento;7;FIJO
04/07/2019;04/07/2019;T/CATALUNYA CAIX/EL P 01-07-2019;-2,75;20906,33;20903,58;12298;-2,75;20903,58;2019-07-01;01/07/2019;CATALUNYA;Gastos_Ocio y transporte;Restaurantes;7;VARIABLES
05/07/2019;05/07/2019;R/Ajuntament d Abonaments IMES j;-36,40;20903,58;20867,18;12299;-36,40;20867,18;2019-07-05;05/07/2019;AJUNTAMENT;Gastos_Banco y organismos;Ayuntamiento;7;FIJO
05/07/2019;02/07/2019;T/AMAZON .ES*M62XD9S14 AM;-225,00;20867,18;20642,18;12300;-225,00;20642,18;2019-07-02;02/07/2019;AMAZON;Gastos_Compras;Hobbys;7;VARIABLES
06/07/2019;06/07/2019;T/CATALUNYA CAIX/EL P 03-07-2019;-3,85;20642,18;20638,33;12301;-3,85;20638,33;2019-07-03;03/07/2019;CATALUNYA;Gastos_Ocio y transporte;Restaurantes;7;VARIABLES
07/07/2019;07/07/2019;T/AUTOPISTAS TERRASSA 04-07-2019;-1,44;20638,33;20636,89;12302;-1,44;20636,89;2019-07-04;04/07/2019;AUTOPISTAS;Gastos_Ocio y transporte;Parking y peaje;7;VARIABLES
07/07/2019;07/07/2019;T/AUTOPISTAS TERRASSA 04-07-2019;-1,44;20636,89;20635,45;12303;-1,44;20635,45;2019-07-04;04/07/2019;AUTOPISTAS;Gastos_Ocio y transporte;Parking y peaje;7;VARIABLES
07/07/2019;07/07/2019;T/CATALUNYA CAIX/EL P 04-07-2019;-3,50;20635,45;20631,95;12304;-3,50;20631,95;2019-07-04;04/07/2019;CATALUNYA;Gastos_Ocio y transporte;Restaurantes;7;VARIABLES
08/07/2019;08/07/2019;T/CATALUNYA CAIX/EL P 05-07-2019;-8,70;20631,95;20623,25;12305;-8,70;20623,25;2019-07-05;05/07/2019;CATALUNYA;Gastos_Ocio y transporte;Restaurantes;7;VARIABLES
08/07/2019;08/07/2019;T/TOCINERIES VENTURA/ 05-07-2019;-11,58;20623,25;20611,67;12306;-11,58;20611,67;2019-07-05;05/07/2019;TOCINERIES;Gastos_Compras;Supermercado;7;VARIABLES
08/07/2019;08/07/2019;T/ORIENT CARS - RECA/TERRASSA;-285,68;20611,67;20325,99;12307;-285,68;20325,99;2019-07-08;08/07/2019;ORIENT;Gastos_Vivienda y vehiculo;Mnto. vehiculo;7;VARIABLE
09/07/2019;09/07/2019;T/WWW.JUST-EAT.ES     06-07-2019;-36,60;20325,99;20289,39;12308;-36,60;20289,39;2019-07-06;06/07/2019;WWWJUSTEATES;Gastos_Ocio y transporte;Restaurantes;7;VARIABLES
09/07/2019;09/07/2019;T/WWW.JUST-EAT.ES     06-07-2019;-24,10;20289,39;20265,29;12309;-24,10;20265,29;2019-07-06;06/07/2019;WWWJUSTEATES;Gastos_Ocio y transporte;Restaurantes;7;VARIABLES
10/07/2019;10/07/2019;T/MERKAL CALZADOS S/B 07-07-2019;-41,99;20265,29;20223,30;12310;-41,99;20223,30;2019-07-07;07/07/2019;MERKAL;Gastos_Compras;Ropa;7;VARIABLES
10/07/2019;10/07/2019;T/WWW.JUST-EAT.ES     07-07-2019;-32,10;20223,30;20191,20;12311;-32,10;20191,20;2019-07-07;07/07/2019;WWWJUSTEATES;Gastos_Ocio y transporte;Restaurantes;7;VARIABLES
10/07/2019;10/07/2019;T/AUTOPISTAS TERRASSA 05-07-2019;-1,44;20191,20;20189,76;12312;-1,44;20189,76;2019-07-05;05/07/2019;AUTOPISTAS;Gastos_Ocio y transporte;Parking y peaje;7;VARIABLES
11/07/2019;11/07/2019;T/CATALUNYA CAIX/EL P 08-07-2019;-1,50;20189,76;20188,26;12313;-1,50;20188,26;2019-07-08;08/07/2019;CATALUNYA;Gastos_Ocio y transporte;Restaurantes;7;VARIABLES
11/07/2019;11/07/2019;T/BON AREA            08-07-2019;-2,45;20188,26;20185,81;12314;-2,45;20185,81;2019-07-08;08/07/2019;BON;Gastos_Compras;Supermercado;7;VARIABLES
11/07/2019;11/07/2019;T/CATALUNYA CAIX/EL P 08-07-2019;-2,00;20185,81;20183,81;12315;-2,00;20183,81;2019-07-08;08/07/2019;CATALUNYA;Gastos_Ocio y transporte;Restaurantes;7;VARIABLES
11/07/2019;11/07/2019;T/SUPER.REYPA  /TARRA 08-07-2019;-8,99;20183,81;20174,82;12316;-8,99;20174,82;2019-07-08;08/07/2019;SUPERREYPA;Gastos_Compras;Supermercado;7;VARIABLES
11/07/2019;11/07/2019;T/FRUTAS Y VERDURAS / 08-07-2019;-6,32;20174,82;20168,50;12317;-6,32;20168,50;2019-07-08;08/07/2019;FRUTAS;Gastos_Compras;Supermercado;7;VARIABLES
12/07/2019;12/07/2019;R/. FINQUES GASS Vto 01-07-19 Rec;-75,31;20168,50;20093,19;12318;-75,31;20093,19;2019-07-01;01/07/2019;FINQUES;Gastos_Vivienda y vehiculo;Alquiler Parking;7;FIJO
12/07/2019;12/07/2019;R/TELEFONO VODAFONE;-97,92;20093,19;19995,27;12319;-97,92;19995,27;2019-07-12;12/07/2019;TELEFONO;Gastos_Servicios tipicos;Telecomunicaciones;7;FIJO
12/07/2019;10/07/2019;T/KIABI.ES;-123,00;19995,27;19872,27;12320;-123,00;19872,27;2019-07-10;10/07/2019;KIABIES;Gastos_Compras;Ropa;7;VARIABLES
12/07/2019;12/07/2019;T/AUTOPISTAS TERRASSA 09-07-2019;-1,44;19872,27;19870,83;12321;-1,44;19870,83;2019-07-09;09/07/2019;AUTOPISTAS;Gastos_Ocio y transporte;Parking y peaje;7;VARIABLES
12/07/2019;12/07/2019;T/CATALUNYA CAIX/EL P 09-07-2019;-2,00;19870,83;19868,83;12322;-2,00;19868,83;2019-07-09;09/07/2019;CATALUNYA;Gastos_Ocio y transporte;Restaurantes;7;VARIABLES
12/07/2019;12/07/2019;T/CATALUNYA CAIX/EL P 09-07-2019;-2,00;19868,83;19866,83;12323;-2,00;19866,83;2019-07-09;09/07/2019;CATALUNYA;Gastos_Ocio y transporte;Restaurantes;7;VARIABLES
14/07/2019;14/07/2019;T/PARKING VAPOR GRAN/ 11-07-2019;-3,90;19866,83;19862,93;12324;-3,90;19862,93;2019-07-11;11/07/2019;PARKING;Gastos_Ocio y transporte;Parking y peaje;7;VARIABLES
14/07/2019;14/07/2019;T/WWW.JUST-EAT.ES     11-07-2019;-24,99;19862,93;19837,94;12325;-24,99;19837,94;2019-07-11;11/07/2019;WWWJUSTEATES;Gastos_Ocio y transporte;Restaurantes;7;VARIABLES
15/07/2019;15/07/2019;R/NATURGY IBER NATURGY2763048071;-4,69;19837,94;19833,25;12326;-4,69;19833,25;2019-07-15;15/07/2019;NATURGY;Gastos_Servicios tipicos;Gas;7;FIJO
15/07/2019;15/07/2019;T/WWW.JUST-EAT.ES     12-07-2019;-32,55;19833,25;19800,70;12327;-32,55;19800,70;2019-07-12;12/07/2019;WWWJUSTEATES;Gastos_Ocio y transporte;Restaurantes;7;VARIABLES
15/07/2019;15/07/2019;T/CATALUNYA CAIX/EL P 12-07-2019;-8,70;19800,70;19792,00;12328;-8,70;19792,00;2019-07-12;12/07/2019;CATALUNYA;Gastos_Ocio y transporte;Restaurantes;7;VARIABLES
16/07/2019;16/07/2019;R/SEGUROS CCM VIDA Y P Recibo:157;-19,33;19792,00;19772,67;12329;-19,33;19772,67;2019-07-16;16/07/2019;CCM;Gastos_Seguros;Seguro vida;7;FIJO
16/07/2019;16/07/2019;R/SEGUROS CCM VIDA Y P Recibo:157;-15,73;19772,67;19756,94;12330;-15,73;19756,94;2019-07-16;16/07/2019;CCM;Gastos_Seguros;Seguro vida;7;FIJO
16/07/2019;16/07/2019;R/LUZ ENDESA ENERG FACTURA DE ELE;-120,65;19756,94;19636,29;12331;-120,65;19636,29;2019-07-16;16/07/2019;ELE;Gastos_Servicios tipicos;Electricidad;7;FIJO
16/07/2019;16/07/2019;T/AUTOPISTAS TERRASSA 13-07-2019;-2,62;19636,29;19633,67;12332;-2,62;19633,67;2019-07-13;13/07/2019;AUTOPISTAS;Gastos_Ocio y transporte;Parking y peaje;7;VARIABLES
17/07/2019;17/07/2019;T/WWW.JUST-EAT.ES     14-07-2019;-32,99;19633,67;19600,68;12333;-32,99;19600,68;2019-07-14;14/07/2019;WWWJUSTEATES;Gastos_Ocio y transporte;Restaurantes;7;VARIABLES
18/07/2019;18/07/2019;T/CATALUNYA CAIX/EL P 15-07-2019;-2,50;19600,68;19598,18;12334;-2,50;19598,18;2019-07-15;15/07/2019;CATALUNYA;Gastos_Ocio y transporte;Restaurantes;7;VARIABLES
19/07/2019;17/07/2019;DEV.COMPRA TJKIABI.ES;10,00;19598,18;19608,18;12335;10,00;19608,18;2019-07-17;17/07/2019;DEVCOMPRA;Ingresos;Devoluciones;7;VARIABLES
19/07/2019;19/07/2019;T/AUTOPISTAS TERRASSA 16-07-2019;-1,44;19608,18;19606,74;12336;-1,44;19606,74;2019-07-16;16/07/2019;AUTOPISTAS;Gastos_Ocio y transporte;Parking y peaje;7;VARIABLES
22/07/2019;22/07/2019;T/WWW.JUST-EAT.ES     19-07-2019;-28,95;19606,74;19577,79;12337;-28,95;19577,79;2019-07-19;19/07/2019;WWWJUSTEATES;Gastos_Ocio y transporte;Restaurantes;7;VARIABLES
23/07/2019;23/07/2019;T/KIABI BARICENT/BARB 20-07-2019;-100,00;19577,79;19477,79;12338;-100,00;19477,79;2019-07-20;20/07/2019;KIABI;Gastos_Compras;Ropa;7;VARIABLES
26/07/2019;26/07/2019;BONIF.COM.5540556264970036;24,00;19477,79;19501,79;12339;24,00;19501,79;2019-07-26;26/07/2019;BONIFCOM;Ingresos;Devoluciones;7;VARIABLES
26/07/2019;26/07/2019;COMIS.TARJETAS5540556264970036;-24,00;19501,79;19477,79;12340;-24,00;19477,79;2019-07-26;26/07/2019;COMISTARJETAS;Gastos_Banco y organismos;Cargos banco;7;FIJO
26/07/2019;26/07/2019;HAB.AJUNTAMENT DE TERRASSA Transfe;2701,43;19477,79;22179,22;12341;2701,43;22179,22;2019-07-26;26/07/2019;HABAJUNTAMENT;Ingresos;Nomina;7;FIJO
26/07/2019;24/07/2019;T/Amazon .es*MH9BA2EI4;-249,00;22179,22;21930,22;12342;-249,00;21930,22;2019-07-24;24/07/2019;AMAZON;Gastos_Compras;Hobbys;7;VARIABLES
26/07/2019;26/07/2019;T/AUTOPISTA MARE NOST 20-07-2019;-7,35;21930,22;21922,87;12343;-7,35;21922,87;2019-07-20;20/07/2019;AUTOPISTA;Gastos_Ocio y transporte;Parking y peaje;7;VARIABLES
26/07/2019;26/07/2019;T/A.C.E.S.A B MART -L 20-07-2019;-10,90;21922,87;21911,97;12344;-10,90;21911,97;2019-07-20;20/07/2019;ACESA;Gastos_Ocio y transporte;Parking y peaje;7;VARIABLES
30/07/2019;30/07/2019;TRANSFBBVABCLM;1200,00;21911,97;23111,97;12345;1200,00;23111,97;2019-07-30;30/07/2019;TRANSFBBVABCLM;No computable;traspasos, transf.;7;
31/07/2019;31/07/2019;REC.6061.9600001223;-448,11;23111,97;22663,86;12346;-448,11;22663,86;2019-07-31;31/07/2019;REC;Gastos_Banco y organismos;Hipoteca;7;FIJO
31/07/2019;31/07/2019;R/AJUNTAMENT D TAXA RESIDUS  CA;-57,66;22663,86;22606,20;12347;-57,66;22606,20;2019-07-31;31/07/2019;AJUNTAMENT;Gastos_Banco y organismos;Ayuntamiento;7;FIJO
01/08/2019;01/08/2019;FACT TARJETASTARJ.CREDITO 07126017 19-08-01;-792,09;22606,20;21814,11;12348;-792,09;21814,11;2019-08-01;31/07/2019;FACT;No computable;Recibo Tarjeta;7;
01/08/2019;01/08/2019;FACT TARJETASTARJ.CREDITO 42689013 19-08-01;-764,88;21814,11;21049,23;12349;-764,88;21049,23;2019-08-01;31/07/2019;FACT;No computable;Recibo Tarjeta;7;
02/08/2019;02/08/2019;T/VIENA TORTOSA       30-07-2019;-6,90;21049,23;21042,33;12350;-6,90;21042,33;2019-07-30;30/07/2019;VIENA;Gastos_Ocio y transporte;Restaurantes;7;VARIABLES
02/08/2019;02/08/2019;T/REDONDEO S0LIDARI/B 30-07-2019;-0,10;21042,33;21042,23;12351;-0,10;21042,23;2019-07-30;30/07/2019;REDONDEO;Gastos_Salud, saber y deporte;Solidaridad;7;VARIABLES
05/08/2019;05/08/2019;R/. FINQUES GASS Vto 01-08-19 Rec;-75,31;21042,23;20966,92;12352;-75,31;20966,92;2019-08-01;01/08/2019;FINQUES;Gastos_Vivienda y vehiculo;Alquiler Parking;8;FIJO
05/08/2019;05/08/2019;T/FARMACIA LINA MONLL 02-08-2019;-34,18;20966,92;20932,74;12353;-34,18;20932,74;2019-08-02;02/08/2019;FARMACIA;Gastos_Salud, saber y deporte;Farmacia;8;VARIABLES
06/08/2019;06/08/2019;R/LUZ ENDESA ENERG FACTURA DE GAS;-115,64;20932,74;20817,10;12354;-115,64;20817,10;2019-08-06;06/08/2019;GAS;Gastos_Servicios tipicos;Gas;8;FIJO
07/08/2019;07/08/2019;T/RESTAURANTE JIN     04-08-2019;-45,95;20817,10;20771,15;12355;-45,95;20771,15;2019-08-04;04/08/2019;RESTAURANTE;Gastos_Ocio y transporte;Restaurantes;8;VARIABLES
07/08/2019;07/08/2019;T/TEMPLE              04-08-2019;-5,17;20771,15;20765,98;12356;-5,17;20765,98;2019-08-04;04/08/2019;TEMPLE;Gastos_Ocio y transporte;Gasolina;8;VARIABLES
07/08/2019;07/08/2019;T/ES LOURDES SL       04-08-2019;-17,98;20765,98;20748,00;12357;-17,98;20748,00;2019-08-04;04/08/2019;LOURDES;Gastos_Ocio y transporte;Gasolina;8;VARIABLES
08/08/2019;08/08/2019;T/CIUDAD DEL TRA/MARI 05-08-2019;-31,73;20748,00;20716,27;12358;-31,73;20716,27;2019-08-05;05/08/2019;CIUDAD;Gastos_Ocio y transporte;Gasolina;8;VARIABLES
09/08/2019;09/08/2019;T/AUTOPISTA MARE NOST 04-08-2019;-19,50;20716,27;20696,77;12359;-19,50;20696,77;2019-08-04;04/08/2019;AUTOPISTA;Gastos_Ocio y transporte;Parking y peaje;8;VARIABLES
10/08/2019;10/08/2019;T/HOSTAL NUEVO TROPIC 07-08-2019;-28,60;20696,77;20668,17;12360;-28,60;20668,17;2019-08-07;07/08/2019;HOSTAL;Gastos_Ocio y transporte;Restaurantes;8;VARIABLES
11/08/2019;11/08/2019;T/DECATHLON MOTRIL    08-08-2019;-19,98;20668,17;20648,19;12361;-19,98;20648,19;2019-08-08;08/08/2019;DECATHLON;Gastos_Compras;Deportivo;8;VARIABLES
11/08/2019;11/08/2019;T/CUEVAS DE NERJ/VILA 08-08-2019;-51,00;20648,19;20597,19;12362;-51,00;20597,19;2019-08-08;08/08/2019;CUEVAS;Gastos_Ocio y transporte;Otros ocio;8;VARIABLES
11/08/2019;11/08/2019;T/HOSTAL NUEVO TROPIC 08-08-2019;-11,00;20597,19;20586,19;12363;-11,00;20586,19;2019-08-08;08/08/2019;HOSTAL;Gastos_Ocio y transporte;Restaurantes;8;VARIABLES
13/08/2019;13/08/2019;R/COMSA SERVIC Factura GB19-0581;-76,45;20586,19;20509,74;12364;-76,45;20509,74;2019-08-13;13/08/2019;COMSA;Gastos_Ocio y transporte;Gasolina;8;VARIABLES
13/08/2019;13/08/2019;R/TELEFONO VODAFONE;-86,93;20509,74;20422,81;12365;-86,93;20422,81;2019-08-13;13/08/2019;TELEFONO;Gastos_Servicios tipicos;Telecomunicaciones;8;FIJO
13/08/2019;10/08/2019;T/RESTAURANTE OLYMPIA;-42,00;20422,81;20380,81;12366;-42,00;20380,81;2019-08-10;10/08/2019;RESTAURANTE;Gastos_Ocio y transporte;Restaurantes;8;VARIABLES
13/08/2019;13/08/2019;T/E.S.VALENCIA SERR/ 10-08-2019;-34,38;20380,81;20346,43;12367;-34,38;20346,43;2019-08-10;10/08/2019;ESVALENCIA;Gastos_Ocio y transporte;Gasolina;8;VARIABLES
13/08/2019;13/08/2019;T/CAFET.LA LECHERA (/ 10-08-2019;-12,70;20346,43;20333,73;12368;-12,70;20333,73;2019-08-10;10/08/2019;CAFETLA;Gastos_Ocio y transporte;Restaurantes;8;VARIABLES
15/08/2019;15/08/2019;R/SEGUROS CCM VIDA Y P Recibo:157;-19,25;20333,73;20314,48;12369;-19,25;20314,48;2019-08-15;15/08/2019;CCM;Gastos_Seguros;Seguro vida;8;FIJO
15/08/2019;15/08/2019;R/SEGUROS CCM VIDA Y P Recibo:157;-15,66;20314,48;20298,82;12370;-15,66;20298,82;2019-08-15;15/08/2019;CCM;Gastos_Seguros;Seguro vida;8;FIJO
16/08/2019;16/08/2019;R/NATURGY IBER NATURGY2763048081;-4,77;20298,82;20294,05;12371;-4,77;20294,05;2019-08-16;16/08/2019;NATURGY;Gastos_Servicios tipicos;Gas;8;FIJO
16/08/2019;16/08/2019;T/AUTOPISTA MARE NOST 10-08-2019;-8,80;20294,05;20285,25;12372;-8,80;20285,25;2019-08-10;10/08/2019;AUTOPISTA;Gastos_Ocio y transporte;Parking y peaje;8;VARIABLES
20/08/2019;16/08/2019;T/AMAZON .ES*MH2775IF4 AM;-378,00;20285,25;19907,25;12373;-378,00;19907,25;2019-08-16;16/08/2019;AMAZON;Gastos_Compras;Hobbys;8;VARIABLES
20/08/2019;17/08/2019;T/ADY*NETFLIX;-11,99;19907,25;19895,26;12374;-11,99;19895,26;2019-08-17;17/08/2019;ADYNETFLIX;Gastos_Servicios tipicos;Servicios online;8;FIJO
21/08/2019;21/08/2019;T/WWW.JUST-EAT.ES     18-08-2019;-24,25;19895,26;19871,01;12375;-24,25;19871,01;2019-08-18;18/08/2019;WWWJUSTEATES;Gastos_Ocio y transporte;Restaurantes;8;VARIABLES
21/08/2019;21/08/2019;T/AUTOPISTAS TERRASSA 17-08-2019;-2,62;19871,01;19868,39;12376;-2,62;19868,39;2019-08-17;17/08/2019;AUTOPISTAS;Gastos_Ocio y transporte;Parking y peaje;8;VARIABLES
23/08/2019;23/08/2019;T/AUTOPISTAS TERRASSA 20-08-2019;-1,44;19868,39;19866,95;12377;-1,44;19866,95;2019-08-20;20/08/2019;AUTOPISTAS;Gastos_Ocio y transporte;Parking y peaje;8;VARIABLES
23/08/2019;23/08/2019;T/AUTOPISTAS TERRASSA 20-08-2019;-1,44;19866,95;19865,51;12378;-1,44;19865,51;2019-08-20;20/08/2019;AUTOPISTAS;Gastos_Ocio y transporte;Parking y peaje;8;VARIABLES
23/08/2019;23/08/2019;T/CATALUNYA CAIX/EL P 20-08-2019;-7,35;19865,51;19858,16;12379;-7,35;19858,16;2019-08-20;20/08/2019;CATALUNYA;Gastos_Ocio y transporte;Restaurantes;8;VARIABLES
23/08/2019;23/08/2019;T/WWW.JUST-EAT.ES     20-08-2019;-30,75;19858,16;19827,41;12380;-30,75;19827,41;2019-08-20;20/08/2019;WWWJUSTEATES;Gastos_Ocio y transporte;Restaurantes;8;VARIABLES
23/08/2019;23/08/2019;T/AUTOPISTA MARE NOST 17-08-2019;-7,35;19827,41;19820,06;12381;-7,35;19820,06;2019-08-17;17/08/2019;AUTOPISTA;Gastos_Ocio y transporte;Parking y peaje;8;VARIABLES
24/08/2019;24/08/2019;T/AUTOPISTAS TERRASSA 21-08-2019;-1,44;19820,06;19818,62;12382;-1,44;19818,62;2019-08-21;21/08/2019;AUTOPISTAS;Gastos_Ocio y transporte;Parking y peaje;8;VARIABLES
24/08/2019;24/08/2019;T/CATALUNYA CAIX/EL P 21-08-2019;-8,60;19818,62;19810,02;12383;-8,60;19810,02;2019-08-21;21/08/2019;CATALUNYA;Gastos_Ocio y transporte;Restaurantes;8;VARIABLES
24/08/2019;24/08/2019;T/A.C.E.S.A LIM SCAP7 17-08-2019;-10,90;19810,02;19799,12;12384;-10,90;19799,12;2019-08-17;17/08/2019;ACESA;Gastos_Ocio y transporte;Parking y peaje;8;VARIABLES
26/08/2019;26/08/2019;T/TERRACASA         / 23-08-2019;-12,62;19799,12;19786,50;12385;-12,62;19786,50;2019-08-23;23/08/2019;TERRACASA;Gastos_Compras;Otras compras;8;VARIABLES
26/08/2019;26/08/2019;T/CATALUNYA CAIX/EL P 23-08-2019;-8,60;19786,50;19777,90;12386;-8,60;19777,90;2019-08-23;23/08/2019;CATALUNYA;Gastos_Ocio y transporte;Restaurantes;8;VARIABLES
26/08/2019;26/08/2019;T/CATALUNYA CAIX/EL P 23-08-2019;-2,50;19777,90;19775,40;12387;-2,50;19775,40;2019-08-23;23/08/2019;CATALUNYA;Gastos_Ocio y transporte;Restaurantes;8;VARIABLES
28/08/2019;28/08/2019;HAB.AJUNTAMENT DE TERRASSA Transfe;2576,07;19775,40;22351,47;12388;2576,07;22351,47;2019-08-28;28/08/2019;HABAJUNTAMENT;Ingresos;Nomina;8;FIJO
29/08/2019;29/08/2019;TRANSFBBVABCLM;1200,00;22351,47;23551,47;12389;1200,00;23551,47;2019-08-29;29/08/2019;TRANSFBBVABCLM;No computable;traspasos, transf.;8;
30/08/2019;30/08/2019;T/WWW.JUST-EAT.ES     27-08-2019;-11,96;23551,47;23539,51;12390;-11,96;23539,51;2019-08-27;27/08/2019;WWWJUSTEATES;Gastos_Ocio y transporte;Restaurantes;8;VARIABLES
30/08/2019;30/08/2019;T/IKEA SABADELL     / 27-08-2019;-11,50;23539,51;23528,01;12391;-11,50;23528,01;2019-08-27;27/08/2019;IKEA;Gastos_Vivienda y vehiculo;Mnto. hogar;8;VARIABLES
30/08/2019;30/08/2019;T/IKEA REST. SABADEL/ 27-08-2019;-14,95;23528,01;23513,06;12392;-14,95;23513,06;2019-08-27;27/08/2019;IKEA;Gastos_Vivienda y vehiculo;Mnto. hogar;8;VARIABLES
30/08/2019;30/08/2019;T/SUPER.REYPA  /TARRA 27-08-2019;-9,78;23513,06;23503,28;12393;-9,78;23503,28;2019-08-27;27/08/2019;SUPERREYPA;Gastos_Compras;Supermercado;8;VARIABLES
31/08/2019;31/08/2019;REC.6061.9600001223;-448,11;23503,28;23055,17;12394;-448,11;23055,17;2019-08-31;31/08/2019;REC;Gastos_Banco y organismos;Hipoteca;8;FIJO
31/08/2019;31/08/2019;T/AUTOPISTAS TERRASSA 28-08-2019;-1,44;23055,17;23053,73;12395;-1,44;23053,73;2019-08-28;28/08/2019;AUTOPISTAS;Gastos_Ocio y transporte;Parking y peaje;8;VARIABLES
31/08/2019;31/08/2019;T/RODELAS           / 28-08-2019;-25,00;23053,73;23028,73;12396;-25,00;23028,73;2019-08-28;28/08/2019;RODELAS;Gastos_Salud, saber y deporte;Belleza;8;VARIABLES
01/09/2019;01/09/2019;FACT TARJETASTARJ.CREDITO 07126017 19-09-01;-899,44;23028,73;22129,29;12397;-899,44;22129,29;2019-09-01;31/08/2019;FACT;No computable;Recibo Tarjeta;8;
01/09/2019;01/09/2019;FACT TARJETASTARJ.CREDITO 42689013 19-09-01;-989,11;22129,29;21140,18;12398;-989,11;21140,18;2019-09-01;31/08/2019;FACT;No computable;Recibo Tarjeta;8;
01/09/2019;01/09/2019;T/BON AREA            29-08-2019;-12,32;21140,18;21127,86;12399;-12,32;21127,86;2019-08-29;29/08/2019;BON;Gastos_Compras;Supermercado;8;VARIABLES
01/09/2019;01/09/2019;T/CATALUNYA CAIX/EL P 29-08-2019;-3,00;21127,86;21124,86;12400;-3,00;21124,86;2019-08-29;29/08/2019;CATALUNYA;Gastos_Ocio y transporte;Restaurantes;8;VARIABLES
02/09/2019;02/09/2019;T/NOSTRUM          /B 30-08-2019;-9,00;21124,86;21115,86;12401;-9,00;21115,86;2019-08-30;30/08/2019;NOSTRUM;Gastos_Ocio y transporte;Restaurantes;8;VARIABLES
02/09/2019;02/09/2019;T/E.S. RUBI II        30-08-2019;-43,25;21115,86;21072,61;12402;-43,25;21072,61;2019-08-30;30/08/2019;RUBI;Gastos_Ocio y transporte;Gasolina;8;VARIABLES
03/09/2019;03/09/2019;T/CINES OSCAR       / 31-08-2019;-12,60;21072,61;21060,01;12403;-12,60;21060,01;2019-08-31;31/08/2019;CINES;Gastos_Ocio y transporte;Espectáculos;8;VARIABLES
03/09/2019;03/09/2019;T/FORN DE PA CAL PORT 31-08-2019;-23,30;21060,01;21036,71;12404;-23,30;21036,71;2019-08-31;31/08/2019;FORN;Gastos_Compras;Supermercado;8;VARIABLES
03/09/2019;03/09/2019;T/AUTOPISTAS TERRASSA 29-08-2019;-1,44;21036,71;21035,27;12405;-1,44;21035,27;2019-08-29;29/08/2019;AUTOPISTAS;Gastos_Ocio y transporte;Parking y peaje;8;VARIABLES
04/09/2019;04/09/2019;T/WWW.JUST-EAT.ES     01-09-2019;-28,60;21035,27;21006,67;12406;-28,60;21006,67;2019-09-01;01/09/2019;WWWJUSTEATES;Gastos_Ocio y transporte;Restaurantes;9;VARIABLES
04/09/2019;04/09/2019;T/WWW.JUST-EAT.ES     01-09-2019;-19,12;21006,67;20987,55;12407;-19,12;20987,55;2019-09-01;01/09/2019;WWWJUSTEATES;Gastos_Ocio y transporte;Restaurantes;9;VARIABLES
05/09/2019;05/09/2019;T/CATALUNYA CAIX/EL P 02-09-2019;-2,50;20987,55;20985,05;12408;-2,50;20985,05;2019-09-02;02/09/2019;CATALUNYA;Gastos_Ocio y transporte;Restaurantes;9;VARIABLES
06/09/2019;06/09/2019;T/CATALUNYA CAIX/EL P 03-09-2019;-2,50;20985,05;20982,55;12409;-2,50;20982,55;2019-09-03;03/09/2019;CATALUNYA;Gastos_Ocio y transporte;Restaurantes;9;VARIABLES
07/09/2019;07/09/2019;T/CEDIPSA LLEIDA II   /ALFRES;-33,93;20982,55;20948,62;12410;-33,93;20948,62;2019-09-07;07/09/2019;CEDIPSA;Gastos_Ocio y transporte;Gasolina;9;VARIABLES
07/09/2019;07/09/2019;T/DECATHLON PAMPLON/BERRIOZAR;-58,96;20948,62;20889,66;12411;-58,96;20889,66;2019-09-07;07/09/2019;DECATHLON;Gastos_Compras;Deportivo;9;VARIABLES
07/09/2019;07/09/2019;T/RESTAURANTE OLARI  /IRURITA;-67,98;20889,66;20821,68;12412;-67,98;20821,68;2019-09-07;07/09/2019;RESTAURANTE;Gastos_Ocio y transporte;Restaurantes;9;VARIABLES
07/09/2019;07/09/2019;T/WWW.JUST-EAT.ES     04-09-2019;-21,60;20821,68;20800,08;12413;-21,60;20800,08;2019-09-04;04/09/2019;WWWJUSTEATES;Gastos_Ocio y transporte;Restaurantes;9;VARIABLES
07/09/2019;07/09/2019;T/BONAREA REDONDEO /B 04-09-2019;-0,14;20800,08;20799,94;12414;-0,14;20799,94;2019-09-04;04/09/2019;BONAREA;Gastos_Compras;Supermercado;9;VARIABLES
07/09/2019;07/09/2019;T/BON AREA            04-09-2019;-25,86;20799,94;20774,08;12415;-25,86;20774,08;2019-09-04;04/09/2019;BON;Gastos_Compras;Supermercado;9;VARIABLES
07/09/2019;07/09/2019;T/AUTOPISTAS TERRASSA 03-09-2019;-2,62;20774,08;20771,46;12416;-2,62;20771,46;2019-09-03;03/09/2019;AUTOPISTAS;Gastos_Ocio y transporte;Parking y peaje;9;VARIABLES
07/09/2019;07/09/2019;T/AUTOPISTA MARE NOST 30-08-2019;-6,25;20771,46;20765,21;12417;-6,25;20765,21;2019-08-30;30/08/2019;AUTOPISTA;Gastos_Ocio y transporte;Parking y peaje;8;VARIABLES
07/09/2019;07/09/2019;T/A.C.E.S.A B MART -L 30-08-2019;-10,90;20765,21;20754,31;12418;-10,90;20754,31;2019-08-30;30/08/2019;ACESA;Gastos_Ocio y transporte;Parking y peaje;8;VARIABLES
07/09/2019;07/09/2019;CAJ. AJENOLA CAIXA 3699     /ELIZONDO;-300,00;20754,31;20454,31;12419;-300,00;20454,31;2019-09-07;07/09/2019;CAJ;Gastos_Gastos varios;Efectivo;9;VARIABLES
07/09/2019;07/09/2019;COM.64970036 SVRED CAJ     OFI;-2,00;20454,31;20452,31;12420;-2,00;20452,31;2019-09-07;07/09/2019;COM;Gastos_Banco y organismos;Cargos banco;9;FIJO
09/09/2019;09/09/2019;T/RESTAURANTE AROTXA  /LEGASA;-101,85;20452,31;20350,46;12421;-101,85;20350,46;2019-09-09;09/09/2019;RESTAURANTE;Gastos_Ocio y transporte;Restaurantes;9;VARIABLES
09/09/2019;09/09/2019;T/WWW.JUST-EAT.ES     06-09-2019;-17,56;20350,46;20332,90;12422;-17,56;20332,90;2019-09-06;06/09/2019;WWWJUSTEATES;Gastos_Ocio y transporte;Restaurantes;9;VARIABLES
09/09/2019;09/09/2019;T/DECATHLON SA TERRA/ 06-09-2019;-54,94;20332,90;20277,96;12423;-54,94;20277,96;2019-09-06;06/09/2019;DECATHLON;Gastos_Compras;Deportivo;9;VARIABLES
09/09/2019;09/09/2019;T/BON AREA            06-09-2019;-8,60;20277,96;20269,36;12424;-8,60;20269,36;2019-09-06;06/09/2019;BON;Gastos_Compras;Supermercado;9;VARIABLES
09/09/2019;09/09/2019;T/GALP GEST MOLINS DE/ 06-09-2019;-30,00;20269,36;20239,36;12425;-30,00;20239,36;2019-09-06;06/09/2019;GALP;Gastos_Ocio y transporte;Gasolina;9;VARIABLES
10/09/2019;10/09/2019;CAJ. AJENOLA CAIXA 5394      /IRURITA;-300,00;20239,36;19939,36;12426;-300,00;19939,36;2019-09-10;10/09/2019;CAJ;Gastos_Gastos varios;Efectivo;9;VARIABLES
10/09/2019;10/09/2019;COM.64970036 SVRED CAJ     OFI;-2,00;19939,36;19937,36;12427;-2,00;19937,36;2019-09-10;10/09/2019;COM;Gastos_Banco y organismos;Cargos banco;9;FIJO
10/09/2019;10/09/2019;T/FARMACIA GUEZURAGA/ 07-09-2019;-4,40;19937,36;19932,96;12428;-4,40;19932,96;2019-09-07;07/09/2019;FARMACIA;Gastos_Salud, saber y deporte;Farmacia;9;VARIABLES
10/09/2019;10/09/2019;T/ SUPER .MINDEGUI    / 07-09-2019;-40,28;19932,96;19892,68;12429;-40,28;19892,68;2019-09-07;07/09/2019;SUPER;Gastos_Compras;Supermercado;9;VARIABLES
11/09/2019;11/09/2019;R/. FINQUES GASS Vto 01-09-19 Rec;-75,69;19892,68;19816,99;12430;-75,69;19816,99;2019-09-01;01/09/2019;FINQUES;Gastos_Vivienda y vehiculo;Alquiler Parking;9;FIJO
11/09/2019;11/09/2019;T/CUEVAS DE URDA/URDA 08-09-2019;-18,00;19816,99;19798,99;12431;-18,00;19798,99;2019-09-08;08/09/2019;CUEVAS;Gastos_Ocio y transporte;Otros ocio;9;VARIABLES
12/09/2019;12/09/2019;R/NATURGY IBER NATURGY2763048091;-4,69;19798,99;19794,30;12432;-4,69;19794,30;2019-09-12;12/09/2019;NATURGY;Gastos_Servicios tipicos;Gas;9;FIJO
13/09/2019;13/09/2019;R/TELEFONO VODAFONE;-86,93;19794,30;19707,37;12433;-86,93;19707,37;2019-09-13;13/09/2019;TELEFONO;Gastos_Servicios tipicos;Telecomunicaciones;9;FIJO
14/09/2019;14/09/2019;T/WWW.JUST-EAT.ES     11-09-2019;-48,05;19707,37;19659,32;12434;-48,05;19659,32;2019-09-11;11/09/2019;WWWJUSTEATES;Gastos_Ocio y transporte;Restaurantes;9;VARIABLES
16/09/2019;16/09/2019;T/WWW.JUST-EAT.ES     13-09-2019;-33,50;19659,32;19625,82;12435;-33,50;19625,82;2019-09-13;13/09/2019;WWWJUSTEATES;Gastos_Ocio y transporte;Restaurantes;9;VARIABLES
17/09/2019;17/09/2019;R/SEGUROS CCM VIDA Y P Recibo:158;-19,16;19625,82;19606,66;12436;-19,16;19606,66;2019-09-17;17/09/2019;CCM;Gastos_Seguros;Seguro vida;9;FIJO
17/09/2019;17/09/2019;R/SEGUROS CCM VIDA Y P Recibo:158;-15,59;19606,66;19591,07;12437;-15,59;19591,07;2019-09-17;17/09/2019;CCM;Gastos_Seguros;Seguro vida;9;FIJO
18/09/2019;18/09/2019;T/WWW.JUST-EAT.ES     15-09-2019;-21,56;19591,07;19569,51;12438;-21,56;19569,51;2019-09-15;15/09/2019;WWWJUSTEATES;Gastos_Ocio y transporte;Restaurantes;9;VARIABLES
18/09/2019;18/09/2019;T/WWW.JUST-EAT.ES     15-09-2019;-26,35;19569,51;19543,16;12439;-26,35;19543,16;2019-09-15;15/09/2019;WWWJUSTEATES;Gastos_Ocio y transporte;Restaurantes;9;VARIABLES
19/09/2019;17/09/2019;T/ADY*NETFLIX;-11,99;19543,16;19531,17;12440;-11,99;19531,17;2019-09-17;17/09/2019;ADYNETFLIX;Gastos_Servicios tipicos;Servicios online;9;FIJO
20/09/2019;20/09/2019;T/FRUTAS Y VERDURAS / 17-09-2019;-8,19;19531,17;19522,98;12441;-8,19;19522,98;2019-09-17;17/09/2019;FRUTAS;Gastos_Compras;Supermercado;9;VARIABLES
21/09/2019;18/09/2019;DEV.COMPRA TJAMZN MKTP ES AMAZON.ES;9,20;19522,98;19532,18;12442;9,20;19532,18;2019-09-18;18/09/2019;DEVCOMPRA;Ingresos;Devoluciones;9;VARIABLES
21/09/2019;18/09/2019;T/AMZN MKTP ES*MA18202P4;-29,15;19532,18;19503,03;12443;-29,15;19503,03;2019-09-18;18/09/2019;AMZN;Gastos_Compras;Hobbys;9;VARIABLES
22/09/2019;22/09/2019;T/WWW.JUST-EAT.ES     19-09-2019;-26,40;19503,03;19476,63;12444;-26,40;19476,63;2019-09-19;19/09/2019;WWWJUSTEATES;Gastos_Ocio y transporte;Restaurantes;9;VARIABLES
23/09/2019;23/09/2019;R/ MINA PUBLICA AIGUES T.01A75789;-31,24;19476,63;19445,39;12445;-31,24;19445,39;2019-09-23;23/09/2019;MINA;Gastos_Servicios tipicos;Agua;9;FIJO
23/09/2019;23/09/2019;R/LUZ ENDESA ENERG FACTURA DE ELE;-116,43;19445,39;19328,96;12446;-116,43;19328,96;2019-09-23;23/09/2019;ELE;Gastos_Servicios tipicos;Electricidad;9;FIJO
24/09/2019;24/09/2019;T/IKEA SABADELL     /SABADELL;-198,00;19328,96;19130,96;12447;-198,00;19130,96;2019-09-24;24/09/2019;IKEA;Gastos_Vivienda y vehiculo;Mnto. hogar;9;VARIABLES
24/09/2019;21/09/2019;T/ es. pandahall bead;-84,51;19130,96;19046,45;12448;-84,51;19046,45;2019-09-21;21/09/2019;PANDAHALL;Gastos_Compras;Hobbys;9;VARIABLES
24/09/2019;24/09/2019;T/WWW.JUST-EAT.ES     21-09-2019;-17,56;19046,45;19028,89;12449;-17,56;19028,89;2019-09-21;21/09/2019;WWWJUSTEATES;Gastos_Ocio y transporte;Restaurantes;9;VARIABLES
25/09/2019;25/09/2019;T/WWW.JUST-EAT.ES     22-09-2019;-39,00;19028,89;18989,89;12450;-39,00;18989,89;2019-09-22;22/09/2019;WWWJUSTEATES;Gastos_Ocio y transporte;Restaurantes;9;VARIABLES
27/09/2019;27/09/2019;HAB.AJUNTAMENT DE TERRASSA Transfe;1890,73;18989,89;20880,62;12451;1890,73;20880,62;2019-09-27;27/09/2019;HABAJUNTAMENT;Ingresos;Nomina;9;FIJO
27/09/2019;27/09/2019;T/IKEA REST. SABADEL/ 24-09-2019;-11,70;20880,62;20868,92;12452;-11,70;20868,92;2019-09-24;24/09/2019;IKEA;Gastos_Vivienda y vehiculo;Mnto. hogar;9;VARIABLES
27/09/2019;27/09/2019;T/IKEA SABADELL     / 24-09-2019;-49,00;20868,92;20819,92;12453;-49,00;20819,92;2019-09-24;24/09/2019;IKEA;Gastos_Vivienda y vehiculo;Mnto. hogar;9;VARIABLES
27/09/2019;27/09/2019;T/GIFI TERRASSA     / 24-09-2019;-8,00;20819,92;20811,92;12454;-8,00;20811,92;2019-09-24;24/09/2019;GIFI;Gastos_Compras;Hogar;9;VARIABLES
27/09/2019;27/09/2019;T/BON AREA            24-09-2019;-7,12;20811,92;20804,80;12455;-7,12;20804,80;2019-09-24;24/09/2019;BON;Gastos_Compras;Supermercado;9;VARIABLES
28/09/2019;28/09/2019;T/WWW.JUST-EAT.ES 25-09-2019;-26,35;20804,80;20778,45;12456;-26,35;20778,45;2019-09-25;25/09/2019;WWWJUSTEATES;Gastos_Ocio y transporte;Restaurantes;9;VARIABLES
29/09/2019;29/09/2019;T/WWW.JUST-EAT.ES 26-09-2019;-11,20;20778,45;20767,25;12457;-11,20;20767,25;2019-09-26;26/09/2019;WWWJUSTEATES;Gastos_Ocio y transporte;Restaurantes;9;VARIABLES
30/09/2019;30/09/2019;REC.6061.9600001223;-448,11;20767,25;20319,14;12458;-448,11;20319,14;2019-09-30;30/09/2019;REC;Gastos_Banco y organismos;Hipoteca;9;FIJO
30/09/2019;30/09/2019;R/SERHS FOOD A Comedor Septiembr;-77,35;20319,14;20241,79;12459;-77,35;20241,79;2019-09-30;30/09/2019;SERHS;Gastos_Salud, saber y deporte;Menjador;9;FIJO
30/09/2019;30/09/2019;R/SERHS FOOD A Comedor Septiembr;-77,35;20241,79;20164,44;12460;-77,35;20164,44;2019-09-30;30/09/2019;SERHS;Gastos_Salud, saber y deporte;Menjador;9;FIJO
01/10/2019;01/10/2019;FACT TARJETASTARJ.CREDITO 07126017 19-10-01;-799,30;20164,44;19365,14;12461;-799,30;19365,14;2019-10-01;30/09/2019;FACT;No computable;Recibo Tarjeta;9;
01/10/2019;01/10/2019;FACT TARJETASTARJ.CREDITO 42689013 19-10-01;-751,55;19365,14;18613,59;12462;-751,55;18613,59;2019-10-01;30/09/2019;FACT;No computable;Recibo Tarjeta;9;
01/10/2019;01/10/2019;TRANSFBBVABCLM;1200,00;18613,59;19813,59;12463;1200,00;19813,59;2019-10-01;01/10/2019;TRANSFBBVABCLM;No computable;traspasos, transf.;10;
01/10/2019;29/09/2019;T/ALIEXPRESS.COM;-61,14;19813,59;19752,45;12464;-61,14;19752,45;2019-09-29;29/09/2019;ALIEXPRESSCOM;Gastos_Compras;Hobbys;9;VARIABLES
03/10/2019;03/10/2019;R/SEGUROS SEGUROS CATA INCLUIDO S;-357,40;19752,45;19395,05;12465;-357,40;19395,05;2019-10-03;03/10/2019;CATA;Gastos_Seguros;Seguro auto;10;FIJO
03/10/2019;03/10/2019;T/WWW.JUST-EAT.ES 30-09-2019;-26,35;19395,05;19368,70;12466;-26,35;19368,70;2019-09-30;30/09/2019;WWWJUSTEATES;Gastos_Ocio y transporte;Restaurantes;9;VARIABLES
03/10/2019;03/10/2019;T/WWW.JUST-EAT.ES 30-09-2019;-22,55;19368,70;19346,15;12467;-22,55;19346,15;2019-09-30;30/09/2019;WWWJUSTEATES;Gastos_Ocio y transporte;Restaurantes;9;VARIABLES
03/10/2019;03/10/2019;T/FRUTAS Y VERDURAS / 30-09-2019;-22,12;19346,15;19324,03;12468;-22,12;19324,03;2019-09-30;30/09/2019;FRUTAS;Gastos_Compras;Supermercado;9;VARIABLES
04/10/2019;04/10/2019;'R/AJUNTAMENT D I.B.I. CA D''ALBI';-48,62;19324,03;19275,41;12469;-48,62;19275,41;2019-10-04;04/10/2019;AJUNTAMENT;Gastos_Banco y organismos;Ayuntamiento;10;FIJO
04/10/2019;04/10/2019;T/EL CAFE D EGARA / 01-10-2019;-20,78;19275,41;19254,63;12470;-20,78;19254,63;2019-10-01;01/10/2019;CAFE;Gastos_Ocio y transporte;Restaurantes;10;VARIABLES
04/10/2019;04/10/2019;T/365 CAFE TERRASSA / 01-10-2019;-4,95;19254,63;19249,68;12471;-4,95;19249,68;2019-10-01;01/10/2019;CAFE;Gastos_Ocio y transporte;Restaurantes;10;VARIABLES
06/10/2019;06/10/2019;T/EL BON GUST / 03-10-2019;-24,69;19249,68;19224,99;12472;-24,69;19224,99;2019-10-03;03/10/2019;BON;Gastos_Compras;Supermercado;10;VARIABLES
07/10/2019;07/10/2019;R/Ajuntament d Abonaments IMES o;-36,40;19224,99;19188,59;12473;-36,40;19188,59;2019-10-07;07/10/2019;AJUNTAMENT;Gastos_Banco y organismos;Ayuntamiento;10;FIJO
07/10/2019;07/10/2019;T/FARMA.ANGEL MORENO/ 04-10-2019;-6,24;19188,59;19182,35;12474;-6,24;19182,35;2019-10-04;04/10/2019;FARMAANGEL;Gastos_Salud, saber y deporte;Farmacia;10;VARIABLES
07/10/2019;07/10/2019;T/CATALUNYA CAIX/EL P 04-10-2019;-8,70;19182,35;19173,65;12475;-8,70;19173,65;2019-10-04;04/10/2019;CATALUNYA;Gastos_Ocio y transporte;Restaurantes;10;VARIABLES
07/10/2019;07/10/2019;T/CATALUNYA CAIX/EL P 04-10-2019;-2,50;19173,65;19171,15;12476;-2,50;19171,15;2019-10-04;04/10/2019;CATALUNYA;Gastos_Ocio y transporte;Restaurantes;10;VARIABLES
07/10/2019;07/10/2019;T/WWW.JUST-EAT.ES 04-10-2019;-33,50;19171,15;19137,65;12477;-33,50;19137,65;2019-10-04;04/10/2019;WWWJUSTEATES;Gastos_Ocio y transporte;Restaurantes;10;VARIABLES
08/10/2019;08/10/2019;R/LUZ ENDESA ENERG FACTURA DE GAS;-122,94;19137,65;19014,71;12478;-122,94;19014,71;2019-10-08;08/10/2019;GAS;Gastos_Servicios tipicos;Gas;10;FIJO
09/10/2019;05/10/2019;T/PERLES AND CO;-49,90;19014,71;18964,81;12479;-49,90;18964,81;2019-10-05;05/10/2019;PERLES;Gastos_Compras;Hobbys;10;VARIABLES
09/10/2019;09/10/2019;T/WWW.JUST-EAT.ES 06-10-2019;-23,92;18964,81;18940,89;12480;-23,92;18940,89;2019-10-06;06/10/2019;WWWJUSTEATES;Gastos_Ocio y transporte;Restaurantes;10;VARIABLES
09/10/2019;09/10/2019;T/WWW.JUST-EAT.ES 06-10-2019;-27,85;18940,89;18913,04;12481;-27,85;18913,04;2019-10-06;06/10/2019;WWWJUSTEATES;Gastos_Ocio y transporte;Restaurantes;10;VARIABLES
10/10/2019;10/10/2019;R/NATURGY IBER NATURGY2763048101;-4,69;18913,04;18908,35;12482;-4,69;18908,35;2019-10-10;10/10/2019;NATURGY;Gastos_Servicios tipicos;Gas;10;FIJO
10/10/2019;10/10/2019;R/SERHS FOOD A Comedor Octubre/;-130,90;18908,35;18777,45;12483;-130,90;18777,45;2019-10-10;10/10/2019;SERHS;Gastos_Salud, saber y deporte;Menjador;10;FIJO
10/10/2019;10/10/2019;R/SERHS FOOD A Comedor Octubre/;-130,90;18777,45;18646,55;12484;-130,90;18646,55;2019-10-10;10/10/2019;SERHS;Gastos_Salud, saber y deporte;Menjador;10;FIJO
10/10/2019;10/10/2019;T/BON AREA 07-10-2019;-19,94;18646,55;18626,61;12485;-19,94;18626,61;2019-10-07;07/10/2019;BON;Gastos_Compras;Supermercado;10;VARIABLES
10/10/2019;10/10/2019;T/FRUTAS Y VERDURAS / 07-10-2019;-11,32;18626,61;18615,29;12486;-11,32;18615,29;2019-10-07;07/10/2019;FRUTAS;Gastos_Compras;Supermercado;10;VARIABLES
11/10/2019;11/10/2019;R/. FINQUES GASS Vto 01-10-19 Rec;-75,69;18615,29;18539,60;12487;-75,69;18539,60;2019-10-01;01/10/2019;FINQUES;Gastos_Vivienda y vehiculo;Alquiler Parking;10;FIJO
12/10/2019;12/10/2019;T/CINESA WEB /BARCELONA;-37,60;18539,60;18502,00;12488;-37,60;18502,00;2019-10-12;12/10/2019;CINESA;Gastos_Ocio y transporte;Espectáculos;10;VARIABLES
12/10/2019;12/10/2019;T/SUPER.BON PREU S16/TERRASSA;-50,19;18502,00;18451,81;12489;-50,19;18451,81;2019-10-12;12/10/2019;SUPERBON;Gastos_Compras;Supermercado;10;VARIABLES
12/10/2019;12/10/2019;T/MERCADONA QUATRE C/ 09-10-2019;-109,77;18451,81;18342,04;12490;-109,77;18342,04;2019-10-09;09/10/2019;MERCADONA;Gastos_Compras;Supermercado;10;VARIABLES
12/10/2019;12/10/2019;T/CATALUNYA CAIX/EL P 09-10-2019;-2,50;18342,04;18339,54;12491;-2,50;18339,54;2019-10-09;09/10/2019;CATALUNYA;Gastos_Ocio y transporte;Restaurantes;10;VARIABLES
12/10/2019;12/10/2019;T/MERCADONA QUATRE C/ 09-10-2019;-17,94;18339,54;18321,60;12492;-17,94;18321,60;2019-10-09;09/10/2019;MERCADONA;Gastos_Compras;Supermercado;10;VARIABLES
13/10/2019;13/10/2019;T/CATALUNYA CAIX/EL P 10-10-2019;-2,50;18321,60;18319,10;12493;-2,50;18319,10;2019-10-10;10/10/2019;CATALUNYA;Gastos_Ocio y transporte;Restaurantes;10;VARIABLES
13/10/2019;13/10/2019;T/WWW.JUST-EAT.ES 10-10-2019;-29,85;18319,10;18289,25;12494;-29,85;18289,25;2019-10-10;10/10/2019;WWWJUSTEATES;Gastos_Ocio y transporte;Restaurantes;10;VARIABLES
14/10/2019;14/10/2019;R/TELEFONO VODAFONE;-86,93;18289,25;18202,32;12495;-86,93;18202,32;2019-10-14;14/10/2019;TELEFONO;Gastos_Servicios tipicos;Telecomunicaciones;10;FIJO
14/10/2019;14/10/2019;T/CATALUNYA CAIX/EL P 11-10-2019;-4,00;18202,32;18198,32;12496;-4,00;18198,32;2019-10-11;11/10/2019;CATALUNYA;Gastos_Ocio y transporte;Restaurantes;10;VARIABLES
15/10/2019;12/10/2019;T/ALIEXPRESS.COM;-1,72;18198,32;18196,60;12497;-1,72;18196,60;2019-10-12;12/10/2019;ALIEXPRESSCOM;Gastos_Compras;Hobbys;10;VARIABLES
15/10/2019;12/10/2019;T/ALIEXPRESS.COM;-21,99;18196,60;18174,61;12498;-21,99;18174,61;2019-10-12;12/10/2019;ALIEXPRESSCOM;Gastos_Compras;Hobbys;10;VARIABLES
15/10/2019;12/10/2019;T/ALIEXPRESS.COM;-3,69;18174,61;18170,92;12499;-3,69;18170,92;2019-10-12;12/10/2019;ALIEXPRESSCOM;Gastos_Compras;Hobbys;10;VARIABLES
15/10/2019;12/10/2019;T/ALIEXPRESS.COM;-1,70;18170,92;18169,22;12500;-1,70;18169,22;2019-10-12;12/10/2019;ALIEXPRESSCOM;Gastos_Compras;Hobbys;10;VARIABLES
15/10/2019;12/10/2019;T/ALIEXPRESS.COM;-2,90;18169,22;18166,32;12501;-2,90;18166,32;2019-10-12;12/10/2019;ALIEXPRESSCOM;Gastos_Compras;Hobbys;10;VARIABLES
15/10/2019;12/10/2019;T/ALIEXPRESS.COM;-1,66;18166,32;18164,66;12502;-1,66;18164,66;2019-10-12;12/10/2019;ALIEXPRESSCOM;Gastos_Compras;Hobbys;10;VARIABLES
15/10/2019;12/10/2019;T/ALIEXPRESS.COM;-1,78;18164,66;18162,88;12503;-1,78;18162,88;2019-10-12;12/10/2019;ALIEXPRESSCOM;Gastos_Compras;Hobbys;10;VARIABLES
15/10/2019;12/10/2019;T/WWW.ALIEXPRESS.COM;-0,59;18162,88;18162,29;12504;-0,59;18162,29;2019-10-12;12/10/2019;WWWALIEXPRESSCOM;Gastos_Compras;Hobbys;10;VARIABLES
15/10/2019;12/10/2019;T/ALIEXPRESS.COM;-4,98;18162,29;18157,31;12505;-4,98;18157,31;2019-10-12;12/10/2019;ALIEXPRESSCOM;Gastos_Compras;Hobbys;10;VARIABLES
15/10/2019;12/10/2019;T/ALIEXPRESS.COM;-2,21;18157,31;18155,10;12506;-2,21;18155,10;2019-10-12;12/10/2019;ALIEXPRESSCOM;Gastos_Compras;Hobbys;10;VARIABLES
15/10/2019;12/10/2019;T/ALIEXPRESS.COM;-7,59;18155,10;18147,51;12507;-7,59;18147,51;2019-10-12;12/10/2019;ALIEXPRESSCOM;Gastos_Compras;Hobbys;10;VARIABLES
15/10/2019;12/10/2019;T/ALIEXPRESS.COM;-3,53;18147,51;18143,98;12508;-3,53;18143,98;2019-10-12;12/10/2019;ALIEXPRESSCOM;Gastos_Compras;Hobbys;10;VARIABLES
15/10/2019;15/10/2019;T/CINESA PARC VALLES/ 12-10-2019;-12,59;18143,98;18131,39;12509;-12,59;18131,39;2019-10-12;12/10/2019;CINESA;Gastos_Ocio y transporte;Espectáculos;10;VARIABLES
15/10/2019;15/10/2019;T/BONPREU ARRODONIM/B 12-10-2019;-0,11;18131,39;18131,28;12510;-0,11;18131,28;2019-10-12;12/10/2019;BONPREU;Gastos_Compras;Supermercado;10;VARIABLES
16/10/2019;16/10/2019;R/SEGUROS CCM VIDA Y P Recibo:159;-15,53;18131,28;18115,75;12511;-15,53;18115,75;2019-10-16;16/10/2019;CCM;Gastos_Seguros;Seguro vida;10;FIJO
16/10/2019;16/10/2019;R/SEGUROS CCM VIDA Y P Recibo:159;-19,08;18115,75;18096,67;12512;-19,08;18096,67;2019-10-16;16/10/2019;CCM;Gastos_Seguros;Seguro vida;10;FIJO
18/10/2019;16/10/2019;T/ALIEXPRESS.COM;-0,85;18096,67;18095,82;12513;-0,85;18095,82;2019-10-16;16/10/2019;ALIEXPRESSCOM;Gastos_Compras;Hobbys;10;VARIABLES
19/10/2019;17/10/2019;T/ADY*NETFLIX;-11,99;18095,82;18083,83;12514;-11,99;18083,83;2019-10-17;17/10/2019;ADYNETFLIX;Gastos_Servicios tipicos;Servicios online;10;FIJO
20/10/2019;20/10/2019;T/WWW.JUST-EAT.ES 17-10-2019;-29,85;18083,83;18053,98;12515;-29,85;18053,98;2019-10-17;17/10/2019;WWWJUSTEATES;Gastos_Ocio y transporte;Restaurantes;10;VARIABLES
21/10/2019;21/10/2019;'R/L.EINA COOPERA L''EINA COOPE Reb';-85,00;18053,98;17968,98;12516;-85,00;17968,98;2019-10-21;21/10/2019;LEINA;Gastos_Salud, saber y deporte;Estudios;10;VARIABLES
21/10/2019;21/10/2019;T/WWW.JUST-EAT.ES 18-10-2019;-23,92;17968,98;17945,06;12517;-23,92;17945,06;2019-10-18;18/10/2019;WWWJUSTEATES;Gastos_Ocio y transporte;Restaurantes;10;VARIABLES
22/10/2019;19/10/2019;T/IKEA IBERICA WEB;-381,99;17945,06;17563,07;12518;-381,99;17563,07;2019-10-19;19/10/2019;IKEA;Gastos_Vivienda y vehiculo;Mnto. hogar;10;VARIABLES
22/10/2019;22/10/2019;T/WWW.JUST-EAT.ES 19-10-2019;-24,00;17563,07;17539,07;12519;-24,00;17539,07;2019-10-19;19/10/2019;WWWJUSTEATES;Gastos_Ocio y transporte;Restaurantes;10;VARIABLES
26/10/2019;28/10/2019;BONIF.COM.5540550276985025;12,00;17539,07;17551,07;12520;12,00;17551,07;2019-10-28;28/10/2019;BONIFCOM;Ingresos;Devoluciones;10;VARIABLES
26/10/2019;28/10/2019;COMIS.TARJETAS5540550276985025;-24,00;17551,07;17527,07;12521;-24,00;17527,07;2019-10-28;28/10/2019;COMISTARJETAS;Gastos_Banco y organismos;Cargos banco;10;FIJO
28/10/2019;28/10/2019;HAB.AJUNTAMENT DE TERRASSA Transfe;1879,97;17527,07;19407,04;12522;1879,97;19407,04;2019-10-28;28/10/2019;HABAJUNTAMENT;Ingresos;Nomina;10;FIJO
29/10/2019;29/10/2019;TRANSFBBVABCLM;1200,00;19407,04;20607,04;12523;1200,00;20607,04;2019-10-29;29/10/2019;TRANSFBBVABCLM;No computable;traspasos, transf.;10;
31/10/2019;31/10/2019;REC.6061.9600001223;-448,11;20607,04;20158,93;12524;-448,11;20158,93;2019-10-31;31/10/2019;REC;Gastos_Banco y organismos;Hipoteca;10;FIJO
31/10/2019;29/10/2019;DEV.COMPRA TJALIEXPRESS.COM;0,83;20158,93;20159,76;12525;0,83;20159,76;2019-10-29;29/10/2019;DEVCOMPRA;Ingresos;Devoluciones;10;VARIABLES
01/11/2019;01/11/2019;FACT TARJETASTARJ.CREDITO 07126017 19-11-01;-272,72;20159,76;19887,04;12526;-272,72;19887,04;2019-11-01;31/10/2019;FACT;No computable;Recibo Tarjeta;10;
01/11/2019;01/11/2019;FACT TARJETASTARJ.CREDITO 42689013 19-11-01;-969,64;19887,04;18917,40;12527;-969,64;18917,40;2019-11-01;31/10/2019;FACT;No computable;Recibo Tarjeta;10;
01/11/2019;01/11/2019;R/U.G.T. UGT CATALUNYA 2on;-78,60;18917,40;18838,80;12528;-78,60;18838,80;2019-11-01;01/11/2019;UGT;Gastos_Banco y organismos;Organismos;11;FIJO
05/11/2019;05/11/2019;TESORO PUBLICOI R P F (IMPTO;-108,06;18838,80;18730,74;12529;-108,06;18730,74;2019-11-05;05/11/2019;TESORO;Gastos_Banco y organismos;Impuestos;11;FIJO
06/11/2019;06/11/2019;'R/L.EINA COOPERA L''EINA COOPE Reb';-85,00;18730,74;18645,74;12530;-85,00;18645,74;2019-11-06;06/11/2019;LEINA;Gastos_Salud, saber y deporte;Estudios;11;VARIABLES
08/11/2019;08/11/2019;R/SERHS FOOD A Comedor Noviembre;-119,00;18645,74;18526,74;12531;-119,00;18526,74;2019-11-08;08/11/2019;SERHS;Gastos_Salud, saber y deporte;Menjador;11;FIJO
08/11/2019;08/11/2019;R/SERHS FOOD A Comedor Noviembre;-119,00;18526,74;18407,74;12532;-119,00;18407,74;2019-11-08;08/11/2019;SERHS;Gastos_Salud, saber y deporte;Menjador;11;FIJO
12/11/2019;12/11/2019;R/NATURGY IBER NATURGY2763048111;-4,69;18407,74;18403,05;12533;-4,69;18403,05;2019-11-12;12/11/2019;NATURGY;Gastos_Servicios tipicos;Gas;11;FIJO
13/11/2019;13/11/2019;R/TELEFONO VODAFONE;-92,63;18403,05;18310,42;12534;-92,63;18310,42;2019-11-13;13/11/2019;TELEFONO;Gastos_Servicios tipicos;Telecomunicaciones;11;FIJO
14/11/2019;14/11/2019;R/. FINQUES GASS Vto 01-11-19 Rec;-75,69;18310,42;18234,73;12535;-75,69;18234,73;2019-11-01;01/11/2019;FINQUES;Gastos_Vivienda y vehiculo;Alquiler Parking;11;FIJO
15/11/2019;15/11/2019;'R/L.EINA COOPERA L''EINA COOPE Reb';-10,00;18234,73;18224,73;12536;-10,00;18224,73;2019-11-15;15/11/2019;LEINA;Gastos_Salud, saber y deporte;Estudios;11;VARIABLES
18/11/2019;18/11/2019;R/SEGUROS CCM VIDA Y P Recibo:159;-15,46;18224,73;18209,27;12537;-15,46;18209,27;2019-11-18;18/11/2019;CCM;Gastos_Seguros;Seguro vida;11;FIJO
18/11/2019;18/11/2019;R/SEGUROS CCM VIDA Y P Recibo:159;-19,00;18209,27;18190,27;12538;-19,00;18190,27;2019-11-18;18/11/2019;CCM;Gastos_Seguros;Seguro vida;11;FIJO
18/11/2019;18/11/2019;R/LUZ ENDESA ENERG FACTURA DE ELE;-117,90;18190,27;18072,37;12539;-117,90;18072,37;2019-11-18;18/11/2019;ELE;Gastos_Servicios tipicos;Electricidad;11;FIJO
28/11/2019;28/11/2019;HAB.AJUNTAMENT DE TERRASSA Transfe;1901,60;18072,37;19973,97;12540;1901,60;19973,97;2019-11-28;28/11/2019;HABAJUNTAMENT;Ingresos;Nomina;11;FIJO
29/11/2019;29/11/2019;TRANSFBBVABCLM;1200,00;19973,97;21173,97;12541;1200,00;21173,97;2019-11-29;29/11/2019;TRANSFBBVABCLM;No computable;traspasos, transf.;11;
29/11/2019;29/11/2019;'R/AJUNTAMENT D I.B.I.  CA D''ALBI';-48,59;21173,97;21125,38;12542;-48,59;21125,38;2019-11-29;29/11/2019;AJUNTAMENT;Gastos_Banco y organismos;Ayuntamiento;11;FIJO
29/11/2019;27/11/2019;DEV.COMPRA TJALIEXPRESS.COM;1,57;21125,38;21126,95;12543;1,57;21126,95;2019-11-27;27/11/2019;DEVCOMPRA;Ingresos;Devoluciones;11;VARIABLES
30/11/2019;30/11/2019;REC.6061.9600001223;-448,11;21126,95;20678,84;12544;-448,11;20678,84;2019-11-30;30/11/2019;REC;Gastos_Banco y organismos;Hipoteca;11;FIJO
01/12/2019;01/12/2019;FACT TARJETASTARJ.CREDITO 07126017 19-12-01;-457,98;20678,84;20220,86;12545;-457,98;20220,86;2019-12-01;30/11/2019;FACT;No computable;Recibo Tarjeta;11;
01/12/2019;01/12/2019;FACT TARJETASTARJ.CREDITO 42689013 19-12-01;-1490,38;20220,86;18730,48;12546;-1490,38;18730,48;2019-12-01;30/11/2019;FACT;No computable;Recibo Tarjeta;11;
02/12/2019;02/12/2019;R/SEGUROS CAJA DE SEGU POL.953975;-467,92;18730,48;18262,56;12547;-467,92;18262,56;2019-12-02;02/12/2019;CAJA;Gastos_Seguros;Seguro hogar;12;FIJO
04/12/2019;04/12/2019;'R/L.EINA COOPERA L''EINA COOPE Reb';-85,00;18262,56;18177,56;12548;-85,00;18177,56;2019-12-04;04/12/2019;LEINA;Gastos_Salud, saber y deporte;Estudios;12;VARIABLES
05/12/2019;05/12/2019;R/LUZ ENDESA ENERG FACTURA DE GAS;-118,14;18177,56;18059,42;12549;-118,14;18059,42;2019-12-05;05/12/2019;GAS;Gastos_Servicios tipicos;Gas;12;FIJO
06/12/2019;06/12/2019;'R/L.EINA COOPERA L''EINA COOPE Reb';-40,00;18059,42;18019,42;12550;-40,00;18019,42;2019-12-06;06/12/2019;LEINA;Gastos_Salud, saber y deporte;Estudios;12;VARIABLES
09/12/2019;09/12/2019;R/SERHS FOOD A Comedor Diciembre;-77,35;18019,42;17942,07;12551;-77,35;17942,07;2019-12-09;09/12/2019;SERHS;Gastos_Salud, saber y deporte;Menjador;12;FIJO
09/12/2019;09/12/2019;R/SERHS FOOD A Comedor Diciembre;-77,35;17942,07;17864,72;12552;-77,35;17864,72;2019-12-09;09/12/2019;SERHS;Gastos_Salud, saber y deporte;Menjador;12;FIJO
11/12/2019;11/12/2019;R/. FINQUES GASS Vto 01-12-19 Rec;-75,69;17864,72;17789,03;12553;-75,69;17789,03;2019-12-01;01/12/2019;FINQUES;Gastos_Vivienda y vehiculo;Alquiler Parking;12;FIJO
13/12/2019;13/12/2019;R/NATURGY IBER NATURGY2763048121;-4,69;17789,03;17784,34;12554;-4,69;17784,34;2019-12-13;13/12/2019;NATURGY;Gastos_Servicios tipicos;Gas;12;FIJO
16/12/2019;16/12/2019;R/TELEFONO VODAFONE;-94,42;17784,34;17689,92;12555;-94,42;17689,92;2019-12-16;16/12/2019;TELEFONO;Gastos_Servicios tipicos;Telecomunicaciones;12;FIJO
17/12/2019;17/12/2019;R/SEGUROS CCM VIDA Y P Recibo:160;-16,39;17689,92;17673,53;12556;-16,39;17673,53;2019-12-17;17/12/2019;CCM;Gastos_Seguros;Seguro vida;12;FIJO
17/12/2019;17/12/2019;R/SEGUROS CCM VIDA Y P Recibo:160;-18,92;17673,53;17654,61;12557;-18,92;17654,61;2019-12-17;17/12/2019;CCM;Gastos_Seguros;Seguro vida;12;FIJO
20/12/2019;20/12/2019;R/ MINA PUBLICA AIGUES T.01A75789;-49,29;17654,61;17605,32;12558;-49,29;17605,32;2019-12-20;20/12/2019;MINA;Gastos_Servicios tipicos;Agua;12;FIJO
20/12/2019;20/12/2019;HAB.AJUNTAMENT DE TERRASSA Transfe;3956,62;17605,32;21561,94;12559;3956,62;21561,94;2019-12-20;20/12/2019;HABAJUNTAMENT;Ingresos;Nomina;12;FIJO
21/12/2019;19/12/2019;DEV.COMPRA TJALIEXPRESS.COM;4,87;21561,94;21566,81;12560;4,87;21566,81;2019-12-19;19/12/2019;DEVCOMPRA;Ingresos;Devoluciones;12;VARIABLES
21/12/2019;19/12/2019;DEV.COMPRA TJALIEXPRESS.COM;1,70;21566,81;21568,51;12561;1,70;21568,51;2019-12-19;19/12/2019;DEVCOMPRA;Ingresos;Devoluciones;12;VARIABLES
25/12/2019;23/12/2019;DEV.COMPRA TJALIEXPRESS.COM;1,66;21568,51;21570,17;12562;1,66;21570,17;2019-12-23;23/12/2019;DEVCOMPRA;Ingresos;Devoluciones;12;VARIABLES
27/12/2019;27/12/2019;R/AJUNTAMENT D TAXA RESIDUS  CA;-57,65;21570,17;21512,52;12563;-57,65;21512,52;2019-12-27;27/12/2019;AJUNTAMENT;Gastos_Banco y organismos;Ayuntamiento;12;FIJO
30/12/2019;30/12/2019;O/JESSICA CHRISTINE SADUSKIE INV;68,00;21512,52;21580,52;12564;68,00;21580,52;2019-12-30;30/12/2019;JESSICA;Ingresos;Transferencias;12;VARIABLES
31/12/2019;31/12/2019;REC.6061.9600001223;-448,11;21580,52;21132,41;12565;-448,11;21132,41;2019-12-31;31/12/2019;REC;Gastos_Banco y organismos;Hipoteca;12;FIJO
31/12/2019;31/12/2019;TRANSFBBVABCLM;1200,00;21132,41;22332,41;12566;1200,00;22332,41;2019-12-31;31/12/2019;TRANSFBBVABCLM;No computable;traspasos, transf.;12;
01/01/2020;01/01/2020;FACT TARJETASTARJ.CREDITO 07126017 20-01-01;-769,30;22332,41;21563,11;12567;-769,30;21563,11;2020-01-01;31/12/2019;FACT;No computable;Recibo Tarjeta;12;
01/01/2020;01/01/2020;FACT TARJETASTARJ.CREDITO 42689013 20-01-01;-1975,49;21563,11;19587,62;12568;-1975,49;19587,62;2020-01-01;31/12/2019;FACT;No computable;Recibo Tarjeta;12;
01/01/2020;30/12/2019;T/PLAYSTATIONNETWORK;-39,99;19587,62;19547,63;12569;-39,99;19547,63;2019-12-30;30/12/2019;PLAYSTATIONNETWORK;Gastos_Servicios tipicos;Servicios online;12;FIJO
02/01/2020;02/01/2020;R/U.G.T.       UGT CATALUNYA 1er;-40,05;19547,63;19507,58;12570;-40,05;19507,58;2020-01-02;02/01/2020;UGT;Gastos_Banco y organismos;Organismos;1;FIJO
06/01/2020;06/01/2020;'R/L.EINA COOPERA L''EINA COOPE Reb';-85,00;19507,58;19422,58;12571;-85,00;19422,58;2020-01-06;06/01/2020;LEINA;Gastos_Salud, saber y deporte;Estudios;1;VARIABLES
08/01/2020;08/01/2020;R/SERHS FOOD A Comedor Enero/ 20;-107,10;19422,58;19315,48;12572;-107,10;19315,48;2020-01-08;08/01/2020;SERHS;Gastos_Salud, saber y deporte;Menjador;1;FIJO
08/01/2020;08/01/2020;R/SERHS FOOD A Comedor Enero/ 20;-107,10;19315,48;19208,38;12573;-107,10;19208,38;2020-01-08;08/01/2020;SERHS;Gastos_Salud, saber y deporte;Menjador;1;FIJO
10/01/2020;10/01/2020;R/. FINQUES GASS R/42020-EUGENI F;-75,69;19208,38;19132,69;12574;-75,69;19132,69;2020-01-10;10/01/2020;FINQUES;Gastos_Vivienda y vehiculo;Alquiler Parking;1;FIJO
13/01/2020;13/01/2020;R/NATURGY IBER NATURGY2763048012;-4,69;19132,69;19128,00;12575;-4,69;19128,00;2020-01-13;13/01/2020;NATURGY;Gastos_Servicios tipicos;Gas;1;FIJO
14/01/2020;14/01/2020;R/TELEFONO VODAFONE;-97,16;19128,00;19030,84;12576;-97,16;19030,84;2020-01-14;14/01/2020;TELEFONO;Gastos_Servicios tipicos;Telecomunicaciones;1;FIJO
16/01/2020;16/01/2020;R/SEGUROS CCM VIDA Y P Recibo:160;-16,31;19030,84;19014,53;12577;-16,31;19014,53;2020-01-16;16/01/2020;CCM;Gastos_Seguros;Seguro vida;1;FIJO
16/01/2020;16/01/2020;R/SEGUROS CCM VIDA Y P Recibo:160;-18,84;19014,53;18995,69;12578;-18,84;18995,69;2020-01-16;16/01/2020;CCM;Gastos_Seguros;Seguro vida;1;FIJO
21/01/2020;21/01/2020;R/LUZ ENDESA ENERG FACTURA DE ELE;-130,57;18995,69;18865,12;12579;-130,57;18865,12;2020-01-21;21/01/2020;ELE;Gastos_Servicios tipicos;Electricidad;1;FIJO
28/01/2020;28/01/2020;HAB.AJUNTAMENT DE TERRASSA Transfe;1887,28;18865,12;20752,40;12580;1887,28;20752,40;2020-01-28;28/01/2020;HABAJUNTAMENT;Ingresos;Nomina;1;FIJO
29/01/2020;29/01/2020;TRANSFBBVABCLM;1200,00;20752,40;21952,40;12581;1200,00;21952,40;2020-01-29;29/01/2020;TRANSFBBVABCLM;No computable;traspasos, transf.;1;
31/01/2020;31/01/2020;REC.6061.9600001223;-448,11;21952,40;21504,29;12582;-448,11;21504,29;2020-01-31;31/01/2020;REC;Gastos_Banco y organismos;Hipoteca;1;FIJO
01/02/2020;01/02/2020;FACT TARJETASTARJ.CREDITO 07126017 20-02-01;-870,07;21504,29;20634,22;12583;-870,07;20634,22;2020-02-01;31/01/2020;FACT;No computable;Recibo Tarjeta;1;
01/02/2020;01/02/2020;FACT TARJETASTARJ.CREDITO 42689013 20-02-01;-1709,30;20634,22;18924,92;12584;-1709,30;18924,92;2020-02-01;31/01/2020;FACT;No computable;Recibo Tarjeta;1;
03/02/2020;03/02/2020;'R/AJUNTAMENT D I.B.I.  CA D''ALBI';-52,60;18924,92;18872,32;12585;-52,60;18872,32;2020-02-03;03/02/2020;AJUNTAMENT;Gastos_Banco y organismos;Ayuntamiento;2;FIJO
05/02/2020;05/02/2020;'R/L.EINA COOPERA L''EINA COOPE Reb';-85,00;18872,32;18787,32;12586;-85,00;18787,32;2020-02-05;05/02/2020;LEINA;Gastos_Salud, saber y deporte;Estudios;2;VARIABLES
05/02/2020;05/02/2020;R/LUZ ENDESA ENERG FACTURA DE GAS;-413,98;18787,32;18373,34;12587;-413,98;18373,34;2020-02-05;05/02/2020;GAS;Gastos_Servicios tipicos;Gas;2;FIJO
06/02/2020;06/02/2020;R/SERHS FOOD A Comedor Febrero/;-113,05;18373,34;18260,29;12588;-113,05;18260,29;2020-02-06;06/02/2020;SERHS;Gastos_Salud, saber y deporte;Menjador;2;FIJO
06/02/2020;06/02/2020;R/SERHS FOOD A Comedor Febrero/;-113,05;18260,29;18147,24;12589;-113,05;18147,24;2020-02-06;06/02/2020;SERHS;Gastos_Salud, saber y deporte;Menjador;2;FIJO
07/02/2020;07/02/2020;R/LUZ ENDESA ENERG FACTURA DE ELE;-39,06;18147,24;18108,18;12590;-39,06;18108,18;2020-02-07;07/02/2020;ELE;Gastos_Servicios tipicos;Electricidad;2;FIJO
11/02/2020;11/02/2020;R/. FINQUES GASS R/47697-EUGENI F;-75,69;18108,18;18032,49;12591;-75,69;18032,49;2020-02-11;11/02/2020;FINQUES;Gastos_Vivienda y vehiculo;Alquiler Parking;2;FIJO
11/02/2020;09/02/2020;T/AMZN Mktp ES*TK7Z363X5;-516,76;18032,49;17515,73;12592;-516,76;17515,73;2020-02-09;09/02/2020;AMZN;Gastos_Compras;Hobbys;2;VARIABLES
12/02/2020;12/02/2020;R/TELEFONO VODAFONE;-94,42;17515,73;17421,31;12593;-94,42;17421,31;2020-02-12;12/02/2020;TELEFONO;Gastos_Servicios tipicos;Telecomunicaciones;2;FIJO
13/02/2020;13/02/2020;R/NATURGY IBER NATURGY2763048022;-4,69;17421,31;17416,62;12594;-4,69;17416,62;2020-02-13;13/02/2020;NATURGY;Gastos_Servicios tipicos;Gas;2;FIJO
15/02/2020;12/02/2020;T/AMZN Mktp ES*TK7Z363X5;-32,28;17416,62;17384,34;12595;-32,28;17384,34;2020-02-12;12/02/2020;AMZN;Gastos_Compras;Hobbys;2;VARIABLES
18/02/2020;18/02/2020;R/SEGUROS CCM VIDA Y P Recibo:161;-16,24;17384,34;17368,10;12596;-16,24;17368,10;2020-02-18;18/02/2020;CCM;Gastos_Seguros;Seguro vida;2;FIJO
18/02/2020;18/02/2020;R/SEGUROS CCM VIDA Y P Recibo:161;-18,75;17368,10;17349,35;12597;-18,75;17349,35;2020-02-18;18/02/2020;CCM;Gastos_Seguros;Seguro vida;2;FIJO
18/02/2020;16/02/2020;T/AMZN Mktp ES*Y938C1NX5;-79,99;17349,35;17269,36;12598;-79,99;17269,36;2020-02-16;16/02/2020;AMZN;Gastos_Compras;Hobbys;2;VARIABLES
22/02/2020;20/02/2020;T/AMZN Mktp ES*DX1KH8X05;-117,86;17269,36;17151,50;12599;-117,86;17151,50;2020-02-20;20/02/2020;AMZN;Gastos_Compras;Hobbys;2;VARIABLES
26/02/2020;26/02/2020;HAB.AJUNTAMENT DE TERRASSA Transfe;1952,52;17151,50;19104,02;12600;1952,52;19104,02;2020-02-26;26/02/2020;HABAJUNTAMENT;Ingresos;Nomina;2;FIJO
29/02/2020;29/02/2020;REC.6061.9600001223;-448,11;19104,02;18655,91;12601;-448,11;18655,91;2020-02-29;29/02/2020;REC;Gastos_Banco y organismos;Hipoteca;2;FIJO
01/03/2020;01/03/2020;FACT TARJETASTARJ.CREDITO 07126017 20-03-01;-403,05;18655,91;18252,86;12602;-403,05;18252,86;2020-03-01;29/02/2020;FACT;No computable;Recibo Tarjeta;2;
01/03/2020;01/03/2020;FACT TARJETASTARJ.CREDITO 42689013 20-03-01;-1814,32;18252,86;16438,54;12603;-1814,32;16438,54;2020-03-01;29/02/2020;FACT;No computable;Recibo Tarjeta;2;
29/02/2020;29/02/2020;TRANSFBBVABCLM;1200,00;16438,54;17638,54;12604;1200,00;17638,54;2020-02-29;29/02/2020;TRANSFBBVABCLM;No computable;traspasos, transf.;2;
05/03/2020;05/03/2020;'R/L.EINA COOPERA L''EINA COOPE Reb';-85,00;17638,54;17553,54;12605;-85,00;17553,54;2020-03-05;05/03/2020;LEINA;Gastos_Salud, saber y deporte;Estudios;3;VARIABLES
06/03/2020;06/03/2020;R/SERHS FOOD A Comedor Marzo/ 20;-130,90;17553,54;17422,64;12606;-130,90;17422,64;2020-03-06;06/03/2020;SERHS;Gastos_Salud, saber y deporte;Menjador;3;FIJO
06/03/2020;06/03/2020;R/SERHS FOOD A Comedor Marzo/ 20;-130,90;17422,64;17291,74;12607;-130,90;17291,74;2020-03-06;06/03/2020;SERHS;Gastos_Salud, saber y deporte;Menjador;3;FIJO
11/03/2020;11/03/2020;R/TELEFONO VODAFONE;-94,42;17291,74;17197,32;12608;-94,42;17197,32;2020-03-11;11/03/2020;TELEFONO;Gastos_Servicios tipicos;Telecomunicaciones;3;FIJO
12/03/2020;12/03/2020;R/. FINQUES GASS R/50559-EUGENI F;-75,69;17197,32;17121,63;12609;-75,69;17121,63;2020-03-12;12/03/2020;FINQUES;Gastos_Vivienda y vehiculo;Alquiler Parking;3;FIJO
12/03/2020;12/03/2020;R/NATURGY IBER NATURGY2763048032;-4,69;17121,63;17116,94;12610;-4,69;17116,94;2020-03-12;12/03/2020;NATURGY;Gastos_Servicios tipicos;Gas;3;FIJO
17/03/2020;17/03/2020;R/SEGUROS CCM VIDA Y P Recibo:161;-16,17;17116,94;17100,77;12611;-16,17;17100,77;2020-03-17;17/03/2020;CCM;Gastos_Seguros;Seguro vida;3;FIJO
17/03/2020;17/03/2020;R/SEGUROS CCM VIDA Y P Recibo:161;-18,67;17100,77;17082,10;12612;-18,67;17082,10;2020-03-17;17/03/2020;CCM;Gastos_Seguros;Seguro vida;3;FIJO
18/03/2020;18/03/2020;R/TERRASSA CIC AIGUES T.E1A75789;-51,49;17082,10;17030,61;12613;-51,49;17030,61;2020-03-18;18/03/2020;TERRASSA;Gastos_Ocio y transporte;Gasolina;3;VARIABLES
27/03/2020;27/03/2020;HAB.AJUNTAMENT DE TERRASSA Transfe;1915,00;17030,61;18945,61;12614;1915,00;18945,61;2020-03-27;27/03/2020;HABAJUNTAMENT;Ingresos;Nomina;3;FIJO
31/03/2020;31/03/2020;REC.6061.9600001223;-448,11;18945,61;18497,50;12615;-448,11;18497,50;2020-03-31;31/03/2020;REC;Gastos_Banco y organismos;Hipoteca;3;FIJO
31/03/2020;31/03/2020;TRANSFBBVABCLM;1200,00;18497,50;19697,50;12616;1200,00;19697,50;2020-03-31;31/03/2020;TRANSFBBVABCLM;No computable;traspasos, transf.;3;
01/04/2020;01/04/2020;FACT TARJETASTARJ.CREDITO 07126017 20-04-01;-248,84;19697,50;19448,66;12617;-248,84;19448,66;2020-04-01;31/03/2020;FACT;No computable;Recibo Tarjeta;3;
01/04/2020;01/04/2020;FACT TARJETASTARJ.CREDITO 42689013 20-04-01;-1373,94;19448,66;18074,72;12618;-1373,94;18074,72;2020-04-01;31/03/2020;FACT;No computable;Recibo Tarjeta;3;
01/04/2020;01/04/2020;R/U.G.T.       UGT CATALUNYA 2on;-40,05;18074,72;18034,67;12619;-40,05;18034,67;2020-04-01;01/04/2020;UGT;Gastos_Banco y organismos;Organismos;4;FIJO
03/04/2020;03/04/2020;R/SEGUROS SEGUROS CATA INCLUIDO S;-377,28;18034,67;17657,39;12620;-377,28;17657,39;2020-04-03;03/04/2020;CATA;Gastos_Seguros;Seguro auto;4;FIJO
14/04/2020;14/04/2020;R/. FINQUES GASS R/53339-EUGENI F;-75,69;17657,39;17581,70;12621;-75,69;17581,70;2020-04-14;14/04/2020;FINQUES;Gastos_Vivienda y vehiculo;Alquiler Parking;4;FIJO
15/04/2020;15/04/2020;R/NATURGY IBER NATURGY2763048042;-4,69;17581,70;17577,01;12622;-4,69;17577,01;2020-04-15;15/04/2020;NATURGY;Gastos_Servicios tipicos;Gas;4;FIJO
15/04/2020;15/04/2020;R/TELEFONO VODAFONE;-149,92;17577,01;17427,09;12623;-149,92;17427,09;2020-04-15;15/04/2020;TELEFONO;Gastos_Servicios tipicos;Telecomunicaciones;4;FIJO
15/04/2020;15/04/2020;R/LUZ ENDESA ENERG FACTURA DE ELE;-134,10;17427,09;17292,99;12624;-134,10;17292,99;2020-04-15;15/04/2020;ELE;Gastos_Servicios tipicos;Electricidad;4;FIJO
16/04/2020;16/04/2020;R/SEGUROS CCM VIDA Y P Recibo:162;-18,58;17292,99;17274,41;12625;-18,58;17274,41;2020-04-16;16/04/2020;CCM;Gastos_Seguros;Seguro vida;4;FIJO
16/04/2020;16/04/2020;R/SEGUROS CCM VIDA Y P Recibo:162;-16,09;17274,41;17258,32;12626;-16,09;17258,32;2020-04-16;16/04/2020;CCM;Gastos_Seguros;Seguro vida;4;FIJO
16/04/2020;16/04/2020;R/LUZ ENDESA ENERG FACTURA DE GAS;-105,45;17258,32;17152,87;12627;-105,45;17152,87;2020-04-16;16/04/2020;GAS;Gastos_Servicios tipicos;Gas;4;FIJO
25/04/2020;23/04/2020;T/AMZN Mktp ES*T619V2O65;-29,99;17152,87;17122,88;12628;-29,99;17122,88;2020-04-23;23/04/2020;AMZN;Gastos_Compras;Hobbys;4;VARIABLES
28/04/2020;28/04/2020;HAB.AJUNTAMENT DE TERRASSA Transfe;1928,51;17122,88;19051,39;12629;1928,51;19051,39;2020-04-28;28/04/2020;HABAJUNTAMENT;Ingresos;Nomina;4;FIJO
29/04/2020;29/04/2020;HAB.NESTOR LOPEZ ROYO;1200,00;19051,39;20251,39;12630;1200,00;20251,39;2020-04-29;29/04/2020;HABNESTOR;Ingresos;Nomina;4;FIJO
30/04/2020;30/04/2020;REC.6061.9600001223;-448,11;20251,39;19803,28;12631;-448,11;19803,28;2020-04-30;30/04/2020;REC;Gastos_Banco y organismos;Hipoteca;4;FIJO
01/05/2020;01/05/2020;FACT TARJETASTARJ.CREDITO 07126017 20-05-01;-249,18;19803,28;19554,10;12632;-249,18;19554,10;2020-05-01;30/04/2020;FACT;No computable;Recibo Tarjeta;4;
01/05/2020;01/05/2020;FACT TARJETASTARJ.CREDITO 42689013 20-05-01;-1870,44;19554,10;17683,66;12633;-1870,44;17683,66;2020-05-01;30/04/2020;FACT;No computable;Recibo Tarjeta;4;
11/05/2020;11/05/2020;R/. FINQUES GASS R/56182-EUGENI F;-75,69;17683,66;17607,97;12634;-75,69;17607,97;2020-05-11;11/05/2020;FINQUES;Gastos_Vivienda y vehiculo;Alquiler Parking;5;FIJO
12/05/2020;12/05/2020;R/NATURGY IBER NATURGY2763048052;-4,69;17607,97;17603,28;12635;-4,69;17603,28;2020-05-12;12/05/2020;NATURGY;Gastos_Servicios tipicos;Gas;5;FIJO
13/05/2020;13/05/2020;R/TELEFONO VODAFONE;-149,42;17603,28;17453,86;12636;-149,42;17453,86;2020-05-13;13/05/2020;TELEFONO;Gastos_Servicios tipicos;Telecomunicaciones;5;FIJO
18/05/2020;18/05/2020;R/SEGUROS CCM VIDA Y P Recibo:162;-16,02;17453,86;17437,84;12637;-16,02;17437,84;2020-05-18;18/05/2020;CCM;Gastos_Seguros;Seguro vida;5;FIJO
18/05/2020;18/05/2020;R/SEGUROS CCM VIDA Y P Recibo:162;-18,49;17437,84;17419,35;12638;-18,49;17419,35;2020-05-18;18/05/2020;CCM;Gastos_Seguros;Seguro vida;5;FIJO
28/05/2020;28/05/2020;HAB.AJUNTAMENT DE TERRASSA Transfe;1915,52;17419,35;19334,87;12639;1915,52;19334,87;2020-05-28;28/05/2020;HABAJUNTAMENT;Ingresos;Nomina;5;FIJO
29/05/2020;29/05/2020;HAB.NESTOR LOPEZ ROYO;1200,00;19334,87;20534,87;12640;1200,00;20534,87;2020-05-29;29/05/2020;HABNESTOR;Ingresos;Nomina;5;FIJO
31/05/2020;31/05/2020;REC.6061.9600001223;-448,11;20534,87;20086,76;12641;-448,11;20086,76;2020-05-31;31/05/2020;REC;Gastos_Banco y organismos;Hipoteca;5;FIJO
01/06/2020;01/06/2020;O/SERHS FOOD AREA S.L.;77,35;20086,76;20164,11;12642;77,35;20164,11;2020-06-01;01/06/2020;SERHS;Gastos_Salud, saber y deporte;Menjador;6;FIJO
01/06/2020;01/06/2020;O/SERHS FOOD AREA S.L.;77,35;20164,11;20241,46;12643;77,35;20241,46;2020-06-01;01/06/2020;SERHS;Gastos_Salud, saber y deporte;Menjador;6;FIJO
01/06/2020;01/06/2020;'R/AJUNTAMENT D I.B.I. CA D''ALBI';-52,60;20241,46;20188,86;12644;-52,60;20188,86;2020-06-01;01/06/2020;AJUNTAMENT;Gastos_Banco y organismos;Ayuntamiento;6;FIJO
01/06/2020;01/06/2020;FACT TARJETASTARJ.CREDITO 07126017 20-06-01;-24,09;20188,86;20164,77;12645;-24,09;20164,77;2020-06-01;31/05/2020;FACT;No computable;Recibo Tarjeta;5;
01/06/2020;01/06/2020;FACT TARJETASTARJ.CREDITO 42689013 20-06-01;-954,17;20164,77;19210,60;12646;-954,17;19210,60;2020-06-01;31/05/2020;FACT;No computable;Recibo Tarjeta;5;
04/06/2020;04/06/2020;R/LUZ ENDESA ENERG FACTURA DE GAS;-4,16;19210,60;19206,44;12647;-4,16;19206,44;2020-06-04;04/06/2020;GAS;Gastos_Servicios tipicos;Gas;6;FIJO
04/06/2020;02/06/2020;DEV.COMPRA TJAMZ*CHUWI-Direct;341,10;19206,44;19547,54;12648;341,10;19547,54;2020-06-02;02/06/2020;DEVCOMPRA;Ingresos;Devoluciones;6;VARIABLES
